id,departure_timestamp,arrival_timestamp,duration,from_id,to_id,from_country,to_country
132106,1699752060,1699756020,3960,134035,152015,GB,GB
113946,1700161260,1700164920,3660,106633,143058,GB,GB
8133,1698968820,1698984360,15540,112299,41799,US,US
76428,1699612800,1699623720,10920,101242,161310,IT,IT
142924,1699275540,1699279140,3600,3341,166206,GB,GB
45235,1700362620,1700372160,9540,195779,191791,IT,IT
72357,1699661880,1699675620,13740,4363,42445,US,US
181545,1699595460,1699613400,17940,106660,152920,AT,SK
160851,1700537940,1700541540,3600,138449,130486,NL,NL
45765,1699392360,1699395960,3600,91747,82399,GB,GB
92529,1700529660,1700533320,3660,157587,164758,GB,GB
9389,1700577120,1700590440,13320,116623,130362,IT,IT
114847,1699273740,1699309680,35940,66891,71746,TR,TR
81932,1700717460,1700749980,32520,66823,112590,TR,TR
183310,1698855480,1698859080,3600,118342,59410,NL,NL
197501,1699521060,1699546560,25500,123592,52675,DE,BG
104008,1700840880,1700850660,9780,18771,28147,IT,IT
2680,1700200500,1700231760,31260,37999,40516,TR,TR
197898,1700470440,1700502840,32400,155864,10956,TR,TR
1239,1699363980,1699368300,4320,1976,58704,AD,FR
168799,1700524860,1700558340,33480,120956,69566,TR,TR
147838,1700269920,1700273520,3600,191811,71456,GB,GB
168182,1700653740,1700665740,12000,144846,99579,US,US
163403,1699805880,1699835880,30000,103591,124885,TR,TR
191550,1700439900,1700464560,24660,133641,121213,DE,DE
94850,1700796300,1700812200,15900,116759,132449,FR,FR
192160,1699464060,1699494900,30840,24938,50167,TR,TR
40984,1698973860,1698986280,12420,22806,182334,IT,IT
93574,1699262100,1699274820,12720,26260,33762,US,US
199309,1699495020,1699505640,10620,66905,99896,HR,HR
178569,1700101440,1700130360,28920,163936,123883,TR,TR
61261,1700319900,1700351100,31200,33538,198098,TR,TR
98860,1699041300,1699074960,33660,166971,159552,TR,TR
168931,1700109060,1700134620,25560,93059,53274,DE,FR
162827,1700079720,1700091780,12060,117950,72455,IT,IT
84468,1700149380,1700152980,3600,153480,109656,GB,GB
67460,1699552260,1699569360,17100,145620,12979,SE,SE
103326,1699299120,1699306140,7020,165546,180174,GB,GB
102526,1699156440,1699183440,27000,48267,43191,PL,PL
41266,1700408940,1700437260,28320,139253,144664,DE,HU
76066,1700223420,1700232240,8820,38706,29194,IT,HU
33396,1699629060,1699654020,24960,184243,89398,DE,DE
53818,1699734060,1699762740,28680,132362,125151,BA,HR
183553,1699333380,1699348020,14640,109029,47233,US,US
146568,1699686600,1699691220,4620,44232,59553,NL,NL
94696,1699202520,1699216980,14460,28786,127396,FR,FR
39590,1699646100,1699680360,34260,30946,136722,TR,TR
191216,1700020680,1700034480,13800,186043,76319,HR,HR
112861,1699613940,1699627320,13380,171483,169433,HR,HR
79255,1699801800,1699805400,3600,124508,76212,GB,GB
193262,1700488020,1700491620,3600,111631,169632,GB,GB
8178,1700628300,1700639700,11400,174889,124732,SK,SK
26798,1700568480,1700593980,25500,190610,93939,BR,BR
150311,1699477260,1699490700,13440,62444,24398,US,US
38026,1698875040,1698905640,30600,123216,40839,TR,TR
21486,1700771400,1700786400,15000,78345,62093,US,US
90619,1700670780,1700702880,32100,44906,101881,TR,TR
155269,1699686180,1699718340,32160,134314,56458,TR,TR
12529,1700098680,1700111280,12600,20336,133387,US,US
71022,1698921960,1698951300,29340,101634,11543,TR,TR
187267,1700294640,1700300940,6300,84515,27890,GB,GB
135450,1699700160,1699756200,56040,62021,56233,BG,AT
2768,1700784420,1700808840,24420,75220,47845,RO,RO
176805,1700416200,1700451720,35520,53271,38417,TR,TR
147923,1699713120,1699717800,4680,33689,9154,GB,GB
37966,1699412280,1699425600,13320,128215,150808,US,US
10122,1698816300,1698821700,5400,123256,68366,GB,GB
112135,1699126740,1699138380,11640,164901,129385,ES,ES
21463,1699225020,1699241280,16260,32440,56531,US,US
129488,1700726940,1700759820,32880,40279,81018,TR,TR
74821,1699393080,1699426020,32940,160096,81911,TR,TR
104747,1699715040,1699727520,12480,137507,152449,US,US
89681,1699046280,1699065780,19500,108273,171308,BE,NL
25372,1699754520,1699763760,9240,33347,95704,HR,HR
114387,1700577420,1700591580,14160,112537,84864,HR,HR
188536,1700109840,1700123580,13740,158300,95438,PT,PT
79481,1699000620,1699017480,16860,143005,53291,RS,SI
113298,1700865840,1700876940,11100,66432,22139,CZ,CZ
34381,1698971520,1698984780,13260,175406,83580,RS,RS
101224,1699701840,1699712520,10680,117519,89310,HR,HR
54546,1700081040,1700098380,17340,62754,128473,FR,DE
3235,1700540940,1700555640,14700,66075,80480,US,US
179255,1698831480,1698835080,3600,154930,82008,GB,GB
138910,1700031180,1700059920,28740,72458,140550,PL,DE
77409,1699078740,1699109820,31080,83414,56953,TR,TR
6896,1699321260,1699356780,35520,10502,39992,TR,TR
15886,1699869420,1699898760,29340,19550,74035,TR,TR
47732,1699959900,1699968660,8760,113655,156069,ES,ES
175471,1699128660,1699132260,3600,89845,75732,GB,GB
144483,1700229480,1700242440,12960,38654,100209,US,US
180024,1698872640,1698903720,31080,173125,153708,TR,TR
39379,1700394840,1700430600,35760,192239,119750,TR,TR
183065,1699023000,1699053180,30180,27325,25864,TR,TR
31991,1700117160,1700152380,35220,31896,124616,TR,TR
82955,1699026780,1699044000,17220,29364,4669,AT,SK
170993,1698957480,1698991500,34020,90099,150683,TR,TR
71282,1700704320,1700735460,31140,182780,86168,TR,TR
110821,1699325880,1699356480,30600,191935,100961,TR,TR
69709,1700594760,1700611140,16380,43779,190620,AT,RS
145433,1699562700,1699577580,14880,162220,123175,AT,AT
42046,1700136600,1700140200,3600,162448,157578,GB,GB
14213,1700102400,1700119980,17580,183011,86814,US,US
51265,1699068780,1699081200,12420,79856,73835,US,US
17420,1699507740,1699536780,29040,37983,79513,TR,TR
20382,1700064180,1700094900,30720,156313,99192,TR,TR
31228,1700615100,1700648640,33540,89835,76580,TR,TR
113409,1700019660,1700055480,35820,42217,191573,TR,TR
164444,1699354680,1699385820,31140,28237,32939,TR,TR
114266,1699713720,1699747800,34080,100775,147512,MX,US
16101,1699480740,1699514100,33360,156611,106187,TR,TR
15017,1700496480,1700531400,34920,121317,164166,TR,TR
51508,1698936000,1698953400,17400,4354,175798,US,US
131921,1699305780,1699338000,32220,138652,75181,TR,TR
119876,1699258140,1699265280,7140,171880,176729,NL,NL
27996,1700620500,1700633280,12780,167250,195027,IT,IT
126480,1699038840,1699073940,35100,109109,160780,TR,TR
56915,1699330080,1699362720,32640,177585,104437,TR,TR
77533,1699861920,1699890840,28920,78173,172745,TR,TR
142102,1700605020,1700608620,3600,44180,144986,NL,NL
127305,1700450040,1700485860,35820,83853,158001,TR,TR
63385,1700109240,1700114640,5400,186439,194265,NL,NL
28659,1700005560,1700040120,34560,81706,41877,TR,TR
35095,1699862880,1699873800,10920,172091,161031,US,US
172501,1700594940,1700621100,26160,157784,80320,BR,BR
163350,1699504800,1699534140,29340,192652,99777,TR,TR
97815,1699459140,1699466940,7800,117941,25519,IT,IT
34373,1699053720,1699057860,4140,144027,112201,GB,GB
187140,1699346580,1699380720,34140,24640,56815,TR,TR
143345,1699190820,1699225500,34680,7775,27675,TR,TR
72217,1699540620,1699549680,9060,10954,168927,SK,AT
70589,1700715600,1700751540,35940,157075,94124,TR,TR
177404,1700371800,1700401140,29340,12869,64821,TR,TR
26946,1700570520,1700599680,29160,118557,148566,TR,TR
110469,1699495980,1699511400,15420,106681,184374,US,US
69703,1699539480,1699570260,30780,120945,20552,TR,TR
81180,1699911060,1699924980,13920,189770,172682,CZ,PL
14161,1700748960,1700754600,5640,1183,113897,GB,GB
163540,1700571660,1700585340,13680,38425,183260,IT,IT
57153,1700452200,1700455800,3600,34797,48456,NL,NL
91383,1699534080,1699540800,6720,61226,160642,GB,GB
157278,1699117260,1699126800,9540,174403,57778,IT,IT
40697,1700842620,1700877720,35100,32395,194699,TR,TR
26234,1700291640,1700307960,16320,48894,33843,CA,US
68419,1698940740,1698952380,11640,93968,91455,AT,BG
105694,1699028460,1699036320,7860,181748,112303,ES,ES
178015,1699797960,1699829880,31920,36338,61154,TR,TR
137901,1699113060,1699144800,31740,72850,74210,TR,TR
194491,1699091400,1699100580,9180,41673,20990,IT,IT
81364,1699990380,1700007420,17040,130113,27063,FR,BE
24248,1699992540,1700010720,18180,5029,12376,FR,BE
133011,1699710600,1699738620,28020,126505,9749,DE,HU
37381,1698964020,1698975300,11280,139446,42171,US,US
157706,1699695540,1699727220,31680,108916,147151,TR,TR
7710,1700555880,1700589780,33900,29236,30037,MX,MX
38769,1700407800,1700416800,9000,99045,37088,HR,BA
8088,1699344600,1699355760,11160,95586,30222,HR,HR
38337,1699069620,1699101720,32100,187539,119862,TR,TR
46561,1700836080,1700869380,33300,108898,73580,TR,TR
31476,1700231640,1700265900,34260,135863,183372,TR,TR
42248,1699159860,1699194420,34560,127426,39338,TR,TR
90054,1700007240,1700011800,4560,42171,140567,NL,NL
161348,1699538280,1699573320,35040,90739,57883,TR,TR
184573,1700206140,1700209740,3600,11479,4549,NL,NL
38372,1699327560,1699361400,33840,149301,33880,TR,TR
130389,1699458240,1699479900,21660,78769,127280,RO,RO
175907,1699899180,1699911960,12780,115793,152068,US,US
146724,1699086660,1699116180,29520,165493,7461,TR,TR
2175,1698818760,1698822840,4080,171227,198358,GB,GB
142488,1699019700,1699023300,3600,23341,116955,GB,GB
146976,1700186220,1700202780,16560,122090,107336,RS,RS
192263,1699613100,1699616700,3600,132229,80890,GB,GB
119201,1699186380,1699208520,22140,99935,40806,BR,BR
81769,1700459820,1700464680,4860,35357,10053,NL,GB
93473,1699902720,1699906980,4260,12379,171034,GB,GB
177398,1700488860,1700523600,34740,198021,129556,TR,TR
189350,1699301520,1699335600,34080,84919,184650,TR,TR
104129,1700710020,1700715840,5820,73802,6897,GB,GB
144241,1700041140,1700071980,30840,33432,165421,TR,TR
185863,1698801840,1698811920,10080,116745,79231,HR,HR
94070,1699413780,1699419000,5220,197873,96967,GB,GB
37589,1700505780,1700509380,3600,86863,116111,NL,NL
110005,1699995000,1700008620,13620,66448,74679,IT,IT
147950,1698909180,1698921660,12480,90853,99742,HR,HR
103296,1700334060,1700347800,13740,71477,37548,IT,IT
52835,1699367640,1699397400,29760,46921,12632,TR,TR
113243,1700187900,1700197740,9840,99739,167288,IT,IT
167422,1700410560,1700445240,34680,55330,189801,TR,TR
55149,1699588440,1699618140,29700,145625,151245,TR,TR
146293,1699523280,1699526880,3600,176918,84176,GB,GB
97317,1699585800,1699615260,29460,79304,16739,TR,TR
72098,1700713740,1700728500,14760,65845,113083,AT,BG
25156,1699907700,1699941360,33660,21625,18753,TR,TR
198780,1699527480,1699549440,21960,83933,163188,DE,DE
197397,1698870960,1698904680,33720,194932,113300,TR,TR
157163,1699474860,1699491180,16320,172626,69958,CZ,DK
165487,1699280580,1699312500,31920,135880,45571,TR,TR
139614,1699089720,1699102200,12480,90859,14263,ES,ES
146933,1699056780,1699086900,30120,185971,95492,TR,TR
105035,1700047440,1700079660,32220,67427,62105,TR,TR
100849,1700466900,1700502360,35460,117410,11886,TR,TR
120731,1700464260,1700486460,22200,119940,79066,PL,PL
189519,1698940740,1698972780,32040,186015,116999,TR,TR
141530,1699088880,1699121400,32520,149949,162519,MX,MX
186765,1699601940,1699611840,9900,183493,112771,IT,IT
4052,1700846340,1700882100,35760,67911,39670,TR,TR
73725,1700259300,1700262900,3600,52141,51369,NL,NL
1231,1699645140,1699678140,33000,155172,142766,TR,TR
167170,1699177860,1699188840,10980,112720,39759,HR,HR
162732,1699944660,1699975980,31320,13427,126493,TR,TR
171788,1699007280,1699021440,14160,158683,105225,US,US
144598,1699957080,1699970640,13560,56778,100005,US,US
18489,1699582920,1699593420,10500,42454,131816,HR,BA
85605,1699498200,1699530000,31800,47764,57553,TR,TR
180023,1699539900,1699557420,17520,193199,15900,CZ,CZ
2704,1699558440,1699569240,10800,111851,37338,IT,IT
104816,1699480860,1699489620,8760,99375,67490,IT,IT
143307,1699596120,1699626240,30120,181013,87767,TR,TR
136477,1700223960,1700252880,28920,30574,174970,TR,TR
28919,1700085240,1700120760,35520,72015,105984,MX,MX
63776,1700325120,1700337660,12540,28162,55146,IT,IT
39099,1700404200,1700409600,5400,131809,28667,GB,GB
160905,1700754480,1700761500,7020,100151,132403,AD,ES
167802,1699308900,1699342200,33300,179497,56978,TR,TR
45483,1699909740,1699927380,17640,133818,53689,CZ,AT
57461,1699532100,1699543500,11400,140452,95341,IT,IT
116975,1699069980,1699103940,33960,174861,39514,TR,TR
167817,1700141100,1700145360,4260,48709,154103,GB,GB
5584,1699704960,1699739640,34680,26653,135240,TR,TR
148530,1700658120,1700670300,12180,172236,10086,US,US
75875,1700203920,1700216280,12360,37017,149133,US,US
183728,1700219520,1700252700,33180,168864,19057,TR,TR
107370,1699131900,1699162020,30120,85415,124795,TR,TR
14701,1699927920,1699934040,6120,119524,18869,NL,NL
10977,1700213940,1700236380,22440,152143,130571,DE,DE
21225,1699606440,1699610040,3600,176123,3042,GB,GB
187958,1698892260,1698924300,32040,49572,13854,TR,TR
145587,1699814760,1699824060,9300,18759,187150,IT,IT
195935,1700535360,1700562720,27360,189260,7063,DE,CZ
107822,1698906240,1698933720,27480,162673,52711,DE,BG
123309,1699826820,1699855560,28740,47708,106527,CH,DE
113209,1699252140,1699264740,12600,85759,188280,US,US
87846,1699476360,1699489440,13080,28149,35914,CZ,EE
105296,1698937380,1698976800,39420,4510,69817,MX,MX
193896,1699782600,1699818120,35520,65697,15089,TR,TR
110749,1699434720,1699470180,35460,127054,50775,MX,MX
77243,1699666020,1699696440,30420,119561,158790,TR,TR
103952,1699348380,1699375440,27060,98578,159429,RO,RO
94550,1700540760,1700555160,14400,74790,182239,US,US
89878,1699984500,1700017920,33420,63363,159839,TR,TR
46727,1698999420,1699028580,29160,6369,20965,TR,TR
155689,1700333340,1700336940,3600,178638,36321,GB,GB
123968,1700095260,1700128320,33060,135647,29060,TR,TR
20228,1700096760,1700101440,4680,166764,89546,GB,GB
28651,1698963900,1698973080,9180,132496,188299,ES,ES
83579,1700029500,1700053740,24240,166242,175045,DE,NL
21776,1699501980,1699531560,29580,10432,107997,TR,TR
86636,1699660200,1699694520,34320,61080,86631,TR,TR
189684,1698837720,1698873480,35760,44300,36711,TR,TR
1548,1700505240,1700509500,4260,192393,178366,GB,GB
133195,1699740300,1699753140,12840,169883,197796,US,US
79933,1700439300,1700461200,21900,43517,57139,DE,DE
171279,1699553820,1699557420,3600,142664,91537,GB,GB
177801,1700108220,1700141160,32940,101843,51518,TR,TR
29614,1699858320,1699863420,5100,166876,28065,GB,GB
159521,1699363080,1699392060,28980,199052,152216,TR,TR
57707,1700847600,1700878500,30900,110451,79124,TR,TR
68593,1700464200,1700472900,8700,131096,91119,IT,IT
199668,1699013280,1699027200,13920,115390,86198,ES,PT
175209,1699207740,1699247280,39540,65525,11257,MX,MX
13392,1699967160,1699974000,6840,125385,51755,GB,GB
164932,1700160600,1700164200,3600,60338,145298,GB,GB
6929,1699314420,1699318440,4020,18681,170866,GB,GB
37091,1699750860,1699786080,35220,11889,25520,TR,TR
47809,1700355420,1700387940,32520,52344,8547,TR,TR
113241,1699124340,1699137900,13560,919,46129,AT,AT
55500,1699278900,1699299780,20880,154219,44630,FR,FR
14725,1699770240,1699803360,33120,140529,168030,TR,TR
199388,1698973200,1698986280,13080,43651,67458,US,US
126424,1699354200,1699357800,3600,165874,188473,GB,GB
124819,1700818380,1700835000,16620,72570,53415,US,US
138758,1698829140,1698859260,30120,41954,23630,TR,TR
62794,1699851900,1699862460,10560,62695,77720,IT,IT
54728,1700216700,1700220300,3600,91229,71191,GB,GB
193601,1700777220,1700811540,34320,60909,28027,MX,MX
182287,1699643040,1699677000,33960,35465,81908,MK,RS
57834,1700232000,1700262120,30120,196536,40983,TR,TR
116563,1699659780,1699670400,10620,54708,128877,SK,SK
116607,1699284420,1699297560,13140,153768,74282,US,US
16944,1699707120,1699729560,22440,180554,175632,RO,RO
65680,1700519700,1700529180,9480,127117,78572,PT,PT
16416,1699437960,1699466940,28980,20436,26387,TR,TR
119193,1700473020,1700490240,17220,68827,132810,US,US
94333,1700350740,1700382900,32160,129517,69801,TR,TR
36600,1699410060,1699413660,3600,39502,120217,NL,NL
40633,1700406000,1700417460,11460,89657,70039,IT,HR
196957,1700224620,1700257620,33000,183492,138838,MX,MX
109098,1699690800,1699702320,11520,62782,13711,US,US
185218,1699894020,1699923540,29520,61885,198923,TR,TR
81850,1700101500,1700133900,32400,12520,118994,TR,TR
31659,1698854520,1698858120,3600,32566,100148,GB,GB
32335,1700130900,1700165160,34260,27145,9566,TR,TR
61298,1698833460,1698850140,16680,108766,175597,RS,RS
120888,1699839780,1699869600,29820,68119,95085,TR,TR
122176,1699917960,1699948620,30660,42942,197567,TR,TR
48115,1699113780,1699117380,3600,95132,126126,GB,GB
73858,1700214840,1700245020,30180,143533,72309,TR,TR
137646,1698894480,1698904740,10260,139429,94573,HR,HR
189654,1699043520,1699058100,14580,197367,94333,US,US
146719,1700009760,1700026800,17040,1123,29744,FR,FR
147138,1699678260,1699711500,33240,5945,154793,TR,TR
162879,1700341980,1700367300,25320,137210,170173,BA,BA
156789,1698840900,1698854460,13560,173114,159164,US,US
131299,1699448400,1699465800,17400,159253,48532,US,US
4363,1700409660,1700422020,12360,53429,195637,HR,DE
140104,1700255160,1700259360,4200,67612,100575,GB,GB
53424,1699572780,1699585080,12300,153553,138725,US,US
143253,1700006400,1700010000,3600,144377,194323,NL,NL
69559,1699502280,1699539660,37380,175765,139189,MX,MX
118774,1699135320,1699145760,10440,96453,65890,IT,IT
132444,1700429520,1700447400,17880,180881,137906,FR,FR
125026,1699874280,1699877880,3600,3110,134138,GB,GB
84168,1699023960,1699058100,34140,23486,45576,TR,TR
90502,1700612940,1700641500,28560,7746,40788,PL,PL
52217,1700622540,1700656440,33900,185296,154294,TR,TR
15567,1699562820,1699568940,6120,26927,8499,GB,GB
153035,1700748120,1700777700,29580,116235,125728,TR,TR
106254,1699100940,1699111860,10920,108218,133173,ES,ES
46811,1699471740,1699487640,15900,155173,187047,US,CA
62382,1698869040,1698876960,7920,78221,61969,IT,IT
57045,1700699640,1700730840,31200,44956,128757,TR,TR
150648,1700133360,1700167800,34440,161416,41447,TR,TR
47269,1700162400,1700166300,3900,139034,63897,GB,GB
51427,1699311960,1699341180,29220,135794,137309,TR,TR
149190,1700255940,1700268840,12900,51343,111452,US,US
30842,1699639140,1699647960,8820,180396,113949,IT,IT
181168,1698800640,1698831900,31260,70076,155950,TR,TR
93659,1699467240,1699486620,19380,111568,88097,FR,FR
148612,1700038560,1700052720,14160,70943,19644,US,US
110099,1700441280,1700453460,12180,18104,112406,IT,IT
166021,1699613520,1699646940,33420,42531,123096,TR,TR
175036,1700809740,1700843280,33540,134840,163333,TR,TR
94135,1699584540,1699605300,20760,110641,14798,FR,IT
186397,1699760580,1699764180,3600,138469,78578,GB,GB
7705,1699195920,1699209780,13860,62887,98212,US,US
173911,1699543140,1699569660,26520,74482,31488,RO,RO
35293,1699697760,1699729140,31380,178834,16524,TR,TR
82035,1699405440,1699435920,30480,166140,129159,TR,TR
54417,1698859980,1698892440,32460,161188,113407,TR,TR
85976,1699721220,1699740960,19740,197986,183567,FR,RS
153217,1699894980,1699909980,15000,47874,187794,US,US
105941,1699794000,1699797720,3720,134103,170715,NL,NL
84948,1699660080,1699671900,11820,186171,10479,CZ,CZ
74478,1700194080,1700228820,34740,65904,153194,TR,TR
74637,1699877400,1699907640,30240,130363,175100,TR,TR
14082,1698935220,1698940860,5640,134933,10030,GB,GB
130044,1698809100,1698812700,3600,92695,177460,GB,GB
196436,1698935520,1698939120,3600,101712,148787,GB,GB
81274,1698805440,1698833880,28440,62479,77875,BR,BR
169915,1699247880,1699270620,22740,107097,62049,PL,PL
93676,1699632180,1699665180,33000,132444,50153,MX,MX
67388,1700428020,1700437980,9960,148148,180366,EE,FI
63322,1700313120,1700345460,32340,135862,104772,TR,TR
183270,1699273500,1699305780,32280,122157,4307,TR,TR
190943,1699112520,1699124880,12360,94036,120827,RS,RS
141002,1699117140,1699148760,31620,163033,31639,TR,TR
24143,1699173540,1699177140,3600,145858,187009,NL,HR
55943,1699911060,1699916340,5280,67382,116924,GB,GB
165815,1699015620,1699050300,34680,124604,114497,TR,TR
98128,1698946080,1698953520,7440,90757,199710,AD,ES
28550,1699255800,1699288440,32640,138879,44066,TR,TR
168813,1700026800,1700056440,29640,136299,84539,TR,TR
85037,1698890460,1698949800,59340,121018,110107,UA,PL
173350,1700669160,1700687160,18000,64641,172199,FR,DE
42205,1698985320,1698991200,5880,20575,147465,NL,NL
108239,1700063160,1700082540,19380,193152,122053,FR,FR
163799,1699200600,1699205160,4560,91918,73965,GB,GB
45495,1699370160,1699408320,38160,41301,152437,MX,MX
133872,1699537380,1699569000,31620,192571,20248,BA,DE
159835,1698898380,1698932040,33660,51680,186729,TR,TR
199789,1699486200,1699489800,3600,51270,14362,NL,NL
116566,1699823220,1699854600,31380,44942,174824,TR,TR
141728,1699015860,1699019460,3600,150267,149119,GB,GB
145842,1699130700,1699144560,13860,178777,45369,CZ,CZ
163495,1699927800,1699958400,30600,29578,64495,TR,TR
143998,1699108020,1699130220,22200,108594,196264,MD,RO
19876,1699771380,1699803660,32280,4115,1981,TR,TR
167347,1700302800,1700336700,33900,167444,11175,TR,TR
36766,1700777640,1700795220,17580,104998,162818,US,US
70567,1699721340,1699724940,3600,145226,137685,GB,GB
55160,1699737420,1699770060,32640,4030,191138,TR,TR
24720,1700666220,1700683980,17760,119182,191377,US,US
175035,1699898580,1699933620,35040,102919,82125,TR,TR
197047,1699102080,1699136400,34320,43474,122031,MX,MX
64953,1700610480,1700638500,28020,63072,163489,PL,UA
129289,1699102620,1699137000,34380,158343,108680,TR,TR
149261,1699691880,1699709580,17700,41904,135554,US,US
199761,1699338660,1699354320,15660,106300,167446,US,US
164045,1700100480,1700117460,16980,159251,156059,FR,BE
77546,1698867180,1698900600,33420,134844,135243,TR,TR
72579,1700055540,1700068560,13020,41468,186851,US,US
187363,1699881540,1699902060,20520,42424,144424,LT,EE
65736,1699682340,1699700220,17880,131324,118752,FR,FR
173590,1699862520,1699893600,31080,45631,30513,TR,TR
113405,1700009340,1700023140,13800,138253,106700,IT,IT
89180,1699334640,1699363800,29160,189498,135088,TR,TR
143086,1700003940,1700008860,4920,62686,199508,GB,GB
141705,1700527320,1700563200,35880,5997,109570,TR,TR
102748,1698999060,1699035000,35940,182503,78229,TR,TR
125856,1699093620,1699129080,35460,198717,110215,TR,TR
118785,1698982320,1699007340,25020,72550,157643,PL,PL
84726,1699252740,1699285800,33060,73038,42261,TR,TR
39610,1699550820,1699563420,12600,85020,155886,CZ,PL
141068,1700578140,1700590080,11940,2717,29365,US,US
144234,1700423580,1700455140,31560,74314,88370,TR,TR
14193,1699057920,1699070460,12540,32891,122627,IT,IT
114442,1700602920,1700606520,3600,72675,7577,GB,GB
55595,1700797680,1700829720,32040,27968,15568,TR,TR
31958,1698909300,1698912900,3600,88849,31044,NL,NL
150702,1699696500,1699700100,3600,194499,60602,GB,GB
178095,1700606760,1700642160,35400,63811,44341,TR,TR
55389,1699177680,1699198320,20640,152522,74658,DK,DK
39205,1700416560,1700445540,28980,114019,168530,MK,RS
88371,1700253840,1700263680,9840,25903,101213,IT,IT
48035,1700698920,1700721420,22500,173832,195438,RO,RO
120883,1698966420,1698970020,3600,62659,12758,GB,GB
43372,1700344560,1700358300,13740,146930,16578,US,US
86164,1700282580,1700296200,13620,45858,177280,RS,DE
61108,1698835440,1698868140,32700,22954,174165,TR,TR
19949,1700647800,1700663940,16140,103755,145176,AT,DE
173489,1699816260,1699846080,29820,120114,98774,TR,TR
154010,1699440120,1699443720,3600,102684,177946,NL,FR
131587,1698995640,1699002960,7320,128393,31651,HR,SI
143493,1699294920,1699327140,32220,171354,127190,TR,TR
120924,1699393620,1699407420,13800,158950,9820,HR,HR
34946,1700561520,1700592900,31380,57373,31211,TR,TR
89402,1698881760,1698914580,32820,57777,37564,TR,TR
164796,1698917400,1698931920,14520,123607,47291,US,US
192398,1700688120,1700711820,23700,119812,179235,CH,DE
158259,1700278740,1700312220,33480,95373,91538,TR,TR
41005,1699602840,1699606440,3600,26148,93438,GB,GB
5081,1700825400,1700855040,29640,80608,142683,TR,TR
161485,1699968300,1700004060,35760,96095,62035,TR,TR
92993,1699179360,1699191720,12360,13210,123230,IT,IT
135055,1700391300,1700408640,17340,140009,57037,US,US
73108,1698957000,1698970800,13800,134703,116833,IT,IT
5657,1698903840,1698930780,26940,102454,94085,RO,RO
5307,1699440960,1699453560,12600,88923,129030,US,US
63701,1700412180,1700441700,29520,54998,187797,TR,TR
45811,1699325400,1699337940,12540,134882,190117,AT,SK
34089,1700834760,1700868660,33900,103417,180122,TR,TR
170784,1700826900,1700857860,30960,99791,68176,TR,TR
75738,1699293840,1699305780,11940,15961,101957,US,US
133618,1700181420,1700216880,35460,56483,94722,TR,TR
76418,1699460880,1699488660,27780,61317,82594,DE,DE
86793,1698877920,1698913140,35220,16457,31933,TR,TR
160146,1700621880,1700633760,11880,199581,94694,IT,IT
104398,1698951960,1698987900,35940,192448,155944,MX,MX
34520,1699397400,1699401900,4500,174690,20535,GB,GB
94945,1700286900,1700290500,3600,16101,100975,GB,GB
148309,1698959340,1698989640,30300,133395,37159,TR,TR
154546,1700415720,1700445000,29280,58469,119432,TR,TR
131474,1699991400,1700027520,36120,150119,90689,MX,MX
172872,1699920660,1699929600,8940,195470,154161,CL,CL
57291,1699312620,1699339020,26400,51098,58767,DE,AT
145142,1700809980,1700843940,33960,32749,1329,TR,TR
20839,1700773560,1700781600,8040,28534,77480,HR,HR
189768,1698797640,1698828720,31080,84841,54884,TR,TR
186930,1700081760,1700089320,7560,1692,38221,IT,IT
179368,1699593780,1699623420,29640,76960,36985,TR,TR
179613,1698968040,1698985860,17820,86641,45327,US,US
130779,1699997760,1700010660,12900,173691,8005,US,US
55690,1700232660,1700267640,34980,129337,184756,TR,TR
184350,1699855620,1699861020,5400,34467,50870,GB,GB
169324,1699299540,1699325880,26340,17682,132577,DE,AT
94171,1700361360,1700394360,33000,97416,105062,TR,TR
77875,1699716840,1699747860,31020,90877,169590,TR,TR
72219,1700149260,1700184960,35700,179432,43438,TR,TR
70879,1699318980,1699335300,16320,109846,21802,US,US
21912,1699773960,1699804920,30960,135090,182399,TR,TR
106337,1700110920,1700139780,28860,186716,182354,TR,TR
99409,1700696340,1700711220,14880,37860,59275,FR,FR
143771,1699519620,1699549560,29940,40141,1142,TR,TR
106480,1699740180,1699769760,29580,8507,157249,TR,TR
69270,1700610480,1700629860,19380,184804,76832,FR,CH
178883,1699853520,1699874580,21060,179943,125113,FR,FR
191034,1699898160,1699912980,14820,7048,42629,FR,FR
128585,1700494740,1700528460,33720,25094,159616,TR,TR
149506,1699529640,1699545480,15840,90137,37689,US,US
99763,1699886460,1699897560,11100,118791,128240,IT,IT
106854,1700228940,1700257800,28860,40386,139015,TR,TR
97920,1700812680,1700834460,21780,112196,122220,DE,RS
161152,1699436220,1699468860,32640,169665,28715,TR,TR
98844,1699194900,1699224480,29580,14196,133480,TR,TR
35079,1699666260,1699693500,27240,56000,35565,DE,IT
127309,1699515360,1699570020,54660,98727,65318,BG,DE
51907,1699254600,1699270260,15660,169148,159200,US,US
13807,1700660460,1700664420,3960,79392,172559,NL,NL
119526,1700456460,1700482440,25980,189381,71201,DE,IT
194894,1699012560,1699018560,6000,50385,148511,NL,NL
147547,1699691160,1699699800,8640,26195,18052,PT,PT
19938,1700028240,1700054100,25860,170575,13216,BR,BR
116683,1699394580,1699406760,12180,149414,140220,PT,PT
182854,1699598700,1699610520,11820,12760,177750,ES,ES
49905,1699465320,1699479180,13860,115854,92068,IT,IT
72889,1699676880,1699691280,14400,87697,51418,US,US
157741,1699105140,1699136580,31440,187517,91180,TR,TR
147681,1699678680,1699682280,3600,37936,4037,GB,GB
19869,1699485120,1699498500,13380,109779,21865,AT,AT
137472,1699569720,1699605240,35520,84894,54868,TR,TR
137331,1699989420,1700005260,15840,90888,79092,US,US
175644,1700342040,1700372100,30060,29219,30090,TR,TR
146380,1700706180,1700737800,31620,135869,102163,TR,TR
9057,1700049480,1700061960,12480,142085,60112,RS,RS
15204,1700612220,1700641140,28920,51272,109838,TR,TR
137980,1700742720,1700756760,14040,7382,72193,RS,RS
101414,1700599020,1700631300,32280,181665,26292,TR,TR
33273,1699404780,1699442280,37500,189554,16361,MX,MX
80822,1700739780,1700745960,6180,177044,22450,NL,NL
106628,1699180380,1699214340,33960,88197,74317,TR,TR
121857,1700404080,1700434740,30660,57607,145775,TR,TR
145067,1699298160,1699325700,27540,62629,71271,DE,HR
193917,1699013100,1699045740,32640,178792,89619,TR,TR
197280,1700300400,1700331000,30600,20777,27404,TR,TR
53851,1700422200,1700444940,22740,57703,57252,DE,IT
142309,1699611300,1699621740,10440,33788,30590,HR,HR
182272,1700353200,1700361660,8460,136244,97781,CL,CL
68503,1699251540,1699263120,11580,128981,134057,HR,DE
167274,1700033580,1700068560,34980,122037,141184,TR,TR
9349,1700347440,1700377980,30540,123963,16692,TR,TR
197056,1698806760,1698832020,25260,101973,28795,DE,DE
108468,1700700300,1700726820,26520,136192,148182,DE,BA
191655,1698842700,1698875340,32640,173940,110935,TR,TR
191310,1700239080,1700258940,19860,199800,118315,FR,AT
51083,1700857140,1700870100,12960,151840,195360,US,US
157754,1699267140,1699272180,5040,177939,59246,GB,GB
41156,1700818560,1700850000,31440,90270,80613,TR,TR
133506,1700734680,1700752080,17400,62064,118328,CZ,CZ
153696,1700027700,1700033100,5400,30531,149537,NL,NL
184485,1700452680,1700484360,31680,35844,56032,TR,TR
95417,1700385060,1700396700,11640,48200,128058,IT,IT
51819,1700113260,1700130660,17400,172393,34987,CZ,HU
159143,1700341500,1700354400,12900,44494,149212,US,US
103129,1699769520,1699793640,24120,4737,25266,DE,FR
27724,1699773780,1699806180,32400,130736,67924,MX,MX
175257,1700816400,1700821080,4680,19355,49918,NL,NL
18728,1699318800,1699348500,29700,144410,139092,TR,TR
164700,1699382100,1699411920,29820,62420,149422,TR,TR
35031,1699466160,1699469760,3600,92551,73304,GB,GB
160455,1699348860,1699381560,32700,141109,80935,TR,TR
140529,1700831580,1700865360,33780,103965,179426,TR,TR
6313,1700666220,1700669820,3600,79246,107068,NL,NL
134024,1698918660,1698930840,12180,9602,146204,IT,IT
172052,1699741800,1699745400,3600,119086,112128,GB,GB
115226,1700543220,1700555400,12180,96246,120662,HR,HR
141310,1699194360,1699212120,17760,20422,165814,AT,AT
164351,1700571780,1700578020,6240,143240,103188,GB,GB
128080,1700013960,1700048700,34740,103303,123226,TR,TR
69482,1700057400,1700062320,4920,121855,115810,GB,GB
57689,1700701020,1700704620,3600,32987,50090,NL,NL
149831,1698961020,1698992880,31860,53958,133369,TR,TR
30818,1700386080,1700420280,34200,136491,95074,TR,TR
60788,1699396260,1699399860,3600,11749,10562,GB,GB
95799,1699739760,1699753080,13320,65888,134384,ES,ES
16319,1700832660,1700861160,28500,177543,149282,DE,DE
96759,1700136360,1700170080,33720,128492,52172,TR,TR
163339,1699291020,1699309980,18960,91588,165723,SE,SE
6253,1700765820,1700770680,4860,137789,40966,GB,GB
15780,1700197140,1700230200,33060,75161,132954,TR,TR
152920,1698938640,1698946800,8160,160202,122786,IT,IT
193554,1699559220,1699573320,14100,79902,106755,IT,IT
105690,1700365080,1700383020,17940,110817,190119,FR,FR
117957,1700839020,1700850720,11700,168497,127750,HR,DE
129874,1699878840,1699882440,3600,153730,77957,NL,NL
42018,1699474380,1699483140,8760,116337,131560,IT,IT
172090,1699486380,1699508700,22320,68100,128528,RO,RO
116335,1699652280,1699665720,13440,54613,128041,AT,AT
35434,1699461720,1699496040,34320,51823,151044,TR,TR
90407,1700388000,1700404740,16740,67905,156820,US,US
184519,1699743660,1699769880,26220,164416,86308,DE,PL
43980,1699423320,1699430220,6900,129558,179020,NL,NL
186422,1699730700,1699753020,22320,135376,179130,RO,TR
199601,1699864980,1699900500,35520,48074,199741,TR,TR
38508,1699290900,1699318920,28020,7930,5435,PL,DE
38542,1699340280,1699348320,8040,57539,130945,PT,PT
194507,1700509020,1700530260,21240,158281,76684,FR,FR
35838,1700758500,1700768280,9780,63746,131717,IT,IT
184246,1700215620,1700226720,11100,198779,186428,US,US
145775,1700080560,1700106000,25440,55942,154898,PL,SK
149772,1700095020,1700109420,14400,184957,164110,CZ,CZ
89494,1699596840,1699609440,12600,171878,145585,CA,CA
118149,1700203080,1700218620,15540,23696,61147,RS,RS
110962,1699735500,1699740420,4920,51208,148212,NL,NL
68143,1699370340,1699400580,30240,152201,13453,TR,TR
47455,1699936260,1699972980,36720,122898,3107,MX,MX
19980,1699311240,1699321320,10080,122714,84402,IT,IT
66673,1699260600,1699293120,32520,27073,19743,TR,TR
71333,1699631280,1699648620,17340,90111,158945,US,US
101301,1699798920,1699802520,3600,161619,145732,GB,GB
37329,1700125560,1700130900,5340,130974,62600,NL,NL
24974,1699620180,1699628640,8460,60410,131881,HR,HR
66247,1698826080,1698854160,28080,175232,98225,PL,CZ
150213,1700115660,1700149680,34020,4076,74967,TR,TR
49219,1699828800,1699834860,6060,63316,56828,NL,NL
159415,1698876720,1698905760,29040,15920,159296,TR,TR
189405,1700800560,1700813940,13380,90668,195421,US,US
190412,1699644600,1699675800,31200,90211,129641,TR,TR
186032,1700066340,1700072220,5880,153607,62573,GB,GB
129993,1700716740,1700745600,28860,122043,89768,TR,TR
74735,1699321740,1699353660,31920,71740,44339,TR,TR
104014,1700143260,1700176560,33300,96153,76098,TR,TR
37420,1698996840,1699002780,5940,71757,104173,NL,NL
65454,1699652700,1699681740,29040,46754,129528,TR,TR
20189,1699196880,1699210320,13440,32478,81390,US,US
4786,1699239420,1699252500,13080,66850,144134,AT,AT
158697,1699544220,1699548720,4500,52169,134922,NL,NL
14907,1699815240,1699818840,3600,46755,16122,GB,GB
160692,1700862300,1700893260,30960,96653,631,TR,TR
98323,1699062600,1699095960,33360,107062,114760,TR,TR
30287,1700172960,1700178120,5160,74887,31429,NL,FR
86238,1699928580,1699958940,30360,172749,80892,TR,TR
194142,1699132020,1699164780,32760,26391,13936,TR,TR
152639,1698950400,1698983640,33240,169557,119926,TR,TR
155239,1699082760,1699115160,32400,6699,63626,TR,TR
134757,1698854280,1698870300,16020,187052,154418,US,US
15677,1699887060,1699890660,3600,142267,92363,GB,GB
82588,1700327340,1700332860,5520,35415,111022,GB,GB
27351,1700190360,1700198520,8160,13010,151800,IT,IT
169206,1699695960,1699725780,29820,164354,189761,TR,TR
192694,1699697040,1699706040,9000,156747,194580,HR,HR
180323,1700080740,1700084340,3600,194805,100421,NL,NL
137531,1700086200,1700116380,30180,11318,41240,TR,TR
145122,1699714860,1699729860,15000,5367,182591,US,US
47127,1700767920,1700778360,10440,134430,47657,ES,AD
83212,1700580960,1700593560,12600,159557,95952,PT,PT
86571,1700449440,1700453580,4140,133954,196655,GB,GB
116185,1699425900,1699461060,35160,112185,146459,TR,TR
188931,1700164680,1700175900,11220,3841,53701,CA,US
136585,1700206200,1700240220,34020,128519,69883,MX,MX
105857,1699650360,1699684200,33840,33106,29699,TR,TR
78116,1700136540,1700148600,12060,21534,124347,US,US
30100,1700533260,1700536860,3600,184750,156072,GB,GB
100778,1700817120,1700844900,27780,84595,153847,DE,AT
111589,1699988580,1700002260,13680,155929,110823,US,US
11436,1700627880,1700660460,32580,43307,110567,TR,TR
129696,1699131720,1699161540,29820,136674,194860,TR,TR
114315,1700308500,1700326080,17580,5027,81429,CZ,HR
27817,1699639920,1699651980,12060,190692,16397,US,US
182189,1700270280,1700286240,15960,327,165615,US,US
42536,1699413840,1699430280,16440,47015,107892,US,US
6143,1699512480,1699527420,14940,73684,6673,US,US
81634,1700735580,1700753100,17520,47305,177997,FR,DE
141607,1700803020,1700815320,12300,19958,33369,PT,PT
48226,1700671200,1700687160,15960,93424,473,US,US
179452,1700092680,1700125800,33120,160627,102633,TR,TR
60644,1700661060,1700684460,23400,50678,123949,RO,BG
33245,1700606880,1700642760,35880,115057,7093,MX,MX
146385,1699938780,1699944300,5520,171348,51022,NL,NL
45435,1700245260,1700248860,3600,74270,38384,GB,GB
5104,1699413360,1699442880,29520,94719,29832,TR,TR
127889,1698995220,1698998940,3720,102754,106528,GB,GB
76670,1699093620,1699124280,30660,198726,42324,MK,RS
180704,1699673820,1699685280,11460,104519,82889,US,US
114884,1700622720,1700630760,8040,188592,28096,IT,IT
104101,1699390200,1699397700,7500,353,92884,HR,HR
136306,1700209200,1700214480,5280,177959,33331,GB,GB
136559,1700204340,1700229660,25320,73262,182198,PL,HU
21169,1699262040,1699269660,7620,55135,67821,ES,FR
2508,1698908700,1698913260,4560,148447,189408,EE,EE
56899,1699002540,1699009920,7380,124791,64079,PT,PT
190036,1699087620,1699119420,31800,136881,102574,TR,TR
127868,1699880160,1699898460,18300,43519,8706,DK,DE
146456,1700124120,1700127720,3600,140166,30101,GB,GB
2607,1699914660,1699930800,16140,198280,8356,CA,CA
118323,1699262400,1699285860,23460,139891,11212,DE,DE
65463,1699548480,1699564260,15780,95729,139178,US,US
99939,1700327040,1700359320,32280,45660,108108,TR,TR
107731,1699882200,1699919340,37140,128324,149517,MX,MX
190530,1699315860,1699319460,3600,37182,57838,GB,GB
14733,1700383740,1700399460,15720,118632,4740,US,US
171904,1699573440,1699581540,8100,97284,184157,HR,HR
116652,1699281840,1699290420,8580,77528,156208,HR,DE
183153,1700031600,1700066700,35100,77481,138123,MK,AL
16110,1700607480,1700611080,3600,106364,145284,GB,GB
63676,1699481400,1699514700,33300,184184,29559,TR,TR
93592,1700850840,1700885940,35100,118902,62457,TR,TR
79028,1699619160,1699643700,24540,138991,198589,RO,RO
59333,1700307600,1700340900,33300,120485,161677,TR,TR
120468,1699088220,1699098480,10260,18299,104204,PT,PT
179345,1699368360,1699398540,30180,160149,157143,TR,TR
159320,1698886140,1698898740,12600,26285,68034,US,US
71657,1699176420,1699187040,10620,27861,62539,HR,HR
104982,1700438100,1700473260,35160,31677,93397,TR,TR
77207,1700082240,1700092860,10620,158402,56057,HR,HR
156539,1700433540,1700446080,12540,150433,155523,IT,IT
32628,1698893580,1698925440,31860,7639,197354,TR,TR
160414,1699752420,1699774080,21660,83096,136183,RO,RO
76377,1700045460,1700056260,10800,154519,27841,US,US
51087,1699111500,1699126620,15120,41562,173436,BE,DE
38625,1699392060,1699399020,6960,73121,98424,GB,GB
172419,1699653960,1699693320,39360,95709,122816,LV,PL
86216,1699358640,1699372080,13440,178082,64621,RS,BA
188803,1700332140,1700335740,3600,8009,179219,GB,GB
28156,1699774440,1699808280,33840,113172,78731,TR,TR
106060,1700018520,1700050920,32400,170055,125273,TR,TR
64942,1699405560,1699425900,20340,166879,74908,FR,AT
197197,1699833660,1699842240,8580,138032,43154,IT,IT
4013,1699978860,1700035920,57060,186360,152551,BG,HU
155060,1700811120,1700840520,29400,93183,93723,TR,TR
101020,1699986120,1700020320,34200,67992,59037,TR,TR
103631,1700717640,1700721240,3600,165115,56824,NL,NL
29389,1699633200,1699668420,35220,22147,179291,TR,TR
180137,1700291520,1700324820,33300,101328,142286,TR,TR
159257,1699083360,1699113000,29640,8805,97590,TR,TR
148982,1700379960,1700412900,32940,36670,86930,TR,TR
42058,1700864220,1700880720,16500,141927,75259,US,US
179804,1700025780,1700039280,13500,78392,27180,IT,IT
103458,1699896300,1699935360,39060,147881,27744,MX,MX
157427,1700148360,1700179680,31320,167414,19099,TR,TR
156648,1700829660,1700847300,17640,47379,196735,RS,RS
187012,1699518000,1699539840,21840,77411,1484,CH,FR
98925,1699994400,1700024100,29700,56109,174978,TR,TR
25401,1699740060,1699773960,33900,28816,66625,TR,TR
16274,1700470020,1700485860,15840,24592,40548,US,US
164964,1700416860,1700433660,16800,98407,58120,US,US
167157,1699659720,1699663320,3600,81572,35132,GB,GB
109608,1699982100,1700017080,34980,163367,157285,TR,TR
27762,1699663560,1699704240,40680,109465,2908,LV,AT
192641,1699754760,1699787880,33120,140096,109938,TR,TR
45171,1700244360,1700256360,12000,17909,48777,IT,IT
46141,1700773200,1700802780,29580,63334,125003,TR,TR
193050,1699640160,1699645440,5280,121122,9763,NL,NL
29772,1699904040,1699933740,29700,69722,107738,TR,TR
137639,1699511100,1699537800,26700,192967,2300,RO,RO
111281,1699233420,1699237020,3600,195338,15617,GB,GB
27565,1700242980,1700258400,15420,181258,59229,RS,RS
133774,1699766400,1699783020,16620,83977,64934,US,US
158430,1699542840,1699553820,10980,41867,26179,IT,IT
184521,1698864540,1698878220,13680,153666,68534,US,US
95183,1699288860,1699318860,30000,46892,97556,TR,TR
146372,1699218300,1699233360,15060,131405,160428,US,US
78403,1699562220,1699589280,27060,92070,94289,DE,NL
199775,1699669020,1699699320,30300,48893,485,TR,TR
21172,1699505280,1699516320,11040,34815,74281,US,US
89999,1699000200,1699030560,30360,93107,82057,TR,TR
34122,1700181960,1700214960,33000,98482,117706,TR,TR
62123,1699839540,1699850940,11400,52865,78674,CZ,CZ
147981,1700155380,1700186940,31560,100213,191628,TR,TR
33027,1700259420,1700270520,11100,54942,38488,AT,DE
166233,1699312020,1699368060,56040,59899,15910,BG,DE
55900,1700841120,1700855700,14580,61939,110623,FR,FR
122590,1700593800,1700624040,30240,30170,6776,TR,TR
1220,1700234940,1700270220,35280,43348,139711,TR,TR
116642,1700206020,1700209620,3600,181468,145946,NL,NL
166052,1700276880,1700291880,15000,48258,146331,RS,RS
160500,1700812920,1700863980,51060,91552,195279,BG,DE
22156,1699318440,1699347960,29520,44804,32549,TR,TR
178104,1699856940,1699891440,34500,118624,23693,TR,TR
3653,1699272540,1699285800,13260,97269,176046,PT,PT
196284,1699454220,1699457820,3600,193788,197204,NL,NL
142705,1699476180,1699510920,34740,64743,137807,MX,MX
157510,1698848700,1698861420,12720,35489,191432,RS,ME
183339,1700309640,1700343600,33960,57912,136423,TR,TR
22409,1699796280,1699807800,11520,11205,91246,US,US
142348,1699156980,1699160580,3600,157325,94731,GB,GB
34382,1699512300,1699523940,11640,45647,137143,US,US
89403,1699481100,1699506780,25680,87186,120535,PL,PL
119453,1700338440,1700352480,14040,77865,177983,US,US
185388,1700374440,1700406120,31680,163500,122896,TR,TR
173368,1700144640,1700161260,16620,3519,126272,US,US
132286,1700361780,1700396820,35040,172558,26176,TR,TR
52776,1699747260,1699750860,3600,102082,143321,NL,DE
113964,1700002080,1700034900,32820,65228,4308,TR,TR
154816,1699859580,1699893240,33660,160446,93983,TR,TR
125186,1700725500,1700755440,29940,19203,134149,TR,TR
156745,1699940760,1699971480,30720,44357,88978,TR,TR
20987,1698953580,1698986040,32460,107796,93428,TR,TR
173102,1700138520,1700174160,35640,181310,24614,TR,TR
171520,1699389660,1699420920,31260,175633,84593,TR,TR
75095,1700814840,1700825340,10500,32981,33759,SK,SK
162720,1699541640,1699570980,29340,45076,100758,TR,TR
172589,1699338480,1699344900,6420,160399,6584,NL,NL
161499,1699057920,1699073760,15840,127157,10915,US,US
55341,1699570080,1699579260,9180,153642,94111,PT,ES
70960,1700329080,1700336520,7440,45941,929,IT,SK
156981,1700828940,1700844720,15780,62877,9679,BE,NL
56346,1700688060,1700704260,16200,56180,129292,US,US
138280,1699327140,1699330740,3600,181601,12576,NL,NL
44109,1699119780,1699149720,29940,135262,127287,TR,TR
180066,1700351280,1700354880,3600,86966,135248,GB,GB
84196,1699602420,1699616460,14040,118977,56587,IT,IT
85826,1700638800,1700642400,3600,2661,100006,NL,NL
28464,1700317560,1700351160,33600,192360,124081,TR,TR
46145,1700730360,1700733960,3600,23316,17655,NL,NL
45151,1700110680,1700139420,28740,161292,22109,DE,BG
166345,1699761000,1699779840,18840,150306,17487,FR,FR
21606,1699500480,1699514340,13860,37816,26490,IT,IT
109590,1700032380,1700035980,3600,196018,8515,GB,GB
14840,1699474920,1699485420,10500,102931,78172,HR,HR
31527,1698800340,1698814620,14280,173557,81352,US,US
21777,1700238420,1700256000,17580,183431,66177,CZ,CZ
51922,1699049040,1699073640,24600,189733,42351,BR,BR
83229,1700381820,1700413560,31740,86777,25552,TR,TR
75534,1699092600,1699105740,13140,50833,131741,CZ,SE
129542,1700656980,1700686080,29100,59109,39861,TR,TR
12641,1700735100,1700762640,27540,19006,73592,DE,DE
137947,1700826540,1700860800,34260,57646,52241,TR,TR
54644,1698834480,1698848400,13920,176789,138051,AT,AT
194057,1699504260,1699534620,30360,36046,134791,TR,TR
196564,1700557860,1700586540,28680,107851,132094,DE,DE
182192,1700293980,1700309280,15300,34777,124053,US,US
20367,1700687820,1700719200,31380,43325,189870,TR,TR
11853,1699213200,1699246140,32940,170897,61212,TR,TR
67245,1699279080,1699291500,12420,97057,89742,IT,IT
50773,1700295240,1700324520,29280,153032,18762,TR,TR
118350,1700083920,1700091000,7080,34537,46650,GB,GB
179128,1700067840,1700074380,6540,194848,94050,NL,NL
165119,1699556820,1699571100,14280,185180,99626,ES,DE
155503,1699443840,1699477380,33540,181017,91766,TR,TR
193381,1699212300,1699225740,13440,173282,162296,AT,AT
146277,1699645200,1699649160,3960,52099,35314,NL,NL
45604,1700568360,1700582520,14160,123368,47697,US,US
52889,1699276200,1699312080,35880,168936,141701,MX,MX
6694,1698845640,1698878100,32460,91080,156052,TR,TR
46636,1699150440,1699162500,12060,128714,94456,IT,IT
82141,1700685240,1700702400,17160,143581,111424,AT,AT
33515,1698871920,1698883020,11100,127623,180040,US,US
20395,1700191980,1700209200,17220,116749,42924,US,US
112967,1699136520,1699168260,31740,113885,168520,TR,TR
191200,1700168280,1700180640,12360,194247,98663,HR,HR
124884,1699521000,1699535460,14460,166856,35847,US,US
37537,1700864400,1700897580,33180,37183,197242,TR,TR
130667,1698908460,1698912360,3900,188993,77823,NL,NL
24993,1699551540,1699584780,33240,139064,120313,TR,TR
125020,1699774260,1699801740,27480,184795,90054,DE,HR
54444,1700098200,1700101920,3720,92180,39528,GB,GB
86634,1700657520,1700668620,11100,115076,5588,AT,AT
83912,1700552280,1700563740,11460,94416,167295,US,US
103223,1699381800,1699398420,16620,156962,96882,CZ,NO
138520,1699073880,1699090080,16200,94556,59689,US,US
66064,1699433700,1699456380,22680,10427,13524,PL,PL
17398,1699907940,1699924800,16860,196675,28104,US,US
42290,1700021100,1700025780,4680,194530,128248,NL,NL
21491,1700071860,1700088060,16200,170707,70883,RS,RS
48555,1700568780,1700572380,3600,63213,45971,GB,GB
39256,1699071540,1699076040,4500,122124,199056,GB,GB
142620,1699250400,1699263480,13080,30137,140460,IT,NL
32220,1699810500,1699841220,30720,167078,166715,TR,TR
179559,1699069560,1699076700,7140,21156,84088,GB,GB
47518,1700825820,1700854500,28680,7647,164338,HU,PL
34103,1698904140,1698933300,29160,102456,192540,TR,TR
48572,1699931640,1699936740,5100,170577,156258,GB,GB
30623,1700626980,1700658360,31380,71375,191001,TR,TR
87856,1700794260,1700817540,23280,176531,100541,DE,CZ
171804,1698873720,1698877320,3600,82977,102461,NL,NL
105652,1700233020,1700246220,13200,16359,55855,US,US
90715,1699462020,1699472640,10620,12434,129474,FI,EE
114837,1699655520,1699659120,3600,13686,69645,GB,GB
17733,1699454400,1699477080,22680,103041,40550,BR,BR
132054,1699839240,1699856400,17160,194132,16354,US,US
157746,1699465920,1699499040,33120,194948,2539,TR,TR
74532,1699161120,1699177860,16740,97049,161409,US,US
72355,1700518620,1700535120,16500,181561,95501,US,US
111397,1699137240,1699157220,19980,194646,49923,FR,FR
171802,1699981500,1699996620,15120,27607,141919,US,US
100940,1699089660,1699119420,29760,90801,33733,TR,TR
90073,1700783880,1700789880,6000,33616,83502,GB,GB
170125,1699986240,1700016840,30600,26995,179109,TR,TR
81643,1699132140,1699165680,33540,117991,104615,TR,TR
50193,1699227960,1699256760,28800,136941,34295,TR,TR
79598,1699870260,1699887540,17280,26910,42487,AT,DE
6554,1700514180,1700518860,4680,115317,85920,GB,GB
154515,1700274360,1700279520,5160,137723,145260,GB,GB
13075,1699344300,1699355400,11100,118161,32443,ES,ES
67882,1699232220,1699236000,3780,135106,47311,GB,GB
167509,1698913080,1698927300,14220,36585,167614,US,US
127715,1699419480,1699449840,30360,69562,76507,TR,TR
171775,1699296540,1699312500,15960,72131,27420,US,US
99472,1700549940,1700565000,15060,46145,160217,US,US
152349,1699932840,1699950060,17220,70908,149989,FR,BE
112901,1699358940,1699374480,15540,65808,81269,US,US
16736,1700040780,1700054700,13920,144559,106217,IT,IT
184512,1700121000,1700150160,29160,160023,114945,TR,TR
140742,1700459100,1700492160,33060,193215,64075,TR,TR
7262,1700310780,1700343720,32940,110054,111372,TR,TR
14481,1700842980,1700848980,6000,157589,82835,NL,BE
125113,1699490520,1699503180,12660,34861,169968,US,US
68352,1700158740,1700192580,33840,131154,151442,MX,MX
74095,1700323080,1700355240,32160,138070,80485,TR,TR
159383,1700524140,1700528280,4140,134134,83192,NL,NL
27826,1699366380,1699383000,16620,139342,137253,US,US
42044,1699788120,1699800840,12720,54677,55616,ES,ES
103992,1700544780,1700571300,26520,39078,101347,PL,PL
50031,1699727460,1699739340,11880,171159,9998,AT,AT
35526,1700236560,1700248920,12360,111658,29790,PT,PT
112415,1700077440,1700108580,31140,149817,15604,TR,TR
111079,1700173380,1700197260,23880,184532,49427,DE,AT
157647,1698991140,1699004220,13080,184774,126178,CZ,AT
115121,1700135100,1700165220,30120,182945,170416,TR,TR
125560,1700621280,1700632440,11160,75241,20561,US,US
120492,1699963860,1699997820,33960,164850,186155,TR,TR
80703,1700018460,1700030940,12480,186454,140869,US,US
44621,1699831920,1699843980,12060,154557,118568,US,CA
139209,1699128780,1699133640,4860,142419,178899,GB,GB
140121,1700354040,1700387160,33120,129317,119374,TR,TR
71464,1699569060,1699598880,29820,29868,148000,TR,TR
173035,1700138280,1700153100,14820,71830,197059,US,US
1216,1700652180,1700665680,13500,46042,26906,US,US
193162,1699416120,1699450800,34680,5075,148939,TR,TR
159131,1699154640,1699178460,23820,149788,188922,PL,FR
77277,1700811120,1700814720,3600,145784,22431,NL,NL
98482,1699958520,1699965780,7260,65160,152379,HR,HR
83088,1699353480,1699364460,10980,58688,99688,HR,HR
34730,1698954300,1698984000,29700,78263,3810,TR,TR
27509,1700462700,1700466300,3600,24790,181115,NL,NL
128654,1699838580,1699862940,24360,124733,83496,DE,DE
7809,1700462100,1700473740,11640,91338,192591,IT,IT
52297,1700359320,1700370540,11220,43429,39242,US,US
23846,1699145220,1699154760,9540,12723,9056,IT,IT
32946,1699448460,1699459980,11520,121249,101337,HR,HR
40012,1700864040,1700895660,31620,30998,75588,TR,TR
94176,1700778960,1700785860,6900,81144,15994,NL,NL
126483,1699715940,1699719540,3600,88459,191131,NL,NL
15458,1700570940,1700598180,27240,1588,18494,PL,CZ
41101,1699639440,1699650300,10860,192908,93929,US,US
105174,1699922760,1699926360,3600,74967,105598,NL,NL
170819,1699381980,1699415280,33300,169759,192794,TR,TR
162749,1699186500,1699224000,37500,87030,2622,MX,MX
156907,1699876920,1699885560,8640,15973,132645,SK,AT
3750,1699414860,1699418640,3780,25064,66868,NL,NL
28868,1699033140,1699047300,14160,109395,45994,US,US
170618,1699819260,1699822860,3600,133471,19170,GB,GB
70678,1700166240,1700178000,11760,45764,30247,US,US
79046,1699132320,1699135920,3600,168099,186744,NL,NL
84280,1699016880,1699050180,33300,129429,192366,TR,TR
13129,1699755300,1699787700,32400,198731,82005,TR,TR
54526,1700687580,1700701860,14280,7692,102745,US,US
171841,1700644860,1700678940,34080,105217,157818,TR,TR
82140,1698820620,1698853440,32820,25973,39711,TR,TR
34751,1699402260,1699432200,29940,18025,21869,TR,TR
125792,1699228260,1699231860,3600,25237,189308,NL,NL
108528,1698959880,1698969240,9360,138635,58182,IT,IT
5448,1699729200,1699759680,30480,30317,95213,TR,TR
151725,1700618760,1700630160,11400,101351,137823,HR,HR
54294,1700209740,1700236320,26580,137919,3224,DE,IT
114368,1699729620,1699748640,19020,158653,80846,FR,BE
195957,1700398380,1700428380,30000,188577,9361,TR,TR
68775,1700010180,1700022600,12420,57311,5082,US,US
129602,1698930240,1698966060,35820,101330,146728,TR,TR
62437,1700804100,1700808840,4740,56306,52728,NL,NL
137466,1699138740,1699165500,26760,101001,152374,PL,PL
51767,1698930300,1698953580,23280,85052,198786,PL,PL
69533,1699566240,1699577880,11640,100457,17362,AT,BG
33807,1699211220,1699245240,34020,180171,465,TR,TR
58790,1699091340,1699125660,34320,189819,198802,TR,TR
37840,1699329720,1699333320,3600,156981,127400,GB,GB
195118,1698864600,1698868200,3600,69066,7623,NL,DE
72045,1699480200,1699493700,13500,28304,158103,AT,AT
20837,1699287060,1699321020,33960,20692,97859,TR,TR
64059,1699835280,1699866960,31680,50549,117278,TR,TR
37698,1699636740,1699652640,15900,122631,45008,AT,DE
163398,1699808760,1699831620,22860,132998,194261,RO,RO
5470,1699359840,1699365540,5700,130852,153223,GB,GB
89938,1699322340,1699334280,11940,36690,78638,RS,RS
133568,1699503840,1699524420,20580,193584,60565,FR,BE
98035,1699235340,1699251000,15660,113472,161027,AT,DE
147532,1699205280,1699236600,31320,9164,164355,TR,TR
24208,1699641060,1699644660,3600,196459,25523,NL,NL
150492,1700439120,1700458920,19800,37649,95995,FR,ES
146445,1699316820,1699326300,9480,84099,99488,IT,IT
10809,1699471260,1699504500,33240,167133,56988,TR,TR
94739,1700700000,1700717640,17640,182690,16838,FR,FR
92103,1699904100,1699912500,8400,69053,79382,IT,CH
134367,1699738500,1699747560,9060,35462,11501,IT,IT
152082,1699873560,1699907520,33960,82242,84949,TR,TR
116295,1699595400,1699607580,12180,102201,126823,PT,PT
63634,1700598720,1700612220,13500,139222,8941,HR,HR
116305,1699690260,1699704780,14520,172239,46047,CZ,CZ
46153,1700806500,1700810100,3600,194497,11495,GB,GB
45954,1699021200,1699037880,16680,162304,50477,US,US
73715,1698810540,1698846480,35940,180162,84205,TR,TR
149005,1698969780,1698986760,16980,199902,78361,CZ,FR
96093,1700509500,1700517840,8340,91864,41068,ES,AD
91564,1698992580,1699027560,34980,50324,173240,TR,TR
24405,1700673780,1700681880,8100,66210,132015,ES,PT
104761,1699965420,1699976280,10860,69650,123865,IT,IT
50204,1700406000,1700421900,15900,180006,99819,FR,BE
158149,1700702400,1700733420,31020,12312,144551,TR,TR
3403,1699457340,1699491540,34200,148922,195763,TR,TR
29778,1698816960,1698850380,33420,108936,80921,TR,TR
153051,1699399020,1699408020,9000,123609,125695,IT,IT
51952,1700579940,1700583540,3600,187736,185799,NL,NL
61629,1699776240,1699788960,12720,171193,36461,US,MX
159029,1699505580,1699528200,22620,30546,84836,PL,PL
177841,1700220900,1700236200,15300,72334,149384,US,US
186108,1700050860,1700062500,11640,84329,65519,US,US
167787,1699828380,1699842540,14160,123737,15263,HR,FR
38857,1700794620,1700829060,34440,3320,163442,TR,TR
59205,1698941940,1698976140,34200,9580,184337,TR,TR
141858,1699927500,1699934340,6840,33798,37288,NL,NL
45549,1699642440,1699676760,34320,124672,117716,TR,TR
56840,1698922740,1698956460,33720,39489,80312,TR,TR
170356,1698886740,1698902520,15780,19567,141278,RS,ME
141659,1700501220,1700534400,33180,185656,11734,TR,TR
43488,1700324460,1700336700,12240,31363,175120,PT,PT
61845,1699992900,1700000280,7380,57408,137944,EE,EE
40026,1699319580,1699352160,32580,22455,72750,TR,TR
82252,1698806880,1698841140,34260,140493,179562,TR,TR
103310,1700609880,1700615220,5340,188941,147959,NL,NL
114166,1699244820,1699265640,20820,108389,61197,BE,FR
183492,1700404440,1700408040,3600,143869,75984,NL,NL
145668,1700781960,1700796720,14760,141024,164878,US,US
141558,1700554620,1700568360,13740,13297,51442,AT,AT
130593,1700726040,1700756040,30000,95935,124923,TR,TR
89444,1700840280,1700852940,12660,173310,30582,HR,HR
60818,1699959540,1699993920,34380,161271,18470,TR,TR
93891,1699112460,1699141380,28920,71512,183600,TR,TR
117335,1700177880,1700191620,13740,51677,192982,AT,BG
56523,1699790820,1699825800,34980,152531,132878,TR,TR
112356,1700466240,1700501220,34980,34039,123576,TR,TR
132068,1699588620,1699592220,3600,104518,93787,NL,BE
136689,1700082840,1700118000,35160,113689,39010,TR,TR
159694,1698964260,1698982080,17820,97782,48495,US,US
111661,1700667720,1700673240,5520,142444,180483,GB,GB
96419,1698899100,1698920940,21840,197463,20121,DE,PL
148538,1699399980,1699411500,11520,9255,156427,PT,PT
141578,1700380800,1700386260,5460,103043,62697,NL,NL
27348,1699518300,1699526400,8100,129381,84306,IT,IT
107208,1699533060,1699556880,23820,65584,57994,RO,RO
70001,1699794540,1699798140,3600,8311,29520,GB,GB
155147,1699657440,1699688340,30900,2386,103331,TR,TR
39364,1699355460,1699378500,23040,68403,155922,PL,PL
117332,1699211220,1699225440,14220,86543,73143,IT,IT
120209,1700341320,1700353860,12540,36964,149391,US,CA
181751,1700704320,1700712420,8100,58676,142787,HR,HR
149661,1698862860,1698874560,11700,125233,127979,US,US
119932,1700502480,1700534580,32100,180308,11654,TR,TR
183264,1700042040,1700062500,20460,65585,175434,FR,NL
26961,1699763580,1699767720,4140,127748,130520,GB,GB
131743,1699684140,1699698780,14640,174884,16107,BE,NL
121130,1699608600,1699612200,3600,71963,184714,NL,NL
76770,1699659960,1699695300,35340,146286,21442,TR,TR
21891,1699888680,1699905360,16680,160958,59001,US,US
100986,1699805220,1699808820,3600,130293,159541,NL,NL
148856,1699710300,1699725120,14820,57089,154857,US,US
62952,1698924000,1698929220,5220,175399,196946,GB,GB
115437,1700413260,1700447220,33960,18964,88623,TR,TR
106175,1699291260,1699322400,31140,4985,165249,TR,TR
51398,1700803440,1700807040,3600,196432,19840,GB,GB
109650,1699722540,1699756740,34200,186502,175709,TR,TR
87145,1700155260,1700186580,31320,94523,53690,TR,TR
43116,1700687880,1700692380,4500,7968,118472,GB,GB
110341,1698803280,1698810960,7680,46391,97897,IT,IT
76948,1699692540,1699722360,29820,75710,91818,TR,TR
191981,1700106660,1700120220,13560,45256,77332,US,US
23933,1699873260,1699884480,11220,15728,190070,IT,IT
41885,1699559340,1699588140,28800,46221,39483,TR,TR
98756,1699464060,1699499580,35520,7619,175769,TR,TR
31771,1700622060,1700638440,16380,145518,66799,US,US
141458,1699879380,1699891560,12180,139514,49207,HR,FR
135836,1700202780,1700228340,25560,4175,107647,HU,DE
59740,1699636140,1699643640,7500,72855,119038,IT,CH
7923,1700763480,1700767080,3600,100329,116496,GB,GB
106111,1699805400,1699820520,15120,28862,198335,FR,BE
168519,1700400480,1700404080,3600,164617,197736,GB,GB
73050,1699340400,1699354440,14040,68756,111158,IT,IT
138018,1700314680,1700340660,25980,93176,43453,RO,RO
59113,1698986340,1698997620,11280,32581,26646,PT,PT
193671,1699818060,1699847940,29880,103193,130735,TR,TR
9703,1700694300,1700727120,32820,63464,169625,TR,TR
84334,1699244820,1699280460,35640,158196,101987,TR,TR
112761,1698885300,1698889080,3780,42093,193537,GB,GB
159003,1699802460,1699837140,34680,39183,115587,TR,TR
175674,1699285440,1699313280,27840,190911,172817,CH,MK
116924,1698991860,1699018080,26220,196786,27594,BR,BR
136557,1699871760,1699889280,17520,45491,165658,FR,CZ
119063,1699519680,1699545000,25320,79628,41682,DE,CH
15166,1699410240,1699422480,12240,85843,60798,IT,IT
145357,1699378020,1699399440,21420,179445,55878,FR,FR
163660,1700009940,1700043780,33840,26483,77554,TR,TR
36369,1700507940,1700520000,12060,61241,157656,US,US
28528,1700826660,1700838360,11700,41449,144882,US,US
162992,1700753520,1700767560,14040,135050,182518,AT,PL
69105,1699573620,1699604220,30600,152684,68372,TR,TR
130233,1700744700,1700763960,19260,48695,139920,FR,FR
3107,1700726520,1700745960,19440,98523,145493,SE,SE
192567,1699842780,1699867380,24600,185919,85319,DE,FR
165910,1699123800,1699156560,32760,19720,2450,TR,TR
46245,1698822780,1698833820,11040,36809,169635,AT,DE
161969,1700701500,1700733540,32040,40867,137557,BA,HR
144409,1699164000,1699196580,32580,20178,178239,TR,TR
129253,1698849660,1698879240,29580,105692,86588,TR,TR
45987,1699006500,1699039440,32940,38033,133856,MX,MX
10830,1699173360,1699185120,11760,168019,164084,IT,IT
161861,1699609620,1699620420,10800,17225,79091,PT,PT
161272,1699668300,1699679580,11280,56546,13355,HR,HR
38116,1698981300,1699001580,20280,168409,180381,FR,DE
128324,1699261380,1699283700,22320,107648,97327,DE,CZ
117364,1699815240,1699827840,12600,158754,4149,US,US
193008,1699991580,1700008740,17160,68610,50565,FR,FR
59133,1700495280,1700511600,16320,76552,163561,US,US
20068,1700101020,1700132520,31500,58936,134488,TR,TR
173555,1699518000,1699553820,35820,170742,156973,TR,TR
176703,1700059560,1700089860,30300,10196,187152,TR,TR
97350,1699583640,1699600260,16620,12351,4502,CZ,CZ
164554,1700650500,1700673600,23100,62892,54048,CH,DE
37866,1700014140,1700017740,3600,120397,44619,NL,DE
119460,1699815660,1699825740,10080,155558,31557,IT,IT
34621,1699408980,1699412580,3600,10062,198129,NL,NL
179508,1699646580,1699657680,11100,91585,199975,IT,IT
16642,1699198500,1699202100,3600,172462,162647,GB,GB
99068,1698973380,1698976980,3600,20461,199226,GB,GB
163809,1700807040,1700810640,3600,168699,177635,NL,NL
90093,1700732640,1700764140,31500,37974,29239,TR,TR
80925,1700470620,1700474220,3600,118543,43060,GB,NL
7948,1700321040,1700356740,35700,56098,79947,MX,MX
58528,1698990120,1699024140,34020,95576,45675,TR,TR
55891,1699203360,1699237560,34200,198678,21480,TR,TR
17942,1699296600,1699316460,19860,24362,191557,BE,NL
106432,1698859260,1698895140,35880,56128,33580,MX,MX
21542,1698891600,1698925380,33780,40046,130895,TR,TR
112631,1700659020,1700683740,24720,61401,87882,DE,DE
149647,1700709660,1700735880,26220,135730,10186,HU,HR
37050,1699343940,1699360560,16620,111359,21350,US,US
97292,1699690320,1699721940,31620,172308,76082,TR,TR
87966,1699343340,1699357860,14520,25238,16481,FR,FR
137689,1700621820,1700656740,34920,33460,141888,MX,MX
71714,1699273860,1699291020,17160,172835,152708,SE,DE
35229,1699746360,1699766340,19980,131939,82473,FR,ES
175869,1700736720,1700761260,24540,107865,193148,PL,DE
101770,1699240140,1699276740,36600,16921,195665,MX,MX
140952,1699306740,1699341900,35160,191846,3923,TR,TR
173687,1700605980,1700641740,35760,14623,92579,TR,TR
89866,1699120500,1699137900,17400,130299,136120,US,US
55334,1699539780,1699575180,35400,145335,117049,TR,TR
50151,1699253460,1699257060,3600,108529,75860,GB,GB
81601,1700765820,1700781660,15840,108381,98270,US,US
52641,1699942680,1699977360,34680,154890,60166,TR,TR
149055,1700447760,1700451360,3600,59354,180092,GB,GB
166883,1699473960,1699477560,3600,162688,152396,GB,BE
69412,1700188380,1700204940,16560,160935,97834,US,US
160906,1698844680,1698865320,20640,2201,40438,FR,IT
81669,1700456280,1700469900,13620,55793,172729,IT,IT
159364,1700853000,1700856600,3600,158596,122376,GB,GB
61988,1700294160,1700326680,32520,29587,123867,TR,TR
40402,1700114880,1700147700,32820,56196,77639,TR,TR
148214,1700603640,1700614860,11220,198175,11824,IT,IT
199975,1699881060,1699896720,15660,115370,119052,AT,HU
44980,1699559160,1699562760,3600,110160,1883,GB,GB
62347,1699128900,1699142760,13860,133834,199343,RS,RS
199108,1700341200,1700344800,3600,174894,28895,NL,NL
33614,1698897360,1698906300,8940,109082,24717,HR,FR
191955,1699685040,1699719660,34620,182242,101532,TR,TR
123741,1699994760,1700008020,13260,84731,4336,AT,AT
71042,1700006880,1700035200,28320,95114,104093,DE,NL
153499,1700069280,1700075940,6660,3575,113155,GB,GB
38168,1699158780,1699167240,8460,167742,156871,PT,PT
8118,1699631460,1699635060,3600,98242,29291,GB,GB
179885,1700847600,1700883300,35700,24970,74252,TR,TR
184726,1699532700,1699568340,35640,160865,19586,MX,MX
89107,1700670600,1700705220,34620,40384,109649,TR,TR
118121,1698963540,1698972900,9360,195430,77316,PT,PT
22011,1700340420,1700372880,32460,99951,63827,TR,TR
126389,1700101020,1700122140,21120,140355,110402,SE,SE
101829,1699490520,1699502220,11700,62120,175238,SK,CZ
170489,1699783560,1699817220,33660,164760,61376,TR,TR
104610,1699113240,1699142220,28980,49107,169386,TR,TR
42093,1700053440,1700085120,31680,23107,19735,TR,TR
20070,1699229520,1699243140,13620,66937,167840,ES,ES
70659,1700673240,1700704440,31200,4983,120223,TR,TR
8639,1699960020,1699975680,15660,25057,43683,US,US
62939,1698821700,1698840420,18720,10393,127095,FR,FR
133950,1700164620,1700172540,7920,61867,52630,IT,IT
69143,1699143540,1699159560,16020,179730,192837,RS,RS
152661,1699458300,1699461900,3600,110185,107653,NL,NL
61621,1699731540,1699767480,35940,80647,77111,TR,TR
11242,1699885080,1699917600,32520,82133,194569,TR,TR
163720,1699308720,1699339260,30540,81828,55105,TR,TR
197086,1699092840,1699128900,36060,174883,56936,MX,MX
182018,1700575260,1700608260,33000,105137,29537,TR,TR
184310,1700576460,1700588760,12300,37116,89759,PT,PT
144253,1699081380,1699118220,36840,21925,72740,MX,MX
140608,1699567320,1699570920,3600,17336,71607,NL,NL
13827,1698912540,1698935040,22500,83451,95789,DE,NL
94891,1699802340,1699840620,38280,7793,67659,MX,MX
32561,1699469100,1699481400,12300,13066,165822,PT,PT
61383,1700063520,1700099340,35820,31976,159953,MX,MX
110990,1700767260,1700798280,31020,34865,174812,TR,TR
41667,1699153140,1699187640,34500,122984,116816,TR,TR
49071,1699697520,1699709040,11520,197959,97155,RS,MK
135639,1700470560,1700499900,29340,141275,57931,TR,TR
27534,1699584780,1699608000,23220,199955,157276,DE,DE
113315,1700047920,1700051520,3600,98905,4895,GB,GB
103390,1700088780,1700108220,19440,12334,110817,FR,FR
83445,1699011420,1699028400,16980,120007,176350,US,US
113135,1700603580,1700634660,31080,17651,55447,TR,TR
186075,1699434120,1699447860,13740,119697,72124,CA,US
77804,1700837700,1700853360,15660,83040,157516,US,US
34032,1700040060,1700050980,10920,88278,102218,RS,RS
169743,1699340220,1699361280,21060,127933,57083,DK,DK
119948,1700125380,1700160660,35280,150603,68437,TR,TR
197068,1700378760,1700384640,5880,187459,20160,GB,GB
31035,1699041180,1699054980,13800,115941,100349,CZ,CZ
194933,1700270880,1700299980,29100,63563,38996,TR,TR
175100,1699878060,1699907880,29820,91109,188055,TR,TR
20485,1700619180,1700650380,31200,191182,183566,TR,TR
100013,1700670180,1700701620,31440,11246,37781,BA,HR
40486,1699988520,1700013840,25320,83988,96842,BR,BR
88209,1699206360,1699242240,35880,123580,188327,TR,TR
138347,1700094300,1700103000,8700,97537,86928,IT,FR
161746,1699117860,1699140240,22380,77827,118526,HU,AT
51940,1700032200,1700035800,3600,163860,58267,NL,NL
80366,1699736460,1699745100,8640,110458,155481,IT,IT
135390,1700172420,1700177520,5100,158792,151482,GB,GB
54452,1699315680,1699331700,16020,19734,153790,US,US
16277,1699452900,1699461780,8880,2642,175004,EE,EE
189224,1699535100,1699541220,6120,146585,130684,GB,FR
153741,1699204680,1699208280,3600,122256,65396,GB,GB
43343,1699659180,1699668840,9660,177691,98465,IT,IT
86512,1700234340,1700243880,9540,82163,94316,FI,EE
132167,1699113300,1699122600,9300,199235,161560,IT,IT
104516,1699606920,1699638840,31920,148576,54752,TR,TR
110385,1698827460,1698856980,29520,20803,62557,TR,TR
30657,1698933240,1698936840,3600,14938,182455,NL,NL
125636,1700438100,1700458020,19920,183905,46600,BE,NL
124118,1700101380,1700118240,16860,87097,196353,BE,NL
16142,1699917840,1699932900,15060,55959,121972,BE,GB
116121,1699272660,1699276260,3600,120260,89716,NL,GB
155802,1700041440,1700075460,34020,88048,164856,TR,TR
65971,1700715780,1700728980,13200,147744,121351,PT,PT
145285,1700454000,1700485560,31560,24882,63003,TR,TR
71970,1699053480,1699068240,14760,148894,53560,CZ,CZ
146723,1699462980,1699488360,25380,26290,66667,PL,SK
51298,1700818260,1700844240,25980,103205,89540,DE,PL
13916,1699339140,1699350600,11460,4360,10828,US,US
133778,1699319940,1699323600,3660,57681,4751,GB,GB
46706,1699499640,1699503240,3600,33040,181719,NL,NL
117475,1698815520,1698842280,26760,192558,115835,DE,CH
82463,1699313220,1699316820,3600,195258,130543,GB,GB
98016,1700684520,1700696880,12360,143619,28439,US,US
112564,1700425920,1700437140,11220,30336,111598,PT,ES
106817,1699049580,1699072440,22860,23256,123285,PL,CZ
173135,1699332480,1699339620,7140,70524,25574,GB,GB
123402,1699142940,1699158480,15540,77137,59496,US,US
149447,1700389440,1700404500,15060,111808,31566,US,US
84539,1698793500,1698828780,35280,92508,131718,TR,TR
106920,1700665500,1700674860,9360,90547,113344,HR,HR
102265,1699226460,1699230060,3600,89796,56033,NL,NL
85015,1698991500,1698997020,5520,18830,72327,NL,BE
189452,1698873240,1698889740,16500,159491,69395,RS,MK
16751,1699966920,1699987200,20280,43520,123196,FR,ES
6333,1700594700,1700609580,14880,83556,113281,US,US
171964,1699839000,1699873320,34320,192867,179424,MX,US
170882,1699016580,1699028280,11700,113109,736,US,US
66416,1699877820,1699932900,55080,69469,41411,BG,DE
14514,1700283840,1700316780,32940,3935,126501,TR,TR
49426,1699825680,1699856520,30840,65753,11797,TR,TR
12241,1699937760,1699941360,3600,151506,8780,NL,NL
88812,1699371780,1699375380,3600,128465,39811,GB,GB
161483,1699118220,1699129680,11460,156251,109682,HR,HR
155683,1699508940,1699525500,16560,47091,158089,FR,FR
79922,1699894320,1699899600,5280,21072,125593,NL,NL
45066,1699203000,1699237380,34380,24764,20933,TR,TR
83791,1699297800,1699307280,9480,33968,39756,IT,IT
117740,1699992780,1700003100,10320,166134,46199,SK,SK
65965,1700708580,1700725800,17220,10514,2603,FR,FR
123448,1700630760,1700646300,15540,81365,20511,RS,RS
121579,1699927860,1699960680,32820,119074,62155,MX,MX
155361,1699501440,1699507140,5700,92493,196048,GB,GB
136582,1699510740,1699536720,25980,27003,162205,PL,PL
118468,1699819140,1699830360,11220,113770,156755,PT,PT
92818,1699867080,1699870680,3600,30636,195148,NL,DE
143437,1699030800,1699042440,11640,68449,187819,HR,HR
138090,1699099200,1699113540,14340,168592,67936,IT,IT
155559,1699795560,1699829160,33600,134048,41336,TR,TR
7683,1699139340,1699170540,31200,89344,163187,TR,TR
160570,1699698360,1699731000,32640,155539,31300,TR,TR
36358,1698804720,1698836820,32100,32057,150332,TR,TR
106349,1700278560,1700291340,12780,132978,114583,PT,PT
63345,1699823400,1699837920,14520,112527,19968,US,US
87424,1700141700,1700175480,33780,94027,85863,TR,TR
62907,1699270500,1699287900,17400,110752,27530,US,US
151666,1700062320,1700095140,32820,164440,101634,TR,TR
94931,1699910280,1699949640,39360,99331,55668,MX,MX
160147,1698835620,1698851220,15600,188478,62171,FR,AD
43580,1700079120,1700083800,4680,180916,30197,GB,GB
97312,1699638480,1699670640,32160,127263,66548,TR,TR
198328,1700631060,1700643840,12780,197594,79855,US,US
192837,1698994500,1699008060,13560,51541,122488,US,US
99723,1700015880,1700028720,12840,74933,9106,IT,IT
45216,1699527900,1699559160,31260,47620,13348,TR,TR
106688,1700613720,1700647440,33720,190032,121160,TR,TR
56661,1700653020,1700686500,33480,169885,9162,TR,TR
197006,1699675140,1699701900,26760,47908,74667,BA,HR
125394,1699712460,1699728060,15600,96499,39474,US,US
49758,1700137440,1700148660,11220,109800,80707,SK,SK
185702,1699545660,1699577760,32100,35798,65062,TR,TR
129088,1700226000,1700260620,34620,25188,113990,TR,TR
146337,1698930480,1698966300,35820,83623,134323,TR,TR
87872,1700089440,1700100180,10740,171433,121751,IT,IT
66230,1699456200,1699489020,32820,130218,68750,MX,MX
82712,1699460460,1699473780,13320,68637,153936,US,US
8536,1700603520,1700634840,31320,149089,35961,TR,TR
47827,1700773560,1700803860,30300,23638,184235,TR,TR
24691,1700206020,1700210280,4260,188387,93881,GB,GB
106679,1700343840,1700347440,3600,199907,112815,GB,GB
171342,1698848100,1698864780,16680,61855,75582,US,US
169829,1700060220,1700072640,12420,28249,132733,IT,IT
152977,1700600640,1700631900,31260,199073,176344,TR,TR
108692,1700300100,1700333520,33420,161622,99228,TR,TR
79862,1700452140,1700483880,31740,80450,15613,TR,TR
81637,1700686380,1700689980,3600,117997,163874,GB,GB
144565,1699334220,1699366260,32040,199887,7465,TR,TR
188423,1700385660,1700389440,3780,63772,191670,GB,GB
14743,1700212500,1700242080,29580,72916,91045,TR,TR
12271,1698796740,1698811020,14280,16106,88575,US,US
13160,1699200000,1699234200,34200,136039,71776,TR,TR
38905,1699748520,1699758360,9840,69941,195241,PT,PT
5059,1699971240,1700007120,35880,98779,119298,MX,US
33223,1700428920,1700440620,11700,4903,48518,US,US
49693,1700404800,1700416080,11280,127385,113368,IT,IT
44854,1700837520,1700841120,3600,97046,64123,GB,GB
100287,1699896300,1699907640,11340,107016,96157,AT,AT
11112,1699983240,1699999920,16680,133841,3161,AT,AT
22212,1699765620,1699794540,28920,177101,113311,TR,TR
27041,1699907340,1699910940,3600,188232,34471,NL,NL
194634,1698989940,1698998040,8100,94305,70842,HR,HR
120330,1700074380,1700105460,31080,75405,33435,TR,TR
78880,1700538960,1700547600,8640,181838,84448,IT,IT
104412,1700673840,1700704080,30240,119196,46966,TR,TR
96420,1700486940,1700511720,24780,100348,180407,PL,PL
176037,1698969480,1698975840,6360,175516,30469,GB,GB
16720,1700193300,1700223060,29760,103331,177176,TR,TR
111250,1699586940,1699621920,34980,117591,108120,TR,TR
8416,1700757960,1700788200,30240,127447,185155,TR,TR
183525,1700520420,1700552940,32520,175162,148066,TR,TR
135995,1700749500,1700766120,16620,151209,159749,AT,BG
27335,1699576800,1699609200,32400,59607,94476,MX,US
60142,1700232660,1700236260,3600,70867,87696,GB,GB
197532,1700383140,1700417940,34800,145591,727,TR,TR
132240,1699409880,1699444080,34200,177177,111667,TR,TR
90414,1700387040,1700416560,29520,3016,118423,TR,TR
39540,1700779620,1700790900,11280,135178,178122,IT,IT
31369,1699562460,1699591560,29100,48772,131160,TR,TR
161041,1700210820,1700227200,16380,99236,150958,FR,FR
177839,1700637300,1700668620,31320,173727,156652,TR,TR
187726,1699783620,1699809660,26040,9045,73530,BR,BR
6048,1700430660,1700434260,3600,50178,189257,GB,GB
186830,1699420440,1699452060,31620,186275,141212,TR,TR
164517,1699300800,1699306860,6060,30945,73129,NL,NL
24644,1700429880,1700457960,28080,132342,159157,DE,DE
106615,1700234700,1700263920,29220,35200,107902,TR,TR
71071,1699521960,1699555200,33240,125307,35591,TR,TR
17979,1700355120,1700366940,11820,80841,135301,HR,HR
84055,1699063740,1699091580,27840,9999,114152,DE,PL
50148,1699539240,1699553220,13980,19392,69987,US,US
198165,1699206840,1699219500,12660,77763,133317,US,US
148169,1700820420,1700844960,24540,31827,139230,DE,DE
175673,1698951780,1698961380,9600,107303,139943,ES,ES
107899,1698820620,1698831600,10980,188992,164870,US,US
77202,1699306860,1699320000,13140,73930,190469,RS,DE
142580,1700543880,1700549280,5400,74465,155532,GB,GB
168104,1698837660,1698867300,29640,1873,196862,TR,TR
177532,1700744880,1700757120,12240,32583,172820,PT,PT
31053,1699241160,1699253160,12000,51314,66756,IT,FR
168334,1699822560,1699828140,5580,34946,35032,GB,GB
168462,1698888300,1698904020,15720,51521,193904,FR,DE
74644,1699174380,1699194900,20520,79746,170548,FR,BE
79228,1699344720,1699358400,13680,52425,189784,IT,IT
10416,1699579680,1699608000,28320,149292,97130,DE,BA
109111,1699809060,1699832880,23820,102219,1358,DE,PT
76182,1699444020,1699447620,3600,7189,25337,GB,GB
140583,1700802900,1700819580,16680,123528,152988,US,US
152924,1698871560,1698884400,12840,151023,26957,RS,BA
155092,1699370760,1699403220,32460,132117,62924,TR,TR
95002,1699248900,1699262040,13140,40466,4898,PT,PT
159906,1700615220,1700632980,17760,135129,185123,US,US
118954,1699760100,1699771080,10980,28359,132009,RS,RS
192548,1700454240,1700463000,8760,127349,152480,IT,IT
29436,1699641900,1699652220,10320,154249,167865,SK,SK
147878,1700116200,1700150160,33960,87372,180873,TR,TR
116052,1700162220,1700171700,9480,155292,105177,IT,IT
102763,1699598880,1699607400,8520,142832,147351,IT,IT
135304,1699088040,1699119420,31380,35506,193336,TR,TR
147499,1700211360,1700241000,29640,88776,51501,TR,TR
104720,1700755620,1700767860,12240,62280,75264,US,US
50041,1700817780,1700823180,5400,43294,41560,NL,NL
94527,1700123220,1700130180,6960,103883,39072,EE,EE
184807,1699897560,1699910640,13080,175349,28690,IT,IT
130711,1699480200,1699504320,24120,47287,70537,DE,DE
74741,1700772960,1700785920,12960,183272,128047,IT,IT
15474,1699542420,1699555920,13500,34060,169078,CZ,CZ
137666,1699501320,1699516860,15540,73276,47117,US,US
103885,1699600380,1699658880,58500,90724,187247,UA,DE
126450,1700396940,1700400540,3600,21559,1731,GB,GB
113621,1699392900,1699425000,32100,180661,68945,TR,TR
140656,1699162260,1699195440,33180,28477,54775,TR,TR
79618,1699776660,1699789860,13200,1730,32722,IT,IT
133392,1699596120,1699607100,10980,37583,114784,HR,HR
39543,1698821700,1698836040,14340,131956,155436,US,US
27787,1699939200,1699952520,13320,124096,21925,IT,IT
158136,1700381100,1700413680,32580,90585,61076,TR,TR
177364,1699192140,1699195740,3600,19095,18620,NL,NL
168341,1700074860,1700085000,10140,16566,179394,ES,ES
188555,1699270440,1699285560,15120,180253,14689,CZ,CZ
69609,1698921180,1698935520,14340,128313,20455,IT,IT
85604,1700588880,1700613900,25020,162078,64449,DE,DE
151709,1699750080,1699753680,3600,37947,60504,GB,GB
112661,1699919700,1699924080,4380,20163,132557,FI,EE
146146,1700072460,1700083920,11460,139884,54253,US,US
184663,1700548920,1700563080,14160,119245,82154,IT,IT
36427,1698842040,1698852000,9960,188196,150673,IT,IT
131125,1700204100,1700214240,10140,50560,75728,IT,IT
127163,1699820040,1699834800,14760,90632,192990,FR,ES
65023,1699549920,1699579740,29820,62963,189701,TR,TR
69656,1700520420,1700524020,3600,15663,70786,GB,GB
178242,1700310420,1700324760,14340,115666,43715,US,US
143818,1700009880,1700013480,3600,6633,127858,GB,GB
19516,1699961220,1699978380,17160,136495,167019,US,US
2048,1700399760,1700422500,22740,136201,85,BR,BR
138833,1700608740,1700616000,7260,96869,147232,HR,HR
105534,1699683420,1699705260,21840,142493,70552,PL,UA
195910,1700360940,1700396760,35820,158322,30587,TR,TR
23781,1700196480,1700208240,11760,63599,116007,IT,IT
110316,1699666380,1699669980,3600,127439,132584,GB,GB
59572,1700517780,1700533200,15420,75847,117870,US,US
160083,1698927360,1698936240,8880,91087,122690,PT,PT
17487,1700158020,1700176740,18720,127928,47826,FR,IT
109047,1700543820,1700555220,11400,137307,34978,US,US
105389,1699664520,1699689960,25440,3208,160315,RO,RO
6913,1699046460,1699082160,35700,146879,140473,TR,TR
55745,1700047680,1700077440,29760,134306,162059,TR,TR
195919,1700712420,1700738640,26220,131870,138317,DE,DE
60944,1700705220,1700720760,15540,179516,182434,BE,CZ
69359,1700473620,1700477220,3600,72702,23950,GB,GB
11301,1699268820,1699285200,16380,45248,145219,US,US
2209,1699579440,1699591140,11700,152844,197991,IT,IT
157683,1698879540,1698901680,22140,110178,181157,HU,CZ
90390,1699275420,1699279020,3600,117368,185678,GB,GB
59258,1699159860,1699191060,31200,101404,56789,TR,TR
108292,1700401560,1700433360,31800,104225,4538,TR,TR
184899,1699017180,1699023720,6540,147053,100898,NL,NL
60009,1699801320,1699834620,33300,174359,123891,TR,TR
21589,1699553760,1699557360,3600,100746,137510,NL,NL
3611,1699063080,1699087740,24660,187544,84360,RO,RO
171922,1698866160,1698881820,15660,136767,180506,BE,FR
29348,1698871980,1698905580,33600,198075,111255,TR,TR
130236,1698886320,1698889920,3600,124511,153268,NL,NL
37921,1700026440,1700056620,30180,68986,92942,TR,TR
178848,1700532120,1700569260,37140,122807,5688,MX,MX
199411,1700805240,1700860200,54960,77070,85171,BG,BG
96004,1699785840,1699837140,51300,60059,60036,BG,HU
104740,1699838220,1699858320,20100,193250,80133,FR,FR
155537,1699628820,1699651680,22860,75204,194313,DE,DE
141630,1699539420,1699543020,3600,148197,178416,NL,NL
102084,1699285920,1699291440,5520,101074,173232,GB,GB
119917,1700520180,1700531160,10980,66776,187149,US,US
132899,1700128980,1700163360,34380,113268,6425,TR,TR
153766,1700836500,1700852640,16140,140185,69452,AT,AT
93415,1700199480,1700211720,12240,9539,4281,US,US
64328,1700372160,1700404620,32460,197400,62537,TR,TR
5414,1699754880,1699771680,16800,180956,16271,US,US
169023,1699496460,1699530000,33540,96556,143940,TR,TR
96362,1700770020,1700788560,18540,136665,89271,SE,FR
139097,1700643900,1700676240,32340,94088,42532,TR,TR
156336,1700455440,1700470680,15240,128280,147743,US,US
148155,1700744520,1700749080,4560,102335,167641,GB,GB
46627,1699012740,1699040340,27600,77568,79575,DE,IT
88645,1699403460,1699413540,10080,126656,156401,IT,IT
12273,1700704800,1700720820,16020,127990,62619,FR,NL
49343,1699798320,1699815900,17580,85651,66133,US,US
145967,1699424100,1699432500,8400,144620,1267,HR,HR
142110,1700447580,1700456160,8580,48304,80308,HR,RS
119302,1699648020,1699679400,31380,49324,82966,TR,TR
12588,1700022720,1700054280,31560,3516,190769,TR,TR
176487,1700018820,1700028360,9540,102648,128385,PT,PT
101515,1698795300,1698811320,16020,163984,111393,US,US
53804,1699118820,1699150020,31200,144831,81623,TR,TR
42850,1700776740,1700806020,29280,136936,39755,TR,TR
43889,1698974340,1698994800,20460,153421,176805,FR,FR
124903,1700050320,1700065800,15480,150721,112819,US,US
137172,1700129640,1700148120,18480,161077,27737,FR,FR
102060,1699148820,1699152420,3600,85288,8010,GB,GB
103978,1699189200,1699223940,34740,62084,80672,TR,TR
83989,1699806720,1699822860,16140,80515,15,US,US
74318,1700669700,1700680680,10980,71115,94151,PT,PT
157751,1700098860,1700110200,11340,192820,113424,US,US
108113,1699299240,1699316940,17700,134275,13328,CZ,CZ
89124,1700083320,1700106120,22800,96833,62358,RO,RO
70887,1698973980,1699007700,33720,107229,49598,MX,MX
65757,1700820780,1700851920,31140,86817,116874,TR,TR
25637,1699273620,1699297500,23880,73261,22240,BR,BR
152379,1698800940,1698816180,15240,51829,117297,US,US
125311,1700171820,1700205300,33480,191380,142823,MX,MX
64933,1700351100,1700376060,24960,47892,108816,DE,HR
170492,1700036940,1700059380,22440,186093,39255,BR,BR
185754,1699641900,1699653300,11400,129954,137988,US,US
61100,1698956460,1698984720,28260,61285,7370,DE,DE
23389,1698865620,1698899340,33720,18535,176963,TR,TR
93334,1700813040,1700816640,3600,199570,130540,GB,GB
158321,1699092180,1699122180,30000,158170,70637,TR,TR
33621,1699162620,1699183440,20820,42754,1507,FR,DE
100,1699862460,1699896900,34440,143597,1213,MK,IT
42221,1699282560,1699308000,25440,174185,29271,DE,DE
37246,1698877500,1698908460,30960,3352,2663,TR,TR
161539,1699044060,1699061340,17280,157056,188483,FR,BE
132491,1700571300,1700574900,3600,6652,15085,NL,NL
163649,1700574120,1700609880,35760,80783,91380,MX,MX
103842,1699928640,1699938480,9840,46609,157505,IT,IT
189192,1700125260,1700160780,35520,124774,163494,TR,TR
42965,1700856780,1700872860,16080,150804,140188,AT,AT
20264,1700167500,1700198520,31020,141296,79566,TR,TR
25732,1699502100,1699516200,14100,101654,10939,AT,AT
129797,1700546700,1700550900,4200,86526,77405,NL,BE
162932,1700099400,1700109840,10440,14636,138670,IT,HR
156890,1700616420,1700625600,9180,131505,141649,SK,AT
64647,1699709280,1699741740,32460,187852,40235,TR,TR
69598,1699861140,1699877400,16260,71587,180209,RS,RS
199453,1700434980,1700463900,28920,86311,69633,TR,TR
165050,1699609860,1699624440,14580,154445,110500,US,US
126927,1700217300,1700246820,29520,35865,144834,TR,TR
126581,1698923460,1698955020,31560,185991,149257,TR,TR
30365,1699168560,1699195380,26820,52456,130867,PL,PL
136222,1700448660,1700484180,35520,177072,194698,TR,TR
145766,1699228200,1699243320,15120,63274,1079,FR,IT
92157,1699940820,1699971240,30420,163732,89138,TR,TR
87555,1699739640,1699764780,25140,26393,166331,DE,CZ
131726,1698901020,1698930120,29100,36138,152774,TR,TR
109566,1700481720,1700515380,33660,36895,142547,MX,US
22843,1699094340,1699127100,32760,56979,128352,TR,TR
111859,1698900300,1698935640,35340,57930,24182,TR,TR
88939,1700728440,1700736300,7860,49018,92753,IT,IT
94923,1698907080,1698921240,14160,97875,177766,IT,IT
98494,1699728120,1699747260,19140,104980,133834,FR,FR
82963,1699432200,1699446540,14340,89795,128460,AT,AT
48908,1700830800,1700844600,13800,60953,98576,US,US
144445,1698902640,1698932700,30060,95773,131211,TR,TR
170633,1699271640,1699278300,6660,53960,71067,NL,NL
199926,1699341000,1699367820,26820,161340,72251,DE,SK
95259,1700209440,1700239800,30360,48708,197678,TR,TR
77219,1699114320,1699132080,17760,22524,140409,US,US
170153,1699651740,1699666380,14640,40331,171196,US,US
156927,1699889220,1699894920,5700,67626,21014,NL,NL
28557,1700379540,1700411460,31920,104830,150967,TR,TR
195340,1699095660,1699130040,34380,24127,81420,TR,TR
180133,1699537440,1699551000,13560,112256,52279,HR,HR
43765,1699488240,1699491840,3600,62965,198380,NL,NL
199551,1699008240,1699013400,5160,13359,3944,NL,NL
162811,1700113080,1700116680,3600,130305,168750,GB,GB
69346,1700038440,1700054520,16080,157618,174346,RS,RS
161044,1700692260,1700724900,32640,17849,27372,TR,TR
168129,1700256780,1700293260,36480,118289,74271,MX,MX
150976,1700519340,1700553900,34560,90781,13559,MX,MX
147796,1699953060,1699956660,3600,60142,168949,NL,BE
48779,1699870500,1699874100,3600,182573,71519,NL,NL
59284,1699195740,1699230420,34680,87647,101640,TR,TR
23813,1700690820,1700719320,28500,157988,132959,PL,PL
91601,1699656960,1699692540,35580,195414,183697,TR,TR
151682,1698877620,1698910320,32700,182476,154771,TR,TR
140816,1699189680,1699223040,33360,29377,52814,TR,TR
11559,1699111920,1699144920,33000,22961,56873,MX,MX
31331,1700222220,1700246400,24180,165750,5416,DE,DE
122807,1700787240,1700818140,30900,160214,118638,TR,TR
7234,1698932160,1698942840,10680,25931,177108,PT,PT
193522,1699440780,1699471380,30600,155911,78240,TR,TR
199375,1699049880,1699059360,9480,77207,126018,EE,FI
58242,1700189820,1700225460,35640,131790,30938,TR,TR
138903,1700308080,1700338020,29940,75070,93615,TR,TR
160733,1699135980,1699139580,3600,154635,50479,GB,GB
34674,1700835780,1700847240,11460,73256,156442,US,US
109521,1700372580,1700395260,22680,81914,55876,DE,DE
171654,1699684800,1699723200,38400,105068,48507,MX,MX
1727,1700223480,1700236800,13320,46191,48086,CA,CA
95246,1700036580,1700058600,22020,147695,196907,PL,PL
26686,1699954680,1699968360,13680,44091,175988,IT,IT
141165,1700716920,1700731800,14880,7220,74361,US,US
76317,1700660820,1700695500,34680,166614,145542,TR,TR
105874,1700125800,1700157720,31920,176007,45219,TR,TR
67302,1699213260,1699243140,29880,148970,40849,TR,TR
168042,1699872540,1699887180,14640,169908,108049,FR,FR
97106,1699181400,1699211340,29940,82409,187532,TR,TR
179771,1699578720,1699582320,3600,147373,163899,GB,GB
21011,1699966080,1699977900,11820,47074,20483,PT,PT
139873,1699979040,1700008080,29040,59518,48609,TR,TR
18341,1698813060,1698846300,33240,81943,91255,TR,TR
22032,1699107240,1699110840,3600,175087,122006,GB,GB
157813,1699465920,1699473300,7380,161736,75098,PT,PT
169318,1700025660,1700051700,26040,65394,156679,PL,HU
38848,1699638600,1699655040,16440,152582,50251,FR,FR
198352,1699042740,1699049520,6780,73825,143909,NL,NL
123060,1700260380,1700275860,15480,112550,159026,AT,AT
86553,1700452500,1700469600,17100,132018,195296,FR,FR
23966,1699019700,1699032060,12360,93522,171042,IT,IT
55069,1699387440,1699395600,8160,162470,52262,SK,SK
118414,1699381500,1699408860,27360,52652,110506,DE,FR
115431,1699752720,1699787340,34620,80244,98591,TR,TR
162723,1699928760,1699946280,17520,174262,137811,RS,ME
49039,1700563320,1700593500,30180,104535,132369,TR,TR
53161,1699067280,1699090320,23040,69806,150239,DE,PL
45849,1699198380,1699231980,33600,166591,107078,TR,TR
75443,1699114980,1699150920,35940,29343,165970,TR,TR
60787,1699946160,1699973100,26940,45989,24601,DE,BA
190745,1700150940,1700164920,13980,36232,54782,IT,IT
5190,1700627700,1700642100,14400,75439,186606,CA,US
191520,1700653500,1700685960,32460,2034,187962,TR,TR
74414,1700646360,1700652840,6480,3957,18547,GB,GB
10743,1699907100,1699944060,36960,171671,31365,MX,MX
185553,1698907920,1698921480,13560,77872,9054,ES,AD
79179,1700738580,1700774400,35820,40120,79854,TR,TR
36590,1700603160,1700635620,32460,153290,10292,TR,TR
174859,1699393260,1699408380,15120,127433,144038,US,US
180223,1700728200,1700731800,3600,161504,113954,GB,GB
131993,1700424720,1700437680,12960,120677,13385,AT,AT
31188,1700672280,1700675880,3600,121813,12276,GB,GB
120867,1698844020,1698878280,34260,168626,32924,TR,TR
153377,1699664520,1699678620,14100,76991,12171,US,US
51517,1700254800,1700284800,30000,150927,43535,TR,TR
87712,1700399340,1700410920,11580,95939,23434,AT,AT
182568,1700430960,1700463480,32520,119214,114983,TR,TR
64013,1699050420,1699063020,12600,109790,77895,IT,IT
32746,1699861200,1699864800,3600,139294,171117,GB,GB
27390,1699222380,1699252920,30540,34211,67492,TR,TR
80253,1700796600,1700800200,3600,78035,148867,GB,GB
173259,1699515720,1699531200,15480,42532,160136,US,US
125990,1700401260,1700415600,14340,9123,49433,RS,RS
4779,1699921800,1699926660,4860,130457,79395,GB,GB
60428,1699657740,1699692960,35220,83691,59184,TR,TR
146776,1700800080,1700803680,3600,154021,146416,GB,GB
49224,1699465080,1699479000,13920,13614,172402,PT,PT
23993,1699287180,1699301400,14220,175615,182349,IT,IT
11998,1698985620,1698997440,11820,134313,194778,US,US
193500,1700120340,1700134320,13980,165120,107656,HR,HR
63324,1699119900,1699128120,8220,30817,95858,IT,IT
146922,1700312880,1700330220,17340,79919,32373,US,US
150301,1700817360,1700826780,9420,77154,84994,IT,IT
12554,1700186820,1700204280,17460,199476,194983,RS,BA
168254,1700458980,1700490420,31440,139930,68682,TR,TR
22293,1699244520,1699261080,16560,154957,192459,AT,AT
25419,1699826100,1699839780,13680,71920,59350,HR,HR
130765,1700604480,1700618220,13740,136458,24634,US,US
57849,1698813000,1698829140,16140,99386,31364,US,US
115657,1699012860,1699029060,16200,23915,178279,US,US
41673,1700435940,1700465760,29820,169723,21766,TR,TR
135977,1699406040,1699409640,3600,135283,80686,GB,GB
139767,1700444580,1700450340,5760,47660,193705,GB,GB
121044,1699155780,1699161540,5760,154069,40718,GB,GB
151982,1699101480,1699118160,16680,184997,160608,US,US
116838,1699778820,1699788000,9180,24049,2474,IT,IT
199990,1699662540,1699691640,29100,18030,28126,TR,TR
136904,1699008060,1699011660,3600,24276,110361,GB,GB
180402,1700675160,1700705040,29880,8131,155755,TR,TR
52425,1699593120,1699599000,5880,168179,193553,NL,NL
38125,1699512300,1699543500,31200,30591,195,TR,TR
143378,1700588760,1700592360,3600,154994,3145,NL,NL
86526,1699348440,1699381560,33120,197596,116146,TR,TR
179396,1699325640,1699354740,29100,126357,41930,TR,TR
176222,1700617320,1700620920,3600,189904,22948,GB,GB
24630,1700204400,1700208900,4500,28233,138425,GB,GB
109509,1699549560,1699584420,34860,93621,171560,TR,TR
189164,1700764380,1700799300,34920,177941,82586,TR,TR
111117,1699537200,1699571280,34080,137749,46707,TR,TR
5976,1698836580,1698870660,34080,125245,114111,TR,TR
106226,1698921420,1698941400,19980,66232,154212,FR,IT
33727,1700461140,1700491740,30600,194230,13047,TR,TR
6238,1700819700,1700875500,55800,181927,20565,BG,BG
52676,1700484780,1700519580,34800,72792,114811,TR,TR
187544,1699070220,1699074900,4680,56141,112908,GB,GB
137526,1700772540,1700778600,6060,187246,23715,GB,GB
112630,1700534700,1700539260,4560,5118,172988,NL,NL
82785,1699252620,1699261680,9060,94279,34724,IT,IT
79316,1700181000,1700210460,29460,152625,127963,TR,TR
130759,1699494780,1699525320,30540,2869,161606,TR,TR
14312,1700577960,1700588940,10980,27564,39805,HR,HR
177078,1699885500,1699896900,11400,24909,13622,IT,IT
82850,1699077180,1699084440,7260,54185,197726,IT,IT
25433,1699833360,1699840260,6900,162778,17673,GB,GB
83364,1700736060,1700765760,29700,195279,137502,TR,TR
70500,1700068380,1700076720,8340,83557,31398,IT,IT
154901,1698861780,1698897240,35460,121257,92142,TR,TR
68476,1700764620,1700795820,31200,150323,140987,TR,TR
10382,1699449180,1699458480,9300,129499,172212,PT,PT
149708,1700064300,1700094480,30180,158767,169313,TR,TR
47558,1699208940,1699214460,5520,47464,150614,GB,GB
145189,1699525080,1699538940,13860,131565,22610,US,US
154687,1699755720,1699767720,12000,75169,55306,CZ,IT
2604,1699203660,1699218180,14520,73641,107494,FR,BE
91916,1699764600,1699796640,32040,22332,78645,TR,TR
143336,1698912120,1698925080,12960,144033,141033,AT,AT
198867,1700293800,1700322660,28860,120564,5816,TR,TR
106699,1700180580,1700213940,33360,42328,123362,TR,TR
7240,1699044720,1699076640,31920,106152,185666,BA,SI
20901,1700728380,1700757600,29220,167176,23937,TR,TR
117256,1699143780,1699174260,30480,21406,130617,TR,TR
135242,1699699860,1699713300,13440,93282,128353,ES,ES
6889,1700249220,1700252820,3600,103454,60848,GB,GB
126576,1700784300,1700819220,34920,180050,77012,TR,TR
33937,1700439300,1700471940,32640,118252,40981,TR,TR
52687,1699530480,1699542240,11760,28596,14101,IT,IT
74393,1698952380,1698957720,5340,79091,164440,GB,GB
106031,1700705160,1700712180,7020,143072,41483,NL,NL
49932,1699363920,1699378920,15000,159801,153774,RS,RS
18340,1698965820,1698979320,13500,5898,78620,AT,AT
60018,1699925040,1699932240,7200,38792,101199,HR,HR
79697,1699098480,1699130280,31800,186721,29449,TR,TR
173061,1699036200,1699039800,3600,115930,113369,GB,GB
193740,1700383440,1700412660,29220,47542,90490,TR,TR
186122,1700046180,1700081040,34860,689,177233,TR,TR
92896,1699509120,1699521600,12480,48069,65669,IT,IT
138281,1699182120,1699228020,45900,186666,97662,LU,DE
182175,1699901160,1699926180,25020,58185,92718,PL,PL
38119,1698852960,1698885480,32520,43211,77392,TR,TR
141436,1699714140,1699724520,10380,193286,160911,PT,PT
45032,1699692300,1699724760,32460,96953,148882,TR,TR
137025,1699401480,1699413840,12360,46471,127707,HR,HR
152943,1699236120,1699239780,3660,67559,69038,GB,GB
137309,1700344620,1700348220,3600,139505,48794,NL,NL
106008,1699794780,1699812660,17880,79010,22643,US,US
120249,1700042760,1700046360,3600,150650,108113,GB,GB
155054,1699448580,1699452180,3600,59697,51527,GB,GB
156420,1699184100,1699194960,10860,121568,157696,IT,IT
178708,1698955440,1698959040,3600,7494,142078,GB,GB
161670,1700366640,1700373300,6660,77152,70764,NL,NL
95475,1700757780,1700771100,13320,96773,196688,HR,HR
100620,1700343840,1700376300,32460,149226,118536,TR,TR
185623,1699996680,1700003700,7020,193404,29385,NL,NL
199840,1700234820,1700259960,25140,17349,4010,PL,FI
87412,1698823620,1698828240,4620,101013,178441,GB,GB
199358,1699812120,1699826880,14760,77691,75462,US,US
87320,1700707740,1700711400,3660,10528,170298,GB,GB
78905,1699618800,1699623540,4740,6718,146263,GB,GB
177924,1699630500,1699659540,29040,98160,196559,TR,TR
29968,1699620660,1699657440,36780,19577,59144,MX,MX
44204,1699493640,1699527540,33900,19759,82872,TR,TR
147898,1700015340,1700030220,14880,129701,149851,US,US
106742,1699572900,1699596840,23940,121171,15870,BR,BR
34178,1699176900,1699182540,5640,157729,75323,GB,GB
164860,1700697360,1700708820,11460,185734,75847,HR,HR
84974,1699296000,1699325460,29460,969,85537,TR,TR
165170,1699477380,1699499700,22320,84316,79096,HU,AT
118299,1699348020,1699361280,13260,49878,128384,US,US
115626,1698941520,1698949620,8100,96177,127209,ES,RO
138072,1699352580,1699356180,3600,104812,185998,NL,NL
131404,1699933500,1699966500,33000,28974,153354,TR,TR
60311,1700771940,1700804340,32400,102411,67805,TR,TR
123259,1700602620,1700620980,18360,3098,154243,FR,FR
190918,1700679300,1700682900,3600,153568,43738,GB,GB
7806,1699949640,1699965600,15960,86523,178543,US,US
190794,1699436040,1699461480,25440,189589,159566,DE,DE
199682,1699510200,1699540800,30600,60124,198363,TR,TR
136729,1698802860,1698832860,30000,39698,111275,TR,TR
69933,1700527560,1700558520,30960,50853,181250,TR,TR
145312,1700474820,1700530380,55560,162994,38619,BG,BG
32758,1699621140,1699655220,34080,101765,147277,MX,US
144471,1699881420,1699885020,3600,18220,181909,GB,GB
68687,1699113960,1699135800,21840,192999,42521,BR,BR
137834,1700803020,1700814960,11940,92105,88156,US,US
21751,1700627760,1700659800,32040,150795,196439,TR,TR
22380,1699805220,1699816500,11280,197170,178905,IT,IT
109239,1700196600,1700209080,12480,119691,69385,HR,HR
71852,1700028360,1700051340,22980,192875,162149,PL,PL
60979,1699426020,1699456680,30660,70530,10036,TR,TR
95619,1700393880,1700403360,9480,91496,193049,IT,IT
185157,1699267320,1699270920,3600,193052,28822,GB,GB
158670,1700086200,1700118900,32700,66656,118677,TR,TR
188757,1699284660,1699317600,32940,20165,127949,TR,TR
186587,1700329740,1700346780,17040,165181,150352,US,US
196360,1700078100,1700083860,5760,199071,86511,GB,GB
71091,1700195880,1700210160,14280,118453,177261,IT,IT
15205,1699847340,1699885800,38460,77684,82759,MX,US
102199,1700723640,1700755860,32220,1519,93773,TR,TR
71504,1699206660,1699243740,37080,67506,127053,MX,MX
65839,1699474620,1699510440,35820,14434,84854,TR,TR
68569,1699414140,1699425540,11400,166674,66608,IT,DE
35036,1699451820,1699460400,8580,123139,21479,ES,FR
93688,1698932400,1698965400,33000,153667,119392,TR,TR
164930,1699836600,1699868400,31800,161762,168111,TR,TR
66864,1699791780,1699826460,34680,169314,176055,MX,MX
108210,1699251780,1699282500,30720,108320,182617,TR,TR
136457,1700004600,1700008200,3600,85766,8943,NL,NL
88826,1699902180,1699935900,33720,148785,96858,TR,TR
56721,1700336880,1700349540,12660,20533,8584,US,US
153090,1699311900,1699340460,28560,120158,125571,RO,MD
194227,1698963120,1698970800,7680,87980,187241,IT,IT
27115,1700182440,1700187540,5100,17271,15754,GB,GB
13321,1700454240,1700460300,6060,199737,172879,GB,GB
195304,1699916340,1699948320,31980,112821,90970,TR,TR
4549,1699519320,1699539360,20040,103172,162001,FR,NL
130080,1699587300,1699605300,18000,63439,159052,FR,FR
29865,1699453440,1699472400,18960,41003,94955,FR,FR
166478,1699489140,1699520280,31140,160046,130216,TR,TR
159849,1699149300,1699178160,28860,125542,162215,TR,TR
143328,1699611120,1699620120,9000,178244,56370,IT,IT
39996,1699008660,1699036440,27780,144755,76984,DE,DE
68930,1700183160,1700210580,27420,62514,22386,DE,DE
125846,1699697100,1699731900,34800,60967,178306,TR,TR
50823,1700579580,1700587260,7680,60685,43829,EE,EE
154980,1700255280,1700288400,33120,189619,194567,TR,TR
7474,1699149360,1699182600,33240,123115,44863,TR,TR
151601,1700290020,1700293620,3600,69769,27774,GB,GB
114796,1700726700,1700733420,6720,137745,85974,GB,GB
37613,1698953640,1698957240,3600,55305,145821,GB,GB
119884,1700375280,1700386800,11520,23965,82848,CZ,CZ
53188,1699668060,1699691700,23640,149161,109625,NO,SE
57830,1699744860,1699751340,6480,144980,70571,GB,GB
156740,1699666140,1699673160,7020,86479,75075,NL,NL
99100,1699485840,1699501080,15240,46540,153719,AT,DE
122431,1699408860,1699424400,15540,92894,82746,AT,BG
147159,1698941760,1698961080,19320,72473,156504,FR,DE
115716,1699382940,1699408500,25560,136215,45007,DE,BG
41752,1699751460,1699768800,17340,178005,79982,US,US
93851,1699151940,1699164840,12900,112885,125492,HR,HR
68861,1699003200,1699011480,8280,63013,61092,IT,IT
96765,1699030020,1699061100,31080,108922,115854,TR,TR
120177,1700559240,1700574060,14820,118976,66730,CZ,SK
191484,1698926760,1698956940,30180,13414,61535,TR,TR
144257,1700663100,1700680560,17460,119459,15330,US,US
6975,1700721600,1700757540,35940,79000,78757,TR,TR
19902,1700362440,1700366040,3600,104130,420,NL,NL
29054,1699841760,1699865520,23760,21946,132213,PL,CZ
85206,1699337160,1699351440,14280,86007,104065,IT,IT
165749,1698918900,1698952560,33660,188034,121983,MX,MX
110840,1700378640,1700409000,30360,114383,19941,TR,TR
160418,1700339520,1700373960,34440,57430,76189,TR,TR
33708,1699586940,1699595220,8280,47431,117292,HR,HR
199483,1699687080,1699690680,3600,65938,111866,NL,NL
50584,1700485920,1700500200,14280,42225,1016,US,US
34236,1699469580,1699509000,39420,6043,50127,MX,MX
107637,1699879320,1699889400,10080,44056,179038,IT,HR
177486,1700866020,1700879820,13800,196943,124398,IT,IT
64782,1699624560,1699634280,9720,41282,31028,HR,HR
74940,1700364000,1700372100,8100,190510,80700,AD,ES
158543,1699657920,1699688940,31020,104354,156728,TR,TR
140638,1700135760,1700139360,3600,137451,190719,NL,NL
28226,1699421100,1699424700,3600,115454,93491,GB,GB
172122,1699289940,1699324500,34560,133715,19489,TR,TR
132993,1699281660,1699295700,14040,39327,120185,IT,IT
79250,1700204220,1700237880,33660,199797,183737,TR,TR
11699,1698967380,1698994440,27060,53457,117355,DE,SE
93837,1700681340,1700712300,30960,93690,173139,TR,TR
19450,1699618320,1699633740,15420,26158,80254,US,US
157354,1699525320,1699537980,12660,79669,132155,US,US
27934,1699183200,1699196880,13680,62641,41627,IT,IT
150657,1700625180,1700654520,29340,82269,42966,TR,TR
194851,1700154480,1700161140,6660,43810,4116,NL,NL
124603,1700860020,1700889780,29760,176570,62633,TR,TR
72286,1700030280,1700038020,7740,14509,22464,PT,PT
87910,1699520880,1699524480,3600,159271,163222,NL,FR
53568,1700224440,1700238240,13800,125231,15384,US,US
108049,1699488900,1699498260,9360,195445,154532,HR,HR
78790,1700652480,1700666820,14340,107397,119716,US,MX
96789,1700210640,1700237640,27000,88244,171150,RO,RO
108582,1700111940,1700125800,13860,116263,188323,HR,HR
33946,1700749860,1700780520,30660,24802,29453,TR,TR
173425,1699031520,1699063500,31980,152466,82529,TR,TR
184442,1700846880,1700882040,35160,107972,129670,TR,TR
38785,1699666080,1699677240,11160,51196,105251,PT,PT
178486,1700001840,1700033700,31860,23707,50283,TR,TR
180037,1699591980,1699622640,30660,124505,30665,TR,TR
14671,1699559520,1699563120,3600,132944,163054,GB,GB
44237,1698817380,1698841740,24360,24337,125877,PL,PL
61318,1699263420,1699267560,4140,67640,167204,GB,DE
165672,1699128240,1699131840,3600,128504,12759,GB,GB
133472,1700287020,1700320020,33000,72105,79579,MK,AT
51556,1700581980,1700599260,17280,173758,192441,US,US
54063,1700826060,1700855880,29820,83815,194309,TR,TR
54411,1699592340,1699606260,13920,128377,144194,IT,IT
139858,1699620480,1699653120,32640,155774,24749,TR,TR
136922,1699113600,1699125420,11820,164173,44459,US,US
164518,1700643360,1700678760,35400,140086,180987,TR,TR
194380,1698844680,1698862620,17940,104650,21527,US,US
115232,1700545260,1700549040,3780,103309,130316,NL,NL
113571,1698936720,1698971400,34680,93887,58616,TR,TR
48649,1700697840,1700712600,14760,126211,184480,US,US
120879,1699575780,1699579380,3600,97430,56894,GB,GB
110674,1699010760,1699014360,3600,56490,194991,GB,GB
163175,1699339500,1699346340,6840,146313,85341,NL,NL
157486,1700757960,1700766300,8340,136960,32094,HR,HR
6438,1699024320,1699039800,15480,69137,13950,CZ,CZ
179080,1700160000,1700195580,35580,112676,109463,TR,TR
56481,1700300040,1700304420,4380,155461,176935,CL,CL
41171,1700311080,1700317320,6240,8752,12137,GB,GB
7168,1699291560,1699300860,9300,87646,28146,PT,PT
178653,1699356780,1699388520,31740,52678,52989,TR,TR
78571,1699108080,1699133940,25860,162373,191464,RO,RO
92772,1700546040,1700557680,11640,168460,172274,AT,CZ
168937,1699279080,1699310640,31560,95326,144871,TR,TR
12004,1700121180,1700124780,3600,182282,111442,NL,NL
142034,1700010300,1700041920,31620,108676,48487,TR,TR
174581,1700011260,1700040480,29220,44246,128364,TR,TR
199548,1699169460,1699184640,15180,142958,52911,US,US
104393,1699356840,1699360440,3600,47507,161987,NL,NL
75972,1699345980,1699375320,29340,160484,81168,TR,TR
59878,1700559960,1700589360,29400,79182,41466,TR,TR
193696,1700739480,1700743080,3600,24251,78510,GB,GB
53179,1699924380,1699929120,4740,71267,186748,NL,NL
176476,1699101000,1699133760,32760,12506,82911,TR,TR
140226,1700451540,1700455140,3600,181247,198526,NL,NL
90826,1700448600,1700501460,52860,192199,195150,BG,BG
101738,1700185800,1700215320,29520,68780,94976,TR,TR
184481,1700714460,1700744820,30360,157895,70013,TR,TR
187212,1699729080,1699742160,13080,172111,58759,US,US
77585,1700508600,1700538000,29400,187078,176263,TR,TR
145805,1698922080,1698956580,34500,12394,92367,TR,TR
117843,1699687860,1699702800,14940,155697,119079,CA,CA
89126,1700312280,1700341260,28980,126428,51799,TR,TR
98985,1699654920,1699667100,12180,150716,81192,RS,RS
116802,1700664960,1700674620,9660,16364,63349,IT,IT
2651,1699818780,1699845780,27000,164103,188014,PL,PL
195799,1699658940,1699670280,11340,137675,16422,IT,IT
138636,1700700900,1700715300,14400,154088,178821,US,US
178958,1699533600,1699545420,11820,14843,44936,US,US
51506,1699260180,1699275780,15600,110375,24273,US,US
160057,1698860760,1698887700,26940,13534,90876,PL,PL
156203,1699647840,1699658100,10260,50126,109053,PT,PT
163511,1699746780,1699768500,21720,91940,197333,RO,RO
145470,1699427100,1699458600,31500,112075,108911,TR,TR
66402,1700534820,1700547720,12900,159010,39618,US,US
72634,1699042860,1699053060,10200,196583,80674,ES,ES
69844,1700088720,1700099820,11100,142910,47937,IT,IT
144667,1700219760,1700230620,10860,141662,191627,ES,AD
165307,1700359140,1700389440,30300,178211,30443,TR,TR
75165,1699203000,1699208520,5520,87990,55419,GB,GB
195631,1699259100,1699270800,11700,157006,134905,RS,DE
80005,1700194320,1700226540,32220,73854,141286,TR,TR
36370,1699661220,1699664820,3600,172030,63654,NL,NL
83026,1700195760,1700208540,12780,114626,102133,US,US
159473,1700244180,1700260680,16500,68423,19774,US,US
181326,1699544100,1699558440,14340,184218,98361,US,US
141997,1699352640,1699359720,7080,96899,94846,GB,GB
150127,1699695540,1699713960,18420,78290,55015,FR,FR
163570,1700463900,1700468100,4200,128464,168613,GB,GB
103772,1699462080,1699477860,15780,58314,60360,US,US
11983,1700019180,1700032800,13620,72776,174675,IT,IT
196158,1699950960,1699980720,29760,70445,16548,TR,TR
109945,1700529900,1700562000,32100,50841,193826,TR,TR
146562,1700677800,1700704920,27120,69688,41648,DE,BG
16942,1699760820,1699774980,14160,180174,128807,US,US
124722,1699854600,1699858620,4020,107847,43645,NL,NL
14666,1699061460,1699096920,35460,33113,123397,TR,TR
30412,1699348200,1699380600,32400,85372,35992,TR,TR
69531,1699331760,1699346580,14820,125016,47000,US,US
98180,1699482720,1699486320,3600,49297,150245,GB,GB
178630,1699193580,1699197180,3600,31146,110117,GB,GB
123743,1699802880,1699815480,12600,98923,147057,AT,AT
71705,1700838060,1700844780,6720,111161,164279,GB,GB
121368,1700278020,1700292720,14700,24660,154490,FR,FR
149110,1699857720,1699891620,33900,65184,26280,MX,MX
129036,1699337400,1699373160,35760,139163,77920,TR,TR
7164,1699002540,1699031520,28980,75044,139790,TR,TR
39271,1700507580,1700523960,16380,178959,149075,FR,BE
25333,1700028240,1700041080,12840,41513,177916,PT,ES
46943,1699534140,1699555980,21840,155836,151918,DE,PL
125360,1700494500,1700498100,3600,109076,317,NL,NL
43669,1700030220,1700064900,34680,29892,161056,TR,TR
39375,1699590840,1699603080,12240,157363,61034,PT,PT
50422,1700167440,1700196420,28980,36504,51778,TR,TR
40909,1699272060,1699289040,16980,151020,170187,FR,FR
45379,1699889220,1699918140,28920,165049,100736,TR,TR
182612,1699263540,1699297560,34020,193766,140615,TR,TR
77382,1699763460,1699779660,16200,151301,163033,FR,FR
194004,1700412900,1700426220,13320,81012,90800,IT,IT
42230,1699881660,1699911300,29640,22289,17725,TR,TR
180872,1700745720,1700754540,8820,74534,168108,IT,IT
117648,1699503360,1699536840,33480,36659,44466,TR,TR
64131,1700139300,1700145780,6480,112177,108739,GB,GB
51461,1699761240,1699777380,16140,41773,23778,US,US
103572,1698832380,1698859620,27240,148300,84301,BR,BR
175297,1699490040,1699496040,6000,93237,100548,GB,GB
123320,1699962480,1699990800,28320,185355,102512,BA,SI
111129,1699269660,1699281000,11340,183000,64966,IT,IT
182062,1700780700,1700789640,8940,105695,143004,ES,ES
84014,1699728420,1699733280,4860,89659,145676,GB,GB
169415,1699083960,1699116360,32400,122999,165575,TR,TR
169640,1699264500,1699296720,32220,183579,133660,TR,TR
131585,1699295640,1699328160,32520,43614,144607,TR,TR
112131,1698922920,1698936480,13560,69180,129891,IT,IT
99052,1699328220,1699336440,8220,18951,143621,IT,IT
194282,1699929600,1699982760,53160,139534,172991,BG,DE
199394,1699614480,1699618080,3600,143720,191940,GB,GB
99192,1700705580,1700710380,4800,137506,82466,GB,GB
5177,1698934560,1698965880,31320,168605,108940,TR,TR
149432,1700394300,1700418120,23820,113810,41576,BR,BR
71241,1699752780,1699785600,32820,126640,27390,TR,TR
113715,1699613460,1699647540,34080,12321,94369,TR,TR
55059,1699215240,1699228680,13440,140026,198389,US,US
58448,1699242600,1699277280,34680,25485,172242,TR,TR
133175,1699762320,1699776900,14580,70450,21812,US,US
105713,1699673280,1699678800,5520,23173,175647,GB,DE
71827,1699520220,1699528800,8580,5609,22560,PT,PT
17837,1700692500,1700724960,32460,113005,102346,TR,TR
120058,1699370880,1699377960,7080,54824,170672,EE,EE
29425,1699710720,1699724700,13980,186682,24807,IT,IT
192748,1699237560,1699247400,9840,50664,8788,EE,FI
96039,1700073540,1700078460,4920,172725,167350,GB,GB
190248,1700371800,1700404620,32820,98930,169319,TR,TR
11893,1700807940,1700821620,13680,127318,179220,HR,HR
174204,1699778700,1699810860,32160,85973,84761,TR,TR
29893,1700395680,1700430780,35100,38393,156406,TR,TR
137667,1699411260,1699446600,35340,62602,195568,TR,TR
172270,1700631120,1700662500,31380,186422,170937,TR,TR
18831,1700318100,1700336520,18420,165844,147544,FR,FR
150425,1700624220,1700645100,20880,101229,66894,FR,FR
142198,1699521480,1699525080,3600,149693,192381,GB,GB
6916,1699220760,1699254900,34140,27763,27079,TR,TR
177865,1700179860,1700209440,29580,30774,140852,TR,TR
122235,1699481040,1699484640,3600,84531,10706,NL,NL
147056,1699809420,1699842240,32820,72723,3336,MX,US
18193,1699468380,1699485060,16680,166972,74456,US,US
47271,1700650740,1700663340,12600,138472,15057,US,US
14178,1699919340,1699922940,3600,45748,139814,NL,NL
180446,1700500800,1700518500,17700,140040,142449,US,US
60663,1699863060,1699874700,11640,16629,152942,IT,IT
138250,1700678040,1700682360,4320,16046,55808,GB,GB
162236,1699941960,1699945560,3600,22740,80130,GB,GB
179045,1700344140,1700351640,7500,43761,10810,HR,HR
44726,1700655960,1700694120,38160,165378,178787,MX,MX
6343,1699259220,1699276740,17520,188795,170714,FR,BE
27711,1700632380,1700664960,32580,5748,82324,TR,TR
72695,1700406180,1700441100,34920,194360,141037,TR,TR
179150,1700499180,1700502780,3600,33244,3945,GB,GB
169874,1699602120,1699623960,21840,147559,83720,BR,BR
55028,1699454040,1699468020,13980,34613,150196,US,US
9274,1700360520,1700373060,12540,76463,56078,HR,HR
61467,1699135260,1699152780,17520,198745,123766,AT,AT
60069,1700146020,1700163480,17460,2669,52129,CZ,BE
175856,1699244100,1699278240,34140,10291,5868,TR,TR
51955,1700812200,1700818740,6540,18798,89254,GB,GB
143613,1700649840,1700653440,3600,48232,52680,GB,GB
135508,1698847500,1698851100,3600,1863,63168,NL,NL
52048,1699335120,1699365360,30240,5016,4873,TR,TR
119851,1698971280,1698983760,12480,181889,17042,US,US
172868,1699036560,1699059060,22500,197565,71579,RO,RO
123020,1700082660,1700086260,3600,46126,28181,GB,GB
89080,1698941340,1698974940,33600,93477,39800,TR,TR
61248,1699963680,1699975200,11520,54757,42954,PT,PT
188581,1699739040,1699756800,17760,96051,146415,AT,PL
171753,1700403960,1700417220,13260,129296,30733,US,US
175,1700330520,1700361720,31200,129003,9445,TR,TR
81033,1699004940,1699025160,20220,5800,61128,FR,FR
22606,1699345140,1699379100,33960,87883,3921,TR,TR
32641,1699884420,1699888020,3600,16810,79436,NL,NL
165626,1698844200,1698868980,24780,123743,76277,PL,DE
72687,1699096140,1699122720,26580,34067,166311,DE,DE
113599,1700357640,1700386740,29100,161163,84996,TR,TR
80509,1700597580,1700615280,17700,70577,136399,FR,ES
124946,1699839060,1699846320,7260,168721,164093,PT,LU
93974,1699468080,1699471680,3600,190534,176407,GB,GB
196930,1700041080,1700073300,32220,175645,151276,TR,TR
189097,1699834560,1699851540,16980,57280,2696,US,US
130521,1699875240,1699880100,4860,150583,113052,GB,GB
157653,1699573500,1699602660,29160,69120,50694,TR,TR
58081,1700397300,1700408220,10920,147165,77648,CZ,PL
281,1699770540,1699784940,14400,160269,51209,AT,AT
168242,1700773740,1700801820,28080,85274,156213,RO,MD
100305,1699727580,1699760280,32700,59507,10609,TR,TR
195917,1700065320,1700075640,10320,156586,107495,IT,DE
33493,1700688360,1700723580,35220,130502,184670,TR,TR
48362,1699313700,1699320540,6840,57390,92813,GB,GB
31218,1700496240,1700528460,32220,100303,174744,TR,TR
16496,1699151220,1699184280,33060,47485,82204,TR,TR
162241,1700865000,1700897580,32580,183639,114821,TR,TR
59466,1699792860,1699823280,30420,141477,13803,TR,TR
77319,1700044860,1700068620,23760,155078,103169,DE,DE
170425,1698854040,1698857640,3600,199639,48622,NL,NL
55003,1699731000,1699763940,32940,171707,53722,TR,TR
45633,1699107480,1699119720,12240,57505,173038,HR,HR
138041,1700475840,1700509380,33540,23383,32170,TR,TR
186055,1700481480,1700486580,5100,104318,119999,NL,DE
35112,1698946920,1698959400,12480,8641,65197,HR,HR
62710,1699412160,1699428840,16680,145376,176337,US,US
197167,1700073300,1700104500,31200,138985,140948,TR,TR
34533,1700636460,1700661060,24600,123885,171159,DE,DE
105500,1700005140,1700008980,3840,108761,33168,GB,GB
153630,1700703060,1700710020,6960,5746,63300,GB,GB
168473,1699071540,1699103820,32280,94453,32867,TR,TR
170793,1698827040,1698834360,7320,70786,52716,PT,PT
59229,1700000640,1700035800,35160,77968,41113,TR,TR
153115,1699331880,1699335480,3600,184077,154845,GB,GB
105864,1699546440,1699581840,35400,95899,101943,TR,TR
11011,1699333260,1699348320,15060,98685,180193,FR,AD
117519,1699246020,1699278840,32820,160011,35113,TR,TR
97605,1700696640,1700708460,11820,29239,78186,ES,ES
35303,1700129280,1700159760,30480,138188,68225,TR,TR
70200,1698837540,1698871860,34320,85454,164978,TR,TR
129753,1699180320,1699202460,22140,139114,124748,DE,MK
47744,1699526160,1699549920,23760,198358,5169,DE,DE
65788,1699995600,1700005320,9720,147284,128270,IT,IT
182722,1699788180,1699793580,5400,168660,71762,GB,GB
117569,1699629840,1699662240,32400,176078,46440,TR,TR
156068,1699005000,1699020540,15540,61877,189097,US,US
121873,1699629540,1699640940,11400,170194,174945,PT,PT
12246,1700407140,1700416200,9060,177106,114551,IT,IT
179933,1700140980,1700144580,3600,177151,118478,NL,NL
143444,1699053600,1699065000,11400,32449,73451,IT,IT
81077,1700864280,1700868840,4560,131206,188855,GB,GB
88313,1699554180,1699573260,19080,32735,6513,FR,FR
141769,1700191140,1700202180,11040,158451,126964,ES,PT
19010,1699296000,1699329900,33900,27375,104503,TR,TR
164394,1699831440,1699855080,23640,103667,190600,BR,BR
7284,1700838420,1700854440,16020,163694,105277,US,US
94592,1700217300,1700234400,17100,134318,92970,US,US
63816,1699221120,1699235340,14220,9279,189207,RS,RS
161328,1700204880,1700229780,24900,44712,40792,DE,HR
104420,1700530740,1700560080,29340,6915,18933,TR,TR
142967,1700273100,1700294580,21480,108373,314,FR,IT
149582,1699972380,1699996680,24300,187798,155975,PL,PL
90611,1700029260,1700040300,11040,185083,74056,RS,RS
106672,1700711760,1700719620,7860,198250,159966,IT,IT
112596,1700264880,1700270880,6000,73847,128291,GB,GB
68411,1700504040,1700518020,13980,151844,78102,IT,SK
175805,1699132200,1699162920,30720,37550,185026,TR,TR
124452,1699386120,1699416720,30600,56609,60838,TR,TR
70554,1699527720,1699562280,34560,157211,175861,TR,TR
59933,1698882840,1698895800,12960,121308,77344,US,US
49723,1699681440,1699716660,35220,74154,98684,TR,TR
122508,1699118040,1699123860,5820,194302,5475,GB,GB
117041,1700454240,1700463120,8880,189068,693,IT,IT
143667,1699874820,1699906860,32040,7315,184382,TR,TR
156170,1700723220,1700741100,17880,169815,171963,US,US
184765,1700182440,1700218260,35820,33403,176807,TR,TR
53939,1700078940,1700114520,35580,181595,90656,TR,TR
45973,1699147200,1699179780,32580,105053,168061,TR,TR
111728,1699061160,1699084260,23100,95315,17208,BR,BR
171337,1700547840,1700551440,3600,143119,103663,NL,NL
187103,1700157720,1700170200,12480,8483,49129,IT,IT
22120,1699996440,1700008320,11880,19569,20868,AT,AT
64954,1698944520,1698977040,32520,171508,56022,TR,TR
86376,1698921120,1698954960,33840,91439,36791,TR,TR
9775,1700381940,1700390040,8100,132193,40451,EE,EE
66685,1699683360,1699740480,57120,111054,198812,BG,AT
32879,1700378940,1700408100,29160,180581,15947,TR,TR
65042,1699306080,1699337940,31860,117450,3772,TR,TR
39882,1699432320,1699453320,21000,98728,95359,FR,FR
105190,1700698980,1700706720,7740,89802,122809,IT,IT
175383,1698982620,1699007160,24540,11259,154548,DE,BA
119106,1700610000,1700639760,29760,8191,107334,TR,TR
45580,1699918380,1699931940,13560,83780,39031,US,US
168365,1700214000,1700247300,33300,66453,88744,TR,TR
99118,1698852960,1698883500,30540,27562,115666,TR,TR
199177,1700660400,1700694780,34380,26390,154386,TR,TR
135961,1699441200,1699472940,31740,114140,63232,TR,TR
110017,1700276100,1700311500,35400,153372,106390,MX,MX
104947,1699921200,1699928100,6900,71192,19427,AD,ES
108710,1699531860,1699565820,33960,50245,41261,TR,TR
148354,1699176000,1699196520,20520,178896,170869,FR,FR
120292,1699252500,1699259400,6900,100402,41643,GB,GB
117245,1700295960,1700299560,3600,170527,8646,GB,GB
187678,1700602080,1700607540,5460,43057,36813,GB,GB
4992,1699874880,1699884060,9180,6580,12191,ES,ES
20685,1700272440,1700285700,13260,177098,140115,SK,SK
162291,1699696140,1699709220,13080,126390,159765,AT,PL
29708,1700028960,1700061900,32940,126517,75437,TR,TR
83736,1699941240,1699971240,30000,25441,66677,TR,TR
175855,1699269240,1699279620,10380,69697,145919,IT,IT
84283,1700394960,1700427600,32640,58384,90114,TR,TR
168238,1699927080,1699958220,31140,103534,40600,TR,TR
170241,1699981860,1700011620,29760,60920,129451,TR,TR
51009,1699509840,1699544280,34440,91481,34427,TR,TR
34897,1700375640,1700411580,35940,67219,107441,TR,TR
57940,1699141320,1699144920,3600,125585,43243,NL,NL
137156,1698936060,1698939660,3600,147362,7332,GB,GB
155869,1699318320,1699356360,38040,66922,23054,MX,MX
96816,1700451240,1700464620,13380,168863,51167,US,US
189547,1698897840,1698927660,29820,18886,102081,BA,BA
99692,1700796480,1700824980,28500,147948,84320,BA,DE
8508,1699523580,1699553760,30180,53977,118128,TR,TR
10889,1700082480,1700117340,34860,32216,94550,TR,TR
25859,1700783940,1700789760,5820,115658,107890,NL,NL
42814,1700784540,1700789520,4980,32651,75842,GB,GB
108747,1699403340,1699418160,14820,86530,104922,US,US
140301,1699333680,1699337280,3600,157792,183261,GB,GB
171926,1698942540,1698972900,30360,84098,46509,TR,TR
44978,1700604600,1700618160,13560,83725,36989,US,US
110382,1699431360,1699466400,35040,62289,41139,TR,TR
58084,1699048800,1699081380,32580,67525,17327,TR,TR
112698,1698810960,1698867600,56640,115428,21775,BG,AT
97092,1700841600,1700870640,29040,196818,198927,TR,TR
69422,1699064700,1699085700,21000,71338,80624,FR,NL
136400,1699874760,1699878360,3600,180049,138211,NL,BE
70209,1700084460,1700099940,15480,175132,85369,FR,ES
146524,1699044480,1699070160,25680,17050,42607,PL,DK
107435,1699547340,1699582380,35040,135194,92790,TR,TR
161789,1699031520,1699056660,25140,103095,13984,DE,FR
24619,1700467920,1700500980,33060,70518,113322,TR,TR
12182,1698841680,1698870960,29280,193700,50699,TR,TR
148824,1700320200,1700349240,29040,75628,60307,TR,TR
154547,1700709120,1700744100,34980,107519,134695,TR,TR
184153,1699615140,1699634100,18960,26628,45824,SE,SE
83794,1699254600,1699283460,28860,134217,184009,TR,TR
181296,1699946340,1699958700,12360,124279,73854,PT,PT
145984,1700475840,1700484780,8940,99355,164531,HR,HR
23817,1700179800,1700189640,9840,190741,131702,AD,ES
66597,1699079340,1699090200,10860,49357,118786,IT,IT
79390,1699193880,1699210320,16440,32798,16124,US,MX
40341,1700454000,1700457780,3780,160753,59554,GB,GB
182932,1700798220,1700801820,3600,185658,1349,GB,GB
87671,1700217300,1700248320,31020,190230,67885,TR,TR
123789,1700342100,1700345700,3600,148159,21497,NL,NL
29166,1699548360,1699557240,8880,195082,55674,IT,IT
55203,1699253580,1699292940,39360,147961,119459,MX,US
147924,1700569260,1700583900,14640,121864,27778,RS,BA
36385,1699025640,1699037520,11880,108064,65179,IT,IT
163223,1700528880,1700559600,30720,153326,39899,TR,TR
46097,1698878040,1698903180,25140,8930,50518,AL,BA
115141,1700444160,1700460780,16620,164408,160488,FR,FR
8564,1699539960,1699550160,10200,96650,31167,EE,EE
170427,1700046420,1700058480,12060,135072,59596,IT,IT
53547,1699426320,1699458600,32280,92840,178190,TR,TR
95532,1699747500,1699751100,3600,184688,126008,GB,GB
46468,1700312760,1700328840,16080,6960,67777,CZ,AT
160125,1699902600,1699918800,16200,62488,155865,US,US
100237,1700821440,1700856660,35220,122854,19924,TR,TR
187896,1700662680,1700697060,34380,28941,189517,TR,TR
141369,1699182420,1699206180,23760,173077,150192,DE,CZ
20736,1700165640,1700180580,14940,5199,199547,CZ,CZ
128442,1698809880,1698843840,33960,18660,154518,TR,TR
175768,1700393880,1700424120,30240,83729,154570,TR,TR
2721,1699340100,1699372920,32820,39160,163513,TR,TR
42861,1699855320,1699884360,29040,13818,105892,TR,TR
19032,1700239140,1700251080,11940,155061,5745,HR,PL
139588,1699743000,1699799940,56940,189031,103946,BG,DE
116663,1700445780,1700458080,12300,83727,37409,CA,CA
135038,1699101360,1699104960,3600,126386,75507,GB,GB
23041,1700350140,1700362680,12540,72699,26093,US,US
155628,1699165980,1699169580,3600,8631,139000,GB,GB
90252,1699239780,1699255620,15840,36901,90019,CZ,CZ
29420,1699451460,1699483980,32520,118372,45820,TR,TR
14680,1698892680,1698905940,13260,95071,101111,RS,RS
25821,1699824720,1699829940,5220,65337,198921,GB,GB
131365,1699551780,1699563300,11520,11806,148910,IT,IT
99482,1700089680,1700093400,3720,121873,72751,GB,GB
89065,1700211180,1700235000,23820,111016,36835,DE,CZ
184971,1699849320,1699879920,30600,47893,101008,TR,TR
90677,1700406360,1700417160,10800,188104,100119,US,US
163433,1700406600,1700426460,19860,60272,109535,FR,FR
20803,1700065740,1700069760,4020,184151,100679,CL,CL
72086,1700826420,1700858940,32520,48350,41651,TR,TR
89103,1700806140,1700820300,14160,88653,11582,US,US
98224,1699048920,1699084740,35820,170479,30148,TR,TR
25646,1700703180,1700733420,30240,183516,47715,TR,TR
5207,1700169600,1700198100,28500,65921,38661,DE,DE
194786,1700161080,1700193300,32220,56566,128802,TR,TR
183137,1700311440,1700337420,25980,101138,41889,PL,CZ
199041,1699965480,1699980780,15300,14365,58152,US,US
50063,1700050560,1700054160,3600,22875,117570,GB,GB
18460,1699006380,1699041660,35280,21859,104034,TR,TR
47303,1700219220,1700248440,29220,198507,107391,TR,TR
128514,1699314540,1699323660,9120,65984,146747,IT,IT
42766,1698896580,1698909240,12660,96236,196892,US,US
41612,1700393100,1700404320,11220,135814,179359,US,US
121663,1700387820,1700423340,35520,185545,6663,TR,TR
27110,1699197120,1699212900,15780,53708,83503,FR,FR
197696,1700077140,1700087880,10740,65745,169910,ES,ES
143726,1699700040,1699718220,18180,37692,38596,BE,FR
25438,1699609500,1699644600,35100,51411,43852,TR,TR
186059,1699772820,1699807740,34920,2109,126665,TR,TR
51884,1699787280,1699821540,34260,61208,78528,TR,TR
143722,1700369220,1700403300,34080,49400,105593,TR,TR
160881,1699607640,1699611240,3600,196031,179540,GB,GB
177969,1699398420,1699427880,29460,158480,172293,TR,TR
76254,1700790540,1700806380,15840,155336,6398,FR,NL
93338,1700096160,1700126400,30240,62351,191646,TR,TR
110187,1700495580,1700531340,35760,92224,191881,TR,TR
75178,1700127060,1700140020,12960,182733,29530,US,US
67724,1700547960,1700553540,5580,18325,143979,GB,GB
163273,1699930980,1699934580,3600,170214,44061,NL,NL
48365,1700370180,1700395680,25500,180478,5401,PL,PL
70954,1699725900,1699732680,6780,158778,54051,GB,GB
5946,1699636140,1699667520,31380,152280,55810,TR,TR
60685,1699117140,1699128300,11160,111891,161525,IT,IT
21927,1700144340,1700177220,32880,51993,15696,TR,TR
173735,1699309140,1699324920,15780,82839,5801,US,US
120654,1699436280,1699469820,33540,144419,53946,MX,MX
86803,1699419660,1699451940,32280,43824,20031,TR,TR
8985,1700597400,1700627520,30120,137308,146314,TR,TR
48404,1700636700,1700644260,7560,110796,199641,HR,IT
93144,1699173420,1699194660,21240,120835,197677,FR,CZ
59688,1700087100,1700100900,13800,46523,46268,RS,RS
103280,1700534040,1700567220,33180,115769,156245,TR,TR
74877,1699836660,1699849620,12960,192619,188435,US,US
160226,1700634720,1700667720,33000,125555,176198,TR,TR
130793,1699118700,1699130220,11520,169261,126370,US,US
22977,1699489260,1699504020,14760,191351,127426,RS,AT
171372,1700503920,1700527080,23160,22674,79749,CH,DE
174498,1700838420,1700842020,3600,163412,2930,NL,NL
154626,1699258620,1699276620,18000,118282,185749,BE,FR
196875,1699122720,1699138440,15720,191623,165642,AT,AT
126096,1698845700,1698876960,31260,134422,81877,TR,TR
64130,1699241880,1699263480,21600,16928,111124,CH,FR
137093,1699341420,1699354260,12840,86099,137882,US,US
135415,1700566320,1700600940,34620,140682,119827,TR,TR
24666,1699808280,1699812060,3780,140836,161224,NL,NL
175939,1699942620,1699971540,28920,181842,184513,TR,TR
140820,1699607220,1699637580,30360,146579,68882,TR,TR
24484,1700053140,1700088600,35460,117359,96484,TR,TR
52265,1700625000,1700637600,12600,79686,92153,IT,IT
22217,1699120980,1699151460,30480,98586,66567,TR,TR
188991,1700839440,1700873520,34080,88591,20503,TR,TR
20599,1700252160,1700285640,33480,82498,88339,TR,TR
137048,1699027980,1699065240,37260,196634,168567,MX,MX
62922,1698944460,1698976200,31740,52325,139455,TR,TR
37500,1699455180,1699458780,3600,36458,183956,GB,GB
172742,1699913880,1699949220,35340,76217,184690,TR,TR
231,1699923360,1699955400,32040,39983,177981,TR,TR
24965,1700347020,1700363220,16200,166287,163272,BE,FR
144862,1699486920,1699490520,3600,85108,176244,GB,GB
125086,1699029540,1699058160,28620,54054,132025,CH,IT
158193,1699183440,1699205160,21720,190639,31711,PL,AT
3543,1699900320,1699931880,31560,17095,45579,TR,TR
54620,1699395540,1699400700,5160,178405,38032,CL,CL
175028,1698812400,1698843240,30840,35851,13986,TR,TR
26662,1700667300,1700672520,5220,35045,49511,GB,GB
175682,1699828200,1699859400,31200,165895,110635,TR,TR
174677,1700547480,1700562960,15480,31743,139508,CZ,CZ
20137,1700092860,1700100060,7200,191683,148562,SK,DE
101989,1700285520,1700303100,17580,137586,102360,FR,FR
50099,1699571340,1699574940,3600,153051,58181,GB,GB
115893,1700656260,1700667720,11460,107195,180004,IT,IT
90235,1698967620,1698973800,6180,162477,20226,GB,GB
1164,1699086780,1699119300,32520,181346,123349,TR,TR
13270,1699518240,1699532040,13800,120338,111864,RS,RS
53334,1699080480,1699090620,10140,172219,176008,HR,BA
74310,1699985820,1699989420,3600,47235,90511,NL,NL
6630,1699733700,1699769280,35580,53687,184938,TR,TR
47421,1700080620,1700090760,10140,34790,24999,IT,IT
34229,1700683920,1700714280,30360,34530,107278,TR,TR
51460,1700423700,1700435040,11340,128682,106056,US,US
81818,1698896220,1698928320,32100,163087,93729,TR,TR
24064,1700194620,1700223480,28860,150686,63366,TR,TR
43829,1699220880,1699255500,34620,70470,180628,TR,TR
119784,1699828620,1699832220,3600,56588,115746,GB,GB
141768,1699337820,1699367280,29460,49756,156613,TR,TR
24350,1700322060,1700355120,33060,95685,105904,TR,TR
159065,1699609620,1699637340,27720,173628,121308,RO,RO
181703,1700797620,1700821320,23700,94142,44538,PL,PL
100014,1699091460,1699117260,25800,59620,155407,PL,PL
89770,1698905160,1698918720,13560,11995,102416,IT,IT
173588,1700134740,1700156880,22140,78176,131532,DK,PL
91082,1700541840,1700553780,11940,5712,17292,AT,AT
137857,1699564380,1699576920,12540,196513,160107,IT,IT
173359,1699885980,1699917480,31500,2630,14603,TR,TR
144744,1700289300,1700327520,38220,34272,12324,MX,MX
24940,1699354620,1699384740,30120,126269,196464,TR,TR
60144,1698865440,1698886200,20760,180647,18380,FR,IT
111038,1700556060,1700562720,6660,62312,164516,GB,GB
35231,1700826300,1700834220,7920,141943,16764,IT,PT
82065,1700629080,1700646480,17400,21600,191560,US,US
110865,1698862440,1698876720,14280,167545,82807,US,US
50982,1699616280,1699623960,7680,112936,85440,IT,IT
140343,1698973500,1699006500,33000,39342,12074,TR,TR
80550,1700213940,1700232660,18720,162988,98563,SE,SE
132413,1700430720,1700444220,13500,9021,91601,IT,IT
103436,1699816380,1699845420,29040,34582,123807,TR,TR
19820,1700578140,1700610180,32040,165327,174679,TR,TR
50825,1699315200,1699318800,3600,111837,171873,GB,GB
122087,1699069080,1699072680,3600,107617,68180,GB,GB
33076,1698917460,1698930060,12600,120809,5896,IT,IT
164103,1700181300,1700215080,33780,169843,107657,TR,TR
36961,1700834520,1700839380,4860,129725,179825,GB,GB
107760,1700528340,1700531940,3600,160272,61530,GB,GB
26773,1700663640,1700695740,32100,116447,164317,TR,TR
59489,1700139420,1700154780,15360,171049,50122,US,US
155330,1699331280,1699354260,22980,130057,191548,BR,BR
133856,1699240920,1699251120,10200,9697,6489,IT,IT
101256,1699515720,1699544640,28920,23271,144348,TR,TR
121037,1700649480,1700653500,4020,58191,118350,GB,GB
79529,1700365920,1700378160,12240,68065,91116,RS,RS
116385,1700443320,1700459700,16380,88848,68109,US,US
27186,1699426020,1699429620,3600,114036,87572,GB,GB
126762,1700552640,1700561520,8880,20695,189469,IT,IT
14058,1699797900,1699828920,31020,66635,39162,TR,TR
161985,1699102800,1699135800,33000,92848,125786,TR,TR
171836,1699461420,1699476180,14760,35845,72766,US,MX
157368,1700611800,1700624220,12420,122029,110070,US,US
136096,1699792440,1699798260,5820,174179,122416,NL,BE
166805,1699618140,1699621740,3600,174329,183834,NL,NL
46231,1700628900,1700642820,13920,159710,131414,PT,PT
6453,1700704620,1700733900,29280,123497,65064,TR,TR
142100,1700395980,1700404560,8580,110126,163418,ES,ES
41317,1699172760,1699205760,33000,105996,24893,TR,TR
143986,1699375740,1699406940,31200,54639,187648,TR,TR
145655,1700281620,1700305800,24180,131648,66281,DE,IT
59983,1699746840,1699763040,16200,187602,114402,US,US
158201,1700782980,1700800800,17820,84467,195920,FR,FR
147509,1699209180,1699244520,35340,192274,72955,TR,TR
93337,1700151540,1700164080,12540,173760,145743,IT,IT
131802,1699757400,1699791540,34140,134831,149051,TR,TR
172257,1699431120,1699447560,16440,187807,102433,US,US
68464,1700751720,1700755320,3600,74575,133276,GB,GB
54405,1700121000,1700155020,34020,176454,57548,TR,TR
27511,1699358820,1699363140,4320,10904,77065,EE,EE
20713,1699455960,1699459560,3600,140082,103734,NL,NL
44100,1699595460,1699606740,11280,31260,103662,US,US
86507,1700121780,1700152680,30900,100879,94182,TR,TR
159799,1700802900,1700835480,32580,138450,70109,TR,TR
22992,1699304760,1699327680,22920,79408,55296,BR,BR
45075,1699318620,1699335600,16980,148555,103222,US,US
39936,1699410060,1699435980,25920,183217,9771,DE,DE
111103,1698824220,1698832380,8160,91416,64936,FI,EE
4340,1699583580,1699619520,35940,41306,94745,TR,TR
90223,1699044720,1699054260,9540,1193,49001,HR,HR
75646,1700427780,1700458620,30840,51417,163877,TR,TR
146530,1699897920,1699926840,28920,89039,184856,TR,TR
83529,1699462020,1699477380,15360,143094,155399,RS,DE
37580,1699225080,1699232760,7680,135192,172746,IT,IT
13318,1700500320,1700536200,35880,62397,49262,TR,TR
169064,1700493180,1700496780,3600,73373,107625,NL,NL
26453,1700309940,1700325120,15180,125760,178909,US,US
115263,1699813080,1699827420,14340,24000,159594,US,US
190393,1700215260,1700222580,7320,41724,16443,IT,IT
77384,1698957300,1698978060,20760,11233,42612,FR,FR
29689,1700112540,1700120460,7920,67632,88109,IT,IT
43481,1700464260,1700501520,37260,137335,141870,MX,MX
181046,1700501220,1700516040,14820,15497,44386,CA,CA
197547,1699551000,1699561920,10920,68435,73176,US,US
88237,1699675440,1699679460,4020,52185,170731,NL,NL
56527,1699198800,1699233300,34500,50323,128187,TR,TR
111581,1700360040,1700374140,14100,47296,198680,IT,IT
57776,1699938000,1699945920,7920,52297,101408,IT,IT
117019,1699479780,1699496940,17160,6296,175228,FR,FR
162074,1700832360,1700867760,35400,44716,125144,TR,TR
25834,1698811140,1698826980,15840,9546,74237,US,US
74649,1700695080,1700722740,27660,70338,76255,BR,BR
54458,1699342440,1699376220,33780,48472,84823,TR,TR
76186,1700370900,1700374500,3600,141156,130298,NL,NL
136187,1700687760,1700707800,20040,86531,74863,FR,FR
150283,1699420260,1699446540,26280,168486,35432,BR,BR
29904,1699239540,1699251960,12420,26010,142836,IT,IT
110420,1698811560,1698843660,32100,105507,141902,TR,TR
141980,1699203120,1699212000,8880,14830,52381,CL,CL
5988,1700824860,1700834820,9960,185435,4462,IT,IT
184760,1698941280,1698963000,21720,198411,64959,PL,PL
42678,1699667820,1699702080,34260,50241,14916,TR,TR
81480,1699182180,1699211400,29220,40137,190134,TR,TR
79323,1699105800,1699162020,56220,24070,103059,BG,DE
107391,1699542360,1699555320,12960,116867,17928,SK,SK
117651,1699456440,1699473900,17460,108224,190980,US,US
48987,1698890580,1698914880,24300,143796,132690,DE,UA
16965,1700851500,1700883360,31860,184263,99089,TR,TR
87049,1698846900,1698854820,7920,107200,126508,IT,IT
23820,1699783860,1699796700,12840,56353,44933,AT,AT
13753,1699178460,1699213740,35280,186434,91808,TR,TR
67140,1699143240,1699156560,13320,146381,93803,US,US
4218,1700104800,1700108400,3600,102524,107199,GB,GB
103484,1699547340,1699560120,12780,99248,88530,PT,PT
159846,1698863700,1698877320,13620,109597,141973,US,US
10020,1699434360,1699465140,30780,63325,104293,TR,TR
91812,1698870000,1698899940,29940,77670,37607,TR,TR
183432,1700315700,1700324700,9000,12896,158258,EE,EE
131372,1699711020,1699744740,33720,51368,172858,TR,TR
177668,1700039760,1700055600,15840,154477,113371,US,US
59963,1699551660,1699565940,14280,134467,17130,ES,ES
5135,1700631600,1700660940,29340,88023,96912,TR,TR
12836,1699441140,1699453920,12780,61381,30042,US,US
9612,1699807080,1699821540,14460,89491,117923,FR,DE
129521,1700266380,1700289000,22620,28914,63812,RO,SE
148139,1700201280,1700212740,11460,21697,137324,HR,HR
174488,1699425000,1699456560,31560,54046,155741,TR,TR
112913,1698820920,1698853380,32460,43636,149114,TR,TR
172907,1700176080,1700187000,10920,126997,86155,RS,RS
197625,1699138200,1699144080,5880,84018,52407,GB,GB
8665,1700104800,1700136660,31860,136107,105586,TR,TR
134813,1700243040,1700272800,29760,174928,3874,TR,TR
136483,1699695420,1699709160,13740,42419,59140,US,US
30580,1698931680,1698966420,34740,68612,88693,TR,TR
117649,1699284660,1699314360,29700,25696,30850,TR,TR
50708,1699500060,1699521780,21720,102523,15103,PL,PL
38993,1700492580,1700497440,4860,55583,131462,GB,GB
81022,1700451960,1700465040,13080,69590,106525,HR,HR
190387,1699303500,1699336380,32880,11952,148282,TR,TR
37135,1699889760,1699906020,16260,16362,171609,US,US
903,1699940580,1699951500,10920,108145,120832,IT,IT
163713,1699534140,1699562460,28320,88338,36775,RO,RO
104924,1700622120,1700632740,10620,182576,61219,IT,IT
145260,1698988980,1699006140,17160,4867,148502,FR,ES
71566,1699293120,1699325340,32220,11642,103328,TR,TR
97444,1700559420,1700593560,34140,193224,121660,TR,TR
11229,1700276460,1700288280,11820,64572,142569,US,US
94403,1700415180,1700427660,12480,51835,60878,RS,RS
179048,1699144920,1699173780,28860,21013,68043,TR,TR
109804,1700701260,1700704860,3600,63493,22740,NL,NL
152575,1699307220,1699323240,16020,142306,65698,FR,FR
129066,1700719380,1700750880,31500,30386,66127,TR,TR
166531,1699839600,1699873860,34260,134710,186723,TR,TR
117015,1700223660,1700245020,21360,144056,18111,FR,FR
179360,1699434000,1699467780,33780,150617,42181,TR,TR
58764,1700329260,1700361600,32340,170629,101288,TR,TR
168200,1699010940,1699046880,35940,149849,22561,TR,TR
186520,1699823100,1699856820,33720,40328,82016,TR,TR
81625,1700029380,1700032980,3600,82330,175933,GB,GB
190034,1700209020,1700240940,31920,107472,49753,TR,TR
117668,1699730460,1699763460,33000,101254,120660,TR,TR
171373,1700547780,1700576040,28260,127339,187757,DE,CZ
34221,1699342920,1699375080,32160,75814,29782,TR,TR
83126,1699168440,1699194900,26460,155003,176412,PL,AT
48633,1699431120,1699462740,31620,34365,148369,TR,TR
96138,1699540500,1699571400,30900,154063,167281,TR,TR
77132,1700575440,1700581620,6180,57643,186961,GB,GB
7663,1699558380,1699588260,29880,4637,107366,TR,TR
18223,1700281680,1700298840,17160,26767,145887,US,US
110613,1700020440,1700052960,32520,118139,171998,TR,TR
174271,1699189740,1699223040,33300,135197,7396,TR,TR
50895,1699456860,1699488120,31260,63044,100708,TR,TR
199455,1700359320,1700368440,9120,92735,35263,IT,CH
144328,1700317320,1700350140,32820,34016,84091,TR,TR
34628,1699165020,1699180260,15240,137327,132774,FR,PT
62046,1700310720,1700345700,34980,199627,104376,TR,TR
135476,1700599740,1700603400,3660,156305,134990,AD,ES
7619,1700192340,1700206080,13740,180463,34561,US,US
182633,1700823660,1700839620,15960,182667,137258,FR,FR
33511,1700773320,1700808720,35400,151158,160558,TR,TR
108931,1699052460,1699086420,33960,66690,77325,TR,TR
195940,1700154360,1700158320,3960,7403,54864,GB,GB
94050,1698944940,1698957900,12960,169219,97416,IT,IT
26778,1699904160,1699907820,3660,32322,10779,NL,NL
156649,1700182980,1700195460,12480,19571,67909,US,US
176114,1700731200,1700734800,3600,16740,62094,NL,NL
55370,1699511160,1699544280,33120,19962,173355,TR,TR
96994,1700583480,1700605620,22140,474,140553,DE,DE
198385,1700708220,1700743020,34800,38339,188129,TR,TR
13190,1699742700,1699775820,33120,153355,64541,TR,TR
61043,1699091520,1699095120,3600,42981,34367,NL,NL
63450,1699814340,1699818540,4200,94009,26199,GB,GB
153402,1700094660,1700109840,15180,73035,152102,SE,DE
56330,1699096440,1699100040,3600,111899,149862,GB,GB
59868,1699109340,1699140780,31440,65314,5729,TR,TR
103199,1700788140,1700791740,3600,34229,135079,GB,GB
145387,1699484400,1699508940,24540,186179,175015,PL,BE
171867,1700061240,1700095800,34560,63914,126402,TR,TR
153776,1700642280,1700658180,15900,79929,112473,US,US
73471,1700073720,1700106120,32400,119007,115219,TR,TR
58896,1700192580,1700209980,17400,177685,108439,US,US
12222,1699884900,1699916520,31620,58446,120915,TR,TR
171679,1700236560,1700268660,32100,101566,195140,TR,TR
49416,1700143680,1700152380,8700,189966,186900,IT,IT
131967,1699606020,1699623540,17520,3551,7459,CZ,CZ
24627,1699178160,1699211580,33420,72565,134165,TR,TR
178893,1699422000,1699433220,11220,125904,54009,HR,HR
171585,1699654080,1699660020,5940,142716,102760,NL,NL
4379,1699034760,1699057440,22680,79693,174530,DE,FR
41875,1700050200,1700066400,16200,131039,131950,US,US
73121,1700269200,1700276520,7320,105440,145451,HR,BA
195004,1699356840,1699384500,27660,191507,33012,PL,PL
102628,1698979620,1699011780,32160,152571,4818,TR,TR
77288,1699420500,1699455420,34920,157766,118783,TR,TR
61559,1700803680,1700837760,34080,154388,163130,TR,TR
21762,1699327800,1699361700,33900,73512,21053,TR,TR
170645,1699895520,1699905120,9600,99216,117337,IT,IT
41356,1699017240,1699049760,32520,36331,178208,TR,TR
132674,1700640120,1700653260,13140,26071,37281,IT,IT
80080,1699187880,1699194600,6720,148908,42855,GB,GB
94647,1699979040,1700006400,27360,73190,167118,PL,LT
100438,1699868580,1699872180,3600,148621,86808,GB,GB
68220,1699319580,1699331580,12000,137716,55681,US,US
3728,1699317120,1699332180,15060,65185,171933,US,US
60133,1699230660,1699260840,30180,134153,145203,TR,TR
55353,1699286880,1699299480,12600,141281,124276,US,US
81057,1699186680,1699203120,16440,186829,56994,US,US
28008,1700166780,1700179380,12600,117500,52230,US,US
122496,1698922620,1698935040,12420,63193,73447,US,US
13901,1700483580,1700496240,12660,199072,100278,HR,HR
87469,1700838840,1700867640,28800,59441,185874,TR,TR
16954,1700177700,1700191140,13440,165962,43482,US,US
16317,1700193360,1700206320,12960,133443,109476,HR,BA
17084,1700257500,1700285700,28200,100277,82294,PL,PL
194273,1700777640,1700790780,13140,34885,109920,US,US
54431,1700197860,1700202720,4860,38504,27840,GB,GB
35632,1700826300,1700859240,32940,83053,16835,TR,TR
87294,1699840200,1699852680,12480,161991,17488,US,US
61010,1700005800,1700017380,11580,14688,163000,US,US
115975,1699133760,1699137360,3600,14634,48549,NL,NL
34726,1699111080,1699125120,14040,9417,113856,IT,IT
109828,1700420820,1700436120,15300,28263,169728,US,US
193193,1699492320,1699503360,11040,88838,188912,IT,IT
22753,1700105700,1700123760,18060,155981,157728,FR,PL
105327,1699965540,1699988100,22560,145651,197213,DE,RS
110286,1698957420,1698988800,31380,130084,153808,TR,TR
141226,1699558800,1699566960,8160,77465,197978,IT,CH
41937,1699551780,1699583700,31920,130067,59427,TR,TR
6033,1700374560,1700382720,8160,131211,194403,IT,IT
159995,1699876080,1699897860,21780,133529,148464,RO,RO
29141,1700100060,1700112840,12780,1366,164292,IT,IT
55103,1698867060,1698894840,27780,156202,34351,CH,IT
98947,1700761080,1700794680,33600,24408,33124,TR,TR
41076,1699538400,1699556220,17820,108248,94778,US,US
6406,1700269320,1700298360,29040,118059,126366,TR,TR
80843,1700652600,1700671920,19320,119562,57780,FR,DE
120799,1700527800,1700557080,29280,55303,173042,TR,TR
67740,1699648560,1699654080,5520,186152,174644,GB,GB
96518,1700284080,1700296440,12360,184331,16729,RS,DE
181559,1699908660,1699920060,11400,139226,133912,CZ,HU
7783,1699909740,1699915380,5640,79264,199826,GB,GB
77849,1699229040,1699252860,23820,13463,135733,PL,PL
31796,1699125300,1699134240,8940,193938,158550,PT,PT
195073,1699745520,1699760220,14700,24604,113756,RS,RS
70937,1700648340,1700677140,28800,74815,29246,TR,TR
51183,1700208660,1700213340,4680,170789,164287,NL,NL
175175,1700663460,1700680320,16860,122506,149129,RS,SI
149498,1699676520,1699689840,13320,199248,54360,IT,IT
183232,1699273440,1699297440,24000,75538,193494,DE,DE
47951,1700132100,1700163300,31200,33796,131835,TR,TR
40259,1698906120,1698918780,12660,180918,57651,US,US
94524,1700383740,1700398500,14760,137503,119205,US,US
95655,1700051580,1700085420,33840,38726,148674,TR,TR
114708,1700738940,1700752980,14040,163132,186529,HR,HR
96807,1700001960,1700034840,32880,113528,31899,TR,TR
111029,1699019100,1699054080,34980,27034,148799,TR,TR
192137,1700369340,1700375100,5760,71685,197542,GB,GB
27361,1698957540,1698962400,4860,89392,76452,GB,GB
47137,1698895140,1698928500,33360,123679,51905,MX,MX
74492,1699944120,1699961040,16920,109091,146785,SE,SE
51146,1699446720,1699462920,16200,132081,52756,US,MX
45204,1700073960,1700080260,6300,59295,164066,GB,GB
37117,1699371300,1699401780,30480,181366,31859,TR,TR
24699,1700103600,1700118480,14880,121927,98856,FR,CH
177572,1700493900,1700517300,23400,91506,116911,DE,BG
167828,1698797040,1698810720,13680,45478,51660,US,US
32109,1700256840,1700289360,32520,70927,66818,TR,TR
140681,1700508600,1700539020,30420,163748,167608,TR,TR
45713,1699040400,1699065660,25260,170228,159730,NO,SE
171644,1699754400,1699767000,12600,94832,149153,US,US
66700,1698830100,1698861660,31560,19241,39177,TR,TR
25988,1699178100,1699190940,12840,90356,77772,IT,IT
102484,1699539000,1699544460,5460,28325,94073,GB,GB
64475,1700610480,1700642640,32160,54426,5903,TR,TR
97792,1699114920,1699126620,11700,163163,112639,IT,IT
164072,1699339080,1699348980,9900,55518,25816,PT,PT
98759,1699374180,1699407300,33120,60280,62345,MK,IT
25806,1699142040,1699158300,16260,96954,189786,CZ,CZ
166930,1699805400,1699839360,33960,90795,131287,TR,TR
78806,1699477260,1699490280,13020,61428,189841,RS,RS
54780,1699305420,1699317120,11700,191034,177161,IT,CH
75391,1700038320,1700071800,33480,193394,107847,TR,TR
143662,1700689140,1700715480,26340,153551,37665,DE,PL
81159,1699536540,1699550760,14220,156997,79104,HR,HR
172806,1700099640,1700103240,3600,161821,12546,NL,NL
142501,1699354560,1699363800,9240,105292,194804,IT,CH
138865,1700010660,1700014260,3600,50510,55097,GB,GB
154371,1700282400,1700287080,4680,74917,62202,NL,NL
33959,1699358580,1699367460,8880,4644,72643,CL,CL
198030,1699636500,1699662840,26340,163819,16166,RO,RO
69653,1698921300,1698924900,3600,90251,5396,GB,GB
5465,1698976680,1698989460,12780,63597,94547,IT,IT
43041,1699973100,1700002620,29520,121479,561,TR,TR
33003,1699635180,1699647540,12360,83998,16969,IT,IT
47473,1700191080,1700204460,13380,55574,64605,SK,AT
86747,1699793280,1699829100,35820,112094,17123,TR,TR
71019,1700154720,1700164440,9720,67881,105741,IT,IT
57022,1699882680,1699889880,7200,142699,166037,IT,IT
67447,1699658640,1699693560,34920,129032,199828,TR,TR
174248,1699099320,1699135020,35700,105526,90482,TR,TR
77531,1700557380,1700588160,30780,188180,10860,TR,TR
7086,1700309640,1700313660,4020,117996,543,GB,GB
60296,1700044980,1700048580,3600,188977,130327,GB,GB
122222,1700239140,1700252460,13320,165743,56027,AT,AT
116388,1699169220,1699180800,11580,10973,75182,ES,FR
154903,1700511660,1700541600,29940,37464,23531,TR,TR
29552,1699147860,1699156740,8880,137460,2165,IT,IT
151756,1700521320,1700553060,31740,86194,154345,TR,TR
62819,1698954120,1698973320,19200,60325,107076,BE,FR
26585,1699047540,1699051140,3600,38321,72541,NL,NL
23903,1699070760,1699083300,12540,194280,97709,US,US
19813,1699772880,1699776480,3600,154374,153882,NL,NL
48830,1700268960,1700275740,6780,145764,71687,GB,GB
191609,1699091820,1699123680,31860,123802,109985,TR,TR
182376,1699781700,1699817040,35340,40746,134056,TR,TR
149499,1699760400,1699778280,17880,87744,21904,US,US
85907,1699610220,1699617180,6960,67273,90711,GB,GB
198772,1700264220,1700267820,3600,78901,105743,NL,NL
92736,1699543380,1699576680,33300,1306,59165,MX,MX
139759,1700113140,1700151900,38760,166385,151874,MX,MX
55743,1699780020,1699792200,12180,1616,31245,ES,ES
177922,1699335540,1699366200,30660,47778,190197,TR,TR
63667,1700151720,1700184600,32880,81905,78944,TR,TR
77473,1700569800,1700573400,3600,183233,63471,GB,GB
172713,1699554300,1699557900,3600,132963,181947,GB,GB
62397,1698919980,1698952920,32940,136896,158245,TR,TR
193082,1700431200,1700465520,34320,80896,93486,TR,TR
69887,1699129200,1699162500,33300,105902,153555,TR,TR
15768,1699537380,1699550940,13560,81067,87813,AT,AT
51056,1700421720,1700433420,11700,119974,104549,US,US
163474,1699397220,1699401060,3840,52489,169372,NL,NL
142539,1699032900,1699065720,32820,113554,73522,TR,TR
76159,1699787520,1699809900,22380,174598,153325,BR,BR
76974,1699039560,1699070940,31380,110367,45887,TR,TR
66988,1700202660,1700233920,31260,156456,9857,TR,TR
141974,1700416740,1700432280,15540,150727,121978,AT,DE
76112,1700132580,1700166060,33480,87783,179117,TR,TR
40398,1699858020,1699867200,9180,179292,56979,HR,HR
73432,1699010640,1699021560,10920,48091,172519,US,US
178925,1699848780,1699862700,13920,1834,82468,US,US
79052,1700797500,1700827200,29700,77273,132641,TR,TR
171871,1699632120,1699637520,5400,62466,83354,GB,GB
28411,1700416320,1700451900,35580,156146,70737,TR,TR
176938,1698996600,1699030500,33900,176801,62942,TR,TR
190538,1700652060,1700664960,12900,147591,139430,ES,AD
3596,1700588580,1700605140,16560,195812,13173,AT,SK
139472,1699582800,1699590540,7740,174619,78820,IT,IT
157948,1699476780,1699487940,11160,161227,36385,US,US
14828,1700635080,1700669400,34320,28319,11946,TR,TR
153782,1698975300,1698987960,12660,25433,191036,US,US
111309,1700338500,1700357340,18840,176880,72,SI,BA
64891,1700443920,1700454060,10140,103804,46288,IT,IT
79118,1699362240,1699374900,12660,11783,68774,HR,HR
159901,1700274480,1700303280,28800,77777,34663,TR,TR
104743,1699416600,1699446000,29400,15000,166634,TR,TR
163812,1698875700,1698895200,19500,90649,140047,FR,NL
154885,1700355720,1700370480,14760,13535,70370,AT,RO
104905,1699190340,1699198320,7980,68137,121887,HR,BA
92055,1700639040,1700672220,33180,45185,30255,TR,TR
100619,1699439340,1699468080,28740,122278,54577,DE,HU
32398,1699783080,1699812480,29400,63489,156668,TR,TR
180436,1699767000,1699770600,3600,152107,101455,GB,GB
184865,1699231500,1699241220,9720,67617,50960,ES,BE
36527,1699470000,1699493700,23700,171393,38503,DE,SK
180075,1699681440,1699688160,6720,135853,151782,GB,GB
151087,1699538220,1699553340,15120,32922,84146,AT,SK
149164,1700667180,1700700240,33060,39978,72974,TR,TR
72975,1700793660,1700805300,11640,133482,151095,IT,IT
120325,1698982260,1699016580,34320,23931,42118,TR,TR
175235,1698987300,1698997980,10680,27396,172849,IT,IT
150873,1699518240,1699552320,34080,96565,115470,TR,TR
190304,1699756680,1699761660,4980,148613,198170,NL,NL
26079,1699181160,1699192860,11700,48366,2299,IT,IT
45303,1699174260,1699189860,15600,121318,75568,US,US
10179,1700395260,1700419380,24120,170998,119865,DE,FR
27637,1700007840,1700011440,3600,25118,76235,GB,GB
145220,1699905360,1699926840,21480,64887,113865,FR,DE
125259,1699050840,1699069500,18660,113194,194801,FR,FR
166007,1700195940,1700200860,4920,138650,119880,NL,NL
1250,1699589220,1699619460,30240,127037,103961,TR,TR
167794,1700357340,1700386980,29640,35956,57304,TR,TR
100735,1700174520,1700199780,25260,47306,21525,DE,DE
34392,1699091880,1699117140,25260,91028,136888,BR,BR
5335,1699632000,1699641780,9780,103951,120692,ES,AD
22580,1698972240,1699003140,30900,124516,121196,TR,TR
126207,1700708460,1700721960,13500,52834,48790,IT,IT
185266,1700548140,1700551740,3600,183945,2241,GB,GB
149418,1699242720,1699259880,17160,151963,2966,US,US
116654,1700193600,1700206500,12900,109694,121473,US,US
37173,1699971240,1699988220,16980,65008,43142,US,US
26711,1700513400,1700542140,28740,34052,171305,CH,DE
24899,1700224320,1700254980,30660,126585,164497,TR,TR
165099,1699186200,1699189800,3600,167954,123054,NL,NL
36575,1700516460,1700546340,29880,65035,147856,TR,TR
4627,1700374500,1700381520,7020,19623,75463,NL,NL
125207,1700168880,1700200020,31140,29779,121584,TR,TR
80582,1700778840,1700795880,17040,10439,129218,US,US
147314,1698985800,1699018140,32340,164911,139996,TR,TR
130741,1700163180,1700194020,30840,31009,71043,TR,TR
100011,1700210340,1700213940,3600,123147,120525,GB,GB
98356,1699022820,1699055640,32820,24670,168182,TR,TR
187289,1698886140,1698915240,29100,164271,104613,TR,TR
67908,1699360320,1699392900,32580,156344,70049,TR,TR
19490,1699465560,1699479060,13500,67459,182712,US,US
151761,1699939500,1699965420,25920,41528,53527,PL,DE
188563,1700182320,1700193300,10980,132641,185814,PT,PT
106183,1700839860,1700846640,6780,195483,174802,GB,GB
76496,1700772720,1700797020,24300,88786,93740,DE,BE
130511,1700604600,1700613600,9000,133682,53502,HR,HR
100889,1699567620,1699595040,27420,178994,88090,DE,NL
55421,1699041060,1699071480,30420,151882,124407,TR,TR
64139,1698847500,1698851100,3600,86879,179864,GB,GB
132165,1699867140,1699896540,29400,110107,153233,TR,TR
45682,1700648580,1700665560,16980,29027,47090,US,US
149674,1700447520,1700479140,31620,63716,93356,TR,TR
186287,1699767840,1699778700,10860,22088,85111,CZ,CZ
57716,1700571420,1700584560,13140,121715,197190,US,US
189294,1700768280,1700802240,33960,37364,142822,TR,TR
26121,1699921860,1699925460,3600,72886,16077,GB,GB
68422,1698793320,1698801960,8640,114534,88397,IT,IT
34115,1698887820,1698913260,25440,12589,178046,DE,DE
194700,1699168740,1699203420,34680,149440,118673,TR,TR
72497,1699612560,1699616160,3600,44102,79718,GB,GB
185532,1699848720,1699853700,4980,70029,41494,GB,GB
33197,1698997320,1699003740,6420,111743,162974,NL,NL
151710,1699787400,1699791600,4200,195099,31097,NL,NL
130155,1700713500,1700730300,16800,16707,21633,US,US
89271,1700143260,1700178780,35520,162407,175801,MX,MX
6049,1699107240,1699134780,27540,154526,102723,PL,PL
95304,1699751400,1699781100,29700,117489,8262,TR,TR
112044,1699536240,1699539840,3600,112417,84504,NL,NL
106773,1699343820,1699371120,27300,100828,86355,HU,IT
59899,1700626080,1700636100,10020,168293,11345,HR,HU
98866,1699645680,1699678140,32460,29338,147686,TR,TR
109687,1699979220,1700015880,36660,189925,92700,MX,US
132972,1700168400,1700174760,6360,24649,99455,NL,NL
131112,1699272120,1699302480,30360,169143,27062,TR,TR
173585,1700852640,1700882640,30000,199606,134332,TR,TR
67400,1699326960,1699356720,29760,64040,3986,TR,TR
115023,1698945360,1698977820,32460,95632,39292,TR,TR
34798,1699216860,1699225500,8640,198621,186743,HR,HR
161705,1699547280,1699579980,32700,81374,159532,TR,TR
129378,1700045400,1700073780,28380,132992,4154,DE,DE
43712,1700847480,1700876460,28980,145825,160087,TR,TR
114505,1700729340,1700732940,3600,36902,4907,NL,NL
153946,1699695360,1699719960,24600,113627,196073,DE,EE
37822,1700574240,1700609880,35640,178127,3534,TR,TR
3661,1700391900,1700403960,12060,55939,99473,IT,IT
160286,1699365600,1699370100,4500,23495,127991,GB,GB
86981,1699086900,1699122600,35700,172288,182405,TR,TR
110252,1700245560,1700275620,30060,164436,31940,TR,TR
172559,1699761360,1699769520,8160,185283,92523,ES,ES
141480,1699339860,1699343460,3600,150829,172775,NL,NL
71207,1699218780,1699233120,14340,118819,87449,IT,IT
189141,1700568660,1700600640,31980,188793,73665,TR,TR
122839,1700134140,1700137740,3600,177409,193866,NL,NL
195844,1700201220,1700239740,38520,67552,89185,MX,MX
155174,1700264940,1700280720,15780,73856,45004,US,US
74861,1700160300,1700191740,31440,129675,66566,TR,TR
10411,1699933680,1699939740,6060,44660,199677,GB,GB
3732,1699297560,1699302180,4620,135509,59865,NL,NL
65916,1700104440,1700111640,7200,54341,152121,IT,HU
171054,1700109540,1700123160,13620,131351,196722,US,US
170320,1699392540,1699408800,16260,164356,65489,US,US
121045,1700826600,1700862300,35700,44913,45545,TR,TR
83729,1700081280,1700084880,3600,47815,195165,GB,GB
65229,1700679840,1700714880,35040,44813,100990,TR,TR
66820,1700721780,1700752320,30540,4372,15929,TR,TR
9640,1700829540,1700843340,13800,160195,60144,IT,IT
102172,1700741460,1700753640,12180,102555,101561,AT,AT
101039,1700401860,1700417760,15900,192087,58234,US,US
3250,1699535520,1699569840,34320,116608,14250,TR,TR
36811,1699290600,1699321500,30900,191691,5555,TR,TR
65596,1698935220,1698954480,19260,198255,20286,FR,FR
107981,1700757060,1700760660,3600,46750,130667,GB,GB
48619,1700216520,1700252160,35640,101700,17991,TR,TR
138214,1699104060,1699136520,32460,168167,112231,TR,TR
145514,1699918440,1699952640,34200,36923,69259,TR,TR
13499,1700847720,1700859120,11400,137380,124962,US,US
80163,1699683060,1699717560,34500,41411,21201,MX,MX
114889,1699960980,1699993980,33000,76800,29377,TR,TR
58744,1700352600,1700383320,30720,127659,111044,TR,TR
50890,1700352960,1700382660,29700,35310,114963,TR,TR
27409,1698833580,1698866640,33060,46383,32784,MK,DE
22749,1700121120,1700126460,5340,102112,63285,GB,GB
193378,1700304420,1700333700,29280,33154,105094,TR,TR
92163,1700626440,1700657580,31140,2914,87903,TR,TR
92449,1699779840,1699814520,34680,174738,120397,TR,TR
178577,1699355280,1699394400,39120,173713,52832,LV,PL
115255,1698968880,1698980280,11400,48326,33916,US,US
139552,1699023960,1699035480,11520,17013,79257,IT,IT
66202,1699493760,1699503720,9960,3002,178732,HR,HR
38292,1700140320,1700174340,34020,137852,191978,TR,TR
181345,1698963000,1698979740,16740,71583,174342,AT,AT
175278,1699185060,1699218540,33480,104695,63582,TR,TR
18475,1700585100,1700619300,34200,25859,131522,MX,MX
48519,1699206600,1699218420,11820,168027,44882,IT,IT
41347,1700127720,1700134200,6480,193575,83128,GB,GB
44850,1699360860,1699397760,36900,172742,185299,MX,MX
95952,1699695600,1699721940,26340,65085,84983,HU,AT
36752,1699339560,1699343160,3600,107898,140954,NL,BE
1390,1700356080,1700389680,33600,154349,172795,TR,TR
40113,1700134440,1700142780,8340,50540,15893,IT,FR
191122,1700103060,1700106660,3600,40252,12564,GB,GB
10350,1699383420,1699408260,24840,30565,33654,DE,BA
46447,1700401620,1700407860,6240,59506,74919,GB,GB
103824,1700256360,1700291820,35460,184870,50615,TR,TR
11013,1700320740,1700337060,16320,80517,42503,AT,AT
27694,1700813340,1700848140,34800,175044,137776,TR,TR
7543,1698888780,1698897480,8700,179447,15015,AD,ES
98836,1700740560,1700756520,15960,169126,100618,US,US
199833,1700690340,1700721180,30840,48377,170182,TR,TR
19716,1699561200,1699564800,3600,116116,137515,GB,GB
93231,1699920120,1699952100,31980,100384,170723,TR,TR
129109,1699965420,1699997640,32220,88898,91133,TR,TR
55885,1700468760,1700482860,14100,16976,181566,US,US
14293,1700735460,1700746860,11400,79814,65315,AT,AT
90276,1699181760,1699202100,20340,182649,113101,BE,DE
66366,1698811200,1698820380,9180,94509,173774,IT,IT
194451,1699039500,1699057500,18000,128562,5919,FR,FR
121084,1699096380,1699099980,3600,66557,186973,NL,NL
152196,1700656380,1700713560,57180,103958,123170,BG,DE
182801,1699287240,1699304040,16800,101250,174386,US,US
196904,1700110500,1700114100,3600,146455,56252,GB,GB
145628,1698968220,1698977640,9420,76101,196010,IT,IT
122092,1700439960,1700447640,7680,135593,100044,IT,IT
106768,1699151640,1699156920,5280,97044,7773,NL,NL
103547,1700459940,1700492220,32280,123377,106587,TR,TR
48108,1699739820,1699770480,30660,4661,32042,TR,TR
21590,1699682700,1699712340,29640,110494,111217,TR,TR
155116,1700183160,1700192760,9600,181166,77485,SK,PL
165445,1699467780,1699502220,34440,36675,117295,TR,TR
31537,1699318500,1699333320,14820,79413,166842,FR,BE
48808,1700494620,1700520540,25920,112410,161260,PL,PL
92858,1700131140,1700166840,35700,27259,76728,TR,TR
62108,1700362560,1700368800,6240,24128,165219,GB,GB
72386,1700138400,1700150520,12120,63123,133519,US,US
163586,1700652360,1700670060,17700,25296,172727,US,US
82489,1700595720,1700629500,33780,175029,160347,TR,TR
184140,1700342940,1700359560,16620,54034,114470,US,US
125720,1698899820,1698928380,28560,92401,31320,DE,NL
168134,1698873360,1698884100,10740,168374,123619,IT,IT
24610,1700304300,1700310600,6300,118974,50686,GB,GB
153991,1700604840,1700619180,14340,66892,75519,US,US
1488,1699448760,1699453920,5160,96520,117238,GB,GB
162977,1698870180,1698899160,28980,15074,136791,TR,TR
154381,1699011300,1699023180,11880,137639,6112,AT,MK
120896,1699394400,1699398000,3600,151508,4508,GB,GB
45228,1700326260,1700329860,3600,66938,32754,GB,GB
190035,1698908040,1698941100,33060,39199,156149,TR,TR
172911,1700324220,1700334780,10560,184434,70245,IT,IT
47463,1700103420,1700120520,17100,193510,112441,CZ,CH
177794,1700482440,1700497440,15000,75329,85493,US,US
28838,1700492580,1700504760,12180,90832,167506,US,US
168795,1699009500,1699041300,31800,185787,80481,TR,TR
58104,1700249640,1700262300,12660,49467,57079,IT,IT
109629,1699036260,1699042620,6360,101747,149200,GB,GB
27999,1700113920,1700130060,16140,39406,21154,US,US
155346,1700144460,1700148180,3720,174471,91106,NL,NL
74342,1700699100,1700710500,11400,49228,169261,HR,HR
89476,1699678620,1699691880,13260,198114,260,IT,IT
2931,1700635620,1700658000,22380,64221,130751,DE,CZ
8666,1699532040,1699535640,3600,49296,168031,GB,GB
161445,1700088000,1700097360,9360,107996,100500,HR,HR
68813,1700162040,1700172180,10140,100031,133458,IT,IT
12736,1700856780,1700891340,34560,70315,147858,TR,TR
141265,1700612760,1700616720,3960,167486,168461,GB,GB
114369,1699599780,1699604880,5100,171861,32893,NL,NL
156585,1699348560,1699368540,19980,16011,101021,FR,BE
43494,1700162340,1700176560,14220,197033,37141,PT,PT
35587,1700401620,1700415960,14340,190786,125154,HR,BA
72338,1700393040,1700427660,34620,131213,185307,TR,TR
124188,1699987020,1700018640,31620,79453,62651,TR,TR
46622,1699293060,1699305660,12600,104300,86440,ES,AD
51021,1699543800,1699579620,35820,155591,4433,TR,TR
30218,1700398080,1700408340,10260,175101,50561,IT,IT
176662,1699535940,1699566360,30420,125339,113854,TR,TR
198579,1698960120,1698963720,3600,3245,124180,NL,FR
64304,1700080200,1700113920,33720,196559,51020,TR,TR
79715,1699254300,1699282920,28620,163919,149856,DE,BG
111629,1699129080,1699136340,7260,140502,185702,IT,IT
155276,1700370660,1700383020,12360,126781,118923,US,MX
83045,1699897680,1699927560,29880,189865,169092,TR,TR
137614,1699485240,1699515660,30420,85856,146958,TR,TR
51524,1700805660,1700836320,30660,73174,189605,TR,TR
117955,1699342500,1699346100,3600,29895,2030,GB,GB
111334,1699478220,1699482660,4440,175949,108673,GB,GB
57973,1699357620,1699391640,34020,148878,57299,TR,TR
195581,1699841100,1699849440,8340,58115,180237,HR,HR
140221,1699662060,1699665660,3600,170614,1721,NL,NL
26943,1700545560,1700569980,24420,143213,158839,DE,SE
165263,1698820440,1698824040,3600,116037,70835,GB,GB
138385,1699658700,1699687860,29160,10437,22959,TR,TR
4897,1700603640,1700638140,34500,145036,199352,MX,MX
113874,1699284660,1699291140,6480,22237,105826,GB,GB
98649,1700709420,1700739240,29820,114351,73113,TR,TR
82084,1699647600,1699651200,3600,49869,70225,NL,NL
152144,1699472340,1699476840,4500,171337,19979,GB,GB
120231,1700683440,1700697660,14220,88164,55722,HR,HR
172455,1699078560,1699085400,6840,121205,175606,GB,GB
132753,1699343460,1699380240,36780,14123,150689,MX,MX
69623,1700426640,1700461980,35340,128963,140326,TR,TR
135001,1699970820,1699983720,12900,10513,10565,US,US
151220,1700700900,1700712240,11340,18187,83422,PT,PT
62029,1700121180,1700129520,8340,159354,12144,IT,IT
179456,1699887240,1699892040,4800,171208,191608,EE,EE
177186,1699646160,1699680840,34680,194108,168749,TR,TR
60121,1699003920,1699038120,34200,28035,7534,TR,TR
125187,1700560680,1700584440,23760,105389,43090,DE,BG
135372,1699934520,1699989720,55200,136130,43704,BG,DE
163524,1700710320,1700723040,12720,45867,17659,CZ,CH
120744,1699785720,1699802580,16860,192342,142944,US,US
33636,1700344320,1700379780,35460,181930,7339,MX,MX
87497,1700787600,1700803980,16380,42244,90235,US,US
82245,1700705100,1700718120,13020,164451,138217,CZ,SE
98643,1699970160,1700005140,34980,135849,48130,TR,TR
194891,1698810060,1698822900,12840,45170,43064,IT,IT
120575,1700254020,1700265000,10980,171027,31255,IT,IT
166525,1700133300,1700145720,12420,96460,5473,HR,HR
79259,1699410600,1699440000,29400,38908,168248,TR,TR
149681,1698867360,1698901800,34440,137702,182885,TR,TR
39116,1699196880,1699210140,13260,191274,74797,US,US
32836,1699901220,1699904820,3600,152170,35789,GB,GB
73507,1700310720,1700330220,19500,167062,119961,FR,DE
121228,1699096560,1699106040,9480,118776,123573,PT,PT
113686,1700013180,1700045040,31860,87824,169031,TR,TR
87191,1700440020,1700443620,3600,123,32298,NL,NL
41351,1699175640,1699196580,20940,25793,33198,SE,SE
180987,1699115940,1699131720,15780,26372,198551,BE,NL
182587,1699196400,1699207920,11520,144423,42082,HR,HR
126504,1700027160,1700038980,11820,162993,37489,HR,HR
33724,1699712280,1699741920,29640,115279,3989,TR,TR
176375,1700703660,1700717940,14280,177174,141659,IT,CH
46916,1699205640,1699238700,33060,135520,146344,TR,TR
193080,1699330380,1699337400,7020,138595,155337,EE,EE
96854,1699428900,1699463880,34980,198787,21825,TR,TR
46971,1699505340,1699508940,3600,72299,107132,GB,GB
69073,1699165440,1699196340,30900,165026,106191,TR,TR
49738,1699252380,1699256640,4260,175626,129132,GB,GB
128623,1700721840,1700751660,29820,110521,113294,TR,TR
57220,1700174220,1700192160,17940,102815,89402,FR,FR
137429,1700107500,1700111460,3960,90985,91175,GB,GB
81253,1700017500,1700021100,3600,126298,196897,GB,GB
44029,1699707720,1699711860,4140,153469,41867,NL,NL
125237,1700100480,1700135160,34680,177274,84098,TR,TR
88275,1699645800,1699656900,11100,72559,131432,US,CA
178677,1700414100,1700446980,32880,11555,176,TR,TR
149729,1700699880,1700723400,23520,90131,7258,DE,HR
170657,1700242920,1700272020,29100,141043,10010,TR,TR
113637,1700366820,1700388840,22020,38459,87856,DE,DE
147979,1699814760,1699829940,15180,192647,12291,FR,FR
73000,1700384400,1700416080,31680,32817,140487,TR,TR
166993,1699137300,1699151220,13920,77382,48162,IT,IT
9099,1698816420,1698831120,14700,93516,37411,AT,PL
145789,1699766640,1699801380,34740,112012,69652,TR,TR
81620,1700500080,1700513100,13020,162122,186253,IT,IT
192823,1699310520,1699325280,14760,45046,147142,US,US
121722,1700676960,1700714700,37740,161219,43577,MX,MX
158322,1699545420,1699573140,27720,95694,26489,HU,AT
84680,1700655720,1700672700,16980,21570,99120,FR,AD
188110,1699058940,1699068960,10020,182934,7262,HR,HR
40874,1700308920,1700338860,29940,95393,195425,TR,TR
12852,1698934800,1698961680,26880,167803,177955,DE,PL
49171,1698995580,1699025520,29940,90830,159574,TR,TR
87388,1699864260,1699878660,14400,44364,149619,US,US
134059,1699179960,1699191120,11160,54755,179498,ES,ES
2150,1700068560,1700085960,17400,29875,127623,SE,SE
90931,1699658460,1699665120,6660,56214,28666,NL,NL
14948,1700647440,1700659440,12000,132187,97802,US,US
160199,1700665200,1700687160,21960,99416,175779,BR,BR
172450,1700749980,1700781360,31380,196276,172619,TR,TR
145657,1699585380,1699589700,4320,165801,121712,EE,EE
57765,1700071560,1700075160,3600,68696,108805,GB,GB
8850,1700070600,1700085240,14640,187311,92565,CZ,PL
83407,1699287000,1699301340,14340,124696,141333,IT,IT
196157,1699434300,1699450200,15900,77710,105835,US,US
10207,1700600580,1700637480,36900,87170,176629,LV,PL
169008,1699038240,1699054140,15900,38283,3932,CZ,CZ
22305,1699389900,1699406340,16440,93669,60073,US,US
37302,1700520780,1700539200,18420,50969,132981,FR,FR
181678,1699080540,1699108860,28320,121928,108403,DE,IT
39495,1700171580,1700206080,34500,93950,79498,TR,TR
22232,1700639880,1700671800,31920,166434,36469,TR,TR
135652,1699416780,1699425840,9060,185169,106668,HR,HR
153326,1699959960,1699989420,29460,192387,136687,TR,TR
27264,1700683620,1700698200,14580,10043,59002,AT,AT
160787,1698942480,1698977100,34620,96214,197686,TR,TR
141192,1698864240,1698882180,17940,53069,154980,AT,BG
13377,1700855280,1700885760,30480,192006,71351,TR,TR
177634,1700774160,1700777760,3600,16386,105942,GB,GB
199705,1699047660,1699057740,10080,45286,136113,HR,RS
102935,1700862720,1700881080,18360,47445,69884,FR,FR
131453,1698878460,1698910020,31560,161972,174680,TR,TR
118306,1700331060,1700366760,35700,33575,39107,TR,TR
86758,1698834360,1698839160,4800,2206,48644,GB,GB
147267,1699102740,1699131960,29220,186482,185338,TR,TR
16294,1699442580,1699455540,12960,94926,18122,HR,HR
1159,1699886160,1699896060,9900,40428,75840,IT,IT
101258,1699132320,1699149840,17520,188078,172893,US,US
117035,1699663260,1699694100,30840,126120,98780,TR,TR
139794,1700862780,1700866380,3600,133367,48866,GB,GB
97968,1699360680,1699395180,34500,117115,140994,TR,TR
140527,1699151040,1699154640,3600,173549,191282,GB,GB
28819,1699152180,1699166880,14700,104995,162435,RS,RS
133657,1700312940,1700372700,59760,136575,15331,UA,PL
70205,1700200200,1700203800,3600,48185,184990,NL,NL
144652,1699410660,1699445940,35280,172415,144762,TR,TR
194456,1700696880,1700706600,9720,193457,26524,PT,PT
106907,1699997760,1700029800,32040,189899,168225,TR,TR
2589,1699545480,1699576560,31080,79199,91617,TR,TR
26906,1699968960,1699975560,6600,180514,93654,GB,GB
13352,1699042320,1699070640,28320,146677,145741,DE,DE
87091,1699436820,1699470060,33240,47848,164855,TR,TR
18365,1700223900,1700254920,31020,79238,101495,TR,TR
145535,1700312400,1700316660,4260,123749,134635,GB,GB
94903,1699819560,1699849980,30420,133622,183595,TR,TR
180975,1700140680,1700167320,26640,95411,50037,DE,DK
29972,1698896280,1698930960,34680,54328,127320,TR,TR
57331,1699402980,1699419660,16680,9964,111193,AT,AT
167421,1700440020,1700453940,13920,105647,180375,US,US
172842,1700258340,1700261940,3600,54856,189230,GB,GB
122728,1699679700,1699713060,33360,139139,9206,TR,TR
163719,1699604880,1699628760,23880,193437,22310,DE,DE
91748,1698863700,1698868860,5160,75532,164697,GB,GB
99923,1700175420,1700198280,22860,117343,184643,PL,PL
174782,1700060520,1700076540,16020,102132,52409,US,US
44672,1699854480,1699870920,16440,146217,143832,US,US
56247,1699917300,1699920900,3600,44902,162075,GB,GB
30587,1699679040,1699689780,10740,199358,63048,IT,IT
193011,1700461200,1700473560,12360,79165,41316,IT,IT
189953,1700558100,1700568960,10860,114249,82243,IT,IT
194885,1699568580,1699595100,26520,142365,178055,DE,BE
96255,1700690640,1700701740,11100,87358,100150,AT,DE
47624,1700518920,1700554320,35400,152179,4872,TR,TR
181518,1700505420,1700537880,32460,83590,124505,TR,TR
105216,1699122540,1699156560,34020,77470,21844,TR,TR
98023,1698977880,1698994860,16980,118750,90571,US,CA
189169,1699277340,1699285200,7860,194314,145522,IT,IT
128729,1700390460,1700410380,19920,129404,85886,BE,FR
43692,1699959600,1699988460,28860,131794,199998,TR,TR
70764,1699696800,1699700400,3600,137908,65472,NL,BE
85381,1700163120,1700172600,9480,84514,85815,IT,IT
179131,1699098840,1699111140,12300,92037,88172,IT,FR
38049,1699103580,1699137060,33480,77806,118724,TR,TR
177336,1700265240,1700282700,17460,70821,183775,AT,CZ
74925,1698964980,1698987720,22740,14455,189424,DE,NL
4697,1698976380,1698981000,4620,186453,66519,GB,GB
136316,1698986400,1699019520,33120,104511,738,TR,TR
98898,1699744020,1699777440,33420,79202,18655,TR,TR
56379,1699886160,1699898700,12540,70025,158611,US,US
35918,1699460640,1699472760,12120,4177,154187,US,US
135705,1700846460,1700879700,33240,72230,54332,MX,MX
98545,1700525400,1700554440,29040,34223,46450,TR,TR
86264,1700735160,1700746380,11220,72965,136097,IT,IT
119305,1698826260,1698842520,16260,9725,192338,US,US
37575,1700323200,1700358300,35100,15945,4197,TR,TR
150783,1700090520,1700117340,26820,90224,108292,ME,RS
176220,1700087700,1700114100,26400,150425,145756,DE,DE
115805,1700191920,1700221860,29940,197326,46844,TR,TR
84664,1700448960,1700478240,29280,112292,77197,TR,TR
102125,1698906720,1698919920,13200,54724,172004,CZ,CZ
196878,1700333580,1700347680,14100,186843,173461,HR,HR
44175,1699742160,1699776180,34020,114540,140904,TR,TR
185579,1700134320,1700166960,32640,104815,8048,TR,TR
51589,1699327440,1699339920,12480,168871,92502,IT,IT
2367,1700425980,1700459100,33120,199782,116691,TR,TR
112895,1699152120,1699155840,3720,99210,74440,GB,GB
29487,1699469040,1699503660,34620,180549,111036,MX,MX
57195,1700784960,1700796360,11400,172423,128922,IT,IT
136775,1699695960,1699710300,14340,43014,143846,HR,HR
127831,1699273020,1699303680,30660,150667,81785,TR,TR
95928,1699930320,1699947240,16920,87159,164775,FR,NL
163266,1699023840,1699046640,22800,177152,108666,PL,LV
56306,1700648160,1700660280,12120,25040,151057,IT,IT
114745,1700336760,1700360280,23520,32590,176051,DE,FR
1780,1699012800,1699029840,17040,131985,99622,FR,FR
66371,1699743180,1699749960,6780,54244,81149,GB,GB
142859,1699479420,1699483020,3600,18359,57380,NL,NL
107479,1699988460,1700014440,25980,167686,67727,DE,PL
84191,1699967880,1699997820,29940,44881,10227,TR,TR
148730,1699452720,1699466220,13500,87988,26961,US,US
64306,1700639340,1700649600,10260,117865,180641,IT,IT
196563,1699407960,1699412940,4980,45524,151763,GB,GB
77610,1698928140,1698940920,12780,178980,199116,US,US
60300,1700521740,1700534040,12300,192053,146563,AT,AT
181309,1700665980,1700671020,5040,65544,147910,GB,GB
7677,1700539620,1700552220,12600,142162,53103,IT,IT
151102,1700777580,1700811540,33960,33690,45354,TR,TR
183051,1700216280,1700241660,25380,39364,135736,PL,PL
5772,1700824500,1700836440,11940,163491,182766,IT,IT
145187,1700335740,1700355960,20220,26720,54122,DK,DK
117219,1700817660,1700853000,35340,122974,106746,TR,TR
196762,1699949880,1699966440,16560,162796,60729,US,US
124079,1698827760,1698839640,11880,156569,91031,PT,PT
43220,1699016880,1699047900,31020,147950,17760,TR,TR
48640,1699716960,1699751880,34920,124947,73097,TR,TR
26536,1700508780,1700540280,31500,28867,31949,TR,TR
65753,1699916280,1699919880,3600,105663,68441,GB,GB
66173,1700304300,1700317080,12780,79921,164592,US,US
72281,1700131740,1700145960,14220,188462,169538,RS,RS
172719,1698948180,1698957060,8880,198595,93379,HR,HR
118693,1700074020,1700087040,13020,53103,62587,CZ,CZ
60411,1699587060,1699621740,34680,47516,21760,TR,TR
158750,1699293360,1699328220,34860,46596,25856,TR,TR
179070,1698914880,1698937740,22860,38225,57617,RO,RO
97719,1699562280,1699575060,12780,51083,21492,PT,PT
78269,1700181660,1700213160,31500,62552,136152,TR,TR
13265,1700790060,1700807700,17640,155295,151037,AT,AT
72083,1700697960,1700715600,17640,104119,2985,US,US
125674,1700529780,1700533380,3600,62050,25576,GB,GB
27333,1699767240,1699770840,3600,116525,98535,GB,GB
58375,1700550360,1700579760,29400,55387,191437,TR,TR
118870,1699844940,1699855860,10920,7601,13930,US,US
17333,1700155080,1700194380,39300,184091,77275,MX,MX
72677,1700695680,1700729340,33660,143519,129914,TR,TR
164485,1700094300,1700119920,25620,161859,47695,DE,IT
74892,1698913560,1698949200,35640,172493,153680,TR,TR
145545,1700191380,1700226780,35400,70426,102945,TR,TR
182935,1699849260,1699878780,29520,169448,130188,TR,TR
102088,1699439880,1699446240,6360,116469,67557,GB,GB
56864,1700514960,1700541060,26100,149059,99977,PL,LV
65557,1700237280,1700268780,31500,72426,63596,TR,TR
150789,1700580060,1700613900,33840,2418,188697,TR,TR
50638,1699448640,1699465620,16980,131400,140569,US,US
100612,1700216520,1700227320,10800,45834,62455,IT,IT
100517,1699579440,1699605120,25680,167404,51911,DE,CZ
66401,1698918780,1698932280,13500,18838,129907,US,US
39685,1700136480,1700140080,3600,14600,191193,GB,GB
124576,1700462160,1700492220,30060,105262,149067,TR,TR
166344,1700090100,1700125740,35640,183302,124060,TR,TR
195784,1699486380,1699519440,33060,188030,61119,TR,TR
113744,1699947120,1699950720,3600,195796,108881,GB,GB
71037,1699320780,1699331760,10980,161395,90354,US,US
181449,1699482540,1699508880,26340,134808,7579,RO,RO
27290,1699279200,1699310280,31080,174487,155007,TR,TR
67199,1700486940,1700517780,30840,177461,154063,TR,TR
182682,1699182120,1699196520,14400,16922,170999,US,US
183542,1700528640,1700557740,29100,199619,129397,TR,TR
89068,1700085120,1700118900,33780,181157,113027,TR,TR
12294,1700000940,1700022300,21360,122609,153032,FR,FR
150573,1700316840,1700326740,9900,148314,156054,IT,IT
16569,1698989160,1698993780,4620,102671,29980,NL,NL
88952,1699002720,1699028640,25920,58013,80174,DE,DE
27591,1700817420,1700830860,13440,110695,157699,IT,IT
118641,1699925400,1699939560,14160,137139,198323,SK,SK
2040,1699824240,1699853040,28800,15983,179145,TR,TR
34784,1700361480,1700395680,34200,42858,145100,TR,TR
182145,1700327880,1700358840,30960,9126,104477,TR,TR
20922,1699435800,1699441260,5460,121227,151719,GB,GB
18013,1698922200,1698926280,4080,139859,26499,GB,GB
22650,1700089440,1700120700,31260,29534,152331,TR,TR
122847,1700153160,1700165160,12000,48629,31133,US,US
182879,1700294340,1700328900,34560,183866,57939,TR,TR
172178,1699891560,1699905420,13860,87147,31285,RS,ME
192732,1700254020,1700286960,32940,105738,40661,TR,TR
128482,1700567280,1700572320,5040,118404,77452,GB,GB
36950,1699572480,1699588800,16320,8119,94204,US,US
145223,1698918180,1698934320,16140,130429,80998,FR,FR
54227,1699467480,1699482120,14640,12700,45085,AT,HR
54803,1699796280,1699825620,29340,86183,62304,TR,TR
40820,1700102760,1700115540,12780,71911,113951,ES,FR
171412,1699391340,1699407960,16620,34711,120433,US,US
52983,1699250760,1699254360,3600,25068,99301,NL,NL
153898,1700383680,1700419020,35340,5378,39530,TR,TR
143709,1700767860,1700801340,33480,11762,197727,TR,TR
64729,1699885080,1699888680,3600,136370,56035,GB,GB
83757,1699193520,1699210080,16560,159417,74302,US,US
53181,1698825420,1698831060,5640,116070,28583,NL,NL
34695,1700017980,1700029560,11580,135239,92015,US,US
170724,1699633260,1699637520,4260,197024,138474,GB,GB
13785,1698977760,1699010580,32820,28917,141585,MX,MX
194486,1699809660,1699842660,33000,88281,194760,TR,TR
73449,1699813440,1699820640,7200,170037,178461,SK,AT
189273,1699748700,1699782360,33660,178982,24609,TR,TR
199237,1698893760,1698924960,31200,163399,80321,TR,TR
156429,1699611780,1699627620,15840,165388,78151,CA,US
38053,1699417980,1699425660,7680,8838,100244,ES,ES
35057,1699394760,1699425600,30840,747,79536,TR,TR
102223,1700422380,1700457540,35160,85713,49594,TR,TR
34642,1700512800,1700518740,5940,130156,138194,GB,GB
140838,1700664540,1700676060,11520,74049,126165,US,MX
194901,1699050480,1699062180,11700,119105,44454,HR,HR
6046,1699473960,1699509660,35700,144265,174982,TR,TR
64548,1699512420,1699541700,29280,170663,52857,TR,TR
105699,1699513200,1699547700,34500,39122,106053,TR,TR
172568,1700527320,1700557440,30120,172199,60832,TR,TR
122455,1700169240,1700198820,29580,145526,121863,TR,TR
75799,1700437080,1700472360,35280,69008,113915,TR,TR
134968,1700692380,1700723340,30960,60387,70041,TR,TR
115058,1699741020,1699768860,27840,73270,70205,DE,BA
70847,1699787580,1699794480,6900,138334,37011,GB,GB
47404,1699335060,1699359780,24720,81841,82825,DE,SK
132955,1699904820,1699921320,16500,25686,102626,US,US
145936,1699683180,1699718760,35580,113633,196280,TR,TR
74099,1699377720,1699383000,5280,175984,51616,GB,GB
72542,1699686660,1699716660,30000,50171,70774,TR,TR
139739,1699630920,1699634520,3600,122675,118417,GB,GB
175574,1698959220,1698971520,12300,67730,123465,ES,ES
171861,1699395000,1699419060,24060,174043,158591,DE,DE
23644,1699363980,1699378020,14040,80538,186088,PT,PT
55356,1699514160,1699521000,6840,136979,35320,EE,EE
48499,1698907440,1698942900,35460,115788,126862,TR,TR
165831,1699971420,1700006160,34740,145267,185515,TR,TR
52529,1699253460,1699287780,34320,159576,89376,TR,TR
52411,1698903960,1698933360,29400,27125,159833,TR,TR
91318,1699516320,1699525860,9540,99392,35235,IT,IT
11488,1700581200,1700584800,3600,23562,122883,GB,GB
137842,1700189580,1700193780,4200,15882,98511,AD,ES
108741,1700255400,1700273340,17940,81157,89392,US,US
144144,1700700060,1700733660,33600,36681,114933,TR,TR
23010,1699967280,1700005500,38220,55338,97488,MX,MX
67753,1699284780,1699323000,38220,79898,76760,MX,MX
63441,1699923660,1699927260,3600,62380,139419,GB,GB
29250,1698814140,1698846060,31920,143670,60949,TR,TR
20469,1699027320,1699033920,6600,32912,125820,GB,GB
184728,1699434300,1699450980,16680,101220,121725,US,US
132919,1699722120,1699731300,9180,107316,180853,IT,IT
69611,1699518900,1699552860,33960,104349,194769,TR,TR
1294,1699092540,1699120560,28020,146763,54988,BR,BR
11633,1698810240,1698813840,3600,148609,191116,GB,GB
176767,1700353800,1700377560,23760,31986,5623,PL,DK
121977,1700199840,1700215200,15360,186523,93399,CA,CA
137642,1699479660,1699511340,31680,91377,105666,TR,TR
27883,1700829900,1700847840,17940,154847,198596,FR,DE
115621,1700446320,1700475420,29100,141232,1301,TR,TR
51168,1700467560,1700473140,5580,152611,181782,NL,NL
185335,1700806320,1700837460,31140,166384,108901,TR,TR
176006,1698983520,1698998700,15180,122501,26938,BE,NL
122585,1700332980,1700336580,3600,49952,123041,GB,GB
174442,1699462740,1699486620,23880,101861,49744,BR,BR
71822,1698910380,1698915300,4920,69231,182769,NL,NL
68052,1700658120,1700673360,15240,92028,99233,FR,IT
175363,1700050020,1700060640,10620,134175,27135,IT,IT
154219,1699639560,1699673400,33840,90285,35273,TR,TR
150865,1700455260,1700472540,17280,144894,168005,US,US
163160,1699724520,1699735380,10860,82002,27355,US,US
77816,1699600140,1699609440,9300,44485,111459,HR,HR
93038,1700116320,1700151840,35520,121506,80136,TR,TR
176747,1699507080,1699536480,29400,54388,183605,TR,TR
42107,1700353860,1700389620,35760,43118,318,TR,TR
129642,1700795400,1700799900,4500,58266,18168,GB,GB
88586,1698935100,1698945900,10800,143760,120475,AT,DE
96537,1699065480,1699090380,24900,99625,48903,RO,RO
18724,1700197860,1700209980,12120,87655,179427,IT,IT
56125,1700209020,1700238480,29460,34523,72071,TR,TR
139481,1700307240,1700341920,34680,69505,31218,TR,TR
191361,1700812320,1700837100,24780,171223,133630,RO,DK
158526,1700527200,1700557800,30600,178334,159546,TR,TR
115575,1698879900,1698883500,3600,62449,125077,GB,GB
122648,1699012320,1699024980,12660,75357,100343,HR,IT
187276,1698890280,1698893880,3600,69894,101426,GB,GB
198448,1699351020,1699384140,33120,38916,68440,TR,TR
31878,1700791500,1700848260,56760,72905,9032,BG,HU
59526,1699821000,1699828980,7980,51134,46281,ES,ES
51806,1700480100,1700487240,7140,134620,56190,GB,GB
36607,1698841500,1698856260,14760,170531,65437,FR,FR
104425,1700787240,1700790960,3720,98067,12916,GB,GB
33711,1700727180,1700732160,4980,108878,107678,GB,GB
90189,1699648380,1699665300,16920,117864,44854,US,US
106487,1699014840,1699020960,6120,53602,171267,EE,EE
112605,1700850180,1700866980,16800,44005,47176,US,US
36967,1699952100,1699964520,12420,3872,85406,RS,RS
27127,1699551480,1699590840,39360,88470,166636,MX,MX
113337,1699228560,1699240500,11940,62378,34560,RS,RS
102687,1699815960,1699841280,25320,191843,41103,CH,FR
173896,1699116420,1699129440,13020,124290,53718,ES,FR
155369,1700785080,1700794620,9540,162123,198076,ES,ES
15004,1699386300,1699400280,13980,167666,102930,IT,IT
71292,1699975380,1699981200,5820,144625,172869,GB,GB
7429,1700061420,1700065080,3660,161050,1747,GB,GB
125078,1699143360,1699160520,17160,131575,165802,US,US
120139,1699584600,1699617720,33120,6971,121204,TR,TR
21548,1699405260,1699434480,29220,197691,100687,TR,TR
175623,1699190520,1699194120,3600,144899,95869,NL,NL
59318,1700705280,1700735400,30120,47846,144094,TR,TR
54742,1700858340,1700874900,16560,166034,56187,US,US
118475,1699868580,1699903020,34440,147622,13798,TR,TR
8497,1698944460,1698978420,33960,167483,18745,MX,MX
182165,1699184280,1699187880,3600,147651,139928,GB,GB
83581,1700253900,1700286060,32160,38309,12029,TR,TR
9542,1699512360,1699542780,30420,21951,121575,TR,TR
30942,1699746060,1699762140,16080,167063,34759,RS,RS
79344,1700267100,1700298240,31140,188616,77496,TR,TR
34471,1699880880,1699889040,8160,43674,39002,HR,HR
170171,1699880700,1699911300,30600,198117,136253,TR,TR
163616,1698963120,1698975900,12780,47780,79729,IT,FR
185688,1700503500,1700515200,11700,190170,157327,US,US
134260,1699062660,1699098240,35580,143128,29553,TR,TR
110202,1700540700,1700551200,10500,9820,153769,EE,EE
21892,1699420500,1699424100,3600,178984,74941,GB,GB
150628,1700769540,1700778360,8820,188512,104742,ES,AD
43928,1698993240,1699025640,32400,142780,15162,TR,TR
187223,1698983640,1699018380,34740,16945,141804,TR,TR
182247,1699453800,1699464900,11100,90065,123725,US,US
60036,1699292880,1699325700,32820,2706,69465,MX,US
149840,1700162040,1700192820,30780,127322,176722,TR,TR
130032,1699761180,1699770360,9180,61685,15760,IT,IT
179872,1700088900,1700092500,3600,20043,26497,NL,NL
72133,1699574640,1699606380,31740,146279,122987,TR,TR
179704,1700413140,1700428740,15600,31731,48129,US,US
192347,1699667280,1699701780,34500,71415,108379,TR,TR
124806,1700735460,1700770440,34980,152153,1470,TR,TR
9030,1698917880,1698922680,4800,9351,15281,NL,NL
117160,1700585400,1700600220,14820,74513,170038,FR,FR
52684,1698978300,1699012920,34620,172386,105821,MX,MX
178378,1699665660,1699694460,28800,146920,169085,TR,TR
155755,1700651520,1700687100,35580,123403,140098,TR,TR
155823,1698831480,1698863820,32340,139559,145600,TR,TR
184296,1700412120,1700423400,11280,101585,105335,HR,HR
59430,1700842860,1700850420,7560,168438,166098,IT,IT
28824,1700649120,1700674680,25560,39556,157009,BA,HR
159077,1700560440,1700578680,18240,55728,128391,FR,FR
72297,1700415900,1700419500,3600,18502,114889,NL,NL
110128,1700834280,1700838180,3900,140374,27223,GB,GB
190192,1700502120,1700515680,13560,154083,66590,US,US
31051,1698979560,1699002120,22560,13815,3272,DE,CH
115982,1699814520,1699849860,35340,6403,26604,TR,TR
112065,1699977240,1700003880,26640,7607,92321,PL,HU
129218,1699927680,1699962720,35040,103294,43312,TR,TR
9505,1699454220,1699457820,3600,101762,77439,GB,GB
27235,1700213640,1700217240,3600,5912,2090,NL,NL
135874,1700780520,1700791020,10500,58751,125314,EE,EE
98462,1699919580,1699947240,27660,195447,34933,BR,BR
40901,1700430900,1700460300,29400,136177,142827,TR,TR
15015,1699647900,1699680960,33060,72867,112268,TR,TR
133187,1699452660,1699482360,29700,69693,154270,TR,TR
40405,1698970140,1699000500,30360,94322,111024,TR,TR
3612,1700490780,1700499060,8280,14039,108079,IT,IT
146294,1699431660,1699436460,4800,129796,191823,NL,NL
125694,1700324880,1700328480,3600,165305,120200,GB,GB
55194,1698876000,1698904380,28380,75430,57810,DE,DE
193853,1700294580,1700302800,8220,111593,129503,EE,FI
17834,1698860940,1698894000,33060,186618,166191,TR,TR
140264,1700164200,1700172900,8700,176185,186988,IT,IT
123478,1698948300,1698983220,34920,28337,170004,TR,TR
62118,1699836660,1699869480,32820,49250,70480,TR,TR
173910,1699178580,1699211880,33300,68039,12666,TR,TR
156142,1699564920,1699575780,10860,68648,25798,HR,HR
61501,1700120820,1700125800,4980,66916,123717,GB,GB
180408,1699036440,1699048440,12000,33503,54265,US,US
104779,1699662420,1699669980,7560,38085,37985,IT,IT
124832,1700377560,1700381160,3600,32626,39397,GB,GB
132560,1699249380,1699285020,35640,38795,113125,TR,TR
145073,1700078160,1700083440,5280,120968,15119,GB,GB
52374,1700445780,1700464560,18780,149455,44593,FR,BE
127967,1700465340,1700495640,30300,41107,73197,TR,TR
114475,1699218000,1699221600,3600,120098,25286,NL,NL
82220,1700197740,1700201340,3600,20754,42970,GB,GB
157081,1699102260,1699118280,16020,180232,7547,US,US
144040,1698956040,1698960660,4620,171766,138782,GB,GB
174594,1699981200,1700010300,29100,128005,66389,TR,TR
12415,1699188720,1699202280,13560,186021,34005,US,US
72869,1699766280,1699796460,30180,417,90609,TR,TR
190251,1700302680,1700317560,14880,42439,30991,US,US
119428,1699705740,1699713660,7920,192007,66812,IT,IT
185108,1700224080,1700258460,34380,142815,56348,TR,TR
30576,1700296440,1700313000,16560,107048,178021,US,US
177126,1699738740,1699742340,3600,70628,9773,NL,NL
125371,1700183040,1700209980,26940,72333,199089,DE,DE
42828,1698797820,1698833220,35400,114856,54970,TR,TR
159751,1699551840,1699583760,31920,102324,130514,TR,TR
31720,1700357400,1700369340,11940,171076,197141,US,US
76306,1700089740,1700100120,10380,160173,116673,IT,IT
133769,1699282140,1699285740,3600,167342,32804,GB,GB
111490,1699281300,1699292700,11400,14087,8035,PT,PT
178386,1700026740,1700030340,3600,16487,140033,GB,GB
27948,1699447920,1699474740,26820,31826,75776,RO,RO
165752,1699661460,1699688220,26760,27119,64121,DE,DE
105221,1699386240,1699409940,23700,142680,89846,DE,DE
133116,1698966480,1698983160,16680,20098,32343,AT,AT
155233,1699272900,1699307460,34560,102429,55967,TR,TR
160671,1698888360,1698911700,23340,96484,71162,DK,DK
50444,1698869400,1698904200,34800,159127,136603,TR,TR
22143,1700319540,1700350920,31380,39292,114737,TR,TR
18025,1698822960,1698835560,12600,98698,192476,ES,ES
179139,1700298840,1700311980,13140,73412,55612,US,US
42451,1700355180,1700363940,8760,188201,80477,HR,BA
44611,1700698860,1700702460,3600,199332,197482,GB,GB
129559,1700158800,1700191260,32460,150591,99353,TR,TR
120236,1699879200,1699908600,29400,35752,173403,TR,TR
31703,1700803860,1700836920,33060,88414,37165,TR,TR
73983,1700853420,1700884320,30900,33891,14812,TR,TR
175791,1700185320,1700188920,3600,113349,60518,GB,GB
95446,1699289040,1699299960,10920,192062,66035,IT,IT
5221,1699951740,1699966380,14640,40259,10819,US,US
158624,1698972660,1698990000,17340,149960,113384,US,US
17176,1700573940,1700603760,29820,159918,94618,TR,TR
152434,1700322600,1700326200,3600,51319,111906,NL,NL
44126,1699039680,1699070340,30660,111182,159406,TR,TR
176700,1699175280,1699185000,9720,160264,105532,HR,HR
153828,1699243080,1699247460,4380,54,183746,GB,GB
180475,1699856520,1699891500,34980,90405,140036,TR,TR
101312,1698913980,1698926220,12240,5302,20254,PT,PT
176841,1700069160,1700088360,19200,44938,104048,FR,BE
137476,1699341720,1699377300,35580,167796,119689,TR,TR
178973,1700020860,1700053440,32580,28698,24376,TR,TR
181141,1700386740,1700420220,33480,3909,146796,TR,TR
41874,1698985080,1699001340,16260,126028,170238,US,US
179576,1699057200,1699062300,5100,98235,97064,NL,NL
129210,1699882680,1699892880,10200,153639,150595,HR,HR
6168,1700317380,1700328180,10800,17369,115677,US,US
21212,1700561580,1700594940,33360,73870,11211,TR,TR
21533,1698834180,1698867060,32880,49093,90427,TR,TR
103431,1700069280,1700091540,22260,108178,182318,DK,DE
579,1699089480,1699118820,29340,153573,11348,TR,TR
13932,1700176920,1700191020,14100,151293,186548,CZ,CZ
110565,1700665080,1700669820,4740,169001,160230,NL,NL
188867,1699342140,1699364940,22800,17854,94220,PL,UA
52136,1700161860,1700165460,3600,37171,77744,NL,NL
184998,1700022540,1700052480,29940,161956,161566,TR,TR
99247,1700482380,1700485980,3600,193290,137879,NL,NL
16166,1700031960,1700043300,11340,26227,131595,PT,PT
71884,1699106700,1699125720,19020,23266,162398,FR,FR
53092,1699413060,1699445340,32280,153227,37783,TR,TR
182340,1698909060,1698940260,31200,24295,10050,TR,TR
120682,1700237160,1700272320,35160,127347,141347,TR,TR
89163,1699290240,1699312740,22500,100267,141750,DE,UA
119522,1700025120,1700028720,3600,66077,94697,GB,GB
8283,1699553040,1699577580,24540,115093,133148,RO,RO
41409,1700555040,1700558640,3600,54637,59391,GB,GB
148973,1700173920,1700202840,28920,21736,73841,TR,TR
142698,1699920120,1699944000,23880,64223,89353,DE,PL
67074,1700372940,1700379840,6900,29430,168533,NL,NL
161589,1699355700,1699379940,24240,27140,135470,BR,BR
124222,1700736780,1700740380,3600,23067,2501,NL,NL
34472,1700547480,1700572620,25140,157693,9084,DE,DE
87906,1700025300,1700056320,31020,82793,76285,TR,TR
138383,1699846080,1699860000,13920,57814,67314,HR,HR
156563,1699240440,1699248360,7920,17938,150632,IT,IT
9169,1698890340,1698924000,33660,174428,62391,TR,TR
20494,1699366620,1699387140,20520,165857,162922,FR,FR
82472,1700677260,1700680860,3600,888,159825,GB,GB
69717,1700086680,1700117580,30900,56378,126600,TR,TR
118103,1700384820,1700397660,12840,55006,135374,AT,AT
122897,1700270880,1700291760,20880,196970,199445,FR,FR
66436,1700638140,1700645580,7440,103347,7122,IT,IT
162582,1699314720,1699348860,34140,39319,114082,TR,TR
95515,1699968120,1699974540,6420,154639,156363,GB,GB
148653,1699095840,1699101540,5700,96242,191204,GB,GB
57308,1700160660,1700169120,8460,127303,169122,ES,ES
49853,1699681860,1699699140,17280,136750,27775,US,US
59314,1699102800,1699141380,38580,138609,121970,MX,MX
29617,1700616900,1700621640,4740,117605,18483,GB,GB
124275,1698893820,1698917520,23700,106728,28357,BR,BR
40340,1700363580,1700368740,5160,83408,107855,NL,NL
22298,1699792860,1699805340,12480,134346,48547,US,US
43747,1699524840,1699535880,11040,147758,92066,ES,AD
116831,1700187600,1700191200,3600,52405,22257,GB,GB
68022,1698993660,1699014780,21120,148975,134231,FR,FR
19990,1700246460,1700266200,19740,61915,1064,FR,FR
120334,1700475660,1700502120,26460,18586,105145,DE,PL
151514,1698991800,1699009740,17940,7133,182812,US,US
174983,1698969240,1698972840,3600,140234,99590,GB,GB
22741,1698844620,1698877020,32400,169076,45178,TR,TR
70834,1700789940,1700820480,30540,101253,49668,TR,TR
14750,1700679900,1700701620,21720,169662,35045,PL,PL
49248,1700435940,1700468280,32340,99160,125235,TR,TR
140698,1699952880,1699969620,16740,109623,86507,US,US
52409,1700539260,1700572980,33720,181859,38432,TR,TR
185046,1700111520,1700145480,33960,160147,131232,TR,TR
68262,1699534500,1699546320,11820,39407,138532,IT,IT
1025,1698795540,1698802380,6840,81149,136516,NL,NL
138157,1700157900,1700163240,5340,106853,10203,NL,NL
80530,1699867860,1699875480,7620,63670,109720,HR,HR
163555,1700178660,1700214420,35760,128869,37412,TR,TR
15141,1699083180,1699097220,14040,21169,125483,IT,IT
123471,1698794400,1698829740,35340,168016,103892,TR,TR
191414,1698873840,1698885000,11160,199568,15775,ES,AD
16959,1700571780,1700607540,35760,171507,9665,TR,TR
36236,1699865100,1699898640,33540,66539,183532,TR,TR
128562,1700384820,1700392260,7440,39971,196692,IT,IT
197550,1699063980,1699094820,30840,60927,118617,TR,TR
76626,1700789160,1700794140,4980,195057,19406,NL,NL
59418,1699592760,1699603380,10620,147067,125988,IT,IT
147079,1699982220,1700017740,35520,101474,120073,TR,TR
199928,1699932840,1699944960,12120,51283,198297,US,US
147662,1700536800,1700574720,37920,9638,88174,MX,MX
154731,1700285520,1700300700,15180,60158,39750,BE,GB
118067,1700529060,1700544960,15900,183310,10303,FR,CH
61025,1699012680,1699026180,13500,45119,155574,US,US
103339,1699312980,1699344780,31800,4857,62792,TR,TR
54706,1700296620,1700309640,13020,155817,99646,ES,ES
19271,1698811980,1698846360,34380,125300,19131,TR,TR
140390,1699931760,1699942200,10440,99861,7369,IT,IT
170296,1700282400,1700313960,31560,131977,193133,TR,TR
84927,1699368180,1699372860,4680,30987,162983,NL,NL
72245,1699145520,1699153440,7920,141870,48061,SK,SK
133567,1699702380,1699717260,14880,182694,174864,US,US
141907,1699253100,1699261200,8100,176839,47801,PT,PT
100366,1698854280,1698888120,33840,182443,63683,TR,TR
165140,1699843620,1699859100,15480,97050,29654,US,US
29262,1700368980,1700379660,10680,92864,86726,HR,IT
23640,1700015040,1700046240,31200,54096,3494,TR,TR
162167,1698960600,1698990900,30300,68954,66805,TR,TR
154425,1700161020,1700196600,35580,129228,29438,TR,TR
119180,1699751940,1699764960,13020,60856,170197,US,US
19611,1700691300,1700724240,32940,186236,191584,TR,TR
19124,1700139420,1700169840,30420,31881,9366,TR,TR
9702,1699744800,1699779600,34800,165623,197586,TR,TR
110411,1699247100,1699252500,5400,111898,191317,GB,GB
124732,1699109280,1699122600,13320,46200,125991,US,US
18420,1699393560,1699397160,3600,107142,168689,GB,GB
114568,1699551360,1699560240,8880,104118,84793,PT,PT
64652,1700614740,1700618340,3600,20232,30738,NL,NL
174700,1699498860,1699502460,3600,197142,192868,GB,GB
139309,1699907220,1699913100,5880,110382,128313,GB,GB
13985,1699151760,1699167120,15360,136216,108267,US,US
133340,1700549220,1700578200,28980,143811,129590,TR,TR
176191,1700021100,1700079300,58200,126651,117183,UA,PL
181258,1699071840,1699101780,29940,37867,116575,TR,TR
159655,1699795080,1699829520,34440,144407,40781,TR,TR
146114,1700655780,1700690940,35160,69682,6713,TR,TR
68935,1699561440,1699572900,11460,167580,41998,AT,AT
153779,1700558220,1700563380,5160,31719,158244,NL,NL
128783,1699144680,1699155180,10500,149167,156333,PT,PT
187199,1699451880,1699484880,33000,68303,149395,TR,TR
165539,1700347200,1700372460,25260,97152,102790,RO,MD
25829,1700865840,1700894700,28860,167928,176569,TR,TR
4839,1698828300,1698833640,5340,133786,101868,GB,GB
126828,1700783880,1700787600,3720,106638,142187,FI,EE
34945,1698937320,1698969840,32520,21253,123053,TR,TR
180566,1700581320,1700597280,15960,17212,123720,US,US
184946,1700095260,1700109780,14520,37982,173644,AT,AT
43185,1699488780,1699523280,34500,41865,68762,TR,TR
25129,1699530360,1699546680,16320,181737,641,US,US
179750,1699274400,1699284240,9840,86739,195299,IT,IT
2017,1699151520,1699186860,35340,147687,171003,TR,TR
58195,1700453400,1700460180,6780,198052,103785,GB,GB
52140,1699890540,1699902360,11820,65227,196752,IT,IT
98149,1700108460,1700118180,9720,147324,136913,EE,EE
2993,1699724880,1699760280,35400,78889,7653,TR,TR
56339,1699710420,1699722480,12060,105548,174718,US,US
52824,1699832040,1699862580,30540,171288,45547,TR,TR
176217,1700255940,1700286120,30180,161055,150125,TR,TR
123632,1699723020,1699736700,13680,74593,185080,IT,IT
22661,1698888660,1698901500,12840,39173,111735,US,US
149223,1698833400,1698863820,30420,125589,98897,TR,TR
42045,1699141380,1699155660,14280,17509,91072,US,US
152882,1700343960,1700354880,10920,41770,145351,US,US
159908,1700845200,1700856900,11700,132792,39260,US,US
192551,1700033760,1700057160,23400,33034,167007,DE,IT
56087,1699002060,1699038780,36720,107467,180970,MX,MX
68017,1698957840,1698984900,27060,189879,55129,DE,FR
120126,1700483940,1700495940,12000,128536,45336,US,US
103715,1699068300,1699088820,20520,117123,180520,FR,FR
182172,1699505940,1699509540,3600,99084,147265,GB,GB
79475,1699612500,1699628760,16260,92919,132056,US,US
62181,1699607700,1699638240,30540,30486,148006,TR,TR
4620,1700180280,1700214720,34440,35963,40929,TR,TR
10390,1698805200,1698836640,31440,6730,48538,TR,TR
77514,1700172000,1700184540,12540,159135,10757,IT,IT
158885,1699120920,1699132980,12060,101660,142882,ES,AD
150381,1699520100,1699524780,4680,172352,46277,NL,NL
62052,1699948440,1699980000,31560,87763,28257,TR,TR
28589,1700141160,1700153520,12360,184648,98126,PT,PT
113321,1698942060,1698965280,23220,124109,40071,DE,IT
95287,1699526040,1699533960,7920,152284,167812,IT,IT
106800,1699103520,1699132860,29340,68693,68515,TR,TR
104456,1699455360,1699476240,20880,47466,57635,FR,BE
39463,1699043280,1699072920,29640,45552,41506,TR,TR
24043,1699680660,1699714560,33900,46655,121793,TR,TR
68157,1700698500,1700726700,28200,152484,47949,PL,CZ
41983,1699153320,1699158000,4680,195494,7939,NL,NL
65565,1700615520,1700649780,34260,171660,16762,TR,TR
79022,1699913640,1699937340,23700,98110,118504,BR,BR
170848,1700046840,1700062560,15720,139105,197148,SE,RO
126080,1698853800,1698864240,10440,185737,172656,IT,HU
163970,1700449620,1700474040,24420,176912,25171,DE,DE
115047,1700662200,1700684580,22380,2314,28702,PL,DE
67881,1698891360,1698921480,30120,78735,4512,TR,TR
97835,1699652040,1699663980,11940,6064,196563,US,US
5363,1699297500,1699331340,33840,68557,176846,TR,TR
183039,1699722720,1699735860,13140,17180,6705,HR,HR
190666,1699787400,1699816200,28800,35102,172445,TR,TR
34430,1698845400,1698880440,35040,138079,197408,TR,TR
166379,1699874340,1699877940,3600,89973,73150,GB,GB
129000,1698990300,1699000920,10620,66985,89500,HR,HR
130625,1699043520,1699052160,8640,6801,84943,ES,ES
45027,1700518620,1700571060,52440,70621,77676,BG,DE
173949,1700140920,1700161800,20880,112277,88508,FR,FR
62222,1699094340,1699097940,3600,43939,187221,GB,GB
193977,1699129200,1699143780,14580,94354,125506,RS,RS
115654,1699907160,1699938120,30960,6060,194016,TR,TR
133589,1700860500,1700865600,5100,162,51934,GB,GB
108067,1699140960,1699144560,3600,61751,197171,NL,NL
123187,1698972840,1698983700,10860,106831,45311,US,US
33479,1700409000,1700417880,8880,150695,169446,EE,EE
84027,1700799900,1700821980,22080,120101,83743,DK,DE
175683,1700794740,1700798460,3720,115888,33288,AD,ES
39667,1699161000,1699164600,3600,185699,111244,GB,GB
53732,1699690800,1699699860,9060,51946,26841,CL,CL
27073,1698820740,1698827100,6360,142610,19143,GB,GB
152780,1699664160,1699677780,13620,49487,27442,US,US
78788,1700270940,1700283960,13020,185565,177538,US,US
19415,1699576380,1699579980,3600,89797,32434,GB,GB
41755,1699326720,1699354860,28140,51213,139872,PL,PL
57383,1700814720,1700844600,29880,190546,161996,TR,TR
111362,1700583660,1700591220,7560,193285,3903,ES,ES
100617,1698866640,1698883020,16380,69201,131540,FR,BA
59483,1698873360,1698902640,29280,114656,155284,TR,TR
184555,1700089140,1700114400,25260,128791,193263,PL,PL
55746,1700311020,1700343120,32100,88093,195815,TR,TR
199916,1700318280,1700333220,14940,111589,144508,US,US
150770,1699520880,1699524480,3600,120648,130297,GB,GB
36289,1698923940,1698958200,34260,137162,183290,TR,TR
131022,1700820240,1700832660,12420,186678,137801,US,US
133877,1698988020,1699045500,57480,124400,352,BG,RO
27081,1698866280,1698872940,6660,145791,72982,GB,GB
151866,1700758680,1700789940,31260,100711,103749,TR,TR
137419,1699914720,1699926120,11400,198142,54543,AT,AT
104202,1699694700,1699725480,30780,109563,46185,TR,TR
138867,1699989600,1699993200,3600,9714,27560,NL,NL
58970,1699524000,1699531200,7200,37873,6950,ES,ES
67774,1699251060,1699254660,3600,129665,174075,GB,GB
49714,1699015800,1699019400,3600,129704,40239,GB,GB
141061,1698941280,1698953160,11880,194931,69875,US,US
79952,1700755740,1700788200,32460,75055,183350,TR,TR
157905,1699406940,1699433100,26160,190473,95897,DE,NL
162373,1698888840,1698945180,56340,98165,190906,BG,DE
146732,1700552760,1700585700,32940,137302,93657,TR,TR
139419,1700370180,1700379540,9360,169777,21957,PT,PT
141209,1700674200,1700699160,24960,73052,118749,BR,BR
64057,1700286900,1700290500,3600,43523,46493,GB,GB
35863,1698962640,1698997800,35160,123871,111899,TR,TR
84629,1700190000,1700201880,11880,31426,4944,AT,AT
26413,1700820780,1700835960,15180,168069,40738,US,US
66246,1700847000,1700861340,14340,83000,14489,IT,IT
67824,1700178900,1700189460,10560,3460,140929,IT,IT
191509,1700865360,1700873580,8220,76412,137567,IT,IT
125361,1700797440,1700808900,11460,6966,94761,US,US
32015,1700301840,1700332140,30300,126945,31473,TR,TR
161075,1700741040,1700766840,25800,32164,170384,DE,DE
180733,1699987620,1700003520,15900,169821,3747,AT,CZ
17163,1700295600,1700328780,33180,113804,91932,TR,TR
152984,1699172640,1699184820,12180,46654,36922,HR,HR
18206,1698993180,1699008180,15000,72183,175948,US,MX
36692,1700559780,1700563380,3600,51060,93449,GB,GB
191475,1700533200,1700536800,3600,168020,130244,GB,GB
164900,1699082580,1699111560,28980,140335,183738,TR,TR
9242,1699150980,1699167180,16200,125060,41666,US,US
11422,1700302560,1700314260,11700,86246,3583,IT,IT
75618,1700391780,1700398500,6720,152500,49497,GB,GB
41974,1699088100,1699109520,21420,199302,88737,SE,NO
74870,1699669620,1699699140,29520,155224,24111,TR,TR
77152,1698982440,1698986040,3600,183087,111915,GB,GB
119947,1698828780,1698832440,3660,14872,105668,NL,NL
57878,1699197900,1699218540,20640,140528,77828,FR,FR
161801,1700789100,1700802360,13260,118488,26302,IT,IT
181272,1700201400,1700205000,3600,156373,140486,GB,GB
197398,1700844360,1700875200,30840,74740,109522,TR,TR
83227,1699323360,1699357560,34200,19946,57536,MX,MX
163612,1700526180,1700557680,31500,38365,180972,TR,TR
79522,1700112540,1700142540,30000,196821,197343,TR,TR
25712,1699798920,1699829520,30600,143965,90873,TR,TR
57824,1700762640,1700778300,15660,102662,118873,US,US
188240,1700758500,1700787900,29400,90812,169028,TR,TR
180411,1699864740,1699883160,18420,25112,52442,FR,FR
133163,1700191800,1700195400,3600,86234,75122,GB,GB
179124,1699620420,1699649340,28920,57049,117251,TR,TR
101058,1700284320,1700294580,10260,34198,781,PT,PT
15132,1699351620,1699373640,22020,51373,26204,BR,BR
126879,1700007120,1700062680,55560,75114,120042,BG,DE
28141,1699893300,1699926480,33180,187382,54246,TR,TR
64895,1699168260,1699179000,10740,142399,127444,IT,IT
186874,1700108220,1700143200,34980,153160,142162,TR,TR
100512,1699114680,1699128180,13500,118325,55053,PT,PT
53875,1698885540,1698919440,33900,171410,154467,TR,TR
53294,1699654020,1699677360,23340,54837,165452,DE,PL
99460,1699307460,1699311060,3600,12671,110584,GB,GB
151566,1700495100,1700522700,27600,185628,111072,CH,DE
170062,1699730760,1699760100,29340,78973,35503,TR,TR
96534,1700812260,1700824980,12720,119175,145764,US,US
171437,1700673180,1700704380,31200,5760,164400,TR,TR
107579,1699270860,1699300260,29400,129851,33942,TR,TR
92088,1700130120,1700164740,34620,83445,76549,TR,TR
7521,1700355000,1700380200,25200,103343,49770,DE,CZ
178542,1699443060,1699471380,28320,109575,174039,DE,DE
127016,1699381440,1699395600,14160,52518,89905,US,US
173713,1699866000,1699898160,32160,175325,92666,TR,TR
64738,1700684040,1700700180,16140,134970,131621,US,US
199074,1698882900,1698914220,31320,24425,112884,TR,TR
14739,1700223900,1700229180,5280,189050,73627,GB,GB
184236,1699984620,1700015400,30780,170289,41879,TR,TR
73227,1699109100,1699141980,32880,70481,80983,TR,TR
76056,1700542860,1700571060,28200,27911,26166,DE,DE
125761,1700785440,1700789040,3600,87457,167257,GB,GB
175166,1698871200,1698898860,27660,22658,5398,PL,PL
41880,1700060580,1700090820,30240,118580,130314,TR,TR
185027,1700273580,1700305080,31500,134148,13973,BA,DE
21227,1700440980,1700470320,29340,132532,185192,TR,TR
66382,1699410060,1699425420,15360,70979,172744,US,US
6716,1700690340,1700722380,32040,5018,7408,TR,TR
152711,1700140620,1700162760,22140,147350,114043,CH,DE
184283,1700604840,1700621640,16800,63578,57047,US,US
138238,1698929220,1698963180,33960,2745,12428,TR,TR
23148,1699900800,1699905360,4560,99345,106299,NL,NL
114684,1699457640,1699464420,6780,32426,138017,GB,GB
55773,1699914540,1699931700,17160,162786,185800,BE,FR
79815,1699052760,1699087980,35220,5605,52216,TR,TR
110101,1699689120,1699699860,10740,137194,161540,IT,IT
1777,1700081640,1700111760,30120,5314,86510,TR,TR
118151,1700750880,1700764860,13980,84140,160866,US,US
63543,1698795480,1698817620,22140,103735,52162,DK,DE
96766,1699046160,1699076820,30660,139735,168953,TR,TR
195591,1700665980,1700688240,22260,32387,158633,DE,GB
28315,1698920040,1698949740,29700,90599,97443,TR,TR
68663,1699376160,1699383060,6900,57937,11700,NL,NL
85586,1700320680,1700338080,17400,68184,160506,US,US
52002,1700821500,1700831520,10020,125520,4169,PT,ES
70424,1698868740,1698874920,6180,176779,101746,EE,EE
95116,1700549700,1700564040,14340,17029,54985,HR,HR
85676,1700534580,1700567340,32760,15703,125784,TR,TR
104733,1699790760,1699802940,12180,182027,163843,US,US
1384,1699339500,1699366320,26820,144979,2186,RO,MD
63091,1699026360,1699032720,6360,161843,138301,NL,BE
107514,1700339520,1700372520,33000,29234,32855,TR,TR
77358,1700286780,1700297640,10860,29340,185781,IT,IT
178031,1698797880,1698814380,16500,46740,134276,AT,AT
160562,1699644120,1699674900,30780,170690,9351,TR,TR
127111,1699438380,1699454520,16140,132711,33578,US,US
179238,1700226720,1700239740,13020,174470,199721,IT,IT
123249,1699716900,1699747680,30780,100856,171151,TR,TR
60157,1699884420,1699912560,28140,9852,169362,PL,SK
51755,1698815220,1698818820,3600,8421,82258,GB,GB
46177,1700609280,1700645100,35820,171685,118942,TR,TR
116819,1698845520,1698877560,32040,186312,15943,TR,TR
145633,1699323840,1699348740,24900,153530,26143,RO,RO
184536,1700722980,1700734200,11220,38590,158557,HR,HR
29334,1700167020,1700181420,14400,48543,131720,US,US
192680,1699972560,1699988700,16140,173688,98466,CZ,CZ
29287,1700294100,1700319900,25800,48246,3353,DE,FR
196638,1700792580,1700826780,34200,173389,96707,TR,TR
74210,1699073520,1699077120,3600,177631,152415,GB,GB
103152,1698956880,1698966240,9360,182117,7441,HR,BA
115650,1699270020,1699287780,17760,101841,83113,FR,ES
48271,1699057620,1699061220,3600,165193,98091,GB,GB
139563,1699894380,1699901280,6900,104365,39882,GB,GB
110442,1700206740,1700214720,7980,132136,78316,IT,CH
67182,1700638080,1700667060,28980,166062,167977,TR,TR
148698,1699273620,1699300380,26760,126673,188949,HU,AT
50421,1700012100,1700022480,10380,82904,48545,IT,IT
34130,1700100420,1700129280,28860,79705,95434,TR,TR
192788,1700720820,1700736720,15900,126333,174816,US,US
199987,1699062300,1699088940,26640,163209,76713,BA,DE
141766,1699821120,1699824720,3600,92091,189948,GB,GB
142950,1699502700,1699536420,33720,171814,19083,TR,TR
113778,1700864400,1700868000,3600,194954,30520,GB,GB
171543,1699297200,1699328520,31320,151441,198360,TR,TR
16176,1699568880,1699600020,31140,164375,144310,TR,TR
104455,1699435740,1699444680,8940,113801,81507,PT,PT
33095,1700475240,1700486820,11580,52273,96025,PT,PT
54154,1700254800,1700285700,30900,85275,45837,TR,TR
21664,1699903500,1699907100,3600,136943,80358,NL,NL
52930,1699786200,1699800540,14340,118938,13407,AT,AT
93351,1698930780,1698961020,30240,53859,3035,TR,TR
9355,1699644780,1699652880,8100,9193,84656,HR,IT
170965,1699019460,1699030080,10620,160250,23127,HR,HR
124595,1699272360,1699282800,10440,179761,164707,IT,IT
79251,1700015340,1700032200,16860,180876,18803,US,US
24218,1699873980,1699884720,10740,73496,66550,IT,IT
137001,1700659800,1700695740,35940,50063,27129,TR,TR
116291,1699762140,1699768500,6360,147973,86820,NL,NL
5144,1699161180,1699194120,32940,170318,95118,TR,TR
106508,1700443620,1700476080,32460,93969,189437,TR,TR
21740,1698961200,1698991260,30060,110965,65524,TR,TR
84933,1699680120,1699712640,32520,106863,50290,TR,TR
56361,1699698720,1699712460,13740,63710,128438,HR,HR
123801,1699215420,1699233360,17940,173221,173849,US,US
38761,1699135680,1699141860,6180,72400,136388,NL,NL
26537,1699781760,1699793520,11760,19040,188677,US,US
194867,1699577520,1699581120,3600,125874,98207,GB,GB
75908,1699599600,1699632900,33300,84725,63182,TR,TR
84335,1699801440,1699811220,9780,180828,49002,IT,IT
173179,1700681160,1700713680,32520,83560,168487,TR,TR
24877,1700548500,1700559240,10740,156954,145809,PT,PT
11597,1699682520,1699712940,30420,49382,102799,TR,TR
112714,1699393800,1699428540,34740,120685,74274,TR,TR
183496,1699102440,1699135800,33360,54813,174002,TR,TR
54344,1699737540,1699767900,30360,56598,107454,TR,TR
93526,1700183220,1700187300,4080,160,133144,NL,NL
100194,1699992000,1700016060,24060,26667,185177,DE,DE
148972,1700771400,1700783760,12360,108198,152787,US,US
115600,1699684500,1699716840,32340,14056,161601,TR,TR
45454,1700660520,1700689140,28620,148710,140381,DE,DE
6123,1700812980,1700823780,10800,93713,135537,AT,SK
62696,1700135040,1700147160,12120,130937,118095,US,US
196397,1699452840,1699488480,35640,158134,173608,TR,TR
132183,1700699040,1700727960,28920,39107,94088,TR,TR
106939,1700072460,1700084460,12000,5501,173800,US,US
16407,1698860940,1698894060,33120,1668,22802,TR,TR
5984,1700351880,1700358900,7020,34323,117943,NL,PL
89147,1700623020,1700637060,14040,177351,108405,AT,AT
96971,1699953000,1699984920,31920,106707,81666,TR,TR
69185,1699192080,1699227780,35700,130018,81546,MX,MX
199946,1700412660,1700425980,13320,118640,190136,HR,HR
191503,1700596260,1700599860,3600,81485,42498,GB,GB
78264,1699467120,1699495440,28320,19987,191021,DE,HR
185665,1700048340,1700059380,11040,40177,141938,IT,IT
29098,1700271960,1700276580,4620,154534,98344,NL,NL
125520,1699103940,1699133100,29160,56799,113013,TR,TR
89160,1699935900,1699951140,15240,42651,69457,RS,RS
24486,1699204620,1699237800,33180,43183,37390,TR,TR
129462,1699821480,1699854420,32940,179806,183767,TR,TR
74943,1699787940,1699800540,12600,158544,199242,US,US
111918,1700071680,1700127180,55500,74882,81260,BG,DE
171458,1700477700,1700503680,25980,60858,62964,RO,RO
24718,1700203080,1700214900,11820,92867,83995,IT,IT
152491,1698799140,1698832500,33360,90659,10101,TR,TR
15133,1700821320,1700854740,33420,147655,30024,TR,TR
128139,1700692320,1700696820,4500,193358,103276,NL,NL
76996,1698802140,1698816720,14580,43041,161008,US,US
136631,1700112420,1700140860,28440,172775,5736,RO,RO
116617,1698871560,1698883560,12000,119064,179213,ES,ES
186859,1699613220,1699631100,17880,147265,7590,US,US
87725,1700359980,1700381940,21960,108873,173931,PL,UA
26377,1700269320,1700300520,31200,137268,28006,TR,TR
96152,1700802360,1700814180,11820,90451,90162,IT,IT
118598,1700560920,1700570040,9120,165561,126225,IT,IT
73482,1699900980,1699907280,6300,23779,142961,NL,DE
167845,1700498160,1700529600,31440,122823,195151,TR,TR
45944,1699789140,1699802160,13020,86709,119746,US,US
171519,1699127940,1699158060,30120,182154,122038,TR,TR
173495,1699967760,1699979940,12180,76837,121710,IT,IT
40131,1699152720,1699185840,33120,5674,131263,TR,TR
168715,1700126160,1700143620,17460,79840,128508,US,US
136924,1700460840,1700479140,18300,18449,53734,AL,MK
49445,1699771200,1699780380,9180,195341,166298,HR,HR
198387,1699843140,1699860060,16920,145081,143143,FR,FR
19562,1699723380,1699755480,32100,108009,167806,TR,TR
13802,1699580940,1699591800,10860,199586,141553,HR,HR
2791,1700230080,1700247900,17820,127892,90440,US,US
22167,1699305300,1699317000,11700,89821,137360,PT,PT
98861,1699248060,1699251660,3600,118311,86292,NL,FR
69645,1700174040,1700208420,34380,175285,162158,TR,TR
178646,1699173600,1699189080,15480,174542,75577,FR,BE
17138,1699351440,1699381860,30420,186161,19494,TR,TR
460,1698859140,1698894060,34920,186522,68656,TR,TR
123069,1700703960,1700707560,3600,121638,59811,NL,HR
93393,1699867740,1699876680,8940,51573,19003,IT,IT
148495,1698882300,1698896220,13920,151235,194050,HR,HR
198633,1700044920,1700049480,4560,158113,140443,GB,GB
115518,1700125920,1700142000,16080,71201,192753,US,US
146911,1700078100,1700105460,27360,4559,65390,PL,PL
51299,1699586040,1699590540,4500,105875,16728,GB,GB
118980,1700139000,1700152320,13320,23246,45957,US,US
4635,1699478820,1699494240,15420,72664,54366,US,US
122530,1699171800,1699183260,11460,11400,67041,IT,IT
35492,1698812400,1698824820,12420,39047,5970,US,US
122190,1699326840,1699359420,32580,153678,122294,TR,TR
140290,1698873720,1698912360,38640,17687,53391,MX,MX
31575,1699046640,1699050240,3600,195062,73808,GB,GB
185212,1700268840,1700297760,28920,65661,103791,TR,TR
6019,1699675920,1699691700,15780,85426,119195,AT,AT
77493,1699659780,1699674300,14520,6743,168145,US,US
42686,1699176600,1699183020,6420,132936,25312,GB,GB
83245,1699108800,1699119840,11040,9502,21805,ES,ES
58838,1699249200,1699260060,10860,175329,189668,IT,IT
172610,1700783340,1700802960,19620,70320,166154,FR,FR
88570,1700737140,1700771640,34500,79429,39736,TR,TR
198179,1700824140,1700852820,28680,146101,113689,PL,PL
32943,1699246680,1699254240,7560,66904,188877,EE,FI
23293,1699143600,1699147200,3600,100684,20235,GB,GB
102693,1700143620,1700161440,17820,183745,110870,US,US
69861,1700302020,1700330820,28800,196768,181681,TR,TR
199426,1699443000,1699476360,33360,145313,45830,TR,TR
96150,1698885960,1698900840,14880,11375,198624,RS,RS
78168,1699851720,1699867080,15360,186498,176210,US,US
16462,1699362420,1699377060,14640,50607,7776,US,US
48545,1700795700,1700799300,3600,26349,80313,NL,NL
14215,1700706480,1700710320,3840,192946,166726,GB,GB
126548,1699927140,1699958220,31080,62517,53993,TR,TR
129245,1699413720,1699420500,6780,30725,157513,GB,GB
115997,1699355400,1699366560,11160,143649,92491,US,US
129739,1698856380,1698873420,17040,57985,76017,US,US
37,1699564140,1699578480,14340,102878,104482,IT,IT
49238,1700550240,1700583720,33480,193653,103459,TR,TR
151471,1700811540,1700815140,3600,156164,92004,NL,PL
54082,1699749600,1699771620,22020,29806,149252,PL,PL
135955,1699878360,1699913100,34740,122257,194775,TR,TR
101208,1699572420,1699582560,10140,167090,30497,HR,HR
24088,1699287840,1699317120,29280,124229,25595,TR,TR
104170,1699900620,1699927860,27240,128496,9222,PL,DE
15272,1699495980,1699531920,35940,104689,122552,TR,TR
176553,1700059260,1700089380,30120,3527,49816,TR,TR
56797,1699068480,1699101060,32580,64421,84737,TR,TR
125435,1700688120,1700704860,16740,160134,108381,AT,AT
139598,1699276500,1699289460,12960,18302,184797,US,US
123449,1699375980,1699391220,15240,147274,11924,RS,RS
35935,1700847420,1700851740,4320,54069,178385,NL,DE
27740,1698928560,1698964200,35640,182160,193490,TR,TR
163973,1698795720,1698807060,11340,139695,5712,IT,IT
140330,1700625600,1700647380,21780,29365,186499,DE,PL
49607,1700131920,1700139180,7260,33728,97438,ES,AD
28735,1699888140,1699917540,29400,39834,180008,TR,TR
151233,1699086600,1699108860,22260,126256,135742,BR,BR
33210,1698821820,1698834420,12600,63238,37004,US,US
53198,1698921960,1698933780,11820,137424,29652,US,MX
66137,1698822420,1698856620,34200,107879,112632,TR,TR
172281,1700726580,1700751480,24900,168731,126953,PL,BE
89436,1699335660,1699364880,29220,81220,33078,TR,TR
157886,1700314860,1700323800,8940,149477,53309,IT,IT
51230,1700258880,1700291100,32220,125004,157896,TR,TR
53720,1699544040,1699577460,33420,9677,189027,TR,TR
100665,1698847620,1698877680,30060,178932,107089,TR,TR
39043,1700134740,1700164020,29280,56221,16123,TR,TR
65694,1699229160,1699250040,20880,79790,151518,FR,FR
38767,1700539440,1700552580,13140,112152,7061,US,US
102847,1700821980,1700825580,3600,19438,50539,NL,NL
158101,1700156940,1700174040,17100,72403,123193,US,US
35740,1699433760,1699437360,3600,5326,67957,NL,FR
78559,1699111560,1699141140,29580,116152,175348,TR,TR
186354,1699552860,1699562400,9540,132516,189477,HR,HR
145500,1699862280,1699897140,34860,43981,66065,TR,TR
89371,1699180680,1699201380,20700,188125,144208,FR,PL
9666,1700815140,1700846640,31500,109239,122473,TR,TR
166077,1699032300,1699068240,35940,56767,133167,TR,TR
72588,1700541600,1700555400,13800,125630,18491,IT,HU
176720,1699304220,1699338780,34560,76374,171500,TR,TR
126380,1700285820,1700289420,3600,13028,194186,GB,GB
121858,1699974720,1699987320,12600,7472,49681,AT,BG
131746,1699018140,1699049340,31200,40499,150236,TR,TR
56028,1698874920,1698901620,26700,141447,104314,PL,PL
103275,1699160580,1699174500,13920,123545,136062,AT,BG
144141,1700790720,1700799240,8520,175117,20164,PT,FR
63449,1699029660,1699063680,34020,102608,79849,TR,TR
53543,1699652340,1699687980,35640,143432,21105,TR,TR
27879,1700683380,1700688120,4740,114714,65653,NL,NL
154600,1700325900,1700339520,13620,59756,168967,ES,BE
130450,1699378800,1699413480,34680,89691,36615,TR,TR
184397,1700288160,1700317800,29640,7213,92392,TR,TR
159587,1698866400,1698896580,30180,177138,153271,TR,TR
48796,1699273980,1699310760,36780,70660,179211,MX,MX
185545,1700802360,1700805960,3600,57378,37917,GB,GB
97113,1699687560,1699709100,21540,174898,194108,BE,FR
158466,1698971340,1698982440,11100,194325,22855,PT,PT
112043,1699845900,1699851240,5340,136317,43236,NL,NL
106793,1700673960,1700707680,33720,183470,196249,TR,TR
62011,1700336160,1700339880,3720,103802,29006,GB,GB
153416,1700186880,1700204160,17280,89541,164836,US,US
146647,1700129880,1700148540,18660,169924,108516,FR,FR
158031,1699734180,1699766940,32760,154479,194918,TR,TR
101536,1700089500,1700112420,22920,199693,63049,PL,DE
15822,1698962940,1698967680,4740,160566,191406,GB,GB
15670,1700737980,1700751120,13140,46919,11441,US,US
53284,1700407800,1700415180,7380,107483,657,EE,EE
86791,1699560120,1699563720,3600,75489,26458,GB,GB
149313,1699481520,1699510920,29400,40536,92730,TR,TR
142437,1699374540,1699378140,3600,88025,114940,NL,NL
49379,1700229720,1700243460,13740,138488,90151,IT,IT
126894,1700287920,1700315220,27300,148866,113460,DE,DE
53516,1700181840,1700195520,13680,109309,151203,CA,CA
199122,1699224420,1699248780,24360,149004,49013,DE,DE
15159,1700144220,1700174100,29880,191527,13018,TR,TR
87163,1700413200,1700445060,31860,148439,19152,TR,TR
35370,1698932340,1698960120,27780,116584,71120,BR,BR
134102,1700336340,1700350380,14040,151393,70598,IT,IT
172941,1699613280,1699617300,4020,96750,100027,GB,GB
109854,1700607420,1700638920,31500,100507,41283,TR,TR
159035,1698837360,1698868980,31620,120031,174592,TR,TR
21831,1699833600,1699847340,13740,27601,75192,IT,IT
79099,1700590080,1700603160,13080,81007,37324,IT,IT
101295,1699254360,1699257960,3600,162216,61541,GB,GB
62651,1698977580,1698984120,6540,171042,136550,GB,GB
119046,1700215920,1700225400,9480,168643,97938,ES,ES
102904,1700785320,1700814840,29520,131123,26340,TR,TR
2371,1698867540,1698873540,6000,35327,40690,NL,FR
139105,1699788360,1699797540,9180,18659,104695,PT,PT
157187,1699323900,1699345560,21660,66770,151703,BR,BR
8202,1700695920,1700708220,12300,85923,2249,IT,IT
155911,1700829660,1700860440,30780,72068,100255,TR,TR
196808,1699441080,1699449780,8700,88232,9198,PT,PT
12525,1699630020,1699645440,15420,145360,160862,US,US
144006,1699883040,1699910340,27300,60152,171309,BR,BR
189550,1698845160,1698859500,14340,55819,178775,SK,AT
26134,1700196960,1700212200,15240,82860,29479,US,US
74424,1699510500,1699526220,15720,110595,37461,BE,NL
183677,1699989600,1700020080,30480,4648,152368,TR,TR
6408,1700556360,1700567280,10920,155660,84134,IT,IT
19713,1700508120,1700519400,11280,83810,151633,HR,HR
54116,1700073720,1700082900,9180,43205,66148,IT,DE
111573,1699233000,1699249560,16560,168719,189281,US,US
12005,1699264800,1699298880,34080,45027,149060,MX,MX
34932,1700190060,1700203740,13680,73652,193137,SK,SK
38384,1700451420,1700463720,12300,31913,138896,IT,IT
172929,1700191380,1700203980,12600,199156,188057,US,US
25280,1700601180,1700617440,16260,97741,74798,US,US
116700,1700270700,1700277540,6840,150661,34309,GB,GB
31338,1700294520,1700322300,27780,1165,37261,DE,NO
101816,1699887360,1699902900,15540,80281,54161,US,US
114208,1699326900,1699362120,35220,161441,180487,TR,TR
117466,1700052240,1700085240,33000,195555,78521,TR,TR
17480,1699943520,1699948260,4740,88405,77127,GB,GB
172484,1699541940,1699568340,26400,30937,101834,DE,PL
179047,1699845600,1699851240,5640,51834,19291,NL,NL
21553,1700175360,1700206080,30720,134463,65147,TR,TR
25692,1699588800,1699619400,30600,59741,146822,TR,TR
174484,1699892580,1699908120,15540,157671,115359,US,US
186362,1699985340,1700015760,30420,5967,33362,TR,TR
149583,1699796520,1699807860,11340,181281,198072,ES,ES
145812,1699068000,1699085580,17580,11933,89693,US,US
45552,1699892460,1699922880,30420,165237,175043,TR,TR
9828,1698809640,1698839160,29520,115625,170573,TR,TR
49627,1699966740,1699977000,10260,195112,126123,IT,IT
74764,1700407380,1700438820,31440,135586,58358,TR,TR
93463,1699856460,1699887900,31440,88444,121981,TR,TR
88626,1700782800,1700786400,3600,158374,33433,GB,GB
94981,1699470660,1699474260,3600,197480,199168,NL,BE
22471,1698947640,1698982200,34560,57467,178504,TR,TR
158203,1700683260,1700692140,8880,153903,194640,IT,IT
142286,1700491920,1700495520,3600,143140,114916,NL,BE
101436,1698998160,1699010160,12000,98147,150876,AT,AT
114940,1699518720,1699550940,32220,8056,133931,TR,TR
40954,1699302900,1699331220,28320,199502,135280,RO,PL
93040,1700491920,1700524860,32940,156001,50576,TR,TR
182191,1700352300,1700360580,8280,175796,994,IT,IT
192969,1699648860,1699680120,31260,72358,189738,BA,HR
192078,1699198020,1699233780,35760,51221,84066,TR,TR
139962,1699658400,1699665180,6780,106628,199918,GB,GB
94977,1700081160,1700107320,26160,171055,47293,DE,NL
157212,1700015940,1700019540,3600,45570,85921,GB,GB
157762,1699268820,1699282140,13320,140491,161655,AT,AT
87241,1700475300,1700494560,19260,94295,74537,BE,FR
113901,1698942360,1698970620,28260,80256,145194,BR,BR
59029,1700379420,1700390760,11340,69055,40988,IT,IT
191820,1698944820,1698979320,34500,155201,197478,TR,TR
174657,1700112540,1700142300,29760,94408,105270,TR,TR
32144,1700725560,1700760900,35340,181694,24776,TR,TR
179908,1699098360,1699151460,53100,156811,55182,BG,RO
22150,1699154220,1699173660,19440,64180,170141,FR,FR
168844,1699608960,1699638960,30000,125845,47112,TR,TR
44881,1700006340,1700036700,30360,139848,39373,TR,TR
31158,1700389080,1700396940,7860,45717,89690,PT,PT
134425,1698843240,1698871680,28440,187706,67383,PL,PL
114905,1700058000,1700061660,3660,50112,2242,NL,NL
101035,1700160720,1700177820,17100,50172,110990,US,US
59944,1699830660,1699863540,32880,85371,77758,TR,TR
193643,1698947940,1698983160,35220,28540,34150,TR,TR
2696,1699926900,1699951920,25020,106490,85181,DE,DE
97009,1699076040,1699091220,15180,89390,151765,US,US
70677,1698793500,1698826620,33120,162083,157816,TR,TR
64779,1699432380,1699462800,30420,105668,99927,TR,TR
145711,1699040880,1699048200,7320,176942,95623,HR,HR
60276,1699516380,1699548300,31920,146403,190998,TR,TR
98909,1699580700,1699612140,31440,42589,112208,TR,TR
155842,1699876800,1699903740,26940,47294,107582,PL,CZ
91949,1700223780,1700227380,3600,134270,17511,GB,GB
25193,1700103420,1700121240,17820,28430,168423,US,US
162170,1700606700,1700634240,27540,174397,44544,DE,DK
146328,1700182140,1700212920,30780,104249,130264,TR,TR
193208,1700694000,1700705040,11040,29772,136155,US,US
167526,1700566980,1700593320,26340,167972,186580,CH,IT
62352,1699286220,1699315800,29580,19289,23556,TR,TR
97407,1700536140,1700540940,4800,64925,127259,EE,EE
165639,1699251300,1699282080,30780,192513,41318,TR,TR
145391,1700322540,1700328480,5940,158382,73363,GB,GB
42724,1699692900,1699703940,11040,177762,152834,SK,SK
192851,1699268280,1699303800,35520,195228,99349,TR,TR
150562,1700731200,1700747280,16080,91663,141427,US,US
21206,1699859340,1699896420,37080,55417,152979,MX,MX
116650,1699512240,1699525860,13620,60960,134257,AT,BG
91408,1700371560,1700376180,4620,143374,149132,GB,GB
69104,1699141080,1699144680,3600,134731,4038,NL,NL
199640,1699255200,1699292160,36960,12065,40927,MX,MX
32550,1700262660,1700278680,16020,102732,61594,US,US
4933,1699787280,1699800720,13440,55553,33536,IT,FR
83667,1699415340,1699421280,5940,142916,106586,GB,GB
107677,1700498040,1700509020,10980,70611,187804,US,US
122494,1700225160,1700236440,11280,96116,80393,ES,ES
190115,1698884400,1698888720,4320,181174,139196,NL,NL
116368,1700513160,1700529360,16200,102138,110843,CA,CA
36494,1699211820,1699235700,23880,190814,92637,DE,DE
123771,1698978000,1698994320,16320,54587,121103,US,US
64090,1700144700,1700153340,8640,82444,95507,IT,IT
163633,1699428840,1699432440,3600,108584,140502,GB,GB
158066,1700603760,1700607600,3840,173107,59513,NL,BE
91208,1700305740,1700309640,3900,37739,114414,NL,GB
132885,1699998660,1700007480,8820,94395,78571,IT,IT
88352,1699025160,1699041300,16140,2428,186589,US,US
10642,1699800420,1699812120,11700,181038,133345,US,US
111356,1699654440,1699690020,35580,96857,153380,TR,TR
24684,1700863320,1700898240,34920,84676,162252,TR,TR
131667,1698941400,1698945000,3600,164009,17466,GB,GB
88336,1699250760,1699264260,13500,109400,89927,US,US
93353,1700238360,1700269440,31080,112435,65724,TR,TR
136058,1700007360,1700029320,21960,57007,31000,DE,HR
175016,1699821420,1699856760,35340,192621,40634,TR,TR
114209,1699073400,1699107120,33720,164027,19010,MX,US
130063,1700700180,1700711700,11520,92808,167778,PT,PT
102037,1699254720,1699258920,4200,71784,11529,GB,GB
143746,1699723020,1699750020,27000,98133,181865,HU,DE
10720,1700599320,1700626740,27420,52450,110338,BR,BR
166667,1699294740,1699329120,34380,138539,71066,TR,TR
107572,1700257080,1700261520,4440,124517,26297,GB,GB
64307,1699775520,1699809240,33720,94517,5907,TR,TR
72097,1698866940,1698890700,23760,139503,85652,DE,ES
193247,1700151360,1700160180,8820,149402,130413,IT,IT
93551,1700668020,1700671620,3600,140326,8689,GB,GB
23489,1700422560,1700426160,3600,157640,189053,GB,GB
162147,1699814820,1699821360,6540,143828,116461,EE,FI
112578,1699307640,1699341900,34260,103139,169917,TR,TR
29809,1699426260,1699454460,28200,97086,116241,DE,DE
170755,1700451360,1700456640,5280,186396,95962,GB,GB
47403,1699324680,1699334400,9720,139821,126204,HR,HR
169975,1699538820,1699542420,3600,191429,194396,GB,GB
155287,1700296500,1700309520,13020,146616,88918,IT,IT
192421,1700786820,1700792700,5880,34542,141350,GB,GB
129493,1699860600,1699891800,31200,64117,141873,TR,TR
82262,1700404680,1700410380,5700,151551,90802,NL,NL
19214,1700395620,1700431560,35940,197015,118233,TR,TR
54301,1700277660,1700295420,17760,3978,181953,BE,NL
57529,1698831960,1698862860,30900,32280,169490,TR,TR
193681,1699779420,1699791780,12360,23764,159356,US,US
189736,1700138520,1700167920,29400,139724,157550,TR,TR
145512,1698982620,1699017540,34920,15252,26582,TR,TR
101228,1699262940,1699266540,3600,30158,187519,NL,NL
192950,1699773060,1699785000,11940,66101,84647,IT,IT
184995,1699485720,1699516440,30720,20108,111162,TR,TR
123076,1700436120,1700467980,31860,104370,50585,TR,TR
117764,1698900840,1698935580,34740,97886,10857,TR,TR
173219,1700648340,1700677680,29340,145913,98760,TR,TR
181762,1699068060,1699071960,3900,58995,67690,GB,GB
49430,1699758600,1699788420,29820,70158,111655,TR,TR
154752,1699810200,1699833720,23520,70044,124896,DE,BG
91026,1699013940,1699027260,13320,185929,94509,SK,SK
40619,1699395600,1699430040,34440,178482,6013,TR,TR
88584,1699656360,1699687800,31440,9886,20171,TR,TR
168682,1698841800,1698853860,12060,50715,105433,IT,IT
90987,1699445640,1699459320,13680,79893,53779,IT,IT
77954,1699180620,1699193940,13320,186591,146660,CZ,CZ
177607,1698835740,1698841680,5940,44900,138318,GB,GB
108814,1700686740,1700693880,7140,172839,197924,GB,GB
169755,1700176680,1700181240,4560,174170,57926,NL,BE
154615,1699057800,1699087080,29280,5332,92127,TR,TR
75742,1699545000,1699577760,32760,151589,145070,TR,TR
138735,1700569620,1700579760,10140,186160,81653,HR,CZ
133893,1699350000,1699373280,23280,125410,81126,ME,RS
79652,1698830460,1698840900,10440,2380,178250,IT,IT
96966,1700193720,1700206140,12420,136353,32250,HR,HR
33906,1700093400,1700112180,18780,59641,63705,BE,NL
179987,1700791740,1700797140,5400,50082,98559,GB,GB
170436,1699908060,1699917540,9480,59303,135123,IT,IT
49707,1699363080,1699367820,4740,93369,1452,EE,EE
190476,1698914700,1698930420,15720,141267,160651,CA,CA
19635,1699868820,1699889580,20760,163183,31405,FR,IT
148643,1698883860,1698915240,31380,169999,170092,TR,TR
5374,1699262580,1699296780,34200,95971,164858,TR,TR
38860,1698831840,1698845040,13200,7071,139526,HR,DE
63413,1699692360,1699748340,55980,183796,198285,BG,HU
110004,1700785200,1700791260,6060,71756,85612,GB,GB
64071,1699586880,1699595700,8820,101917,83426,IT,IT
9252,1698816480,1698838920,22440,73342,79891,SI,BA
17652,1700449860,1700453460,3600,111089,189202,GB,GB
129023,1699150920,1699167060,16140,129139,168393,AT,AT
190728,1699681440,1699712460,31020,107954,10284,TR,TR
28782,1699876200,1699902360,26160,17217,112118,DE,AT
195365,1699913460,1699928520,15060,79318,171134,US,US
147926,1699822740,1699860900,38160,140763,38667,MX,MX
24910,1700167800,1700180040,12240,104847,72050,US,US
13711,1699354800,1699390020,35220,172281,193804,MX,MX
149221,1699054800,1699068360,13560,80688,65671,ES,AD
162013,1700351580,1700381940,30360,150965,75358,TR,TR
28270,1699396740,1699430160,33420,182298,43984,TR,TR
158227,1698964860,1699000140,35280,39177,171054,TR,TR
193122,1700393700,1700411820,18120,112261,127549,FR,DE
159444,1699073820,1699081920,8100,90194,180915,ES,ES
141356,1700827440,1700861940,34500,49782,14597,TR,TR
167715,1700542320,1700548200,5880,177356,70009,NL,NL
58260,1699282560,1699287060,4500,42628,36640,GB,GB
120304,1699030320,1699063020,32700,18684,80988,MX,MX
178673,1699160460,1699193160,32700,140755,12603,TR,TR
153060,1700169060,1700180580,11520,63201,169262,US,US
112815,1699667340,1699671780,4440,4618,182390,NL,NL
189655,1700118960,1700151960,33000,25186,91197,TR,TR
46843,1700807640,1700820420,12780,139370,21833,AT,AT
157215,1700277240,1700293140,15900,197436,15048,FR,FR
190013,1699456500,1699467360,10860,195208,64365,ES,ES
118514,1698958800,1698972120,13320,181112,38530,RS,RS
55904,1699278360,1699295700,17340,111154,43230,US,US
78231,1699274880,1699286400,11520,52192,69367,US,US
162146,1699206960,1699219560,12600,142144,35810,IT,CH
97606,1700333940,1700358000,24060,135315,134013,DE,RS
50322,1699969680,1699978740,9060,28866,22052,IT,IT
157394,1700034360,1700067660,33300,57656,31232,TR,TR
144962,1700576880,1700580480,3600,87021,48831,GB,GB
119169,1698867000,1698902940,35940,27040,122865,TR,TR
116328,1699270380,1699299720,29340,161005,17377,TR,TR
105378,1698986400,1699021200,34800,164640,167341,TR,TR
153694,1698877380,1698893400,16020,86452,154975,AT,AT
69553,1699684920,1699717380,32460,381,185980,TR,TR
12380,1699101480,1699131780,30300,106997,127703,TR,TR
146657,1699149180,1699183440,34260,109802,64102,TR,TR
34098,1698801900,1698813900,12000,155112,40454,US,US
28207,1699125240,1699149780,24540,186953,146837,PL,BE
49274,1699967220,1699974900,7680,190581,28809,SK,SK
169920,1699120860,1699156080,35220,150828,96073,MX,US
129849,1699592040,1699620540,28500,26503,77713,PL,PL
34758,1700091480,1700103780,12300,190263,105589,US,US
47193,1699658460,1699683180,24720,169607,149555,DE,IT
1649,1699533300,1699545120,11820,195079,168735,IT,IT
100727,1700612400,1700634360,21960,179504,98036,PL,PL
177937,1699191420,1699202880,11460,14071,7606,PT,PT
181736,1700613840,1700630160,16320,99122,99028,US,US
6068,1700526720,1700532960,6240,142733,73881,GB,GB
170115,1699536600,1699547760,11160,183188,196348,IT,IT
51478,1699578120,1699608540,30420,18958,87308,TR,TR
872,1699454160,1699489440,35280,183236,198126,TR,TR
28313,1700519340,1700553480,34140,45388,30963,TR,TR
112550,1700682420,1700698800,16380,111525,186099,US,US
187362,1700052300,1700085060,32760,146697,168068,TR,TR
182656,1699123200,1699148580,25380,62638,12001,PL,PL
45362,1699886340,1699900200,13860,54698,192499,US,US
28507,1700026500,1700036700,10200,92754,47905,ES,ES
156273,1700420460,1700433780,13320,198449,143797,CA,US
53293,1700255220,1700268000,12780,109133,141575,US,US
8444,1700804160,1700816820,12660,49368,147939,AT,BG
6265,1700772720,1700803920,31200,68919,94353,TR,TR
84797,1699237260,1699249620,12360,84598,38696,US,US
31877,1698966060,1698999960,33900,194592,124819,TR,TR
76395,1699337640,1699341240,3600,39095,146447,GB,GB
56039,1699182660,1699211940,29280,4740,87004,TR,TR
196059,1699571100,1699602720,31620,153521,179527,TR,TR
84458,1699050600,1699067820,17220,102437,127491,US,MX
25202,1699502880,1699514460,11580,84729,144463,US,US
127126,1699776420,1699808520,32100,38044,81703,TR,TR
143604,1700407980,1700441400,33420,194310,139385,TR,TR
63508,1699860900,1699891740,30840,96268,24798,TR,TR
172377,1700845500,1700875980,30480,73377,78588,TR,TR
162607,1699996680,1700021880,25200,59387,160681,PL,DE
15634,1699688040,1699691820,3780,192721,103027,NL,NL
80468,1699523940,1699558080,34140,159227,28711,TR,TR
99866,1700077260,1700110440,33180,73959,87985,TR,TR
129707,1700377020,1700412180,35160,18678,59494,TR,TR
58024,1699787220,1699819860,32640,179090,80524,TR,TR
74517,1699024620,1699055280,30660,174704,46405,TR,TR
20816,1699687980,1699702860,14880,3987,199980,US,US
116898,1698873360,1698906120,32760,119059,130356,TR,TR
145779,1699605180,1699637640,32460,86254,163789,TR,TR
193085,1699300920,1699312440,11520,35320,132766,IT,IT
93091,1700434800,1700466480,31680,2209,177381,TR,TR
111401,1700812860,1700842320,29460,124477,160454,TR,TR
179546,1700279160,1700290560,11400,169168,107036,US,US
162721,1699749120,1699761420,12300,100915,47728,PT,PT
24429,1700802900,1700812860,9960,3478,113158,IT,IT
17797,1699987740,1700008800,21060,1233,166012,BE,NL
10957,1700787960,1700817600,29640,140674,4430,TR,TR
158449,1698794880,1698811860,16980,104246,52729,US,US
147721,1699203780,1699220340,16560,5093,101607,AT,AT
179321,1700271840,1700302920,31080,196108,165002,TR,TR
63529,1699007280,1699023060,15780,55246,69406,US,US
118194,1700077080,1700084760,7680,179860,35726,IT,IT
158946,1699774020,1699778940,4920,74957,9844,GB,GB
83258,1699702380,1699708860,6480,68847,4729,GB,GB
78511,1700211420,1700215020,3600,180832,105215,GB,GB
95254,1699002540,1699042080,39540,75611,14864,MX,MX
119355,1699082280,1699114800,32520,173762,173067,TR,TR
19514,1700388720,1700419200,30480,15617,142518,TR,TR
2900,1700533020,1700548680,15660,69275,70707,US,US
77187,1700386920,1700417820,30900,61995,21559,TR,TR
55797,1699589340,1699625160,35820,89581,20046,TR,TR
105254,1698959220,1698981420,22200,164549,64542,DE,BG
105727,1699260840,1699289820,28980,2410,21553,TR,TR
108215,1700270100,1700274840,4740,14307,115476,GB,GB
154234,1699534260,1699570140,35880,53677,45972,TR,TR
64708,1699433940,1699468500,34560,175327,57245,TR,TR
16941,1700275680,1700306700,31020,67811,12877,TR,TR
172018,1699375200,1699386540,11340,162674,117838,US,US
148778,1700821380,1700851620,30240,173615,55887,TR,TR
116841,1698879840,1698911760,31920,188082,30514,TR,TR
16717,1700303040,1700333460,30420,68194,77078,TR,TR
81497,1699359600,1699363200,3600,165111,198201,NL,NL
112813,1698850200,1698862980,12780,32774,191289,US,US
188012,1699008900,1699012500,3600,56255,42264,NL,NL
178048,1700608440,1700614440,6000,42713,139660,GB,GB
193542,1699206720,1699223640,16920,147741,110785,BE,NL
116689,1700258100,1700272920,14820,12276,154428,CA,CA
181580,1699384860,1699393560,8700,162526,166389,HR,HR
100077,1699937760,1699966260,28500,155908,19049,PL,AT
118618,1699915440,1699922340,6900,133298,35080,GB,GB
159759,1699812360,1699827120,14760,109053,138148,CA,US
61814,1700072940,1700091120,18180,125939,186212,BE,NL
89891,1699897440,1699920360,22920,169799,158785,PL,PL
184468,1700461080,1700494320,33240,16010,120076,TR,TR
176631,1699413840,1699447800,33960,93633,46117,TR,TR
51605,1700594160,1700597760,3600,104048,20280,GB,GB
37953,1699857120,1699870740,13620,131258,141321,AT,AT
125861,1700484540,1700510640,26100,19156,161759,DE,NL
41987,1698802800,1698807540,4740,33596,168809,GB,GB
121784,1700539440,1700543580,4140,177324,132680,GB,GB
54704,1700622900,1700660340,37440,195010,40428,MX,MX
140487,1700306040,1700343180,37140,47727,117146,MX,MX
411,1699710720,1699744560,33840,79093,189204,TR,TR
49662,1700427240,1700454540,27300,183829,171539,BR,BR
39476,1699599420,1699632600,33180,142470,91001,TR,TR
54041,1700862840,1700895360,32520,85782,73291,TR,TR
9554,1699528740,1699559580,30840,50175,179369,TR,TR
184669,1700448420,1700457060,8640,159405,82771,PT,PT
104074,1700509080,1700512680,3600,97077,178460,GB,GB
71212,1699055640,1699079760,24120,38355,47496,RO,RO
16458,1699298100,1699309140,11040,139467,90977,CA,US
1786,1698898200,1698915960,17760,105552,143063,US,US
102452,1700461740,1700492820,31080,78860,32528,TR,TR
83416,1699720320,1699750860,30540,72448,55916,TR,TR
52980,1699330980,1699338240,7260,192752,184795,IT,IT
64290,1699330200,1699347000,16800,52955,79363,US,US
40501,1700142840,1700175660,32820,100251,59652,TR,TR
14676,1700849160,1700860320,11160,168857,171582,US,US
14958,1700572200,1700601300,29100,47182,13717,TR,TR
198447,1699577700,1699611480,33780,192297,179526,TR,TR
184557,1699878540,1699893540,15000,34279,20141,FR,FR
4035,1699959060,1699983180,24120,194213,92284,HU,AT
19000,1699911360,1699916520,5160,85448,113467,NL,PL
192392,1699339920,1699362840,22920,169946,158454,BR,BR
96625,1699387200,1699390800,3600,90999,102730,GB,GB
53354,1700492340,1700510820,18480,80454,32402,FR,BE
37662,1699981080,1699984680,3600,88142,85008,NL,NL
8191,1700178660,1700193960,15300,76471,24284,US,US
60904,1699394460,1699427460,33000,116599,55712,TR,TR
3347,1700789700,1700808000,18300,30391,149739,FR,DE
96120,1699683720,1699698840,15120,182089,144496,FR,IT
84305,1699605900,1699610100,4200,161784,184577,GB,GB
33393,1700422800,1700430120,7320,127414,39652,IT,IT
118522,1699587360,1699618140,30780,164945,12812,TR,TR
20003,1700256300,1700271240,14940,99812,108326,US,US
177738,1699733040,1699749180,16140,33939,67302,SE,NO
107001,1699517400,1699521000,3600,29185,13516,GB,GB
56488,1699331340,1699360320,28980,52845,1122,TR,TR
93177,1699438980,1699469460,30480,27725,21058,TR,TR
112656,1700763300,1700778060,14760,50200,17490,US,US
187255,1699081020,1699085340,4320,194174,90742,GB,GB
12665,1699906920,1699939020,32100,107631,18940,TR,TR
118079,1700316240,1700350380,34140,21100,190638,TR,TR
145622,1699163820,1699167420,3600,35974,59571,NL,DE
123415,1698941940,1698964800,22860,2355,162685,BR,BR
77962,1699247640,1699264260,16620,33181,33030,US,US
114580,1700035320,1700052360,17040,171269,109240,FR,FR
189482,1700082180,1700112420,30240,64195,11155,TR,TR
67349,1700117460,1700123520,6060,176195,10762,GB,GB
19622,1699133280,1699164660,31380,84916,109901,TR,TR
21733,1700240520,1700261460,20940,1899,83231,FR,FR
114785,1699239660,1699274820,35160,54580,15466,TR,TR
146143,1700327220,1700353260,26040,9693,57769,DE,PL
91583,1700273640,1700309700,36060,176784,121728,MX,MX
62028,1698921540,1698954300,32760,30650,13285,TR,TR
47513,1700541960,1700570820,28860,8151,75883,MK,CH
7866,1700282760,1700288400,5640,23818,101143,GB,GB
96191,1700481660,1700516700,35040,55003,25397,TR,TR
163588,1700643000,1700677140,34140,163247,51490,TR,TR
144146,1700578380,1700590080,11700,86807,577,HR,HR
152660,1699836840,1699840440,3600,7776,109197,NL,NL
36584,1700517060,1700542920,25860,54645,11857,PL,PL
197819,1700372880,1700401920,29040,189405,20131,BA,RS
171118,1698907320,1698910920,3600,45225,68221,NL,NL
73260,1699940820,1699952940,12120,74187,24193,ES,ES
91680,1699176720,1699192560,15840,4610,3219,FR,RS
199950,1700586060,1700592000,5940,42149,77866,NL,NL
146842,1699375860,1699383300,7440,69521,127163,SK,AT
14156,1700629920,1700641980,12060,184330,28178,US,US
194719,1700319180,1700334360,15180,169161,50095,US,US
65478,1700459880,1700488680,28800,153879,56076,TR,TR
110694,1700764080,1700778420,14340,77254,187682,RS,DE
2558,1699086480,1699102080,15600,75535,37864,CZ,NL
151013,1698858720,1698871560,12840,169374,43926,CA,US
36925,1700111580,1700144880,33300,161912,131122,MX,MX
3097,1699236960,1699250580,13620,24124,66688,US,US
161558,1699746000,1699762080,16080,78554,29420,US,US
1663,1699216860,1699225020,8160,154193,95068,HR,RS
195137,1700417280,1700449080,31800,171715,25784,TR,TR
136026,1699923960,1699939080,15120,108277,172300,US,US
28326,1698843720,1698879060,35340,29787,90755,TR,TR
26997,1699338480,1699353840,15360,143833,27327,US,US
40676,1700704020,1700721540,17520,112796,120281,US,US
100275,1699010460,1699043700,33240,133401,169218,TR,TR
132564,1699619280,1699623960,4680,112803,139425,GB,GB
78735,1699950780,1699964700,13920,128371,63932,US,US
184756,1699385340,1699441920,56580,90264,82246,BG,DE
141564,1700757240,1700787600,30360,84835,2841,TR,TR
2480,1699867200,1699885080,17880,175780,9561,FR,FR
168050,1699358340,1699361940,3600,52895,133431,GB,GB
126752,1699204500,1699209840,5340,164203,97311,GB,GB
186426,1700193600,1700225940,32340,190820,22543,TR,TR
70948,1700783880,1700788980,5100,199185,125928,GB,GB
8199,1699073760,1699108140,34380,126109,15435,TR,TR
131769,1699595340,1699609500,14160,127585,46083,IT,IT
18458,1700253120,1700285340,32220,144613,132742,TR,TR
73457,1700200500,1700230140,29640,174297,43803,TR,TR
475,1700328180,1700360340,32160,145941,15879,TR,TR
80058,1699127760,1699152420,24660,195458,96219,DE,AT
195664,1700772420,1700804220,31800,45642,104261,TR,TR
154321,1698896820,1698927780,30960,102007,92293,TR,TR
181950,1699698900,1699733520,34620,147348,34692,TR,TR
148167,1700402460,1700416680,14220,100750,66751,US,US
75377,1699709160,1699734600,25440,46806,156472,BA,BA
42198,1699503780,1699516740,12960,179252,40549,US,US
172637,1700778420,1700801400,22980,172923,58447,HU,HR
4300,1699345500,1699351320,5820,122082,75885,AD,ES
141597,1699484520,1699514580,30060,172817,198331,TR,TR
126122,1700447460,1700464200,16740,79339,148813,US,US
118690,1700092080,1700124780,32700,93248,4097,TR,TR
162920,1700290860,1700303100,12240,102795,38000,HR,HR
52083,1700539080,1700548320,9240,6045,63870,PT,PT
16730,1699046820,1699059360,12540,171636,92218,RS,RS
16899,1699396080,1699429500,33420,124831,198388,TR,TR
90219,1699392240,1699427220,34980,137911,61238,TR,TR
64638,1700483040,1700495760,12720,18617,19407,RS,RS
42262,1699581600,1699614240,32640,135822,150461,TR,TR
69566,1700389200,1700413680,24480,149154,198691,BR,BR
118799,1699941180,1699953780,12600,153407,180625,IT,IT
94692,1700346300,1700360400,14100,88033,141487,US,US
96998,1699228260,1699231860,3600,101490,181939,GB,GB
75097,1699188480,1699222980,34500,170845,25332,TR,TR
123716,1699623720,1699627320,3600,80656,1409,NL,DE
97320,1699484880,1699497120,12240,15140,75743,AT,BA
160993,1699610460,1699614060,3600,72086,173510,NL,NL
81046,1699812240,1699822800,10560,132502,90056,GR,BG
20398,1699818660,1699848660,30000,7153,770,TR,TR
165882,1700196180,1700230500,34320,155318,190287,MX,MX
18582,1699636860,1699650900,14040,89641,156791,IT,IT
10954,1699456500,1699464720,8220,77685,74191,IT,IT
169553,1699600080,1699629000,28920,85038,110518,TR,TR
38380,1699730580,1699742640,12060,174274,194339,IT,IT
123864,1699969860,1699973760,3900,5405,1771,NL,NL
187906,1700721180,1700731620,10440,91086,131165,IT,IT
122795,1700357640,1700383260,25620,163956,63460,RO,RO
45761,1700423400,1700456640,33240,199483,179499,TR,TR
163905,1699867380,1699901640,34260,197819,179270,TR,TR
156304,1699805160,1699819140,13980,7889,40250,AT,AT
190511,1700422020,1700425620,3600,184798,133166,NL,NL
101640,1699489020,1699516740,27720,172443,74547,DE,BA
58087,1700529120,1700534100,4980,7560,121383,GB,GB
111885,1700043240,1700050080,6840,148788,193630,GB,GB
86993,1699739760,1699769040,29280,146359,199225,TR,TR
185909,1699301340,1699324260,22920,120590,90705,DE,FR
137036,1699818360,1699846560,28200,127254,138197,HU,DE
147336,1699398720,1699454160,55440,179091,13607,BG,HU
108652,1700646120,1700669100,22980,2340,106027,PL,PL
21870,1700679840,1700714280,34440,93804,37017,TR,TR
122517,1699531920,1699558800,26880,141873,38184,BR,BR
10491,1699896240,1699909380,13140,57441,124990,US,US
2430,1700019420,1700026080,6660,18241,105695,GB,GB
151552,1700432820,1700439480,6660,96475,164710,NL,FR
193064,1700769420,1700803980,34560,111024,74987,TR,TR
79055,1699179900,1699209480,29580,78012,168668,TR,TR
20340,1700603880,1700618280,14400,77959,78389,US,US
169093,1700124180,1700157660,33480,705,65381,TR,TR
127576,1699127880,1699146000,18120,44195,108505,BE,NL
10982,1700764500,1700781420,16920,188884,121920,US,US
78173,1700142360,1700152140,9780,119250,173312,PT,PT
107607,1699307100,1699314360,7260,163964,195115,AD,ES
2776,1698880320,1698896580,16260,82729,1431,BE,DE
62274,1698997200,1699028460,31260,101814,158451,TR,TR
43299,1700258760,1700267760,9000,130896,60274,IT,IT
95781,1699362300,1699391640,29340,1537,63804,TR,TR
5108,1700472600,1700498040,25440,162240,196837,DE,CZ
86874,1699828920,1699861980,33060,77600,30633,TR,TR
106378,1700215800,1700250060,34260,77387,27256,MX,MX
106118,1699592040,1699603920,11880,117589,147663,HR,HR
122206,1700564940,1700600100,35160,71471,154019,TR,TR
195967,1700320440,1700350740,30300,140066,128894,TR,TR
11866,1699842780,1699876440,33660,137766,125499,TR,TR
164787,1699097460,1699126980,29520,46641,176082,TR,TR
31213,1699648080,1699666080,18000,67819,61078,FR,FR
63849,1699600380,1699631640,31260,161320,23085,TR,TR
41584,1700767620,1700799240,31620,76763,152908,TR,TR
195063,1700755860,1700788680,32820,75548,119621,TR,TR
3000,1699748820,1699759860,11040,45899,64174,US,US
108086,1698956040,1698990360,34320,179501,183030,TR,TR
31423,1698813480,1698864240,50760,181805,120878,BG,AT
177960,1699370040,1699390800,20760,139321,79230,SE,SE
13212,1699660080,1699663680,3600,65769,167875,GB,GB
167334,1700463240,1700466840,3600,134894,120529,NL,NL
41671,1699945860,1699973880,28020,149889,62934,DE,IT
182216,1700813820,1700831340,17520,49780,10737,AT,DE
162226,1699559820,1699571220,11400,189992,79149,CZ,CZ
88504,1699705620,1699730820,25200,45667,33528,PL,PL
5615,1700113500,1700121240,7740,122825,110298,PT,PT
119593,1700638980,1700671380,32400,2077,31381,TR,TR
34900,1700447220,1700478840,31620,134442,155277,TR,TR
82138,1699724580,1699748700,24120,138174,41512,HU,AT
189146,1700096400,1700106360,9960,71901,10529,IT,IT
192634,1699840140,1699875120,34980,109624,112820,TR,TR
99107,1699584120,1699600440,16320,9084,17692,CZ,CZ
160307,1700462640,1700466240,3600,81779,21685,NL,NL
19566,1699592820,1699626900,34080,179853,84178,TR,TR
35588,1700789640,1700821140,31500,99936,118202,TR,TR
185209,1699224840,1699259820,34980,87893,122493,TR,TR
156526,1699101480,1699115100,13620,110618,108965,IT,IT
199661,1700788200,1700813820,25620,64691,63759,DE,IT
148081,1699425240,1699452420,27180,122707,64348,PL,PL
4049,1700788380,1700819220,30840,31291,16393,TR,TR
105869,1700483880,1700516520,32640,191505,51707,TR,TR
20244,1699471200,1699505220,34020,47734,190758,TR,TR
129776,1700144820,1700151720,6900,161173,102859,GB,GB
139573,1699626900,1699630500,3600,46679,129319,GB,GB
186436,1700015520,1700019300,3780,11687,179545,GB,GB
193113,1698881340,1698884940,3600,75856,140353,GB,GB
58431,1699951200,1699966020,14820,134261,172786,US,US
53503,1700490780,1700522880,32100,191727,16326,TR,TR
183590,1700428500,1700432100,3600,40551,107453,GB,GB
84889,1700593620,1700627700,34080,40817,51798,TR,TR
95122,1700176740,1700213520,36780,54071,144785,MX,MX
98773,1700284140,1700310360,26220,28543,5083,RO,RO
143426,1699473540,1699477920,4380,135094,26737,NL,NL
112537,1700759340,1700791800,32460,125376,107028,TR,TR
93557,1700311080,1700344200,33120,45726,81294,TR,TR
51389,1700137620,1700172180,34560,100045,76151,TR,TR
101637,1700568840,1700574360,5520,31635,189111,GB,GB
96292,1700135880,1700145180,9300,124972,88723,PT,PT
44674,1699852260,1699867320,15060,104163,88446,US,US
101374,1700345280,1700357940,12660,131591,45216,PT,PT
116910,1699587960,1699600080,12120,32400,160371,HR,HR
67574,1700519760,1700523360,3600,198152,11930,GB,GB
184379,1700528580,1700562120,33540,135966,154630,TR,TR
127568,1700473800,1700486160,12360,174207,71881,IT,IT
135455,1699289820,1699321440,31620,16372,113076,TR,TR
61119,1700858520,1700866500,7980,72781,126517,IT,IT
114536,1699447080,1699478040,30960,38357,83600,TR,TR
43646,1699990020,1700024580,34560,170349,100540,TR,TR
16282,1698839400,1698844020,4620,106910,115396,NL,NL
153259,1699924740,1699936380,11640,126165,144487,IT,IT
123298,1700054520,1700087700,33180,81008,20037,TR,TR
103040,1698870300,1698873900,3600,62148,172536,NL,NL
56801,1700678760,1700709960,31200,57564,157742,TR,TR
194584,1700760960,1700773260,12300,179356,141721,AT,AT
122142,1699406100,1699441620,35520,98767,168132,TR,TR
28046,1699578360,1699582560,4200,116736,199115,GB,GB
55567,1700095980,1700112120,16140,160334,2288,FR,IT
94796,1699899180,1699906920,7740,92000,163477,IT,IT
137904,1700133780,1700138040,4260,4966,179014,GB,GB
58949,1700749140,1700752740,3600,140028,59673,GB,GB
184082,1699685700,1699696080,10380,177796,6541,PT,PT
50543,1699342560,1699357440,14880,102622,105183,US,US
132648,1699198800,1699233180,34380,136396,78691,TR,TR
6821,1699979040,1699982640,3600,72255,97937,NL,NL
9917,1699682460,1699704660,22200,109427,55230,DE,DE
17296,1700837580,1700842200,4620,78547,41133,GB,GB
192698,1699198440,1699224480,26040,178259,103540,DE,IT
80145,1698800160,1698820500,20340,52458,54339,FR,NL
90598,1700175480,1700185560,10080,196450,106194,FI,EE
83657,1700580660,1700615040,34380,97324,115229,TR,TR
174449,1700565900,1700593020,27120,3766,101178,PL,PL
39783,1698879840,1698912600,32760,151500,97373,TR,TR
40522,1699458000,1699461600,3600,196718,81330,GB,GB
96952,1700272860,1700279280,6420,53056,3881,NL,NL
198187,1698794100,1698815160,21060,158143,22563,FR,FR
27383,1699796520,1699807380,10860,12246,167704,CZ,FR
5201,1700588160,1700597040,8880,77353,31533,HR,HR
183940,1700184540,1700194020,9480,80786,108631,IT,IT
172515,1699260960,1699264560,3600,25980,68369,GB,GB
6625,1699925760,1699946280,20520,121119,78358,FR,DE
23236,1699872180,1699894620,22440,7682,164907,DE,DE
178706,1700223960,1700283960,60000,17359,125761,UA,PL
40953,1699382040,1699395540,13500,107083,155539,AT,HR
25812,1700137740,1700168580,30840,83372,16649,BA,HR
154679,1699724460,1699757640,33180,181428,129286,TR,TR
94811,1699915200,1699946700,31500,75054,100979,TR,TR
49586,1699593300,1699602120,8820,118313,126780,IT,IT
151625,1698990240,1699002720,12480,158408,32544,US,US
93597,1698827100,1698858120,31020,94293,11429,TR,TR
123357,1699189320,1699201740,12420,102721,196686,PT,PT
170406,1699229640,1699241940,12300,181516,118332,US,US
78424,1699572900,1699608120,35220,61833,77568,TR,TR
179041,1699332600,1699341000,8400,183947,70197,IT,IT
49688,1699183860,1699187460,3600,70586,138420,NL,NL
17828,1699810740,1699832580,21840,140125,57982,PL,FR
20517,1699268340,1699301520,33180,51223,12448,TR,TR
180661,1699914060,1699947840,33780,61488,145670,TR,TR
116048,1700543220,1700573340,30120,22275,83427,TR,TR
77932,1700703600,1700707200,3600,34129,126793,NL,NL
98705,1699663860,1699670340,6480,72591,167343,GB,GB
77076,1700275800,1700302500,26700,106375,123396,BR,BR
342,1699324680,1699354200,29520,132448,76781,TR,TR
82314,1700749080,1700754960,5880,77478,183569,EE,PL
184423,1700173020,1700202240,29220,43960,70656,BA,DE
72512,1699748400,1699762620,14220,76674,47473,IT,SK
14524,1698950460,1698961740,11280,90506,48750,AT,DE
124035,1699305720,1699315200,9480,189827,97222,IT,IT
32814,1699028460,1699060980,32520,41331,44994,TR,TR
128938,1700094060,1700129460,35400,153886,148292,TR,TR
93097,1699205040,1699208820,3780,124072,177227,NL,NL
21990,1700326380,1700355180,28800,103118,194593,TR,TR
123053,1699937820,1699989840,52020,177325,182203,BG,BG
11524,1699823100,1699827600,4500,61127,9850,GB,GB
77519,1700516640,1700550300,33660,132456,120381,TR,TR
139575,1700082120,1700094420,12300,98198,51561,IT,IT
81550,1700470980,1700486400,15420,143936,88153,BE,FR
134741,1699789020,1699819560,30540,1662,175079,TR,TR
130081,1700603400,1700634720,31320,198066,125324,TR,TR
123753,1699119600,1699149600,30000,159080,166061,TR,TR
44276,1699980540,1699984140,3600,58983,164725,NL,NL
196679,1700421960,1700455440,33480,57010,95194,TR,TR
94667,1700428980,1700456880,27900,68727,88683,PL,HR
62448,1700349180,1700384100,34920,53877,150630,TR,TR
93101,1699742820,1699753860,11040,92007,25961,US,US
25648,1699858080,1699888680,30600,87307,167820,TR,TR
167838,1699139280,1699155000,15720,96909,53097,US,US
168824,1699652400,1699681800,29400,84240,20241,TR,TR
98469,1700355900,1700369880,13980,160483,76889,RS,DE
59731,1699624860,1699628460,3600,134112,149875,NL,NL
191964,1699082040,1699117980,35940,3323,52114,TR,TR
175896,1700732220,1700761440,29220,199831,34278,TR,TR
138618,1700311260,1700322180,10920,133415,176389,IT,IT
133042,1700001300,1700026680,25380,38018,18149,RO,RO
35512,1700219880,1700230740,10860,52576,79177,US,US
96972,1699791600,1699815540,23940,168339,72118,DE,SE
15340,1699623000,1699658460,35460,74448,173037,TR,TR
46068,1700054940,1700087040,32100,147831,141015,TR,TR
48846,1699066260,1699095120,28860,45640,52820,TR,TR
7193,1700518740,1700553480,34740,157940,65967,TR,TR
189833,1700445180,1700474580,29400,157474,84852,TR,TR
67567,1700715660,1700719260,3600,177755,128825,NL,NL
124755,1700506140,1700562000,55860,175729,164120,BG,DE
172473,1700167620,1700183940,16320,54106,109492,FR,IT
187023,1699017060,1699031220,14160,118732,95931,IT,IT
105294,1700277060,1700310240,33180,89274,34856,TR,TR
41670,1699999740,1700007060,7320,136644,101537,IT,IT
186912,1700736780,1700742240,5460,15328,19930,NL,NL
164760,1699619760,1699623360,3600,126478,119095,GB,GB
113397,1700716500,1700723880,7380,52926,186840,ES,ES
176359,1700182500,1700213520,31020,172699,79453,TR,TR
170124,1699463340,1699472520,9180,34566,36882,IT,IT
28701,1700011980,1700015580,3600,85764,74567,NL,NL
122025,1699992900,1700006640,13740,73089,42382,US,US
182119,1698861360,1698876300,14940,74404,155204,AT,AT
42673,1699773900,1699802580,28680,48546,110749,DE,BE
31030,1698869820,1698873420,3600,121299,8441,GB,GB
84892,1698962880,1698998340,35460,114301,159386,TR,TR
57641,1700303580,1700307180,3600,25182,53509,NL,NL
12835,1699538820,1699542420,3600,74174,66137,GB,GB
165043,1699377420,1699382340,4920,138347,159896,GB,GB
66935,1699146720,1699157400,10680,174351,119237,HR,HR
76928,1700505960,1700541060,35100,59542,48062,TR,TR
184309,1700379120,1700411820,32700,116801,127900,TR,TR
44231,1699381860,1699394460,12600,117245,184653,US,US
194987,1700734140,1700740140,6000,170188,76384,GB,GB
21591,1700315460,1700345400,29940,98405,70224,TR,TR
52574,1700545800,1700559000,13200,64395,139537,IT,FR
188267,1700764920,1700798040,33120,67659,2070,TR,TR
121485,1700162280,1700165880,3600,100506,134388,NL,NL
56556,1700509260,1700520840,11580,147709,153463,US,US
145095,1700824020,1700853240,29220,95955,107905,TR,TR
22649,1699493040,1699503540,10500,150841,175134,ES,ES
93060,1699929360,1699960200,30840,21433,78955,TR,TR
84029,1699206060,1699226280,20220,38857,178410,FR,ES
183792,1699822740,1699856100,33360,35119,1451,TR,TR
161524,1700528400,1700561040,32640,136958,100869,TR,TR
141188,1700177760,1700209020,31260,16112,5010,TR,TR
130186,1699573560,1699604220,30660,87554,119401,TR,TR
113798,1700350560,1700384460,33900,7395,11837,TR,TR
93269,1699110840,1699119840,9000,155055,105607,ES,AD
150442,1698964740,1698968340,3600,45097,158437,GB,GB
44071,1699262700,1699278780,16080,99254,144121,US,US
14679,1699942740,1699954200,11460,92880,92805,US,US
12845,1698825600,1698840360,14760,156758,85143,US,US
174574,1700451240,1700483340,32100,94421,83018,TR,TR
40332,1699896720,1699927800,31080,51062,147134,TR,TR
168229,1698998580,1699008900,10320,102407,808,IT,IT
23142,1699210620,1699226160,15540,113478,105519,US,US
190288,1699547160,1699558560,11400,181390,159111,IT,IT
135858,1699170360,1699183620,13260,20895,140798,IT,IT
135208,1700611200,1700616180,4980,50548,157580,NL,NL
164683,1699957980,1699995000,37020,29690,151272,MX,US
147057,1699121280,1699124880,3600,27568,102586,GB,GB
131089,1699760280,1699771260,10980,117933,81065,US,US
153894,1700002500,1700017800,15300,143100,147313,FR,FR
198341,1699593180,1699609140,15960,84719,5935,US,US
187404,1699659480,1699669260,9780,175745,178440,PT,PT
178543,1700130900,1700134500,3600,125733,167197,NL,NL
35137,1700398200,1700427900,29700,103973,189807,TR,TR
12049,1699691640,1699717260,25620,32198,120182,BA,BA
75947,1699033740,1699039260,5520,64211,8942,GB,GB
73596,1699720380,1699733820,13440,169819,5109,US,US
21821,1699902720,1699906320,3600,161095,50240,NL,NL
193519,1700316360,1700344860,28500,166303,139761,BR,BR
76818,1699199400,1699231680,32280,27411,144102,TR,TR
149321,1699659660,1699677420,17760,26727,120584,US,US
29747,1699979940,1699990620,10680,87286,79721,HR,HR
127018,1698813240,1698828540,15300,112773,25192,CZ,CZ
191227,1700772900,1700776500,3600,158119,84513,GB,GB
7402,1699202940,1699236720,33780,182832,140144,TR,TR
70029,1700672460,1700677200,4740,39259,134846,NL,NL
109011,1700388600,1700408400,19800,185001,175718,FR,FR
148390,1700525640,1700558940,33300,178832,141297,TR,TR
6221,1700589060,1700603400,14340,171438,155967,IT,IT
96989,1699663320,1699698660,35340,70815,148784,TR,TR
137292,1698996660,1699031880,35220,141861,45288,TR,TR
155720,1700762760,1700785140,22380,34339,81811,DE,PL
147197,1700717460,1700728320,10860,101208,154819,US,US
186958,1700250480,1700275680,25200,132741,6413,DE,UA
48712,1699473600,1699485840,12240,143139,159768,US,US
142425,1699328580,1699339380,10800,64842,15661,RS,RS
121644,1700144700,1700177640,32940,138780,19814,TR,TR
128508,1699774740,1699805220,30480,74671,37351,TR,TR
54926,1699870620,1699887000,16380,70175,25049,US,US
39103,1698871380,1698902940,31560,100783,119778,TR,TR
137675,1699284120,1699315920,31800,36908,9463,TR,TR
137411,1699710660,1699714320,3660,198493,11162,GB,GB
149208,1699944240,1699960740,16500,179777,159385,US,US
3489,1699500180,1699527960,27780,54216,186396,DE,CH
152102,1698916320,1698920700,4380,113932,50422,GB,GB
15039,1699539720,1699544520,4800,123295,89605,GB,GB
43045,1700782620,1700795520,12900,57852,14941,US,US
194692,1698985020,1699017600,32580,27624,8605,TR,TR
9654,1699620780,1699633680,12900,178728,193027,US,US
36909,1699698300,1699712220,13920,133238,140444,RS,RS
137784,1699667820,1699702560,34740,35639,79441,TR,TR
116655,1699012920,1699025160,12240,108883,165280,US,US
63897,1699167420,1699171260,3840,121007,3702,GB,GB
67626,1700313480,1700344440,30960,152847,31812,TR,TR
180219,1700082300,1700117340,35040,90504,8057,TR,TR
175441,1699855620,1699887900,32280,57208,21621,TR,TR
33488,1699144140,1699149480,5340,19801,24229,NL,NL
183651,1700187840,1700223780,35940,100935,58702,TR,TR
108734,1699118460,1699129440,10980,23410,181579,US,US
186290,1700785740,1700802600,16860,137470,176601,RS,RS
81403,1700161980,1700165580,3600,80406,170427,GB,GB
53761,1699988940,1700013060,24120,69232,25379,DE,HU
172272,1698875820,1698890700,14880,191880,146610,US,US
122716,1699424460,1699440360,15900,103143,58823,US,US
160571,1698862740,1698891600,28860,35316,2141,TR,TR
179617,1699549320,1699565400,16080,64540,48262,US,US
56737,1700085180,1700119440,34260,58358,162575,TR,TR
120027,1700486520,1700498220,11700,115974,90498,HR,HR
36465,1700442360,1700476680,34320,88506,61925,TR,TR
50102,1698807960,1698811560,3600,150987,90366,GB,GB
52224,1699240320,1699262640,22320,173535,188461,DE,HU
20175,1698861060,1698875460,14400,43373,36006,US,US
101597,1699488660,1699506480,17820,94796,64227,FR,FR
19677,1699379340,1699384320,4980,191465,146421,NL,BE
78871,1699210920,1699222740,11820,190407,84533,CZ,CZ
164476,1698947280,1698958200,10920,168332,16415,US,US
187293,1700622960,1700656800,33840,136331,9623,TR,TR
164088,1699841460,1699858020,16560,158863,41220,AT,NL
87166,1699289940,1699299900,9960,16146,113247,PT,PT
113070,1700515320,1700518920,3600,29277,138571,GB,GB
123326,1700511540,1700530380,18840,173096,85947,FR,FR
3170,1700481420,1700511780,30360,171068,54270,TR,TR
6277,1700706720,1700739720,33000,141496,122813,MX,MX
195056,1699656540,1699673280,16740,75874,140050,FR,FR
89427,1699360380,1699395300,34920,197189,160742,TR,TR
162453,1700409180,1700426580,17400,94024,6101,US,US
169136,1699033620,1699045500,11880,39368,115319,AT,AT
134009,1699088100,1699113540,25440,31894,18673,DE,AT
116119,1700064120,1700093640,29520,145537,168779,TR,TR
146921,1700523780,1700559480,35700,108056,86073,TR,TR
76111,1699183980,1699207500,23520,173550,172955,DE,PL
83336,1700748000,1700760000,12000,30333,62874,US,US
39083,1699768080,1699800600,32520,146908,66461,TR,TR
23678,1700421900,1700450940,29040,66111,103115,TR,TR
50795,1699205220,1699219140,13920,34019,45943,US,US
45574,1699050360,1699053960,3600,193211,19776,NL,NL
123174,1699796940,1699814160,17220,168841,36047,US,US
71410,1700722980,1700746200,23220,59669,179918,DE,DE
103175,1700472180,1700502180,30000,102856,55243,TR,TR
118874,1700335620,1700361600,25980,12959,97695,DE,DE
187735,1699500300,1699511820,11520,58862,199259,IT,IT
13931,1699216500,1699248060,31560,156513,27617,TR,TR
42539,1700486280,1700501880,15600,115001,172460,US,US
10360,1699177020,1699209600,32580,149350,77394,TR,TR
122776,1700765400,1700777280,11880,4593,191855,US,US
106453,1698932220,1698964380,32160,109308,102402,TR,TR
78126,1700718360,1700752140,33780,64164,149741,TR,TR
179978,1699798380,1699818300,19920,141658,149329,FR,BE
163982,1699484940,1699488540,3600,193761,72179,GB,GB
136628,1699658880,1699691580,32700,197161,156752,TR,TR
94441,1699052460,1699069500,17040,91214,58898,FR,BE
134809,1699704480,1699708080,3600,153788,11129,GB,GB
69182,1700319720,1700354460,34740,61272,81864,TR,TR
134726,1699217640,1699247460,29820,186237,31051,TR,TR
197390,1699923540,1699955040,31500,197026,120908,TR,TR
68677,1700033040,1700065920,32880,74082,100763,TR,TR
153919,1700542380,1700571180,28800,37522,81616,TR,TR
61749,1699005720,1699023480,17760,43736,19668,US,US
108987,1700491980,1700505960,13980,183433,5821,IT,IT
29558,1700267820,1700298480,30660,13692,86777,TR,TR
138931,1699126500,1699150500,24000,183510,134961,DE,BA
153233,1700004960,1700015640,10680,70708,79861,IT,IT
173274,1699730580,1699761720,31140,21532,155057,TR,TR
63069,1699315380,1699318980,3600,137398,73335,NL,AT
21085,1700046420,1700077500,31080,34264,30596,TR,TR
29030,1700558160,1700564700,6540,76993,144848,GB,GB
39925,1699572540,1699604340,31800,87555,148574,TR,TR
48661,1700241720,1700256300,14580,183256,132494,US,US
33364,1699029000,1699064580,35580,180439,12267,TR,TR
49436,1699946400,1699971120,24720,85490,122921,RO,MD
115200,1699867860,1699906200,38340,35340,194092,MX,MX
117009,1699023060,1699033440,10380,181739,137373,IT,IT
153495,1699560840,1699575780,14940,43812,196383,US,US
126313,1699283040,1699315320,32280,58903,199907,TR,TR
191652,1699493400,1699513140,19740,28125,180660,SE,SE
21604,1700825400,1700836380,10980,79901,164026,ES,ES
185034,1700606160,1700645640,39480,36705,68250,MX,MX
165290,1699909500,1699913100,3600,47451,169988,NL,NL
81348,1700310120,1700324220,14100,156593,62498,IT,IT
64115,1699225800,1699241100,15300,81135,89736,AT,AT
106477,1699487280,1699491660,4380,169417,54923,NL,NL
149098,1699574700,1699589160,14460,193307,142580,FR,BE
3142,1700570100,1700575020,4920,60804,184226,FI,EE
65433,1700038200,1700041800,3600,71143,107537,GB,GB
151839,1699921020,1699955040,34020,187304,32520,MX,MX
99887,1699532280,1699561560,29280,173136,133813,TR,TR
145407,1699835760,1699839360,3600,6675,8306,GB,GB
40173,1700512380,1700548320,35940,198825,120575,TR,TR
105391,1700620440,1700654460,34020,25768,144223,TR,TR
180694,1700833740,1700857500,23760,196431,12335,PL,AT
84937,1700692860,1700726160,33300,129732,172801,TR,TR
77291,1700674740,1700696100,21360,198965,5985,BE,FR
198973,1699680300,1699693800,13500,131197,66093,US,US
71951,1698962220,1698971520,9300,113277,120495,ES,ES
67565,1699614780,1699625940,11160,195872,73004,US,US
27004,1698874560,1698906060,31500,148346,72496,TR,TR
58059,1700705820,1700734800,28980,142742,144386,TR,TR
122620,1699875360,1699886760,11400,155481,17302,US,US
126271,1699417500,1699448760,31260,180968,109423,TR,TR
120840,1700204580,1700214540,9960,85252,43250,SK,SK
58916,1699673940,1699683660,9720,180521,132484,HR,HR
59901,1700728260,1700760540,32280,152018,117808,TR,TR
12495,1700543760,1700548140,4380,138153,139250,EE,EE
118017,1700137380,1700165280,27900,55720,167482,PL,PL
128036,1700725740,1700737680,11940,180671,103080,IT,IT
27119,1699390200,1699424940,34740,28305,91580,TR,TR
4510,1699536420,1699572180,35760,71266,143463,TR,TR
114641,1699224960,1699229340,4380,9511,77438,GB,GB
185058,1699365060,1699393560,28500,147484,177953,PL,NO
110576,1698832020,1698836940,4920,32466,57686,GB,GB
9366,1699679640,1699701900,22260,93182,132117,MD,RO
139923,1699858140,1699861740,3600,160521,64084,NL,NL
9668,1699063800,1699094460,30660,126467,196612,TR,TR
100981,1699565040,1699594560,29520,34984,150745,TR,TR
171272,1699535580,1699571340,35760,102158,175093,TR,TR
129729,1699295340,1699330740,35400,38009,72520,TR,TR
50057,1699191060,1699224300,33240,105482,12032,TR,TR
57636,1700826660,1700830260,3600,146161,125064,GB,GB
125110,1700418780,1700422380,3600,159684,69238,NL,NL
173265,1698804480,1698810480,6000,28248,50054,GB,GB
133436,1700844420,1700860440,16020,141380,187322,FR,FR
20235,1698984180,1698994920,10740,165018,175815,IT,IT
41980,1699842600,1699850340,7740,100723,143564,EE,EE
190499,1698869280,1698872880,3600,32182,106678,GB,GB
81166,1700587140,1700615340,28200,166613,165962,PL,PL
177674,1700585040,1700589780,4740,138683,114487,GB,GB
161118,1700769540,1700801400,31860,27391,2664,TR,TR
103188,1700452980,1700475480,22500,63349,156854,HU,CZ
133547,1698897900,1698910740,12840,47544,142930,ES,ES
26840,1698800520,1698804120,3600,184456,156928,GB,GB
90908,1699279080,1699288140,9060,128043,25512,HR,HR
127527,1700348880,1700377560,28680,31716,197710,DE,HR
118166,1700336520,1700350380,13860,114809,104044,IT,IT
190808,1700607900,1700627580,19680,197653,76527,BE,NL
57477,1699363440,1699393680,30240,27200,8954,TR,TR
191240,1700374020,1700385420,11400,158560,119059,IT,IT
130076,1700016900,1700021760,4860,3617,68717,NL,NL
157671,1700178480,1700189340,10860,210,48714,IT,IT
100031,1699705440,1699718460,13020,194060,52791,US,US
91274,1700285580,1700297820,12240,119236,191785,CZ,SE
146985,1698949440,1698958680,9240,131504,18330,HR,HR
116056,1699595700,1699604100,8400,50994,109931,PT,PT
86302,1700734020,1700767200,33180,190228,171530,TR,TR
189796,1700112960,1700148180,35220,101819,1758,TR,TR
108911,1699474560,1699509900,35340,47810,138978,TR,TR
184922,1699881240,1699912380,31140,16894,27812,TR,TR
68618,1700047080,1700053740,6660,196295,40978,GB,GB
176521,1700696220,1700728080,31860,12619,59539,TR,TR
87336,1700283900,1700288280,4380,154488,78605,GB,GB
36598,1700270700,1700285940,15240,63496,1011,US,US
98544,1699604460,1699613580,9120,52788,53077,SK,SK
171912,1700229000,1700260080,31080,7058,178793,TR,TR
40180,1700089020,1700107380,18360,169795,45601,BE,NL
183021,1700606880,1700642640,35760,128202,28651,TR,TR
184747,1699091940,1699108020,16080,179608,34734,US,US
136211,1699976100,1700014080,37980,74453,112775,MX,MX
4029,1699992660,1700020680,28020,48575,86012,DE,FR
190155,1700198220,1700212620,14400,175589,196411,US,US
124314,1700383920,1700417940,34020,125656,150996,TR,TR
179751,1700459460,1700493780,34320,15372,148444,TR,TR
53636,1699646460,1699656960,10500,93175,14387,IT,IT
61531,1700111040,1700130240,19200,30076,159435,FR,FR
189697,1699306020,1699315620,9600,13599,107402,ES,FR
30767,1700735700,1700767260,31560,53366,156231,TR,TR
1611,1700027400,1700061840,34440,144463,191000,TR,TR
156042,1699670400,1699675020,4620,39049,151827,GB,GB
128768,1699637580,1699650000,12420,148183,44823,US,US
120773,1699001760,1699023420,21660,154093,122860,PL,PL
196092,1698894420,1698933540,39120,135883,8792,MX,MX
106658,1699565820,1699595940,30120,99220,51009,TR,TR
28238,1700377740,1700390640,12900,70018,6744,HR,HR
65811,1699053420,1699083360,29940,152402,159353,TR,TR
190258,1699594860,1699628880,34020,148978,182233,TR,TR
24734,1699270860,1699284420,13560,180328,196584,US,US
141153,1699105560,1699113480,7920,133098,87831,IT,IT
148125,1699089720,1699117440,27720,33405,4925,BA,HR
6261,1700054580,1700089500,34920,65388,40993,TR,TR
114832,1699446780,1699479600,32820,150418,104863,TR,TR
173097,1700011020,1700022180,11160,154777,54815,US,US
159,1699862700,1699889520,26820,82187,80817,DE,UA
153627,1699462080,1699496040,33960,67249,123679,TR,TR
42549,1699415400,1699431480,16080,164780,43338,CZ,CZ
89991,1699872900,1699881180,8280,123568,172197,ES,ES
11895,1699268520,1699280820,12300,165905,186050,US,US
59679,1700140800,1700144400,3600,37976,67380,NL,NL
97470,1700007120,1700026320,19200,143853,137224,FR,FR
170526,1700458560,1700471520,12960,25605,59701,US,US
88791,1699061220,1699096320,35100,121120,42201,TR,TR
82031,1700794680,1700826720,32040,86784,27287,TR,TR
9139,1700243760,1700256360,12600,45156,54361,HR,HR
187718,1700775300,1700789700,14400,48141,72638,US,US
69165,1699491180,1699508100,16920,143662,51339,US,US
110024,1700084220,1700111760,27540,146844,148386,DE,FR
177095,1700175600,1700185620,10020,16528,15022,IT,IT
184451,1699247160,1699256400,9240,180950,97805,HR,HR
110407,1700721780,1700725380,3600,100371,185665,NL,NL
69733,1700055060,1700058660,3600,1229,142601,GB,GB
121759,1699514040,1699547520,33480,110639,93285,TR,TR
105323,1700174460,1700208120,33660,137726,176906,TR,TR
47420,1700706600,1700739360,32760,141917,111197,MX,MX
40636,1700529660,1700563140,33480,177147,88379,TR,TR
101615,1699093560,1699097160,3600,32070,56975,GB,GB
31676,1698821100,1698849660,28560,55769,92740,DE,HR
112510,1699887780,1699891380,3600,68454,136387,GB,GB
135074,1699184100,1699214700,30600,65989,10280,TR,TR
78006,1699075620,1699105560,29940,106981,155276,TR,TR
143179,1699160580,1699189920,29340,38271,72646,TR,TR
53904,1700669640,1700683320,13680,106816,340,US,US
96610,1698993480,1699005960,12480,190212,61261,HR,HR
145007,1699282320,1699290360,8040,54277,158670,IT,IT
161891,1699441560,1699448460,6900,86205,185186,NL,NL
148761,1699403700,1699437960,34260,121197,10476,TR,TR
11462,1699262340,1699295280,32940,55310,47104,TR,TR
45120,1700115840,1700119440,3600,52158,188216,GB,GB
88766,1699511460,1699541040,29580,126457,51956,TR,TR
125727,1700486820,1700494080,7260,145373,109840,EE,EE
194173,1699110960,1699146600,35640,79926,151007,MX,MX
169686,1700147700,1700151600,3900,35414,68702,GB,GB
103127,1700806260,1700839320,33060,16581,15052,TR,TR
9888,1699132260,1699165380,33120,61749,123335,MX,MX
18512,1700185620,1700193540,7920,38641,108281,IT,IT
93519,1699855020,1699878420,23400,85620,41968,RO,RO
32412,1699197540,1699201140,3600,168567,93619,GB,GB
113818,1699213500,1699229820,16320,111520,13478,FR,FR
118277,1700078160,1700081760,3600,144471,196494,GB,GB
141252,1700341620,1700374140,32520,16478,121226,TR,TR
167095,1698826320,1698835320,9000,171737,23093,IT,IT
154278,1698868440,1698877020,8580,115302,62153,HR,PL
182872,1698948240,1698981000,32760,63835,126183,TR,TR
103042,1698989040,1698999840,10800,194642,185886,US,US
158656,1699203720,1699220460,16740,13073,194945,AT,DE
116340,1699071420,1699085640,14220,2771,60505,IT,DE
18977,1700128200,1700161320,33120,73824,81325,TR,TR
160690,1700050920,1700054520,3600,32153,198844,GB,GB
65144,1700362620,1700366220,3600,36433,187598,NL,NL
77474,1700472780,1700512080,39300,125895,108687,MX,MX
92550,1700254620,1700287320,32700,172573,164964,TR,TR
49838,1699460280,1699477320,17040,106755,109025,FR,FR
96529,1700672700,1700684580,11880,148452,1000,IT,IT
36592,1700538660,1700543040,4380,92627,187258,NL,NL
105890,1699560840,1699569420,8580,55746,97188,ES,ES
34905,1700564160,1700575680,11520,64626,176387,US,US
1233,1700587260,1700620920,33660,57099,76844,TR,TR
90081,1698867480,1698878580,11100,179725,8482,RS,BA
21115,1699284840,1699314660,29820,146509,29818,TR,TR
86629,1699970160,1699983480,13320,175782,104565,SK,SK
188717,1700378520,1700408820,30300,103551,154663,TR,TR
136412,1699978260,1699991340,13080,176410,12814,IT,IT
3976,1700452800,1700483700,30900,57680,160645,TR,TR
35572,1700224980,1700263140,38160,148792,196116,MX,MX
179118,1698931920,1698966600,34680,78859,174918,TR,TR
142014,1700442120,1700475900,33780,133317,125172,TR,TR
52957,1699859520,1699883760,24240,2873,41833,RO,MD
116515,1700421300,1700455440,34140,176459,39981,TR,TR
127799,1698845820,1698856140,10320,81090,124564,IT,IT
187793,1699682340,1699698540,16200,172675,135422,US,US
127248,1700254380,1700267040,12660,114477,49279,US,US
47013,1700106720,1700110980,4260,58316,21622,NL,NL
106821,1700048880,1700082480,33600,50784,134665,TR,TR
131051,1699660020,1699689780,29760,95298,159598,TR,TR
54908,1699395480,1699401600,6120,176187,820,GB,GB
198250,1700191680,1700224860,33180,143223,19476,TR,TR
11982,1699949100,1699975140,26040,184395,192220,BR,BR
47008,1700013420,1700049480,36060,75546,191534,MX,MX
99055,1699895520,1699931460,35940,187173,76970,TR,TR
154572,1699153320,1699183380,30060,112583,33604,TR,TR
55117,1699243140,1699281660,38520,44026,71485,MX,MX
138120,1700325840,1700329440,3600,66442,186057,NL,NL
149788,1700864220,1700873160,8940,116958,19834,PT,PT
105051,1700085540,1700095500,9960,105914,56765,HR,HR
32074,1700739300,1700772060,32760,48033,178436,TR,TR
10389,1700777940,1700813220,35280,74321,83981,TR,TR
63789,1700014980,1700018580,3600,197477,43601,NL,NL
30511,1699386660,1699390260,3600,3667,79965,GB,GB
4759,1699161180,1699172580,11400,161075,124702,AT,AT
123128,1699187520,1699220700,33180,156102,83900,TR,TR
44716,1700054580,1700058180,3600,40221,126615,NL,NL
177748,1699901640,1699915920,14280,5729,48458,US,US
39161,1700305080,1700319240,14160,85661,7537,US,US
75892,1698982500,1699017900,35400,186519,22473,TR,TR
181062,1699181700,1699193100,11400,171372,6261,US,US
88438,1700392680,1700401080,8400,183817,112272,IT,IT
33686,1699098960,1699133700,34740,38943,110968,TR,TR
73637,1699288380,1699314480,26100,170390,47736,DE,DE
128628,1699730940,1699744320,13380,155952,177315,IT,IT
68606,1699472100,1699506720,34620,116100,92315,TR,TR
28667,1699792500,1699826340,33840,101658,114075,TR,TR
121500,1700476500,1700480100,3600,95972,74042,NL,FR
4427,1700753520,1700766420,12900,58693,21860,IT,IT
32033,1699985700,1700038620,52920,143830,190625,BG,DE
96664,1700605620,1700620020,14400,8377,179739,FR,BE
199301,1699931520,1699948080,16560,49568,53269,US,US
22541,1698813960,1698843060,29100,142856,159863,TR,TR
125137,1700723220,1700729640,6420,85978,61911,FI,PL
35641,1700545620,1700559900,14280,89978,36207,US,US
1609,1700581560,1700603220,21660,47208,151125,DE,DE
157799,1699024860,1699056420,31560,24805,156550,TR,TR
74008,1700636880,1700648640,11760,159448,114925,AT,AT
127628,1699736520,1699770540,34020,47541,77623,TR,TR
78898,1699769220,1699783320,14100,106732,174327,US,US
61869,1699555320,1699562220,6900,36954,162609,NL,FR
73902,1699465680,1699496880,31200,75156,107437,TR,TR
18338,1699713480,1699720020,6540,69962,181101,NL,NL
150903,1700251080,1700254980,3900,168786,43124,GB,GB
123090,1699531980,1699565640,33660,195983,168698,TR,TR
168206,1699981860,1699995120,13260,181814,141795,US,US
79575,1698833220,1698846960,13740,93755,192409,IT,IT
40435,1699768740,1699799280,30540,44681,73809,TR,TR
31645,1698818280,1698832140,13860,175005,96909,US,US
89804,1700241060,1700257980,16920,125557,103130,US,US
65879,1700854140,1700880240,26100,124654,173841,DE,DE
172716,1699666380,1699701720,35340,116396,179391,TR,TR
188884,1700589900,1700598720,8820,68566,145097,HR,HR
170785,1700266200,1700279340,13140,160674,116351,US,US
22663,1699428480,1699457340,28860,47456,103680,TR,TR
188218,1700502060,1700519700,17640,48940,61630,US,US
185800,1698896820,1698912600,15780,45793,129022,US,US
147497,1700529240,1700560260,31020,122026,75738,TR,TR
177711,1699706220,1699721340,15120,30507,38989,FR,FR
133289,1700313660,1700347200,33540,7176,123485,TR,TR
35714,1699466760,1699496640,29880,156548,155417,TR,TR
102325,1699389660,1699403100,13440,171587,7044,IT,IT
79068,1698882120,1698892320,10200,86720,8104,PT,PT
112792,1699066740,1699096140,29400,57480,39529,TR,TR
174968,1699964760,1699979280,14520,189737,24198,US,US
33712,1700477100,1700536980,59880,7070,5909,UA,DE
20792,1700297220,1700330580,33360,132554,103158,TR,TR
73326,1700810400,1700830200,19800,46322,112793,SE,DE
125918,1699094400,1699108140,13740,193362,127933,IT,IT
35793,1699589640,1699620360,30720,49275,135720,TR,TR
127566,1698810540,1698821040,10500,42999,196334,IT,IT
75127,1699205160,1699216380,11220,100551,4247,US,US
136701,1700133660,1700165280,31620,13992,105998,TR,TR
141875,1698919320,1698931020,11700,155243,163006,US,US
166218,1700152860,1700179440,26580,9762,199548,RO,RO
175720,1699934820,1699969380,34560,53168,70541,TR,TR
92205,1699328340,1699331940,3600,158122,53582,GB,GB
18523,1699094100,1699126680,32580,9822,104955,TR,TR
147053,1700125140,1700131500,6360,29565,65394,NL,NL
28554,1700106540,1700110140,3600,176307,162400,GB,GB
796,1700799540,1700812320,12780,69293,199309,US,CA
176212,1699175040,1699210800,35760,39184,69719,TR,TR
55766,1699279800,1699311000,31200,191107,133385,TR,TR
93027,1699142940,1699147680,4740,67996,157057,GB,GB
117345,1699037700,1699042440,4740,132890,14618,GB,GB
120560,1699468920,1699481280,12360,16717,136790,HR,HR
91679,1699111500,1699124400,12900,100173,147574,US,US
405,1699141200,1699176480,35280,191649,142338,TR,TR
195635,1700853000,1700884440,31440,114199,4310,TR,TR
198437,1699067700,1699099440,31740,115889,150210,TR,TR
86341,1700707380,1700741400,34020,57590,184584,TR,TR
78021,1699614120,1699625640,11520,161047,177077,US,US
115328,1700568060,1700599320,31260,151259,193783,TR,TR
10779,1700019540,1700054940,35400,8140,43774,TR,TR
81114,1699548960,1699560120,11160,60452,83485,US,US
101272,1698969600,1698981540,11940,78242,25818,HR,DE
134434,1699509660,1699561260,51600,113968,82546,BG,AT
41725,1700378040,1700382600,4560,172631,169518,GB,GB
142135,1700152920,1700185500,32580,152525,119762,TR,TR
69471,1699653480,1699657080,3600,24565,30716,GB,GB
20974,1700340420,1700344260,3840,116779,21412,NL,NL
10274,1700543160,1700548140,4980,180036,56604,GB,GB
740,1699935240,1699939560,4320,117788,67968,NL,NL
83826,1700460540,1700476320,15780,60306,43963,US,US
183607,1700222820,1700232480,9660,112133,80193,IT,IT
12335,1700399400,1700427420,28020,174563,87901,HU,DE
130193,1700192280,1700204580,12300,81438,186625,CZ,AT
124725,1700444340,1700448840,4500,164252,174379,GB,GB
181246,1700796780,1700827860,31080,155128,154983,TR,TR
154601,1700506080,1700531700,25620,41526,129836,BA,RS
19847,1699144140,1699153320,9180,36133,189473,IT,IT
188519,1699680720,1699715880,35160,126727,86852,TR,TR
190475,1699421220,1699447860,26640,182431,47248,DE,AT
38723,1700018220,1700052120,33900,173197,46963,TR,TR
9843,1700240520,1700252040,11520,108505,197361,IT,SK
8462,1699668660,1699680000,11340,6703,798,IT,IT
142023,1699805880,1699809480,3600,160543,53177,GB,GB
101128,1699083720,1699094100,10380,29611,11127,SK,AT
134630,1699388160,1699404300,16140,102908,17768,SE,SE
163915,1700563500,1700593080,29580,1794,179949,TR,TR
123007,1698805800,1698812340,6540,11072,74326,GB,GB
101383,1700592360,1700610060,17700,20226,162527,US,US
127150,1699680060,1699692120,12060,195471,67228,US,US
63880,1699215900,1699247820,31920,2182,43942,TR,TR
143483,1699039020,1699049760,10740,2431,144256,IT,IT
13604,1699908900,1699943340,34440,143774,130911,TR,TR
33778,1699579920,1699615020,35100,64708,98202,MX,US
129815,1700365560,1700395980,30420,97422,189096,TR,TR
114286,1698995340,1698999720,4380,158418,153674,NL,NL
181852,1698821520,1698834960,13440,88989,135980,IT,IT
7287,1700618520,1700649420,30900,90971,163004,TR,TR
138989,1699833120,1699859160,26040,64463,10908,DE,DE
188995,1700297520,1700352960,55440,168524,143973,BG,BG
30350,1699911420,1699936320,24900,161299,53627,DE,FR
161872,1700623440,1700648400,24960,98543,1182,RO,RO
23270,1700354940,1700389080,34140,172510,3630,MX,MX
60784,1700422680,1700451480,28800,143231,100664,TR,TR
34075,1698841020,1698844620,3600,28936,171932,NL,NL
183602,1699061040,1699095540,34500,187576,38046,TR,TR
13214,1700226840,1700260320,33480,157493,116694,TR,TR
57464,1699978920,1699994460,15540,174659,88934,SE,DE
15328,1699807200,1699818420,11220,142491,77873,US,US
120680,1700327220,1700336040,8820,21190,179967,ES,ES
34326,1700432820,1700443800,10980,3724,98401,US,US
97170,1698955980,1698968280,12300,195991,111237,US,US
142969,1700421420,1700445780,24360,9795,197767,DK,SE
163418,1700543580,1700547180,3600,139523,191003,GB,GB
98849,1699603800,1699617000,13200,27229,152243,US,MX
156243,1699663560,1699667160,3600,35213,82162,GB,GB
152283,1699348560,1699382040,33480,154148,115272,TR,TR
39704,1699572000,1699586460,14460,189597,18665,CZ,CZ
195895,1699838640,1699868580,29940,143090,30482,TR,TR
41461,1699558140,1699587300,29160,87930,189839,BA,HR
176133,1698979500,1699014060,34560,48826,51989,TR,TR
158851,1700173200,1700188260,15060,15082,127778,FR,FR
17622,1700096820,1700100420,3600,19229,196999,GB,GB
30824,1700726580,1700730180,3600,75407,124149,GB,GB
157947,1700448180,1700466420,18240,135356,61271,FR,FR
162218,1699305720,1699323060,17340,40737,18158,US,US
128509,1699671900,1699705680,33780,69558,186125,TR,TR
112094,1699550520,1699563360,12840,185605,20044,IT,IT
98907,1700288520,1700297280,8760,171515,157905,PT,PT
30222,1699696920,1699728660,31740,4943,36264,TR,TR
489,1699822980,1699826580,3600,173332,163463,NL,NL
99013,1699217100,1699250340,33240,75948,96185,TR,TR
68896,1700268180,1700297820,29640,123380,132121,TR,TR
78712,1700411160,1700414760,3600,34189,146412,GB,GB
20062,1700331960,1700346660,14700,81361,164927,FR,FR
102717,1699622220,1699653360,31140,33500,19994,TR,TR
91800,1699422000,1699438560,16560,127489,175670,SE,RO
77926,1700339640,1700375400,35760,28429,31506,TR,TR
128459,1699280700,1699313820,33120,33124,7896,TR,TR
691,1700155500,1700171580,16080,16156,179058,US,US
50716,1699505640,1699514160,8520,195432,39040,AD,ES
114995,1699124880,1699158840,33960,53865,11596,TR,TR
29318,1699351260,1699373820,22560,24549,198817,HU,FR
46223,1700178180,1700191020,12840,59823,62473,US,US
116575,1698956940,1698972720,15780,180611,130460,RS,RS
124795,1699358760,1699362360,3600,113688,168598,NL,NL
158747,1699461540,1699466760,5220,21027,187339,NL,NL
114140,1698798840,1698831720,32880,160701,56985,TR,TR
160223,1700007900,1700027160,19260,4606,79905,SE,RO
92794,1700657880,1700670480,12600,38200,108117,ES,ES
41532,1699349100,1699384260,35160,157312,144566,TR,TR
144109,1699908180,1699931160,22980,153067,150046,SI,RS
113342,1700111580,1700145660,34080,29068,158200,TR,TR
199874,1699447380,1699454580,7200,20742,41685,IT,DE
92105,1699490340,1699505160,14820,55366,175641,US,US
41294,1698863100,1698866700,3600,65542,25782,NL,NL
15914,1699686720,1699717500,30780,77344,186284,TR,TR
192744,1699968480,1699980540,12060,168831,67010,IT,IT
61031,1700545920,1700549520,3600,198243,54342,GB,GB
149048,1699525980,1699537080,11100,133779,137438,US,US
84259,1700542920,1700571840,28920,23993,11490,TR,TR
26393,1699290600,1699320420,29820,109321,117336,TR,TR
109860,1699298940,1699332720,33780,82701,76288,TR,TR
172667,1699705800,1699716900,11100,37836,18986,IT,IT
47050,1700610960,1700642460,31500,144223,52755,TR,TR
119124,1700017620,1700046540,28920,85182,168597,TR,TR
69633,1699917780,1699951740,33960,170403,160847,MX,MX
84513,1699913640,1699947120,33480,105032,145516,TR,TR
143076,1698950100,1698980400,30300,132533,51431,TR,TR
68134,1698997500,1699011360,13860,107082,134457,IT,HR
155986,1698983460,1698994920,11460,183739,17252,IT,IT
47105,1699780080,1699783680,3600,9944,7987,GB,GB
160813,1699317840,1699346220,28380,91774,29457,DE,CZ
127674,1700287800,1700296260,8460,171906,121819,IT,IT
99663,1699868340,1699877460,9120,149070,50965,HR,HR
192379,1700318940,1700352660,33720,2404,51071,TR,TR
35105,1699247220,1699250820,3600,180243,102460,GB,GB
87445,1699884120,1699897980,13860,28241,126974,IT,IT
13571,1700355780,1700371740,15960,25747,37815,US,US
112389,1700739540,1700755560,16020,188229,122875,US,US
89397,1700026380,1700058540,32160,168040,162886,TR,TR
85590,1700057400,1700071440,14040,195013,83603,AT,AT
2383,1699256280,1699260540,4260,175335,90254,GB,GB
193877,1699156080,1699165860,9780,62121,187920,PT,PT
166904,1699409460,1699439220,29760,185528,147596,TR,TR
148145,1699751640,1699785720,34080,78491,84626,MX,MX
2276,1700831220,1700861040,29820,77393,60292,TR,TR
20653,1699064880,1699078440,13560,121982,28898,US,US
179648,1699938840,1699973160,34320,163547,134707,TR,TR
66571,1700007480,1700041380,33900,130691,61715,TR,TR
186624,1698830220,1698841380,11160,139612,171360,US,US
28585,1700401020,1700414340,13320,95233,21209,IT,IT
60526,1700210700,1700235840,25140,189590,78902,DE,CZ
154083,1699124340,1699157280,32940,52684,22598,TR,TR
95777,1699587600,1699598580,10980,67348,19551,CZ,DE
115560,1700761680,1700796000,34320,133495,34543,TR,TR
197650,1699780740,1699811760,31020,172496,47181,TR,TR
110464,1699091100,1699105500,14400,29545,158771,AT,NL
153177,1699043520,1699059900,16380,58940,196039,BE,FR
115082,1699091580,1699130160,38580,64890,95339,MX,MX
27570,1699569420,1699600860,31440,135769,140138,TR,TR
35255,1700089800,1700100660,10860,12297,109672,US,US
43165,1699229280,1699265040,35760,48421,192924,TR,TR
6862,1700510940,1700522760,11820,124141,4961,IT,IT
66076,1700526900,1700530500,3600,9955,40465,GB,GB
136126,1699011780,1699046220,34440,189063,29102,TR,TR
136670,1699253400,1699261740,8340,16788,23890,IT,IT
32209,1699749720,1699779780,30060,120865,179906,TR,TR
3042,1699065780,1699077120,11340,68819,77852,US,US
137202,1699680480,1699709880,29400,184009,6438,TR,TR
193667,1700852700,1700856300,3600,42547,61873,NL,NL
36556,1699521600,1699554420,32820,23811,18233,TR,TR
115773,1700607960,1700631660,23700,161272,195715,ME,BA
128536,1699392240,1699423740,31500,131246,189523,TR,TR
153620,1700681820,1700688180,6360,187112,163824,GB,GB
40267,1700711100,1700714700,3600,35266,20824,NL,NL
93799,1699752300,1699759860,7560,618,105222,IT,IT
10418,1700710140,1700724420,14280,42178,29883,RS,RS
93620,1700843100,1700848140,5040,150023,168548,GB,GB
82832,1700822760,1700855340,32580,195113,131672,TR,TR
23440,1699172520,1699205280,32760,144176,177416,TR,TR
97693,1700812140,1700846760,34620,131492,110169,TR,TR
112971,1700081280,1700113200,31920,24785,130033,TR,TR
144480,1699055820,1699090620,34800,50798,70626,TR,TR
161014,1700695620,1700726220,30600,170840,96323,TR,TR
86716,1699909140,1699940580,31440,174989,168501,TR,TR
157357,1699022580,1699053060,30480,147964,135605,TR,TR
33953,1698859860,1698876900,17040,116091,51868,US,US
125571,1700647740,1700661660,13920,50615,100204,HR,PL
195378,1699634880,1699688160,53280,197194,136939,BG,BG
185797,1700063820,1700086920,23100,85413,92518,DE,BA
66107,1699566660,1699570260,3600,70126,139020,GB,GB
67846,1699973940,1699978080,4140,174939,197587,NL,NL
131383,1699675620,1699687200,11580,164378,135368,US,US
127436,1699681020,1699695060,14040,138042,98141,RS,RS
36992,1699620660,1699627200,6540,34176,58148,GB,GB
80399,1699320360,1699334040,13680,196842,193936,US,US
55959,1700473800,1700492340,18540,58165,81808,BE,NL
76724,1699121220,1699134480,13260,90165,82907,US,US
172436,1700805840,1700838780,32940,127681,9322,TR,TR
82940,1699637940,1699654680,16740,169645,82080,US,MX
32397,1700231100,1700238780,7680,120629,15251,IT,IT
55163,1699338360,1699373760,35400,10203,98832,TR,TR
121242,1699833480,1699866480,33000,90383,67548,TR,TR
152631,1699137060,1699146000,8940,69246,189558,IT,IT
166792,1700053500,1700065200,11700,184739,19781,PT,PT
38465,1700418960,1700454120,35160,116445,89399,TR,TR
41388,1700699940,1700730420,30480,52605,57314,TR,TR
88105,1700848680,1700874840,26160,183378,124712,DE,PL
68868,1700698260,1700717040,18780,171780,48321,SI,RS
138082,1698863520,1698895260,31740,18151,118867,TR,TR
26019,1700769540,1700776020,6480,129770,109119,NL,BE
96449,1700151480,1700185860,34380,72648,20619,TR,TR
40031,1699530360,1699557240,26880,23116,40367,DE,BA
95102,1698934800,1698964560,29760,57294,79109,TR,TR
119689,1700510580,1700539980,29400,113290,85813,TR,TR
197722,1699471920,1699504320,32400,108822,29262,TR,TR
198023,1698886740,1698915600,28860,45910,195293,TR,TR
69883,1700836080,1700864820,28740,31312,49677,DE,DE
131172,1700140860,1700176620,35760,39767,57745,TR,TR
60065,1700047500,1700082000,34500,130209,164188,TR,TR
41603,1699713360,1699716960,3600,75970,197231,GB,GB
196451,1699418940,1699425840,6900,39900,91909,EE,EE
168572,1700126400,1700130000,3600,101682,95362,NL,NL
70922,1699986720,1700020980,34260,35018,106835,TR,TR
174294,1699167060,1699179900,12840,144509,33975,IT,IT
96983,1698836160,1698872160,36000,61422,139188,MX,MX
6631,1699552860,1699577520,24660,182493,39588,DK,DK
138376,1700673720,1700691240,17520,155204,161451,US,US
37653,1700449440,1700458980,9540,100753,184999,PT,PT
100757,1698817020,1698852180,35160,105753,68438,TR,TR
126746,1699295880,1699309680,13800,13492,151020,US,US
39955,1699150860,1699184040,33180,171056,2081,MX,MX
36481,1700814120,1700846220,32100,43055,42743,TR,TR
155334,1699442280,1699453740,11460,187445,84105,US,US
88857,1700618820,1700628540,9720,31802,25097,HR,HR
134227,1700097240,1700100840,3600,7955,88299,GB,GB
155331,1700171280,1700200380,29100,20494,90061,TR,TR
138398,1700049120,1700065200,16080,114458,164472,US,US
76997,1699480680,1699512840,32160,102654,56745,TR,TR
83288,1699710000,1699729380,19380,199403,192139,FR,NL
713,1700473560,1700477700,4140,187708,152767,EE,EE
87746,1699700640,1699714140,13500,13494,32933,IT,IT
49010,1700154600,1700186940,32340,189782,170125,TR,TR
5302,1699392960,1699402680,9720,93301,142318,PT,PT
193672,1698856800,1698861480,4680,12770,190111,GB,GB
72122,1698875820,1698905820,30000,152631,35812,TR,TR
85349,1700696820,1700719080,22260,4178,122395,BR,BR
123124,1700775060,1700805780,30720,79763,74394,TR,TR
3515,1700848200,1700870520,22320,199468,55261,DE,UA
54380,1700099460,1700135700,36240,31685,158634,MX,MX
108294,1700635740,1700639340,3600,89132,198403,GB,GB
99358,1700086260,1700120280,34020,156377,109376,TR,TR
52794,1699065360,1699095600,30240,46707,98273,TR,TR
166064,1699302720,1699306320,3600,183255,134255,GB,GB
51140,1700824980,1700839380,14400,33663,47817,FR,CH
156884,1699788060,1699803060,15000,74528,157568,AT,HR
187409,1700293440,1700297040,3600,184466,171628,GB,GB
53792,1700535300,1700538900,3600,17676,11009,GB,GB
115611,1699477620,1699492020,14400,161776,176225,US,US
70333,1699903500,1699916700,13200,51498,192101,IT,IT
70467,1699948680,1699972740,24060,61967,80219,PL,PL
116177,1699052280,1699068720,16440,143061,103801,RS,DE
179979,1699348320,1699378980,30660,16070,121380,TR,TR
75754,1700191680,1700208360,16680,80205,50505,US,US
152867,1699183500,1699197780,14280,89859,112275,AT,DE
94980,1700640600,1700657160,16560,46371,118997,RS,ME
14627,1699547880,1699580400,32520,32685,87577,TR,TR
71972,1699972560,1700002500,29940,143924,147658,TR,TR
110355,1699846860,1699858020,11160,113009,167303,US,US
111868,1700166660,1700188740,22080,2858,102804,DK,DK
34482,1700743260,1700750460,7200,31538,145093,PT,PT
57411,1700747520,1700757180,9660,41658,36705,ES,FR
179837,1699674600,1699705560,30960,144651,184269,TR,TR
45190,1699304880,1699320120,15240,156291,147385,US,CA
22072,1700356080,1700386380,30300,102260,176893,TR,TR
17607,1698793560,1698821400,27840,69426,139612,BR,BR
167479,1698844980,1698848580,3600,130759,44657,GB,GB
57966,1699094280,1699110960,16680,98717,50569,US,US
24102,1699449420,1699483500,34080,70548,99111,TR,TR
131679,1700147580,1700174820,27240,96060,198650,RO,RO
43741,1698895200,1698927600,32400,158719,43483,TR,TR
41134,1699408620,1699414080,5460,90086,147716,GB,GB
124489,1699455780,1699469760,13980,192974,65683,IT,IT
107853,1699333920,1699337520,3600,186013,35469,NL,NL
72287,1699859280,1699888140,28860,24234,32852,TR,TR
92592,1700209800,1700213400,3600,161444,21256,GB,GB
11233,1700009340,1700039280,29940,77442,33400,TR,TR
100466,1698794880,1698800460,5580,142148,99506,GB,GB
157520,1699357080,1699390740,33660,129913,23371,TR,TR
149967,1700571360,1700574960,3600,179954,51617,GB,GB
187980,1699542420,1699572420,30000,64705,176133,TR,TR
3793,1700698260,1700711460,13200,60241,194216,US,US
33729,1699019400,1699031100,11700,124761,110094,PT,PT
141421,1699744080,1699751520,7440,21273,77161,IT,IT
187789,1700790300,1700804640,14340,190791,127235,PT,PT
169472,1699450380,1699466160,15780,93453,138734,US,US
62527,1700322960,1700334180,11220,59675,199471,US,US
18708,1699819380,1699822980,3600,162005,45809,GB,GB
31287,1700632980,1700648100,15120,58012,65141,US,US
126107,1700866500,1700880420,13920,97535,165404,IT,IT
180087,1699217220,1699254600,37380,171380,189531,MX,MX
176954,1699855500,1699865040,9540,32318,22672,HR,HR
76947,1700232480,1700244180,11700,47327,88221,US,US
46042,1699155000,1699176780,21780,98990,105097,DE,SK
146321,1700534460,1700539320,4860,111165,120733,NL,NL
65820,1700632980,1700636820,3840,27079,179009,NL,NL
198032,1699856340,1699887120,30780,158649,92648,TR,TR
93567,1700414520,1700443020,28500,199351,8925,DE,DE
113994,1700693280,1700726580,33300,113617,167314,TR,TR
51564,1699143840,1699169460,25620,53208,121886,PL,PL
147442,1699605540,1699614420,8880,87198,71974,IT,IT
197025,1700079060,1700093040,13980,187805,17945,RS,RS
166913,1700504160,1700516040,11880,171730,118398,IT,IT
110016,1700156460,1700180340,23880,149594,13329,DK,BE
149835,1699360020,1699365120,5100,167527,59174,GB,GB
68168,1700470680,1700476320,5640,91402,172021,GB,GB
89372,1699003500,1699010220,6720,95201,115298,GB,GB
192832,1699859460,1699877100,17640,41159,60452,CZ,CZ
144946,1699675740,1699679340,3600,103643,95475,GB,GB
14837,1699820160,1699855080,34920,45051,20866,TR,TR
150898,1700008680,1700012280,3600,140950,193732,GB,GB
21642,1698941040,1698970320,29280,3072,98356,TR,TR
12192,1699167360,1699202100,34740,5062,98872,TR,TR
184269,1699759920,1699790940,31020,68590,100263,TR,TR
23616,1699699080,1699702680,3600,170739,60101,NL,NL
183010,1699066980,1699079280,12300,23479,47007,PT,PT
199059,1698860580,1698877440,16860,138765,187813,US,US
163845,1699045560,1699059060,13500,193107,128104,US,US
66462,1699944000,1699978980,34980,16345,9614,TR,TR
36107,1698882600,1698915780,33180,13630,148573,TR,TR
22168,1699421760,1699435140,13380,160580,93100,IT,IT
3970,1699793820,1699806660,12840,113722,164332,ES,ES
15891,1700045700,1700065140,19440,115048,199510,SE,SE
10551,1700141820,1700170680,28860,192398,11817,TR,TR
45759,1699106160,1699109760,3600,72572,197065,GB,GB
58647,1700218200,1700234760,16560,67939,37126,US,CA
189980,1700548440,1700552040,3600,199239,196734,NL,NL
132484,1699814340,1699818480,4140,110955,81017,GB,GB
94486,1698912360,1698936780,24420,166668,80394,HU,HR
198278,1699985640,1700004480,18840,19688,88481,DK,DE
151399,1699365840,1699401960,36120,62621,103385,MX,US
169110,1700355300,1700367060,11760,118546,93451,AT,LV
110913,1699224540,1699263420,38880,61421,183662,LV,PL
43882,1699521720,1699556460,34740,142015,153918,TR,TR
145527,1699899540,1699931460,31920,191954,104763,TR,TR
123367,1699617720,1699622940,5220,158593,11715,AD,FR
151686,1699373040,1699381380,8340,132632,342,HR,HR
88919,1699237380,1699240980,3600,165752,10933,GB,GB
163483,1700102820,1700114640,11820,130918,165695,SK,SK
186474,1699549980,1699582620,32640,67735,67059,TR,TR
9190,1698841080,1698856500,15420,188106,132699,US,US
83056,1699207140,1699238640,31500,72650,13775,TR,TR
50665,1700841720,1700867040,25320,130679,129601,DE,DE
27653,1699081560,1699085160,3600,114598,149180,NL,NL
160925,1700770140,1700781720,11580,165968,165479,US,US
108054,1699053960,1699057560,3600,4264,37494,NL,NL
43592,1700158740,1700170860,12120,193868,95190,US,US
25956,1700006640,1700021940,15300,99102,64554,FR,IT
146534,1700527140,1700534280,7140,141692,176026,GB,GB
47026,1699729440,1699760100,30660,139686,100544,TR,TR
20845,1699153800,1699188540,34740,156140,169624,TR,TR
16262,1699386060,1699399440,13380,152623,72047,IT,IT
82922,1700080380,1700091600,11220,100500,160894,HR,HR
112227,1699211460,1699227420,15960,73251,30011,US,US
86319,1700797560,1700832120,34560,137864,49877,TR,TR
64976,1700120220,1700136240,16020,28026,153831,US,US
112358,1700537160,1700570160,33000,76014,5182,TR,TR
184113,1698948900,1698956160,7260,156666,72204,PT,PT
154240,1700196300,1700199900,3600,51458,88763,GB,GB
189283,1699007580,1699012020,4440,95139,59755,GB,GB
127953,1700791380,1700806320,14940,137614,6894,US,MX
193986,1699320360,1699354200,33840,33070,154804,TR,TR
181618,1698856800,1698888060,31260,26051,147178,TR,TR
53850,1700601540,1700605140,3600,108434,35370,GB,GB
44154,1700811480,1700828580,17100,76972,45847,US,US
165606,1699266780,1699277700,10920,96306,123280,IT,IT
26831,1699028460,1699061340,32880,63115,77377,TR,TR
139610,1699369560,1699377720,8160,186517,69322,IT,IT
86587,1699545120,1699551240,6120,153809,30612,NL,NL
102483,1699767000,1699798920,31920,35354,6826,TR,TR
33415,1699715040,1699718640,3600,46309,146313,GB,GB
106341,1700731320,1700763960,32640,141245,115332,MX,US
101622,1699936380,1699944180,7800,57683,95885,ES,ES
113572,1700308500,1700331720,23220,3980,53371,PL,PL
54667,1699777320,1699792740,15420,197891,6832,CZ,UA
28246,1700837940,1700841840,3900,158939,187501,GB,GB
48017,1699835160,1699849980,14820,182628,76003,CZ,CZ
194437,1700080200,1700090940,10740,64297,162229,IT,IT
41570,1700151300,1700169240,17940,119152,84252,US,MX
180514,1699679520,1699694580,15060,115224,144640,US,US
157753,1699152120,1699156920,4800,195352,111437,GB,GB
171456,1698923160,1698961980,38820,23201,163915,MX,MX
79932,1699914720,1699921740,7020,165252,19029,GB,GB
109251,1698821520,1698838620,17100,37280,62908,RS,RS
79879,1699571580,1699582020,10440,9049,191521,IT,IT
22426,1699328220,1699336260,8040,32135,39230,IT,IT
178657,1698952140,1698955740,3600,168310,106138,NL,NL
130655,1700726340,1700743440,17100,95926,114561,US,US
162951,1700714280,1700717880,3600,83632,77548,GB,GB
182724,1698853500,1698883980,30480,64809,47244,TR,TR
38865,1699029420,1699036980,7560,36547,178986,PT,PT
16522,1699868280,1699902660,34380,35130,122029,TR,TR
168490,1699538220,1699547280,9060,108658,69619,ES,ES
109983,1700468220,1700501340,33120,161211,96581,TR,TR
57762,1700398860,1700421600,22740,155804,71267,PL,DE
167037,1699329420,1699336980,7560,91405,67239,HR,RS
47259,1699921080,1699955760,34680,117247,88067,TR,TR
145611,1699995960,1700011260,15300,18558,13263,FR,NL
116941,1699678260,1699687500,9240,22377,104701,CL,CL
80490,1700029980,1700063460,33480,151068,93049,TR,TR
664,1700541960,1700561640,19680,79175,155521,SE,SE
177724,1700207520,1700221140,13620,41772,189986,US,US
180119,1700091720,1700099460,7740,152048,192471,EE,EE
131149,1699799160,1699831680,32520,164379,89694,TR,TR
173741,1699244160,1699274760,30600,6611,96137,TR,TR
38425,1699218960,1699226460,7500,73188,84515,PT,PT
94376,1699920120,1699954680,34560,40840,21139,TR,TR
1248,1699096380,1699118520,22140,20296,45275,HU,FR
154072,1699390980,1699404180,13200,6526,30510,US,US
159576,1699055580,1699059180,3600,145117,177010,NL,NL
26978,1698862740,1698897060,34320,132687,84961,TR,TR
17268,1700504520,1700538900,34380,51276,141706,MX,US
86384,1700228460,1700254500,26040,113514,122610,BA,HR
98445,1699378320,1699386420,8100,198098,74057,IT,IT
14790,1699857780,1699872780,15000,183893,112391,US,US
160497,1700648760,1700661840,13080,54443,124078,HR,HR
182291,1700781960,1700798760,16800,186710,191702,US,US
138204,1700690880,1700722440,31560,12431,1661,TR,TR
191242,1699110000,1699119420,9420,118160,192478,IT,IT
141071,1700664420,1700687820,23400,115599,123989,DE,DE
58102,1699901880,1699914960,13080,181003,7023,IT,IT
157958,1699045080,1699057620,12540,166484,143482,US,US
58677,1699659660,1699672380,12720,54448,185776,IT,IT
101041,1699558980,1699571280,12300,167452,8727,IT,IT
149100,1699641300,1699653780,12480,180711,66747,PT,PT
61485,1698985440,1698999900,14460,12385,159155,CZ,CZ
120149,1700345940,1700352180,6240,35345,103896,NL,NL
19669,1699829700,1699863960,34260,35278,194676,TR,TR
52260,1699186620,1699220640,34020,23345,82079,TR,TR
57965,1700085900,1700100600,14700,169255,141490,SE,SE
122444,1699765380,1699801140,35760,86296,198791,TR,TR
126098,1699021140,1699035840,14700,84510,121448,US,US
125362,1699800540,1699805940,5400,54814,10563,GB,GB
43283,1700340360,1700374860,34500,166679,65484,TR,TR
147776,1699796820,1699823880,27060,31573,195295,ME,HR
190993,1700242020,1700275800,33780,97451,124510,TR,TR
193574,1699264440,1699269180,4740,62937,65899,EE,EE
112408,1699689600,1699703100,13500,110063,89348,US,US
154843,1700243640,1700274720,31080,121036,181994,TR,TR
1445,1699595880,1699631520,35640,124264,97249,TR,TR
179655,1699614300,1699645440,31140,41559,189342,TR,TR
165436,1699449900,1699465080,15180,3531,191692,RS,RS
106421,1699999260,1700012460,13200,105926,173407,IT,IT
23855,1699154940,1699158540,3600,149437,99452,GB,GB
98109,1699847280,1699869660,22380,82634,18319,DE,FR
29053,1699230960,1699241160,10200,113130,132939,HR,HR
123785,1699222020,1699233780,11760,91120,90812,IT,IT
111672,1700103840,1700111580,7740,94222,29768,SK,AT
121154,1699300620,1699310340,9720,107700,71750,IT,IT
40417,1700513280,1700527380,14100,90804,157403,IT,IT
142320,1699804260,1699835040,30780,198309,103469,TR,TR
71049,1699412160,1699446540,34380,36316,81194,TR,TR
90324,1700765580,1700789940,24360,144753,66180,DE,IT
174562,1700675760,1700706300,30540,114449,34335,TR,TR
147630,1700090100,1700104020,13920,49692,146080,IT,IT
58442,1700789220,1700823180,33960,181035,197404,TR,TR
78333,1698996840,1699029960,33120,69129,48308,TR,TR
13427,1700173440,1700185020,11580,15255,38294,RS,RS
58265,1700753760,1700785200,31440,173456,177170,TR,TR
77502,1698827820,1698866580,38760,82406,48693,MX,MX
66613,1699091880,1699097580,5700,189475,133449,GB,GB
128101,1699248180,1699257780,9600,45558,124261,IT,IT
181126,1700092020,1700124480,32460,73284,138237,TR,TR
128753,1699254360,1699281240,26880,67358,65283,PL,PL
41097,1700465760,1700469360,3600,67284,163150,GB,GB
13115,1699355340,1699388460,33120,192978,121768,TR,TR
28328,1699312920,1699344540,31620,130001,164298,TR,TR
126124,1699608120,1699636980,28860,84611,176959,TR,TR
19664,1698796200,1698800940,4740,162855,177006,GB,GB
77210,1700857080,1700860680,3600,14708,68386,NL,NL
143914,1700826660,1700861520,34860,111840,75439,TR,TR
2273,1699717200,1699720800,3600,68032,36071,NL,NL
87667,1699549620,1699563660,14040,72007,67365,US,US
183894,1699949280,1699979460,30180,143368,112836,TR,TR
145081,1698831120,1698855540,24420,135277,177155,DE,AT
48821,1699823100,1699828380,5280,151194,171327,GB,GB
17744,1699091820,1699103760,11940,191944,35191,US,MX
27931,1699226820,1699258440,31620,41592,106913,TR,TR
195162,1699314480,1699344720,30240,93087,19424,TR,TR
35865,1698856080,1698867780,11700,81630,163642,US,US
230,1699142580,1699166700,24120,160851,7831,PL,PL
151041,1700188380,1700212200,23820,43247,183294,BR,BR
7047,1699132980,1699165980,33000,28505,143256,MX,MX
137146,1700158860,1700205420,46560,50522,49807,LU,IT
118054,1698813180,1698845100,31920,109284,139233,TR,TR
177145,1698950940,1698981960,31020,124170,56265,TR,TR
162543,1699384980,1699414800,29820,5842,37407,TR,TR
137480,1699259400,1699284480,25080,120468,138131,PL,PL
33862,1699906980,1699939860,32880,115643,132564,TR,TR
144182,1698968040,1698975120,7080,88828,154134,NL,LU
36884,1698894060,1698907680,13620,58760,13760,ES,ES
191438,1700121660,1700130960,9300,4826,169254,IT,IT
120716,1699736640,1699765260,28620,74907,15847,PL,FR
107504,1699598160,1699629480,31320,60863,151728,TR,TR
116589,1700564940,1700581740,16800,85271,143557,US,US
60743,1699409520,1699440300,30780,175806,28735,TR,TR
105825,1699685760,1699719540,33780,155987,10121,MX,MX
5499,1700044200,1700058240,14040,14498,88150,IT,IT
113301,1700463420,1700467020,3600,67206,43350,NL,FR
19743,1700283300,1700317200,33900,143051,171506,TR,TR
192666,1700620860,1700629980,9120,337,6724,IT,IT
127303,1699289280,1699306440,17160,64821,51179,FR,IT
158371,1699615200,1699641180,25980,197563,25794,DE,DE
168703,1699262340,1699265940,3600,89825,159785,GB,GB
107819,1699663980,1699672320,8340,177989,135074,SK,SK
11081,1700594100,1700606760,12660,34708,175704,ES,ES
15087,1700584500,1700591880,7380,95837,144908,PT,PT
8304,1699903620,1699921800,18180,152622,21496,FR,FR
186596,1699004220,1699028700,24480,17323,63994,DE,IT
26283,1700060580,1700092980,32400,18205,5790,TR,TR
82454,1700227860,1700242200,14340,151009,131938,US,US
190158,1699190880,1699203000,12120,49853,86479,IT,IT
150801,1698849540,1698853140,3600,54704,164774,GB,GB
36540,1699514700,1699520340,5640,177831,170506,NL,NL
48541,1700134860,1700167920,33060,136312,92760,TR,TR
195969,1698870420,1698875400,4980,87537,144001,GB,GB
30914,1700374800,1700389200,14400,188481,155068,AT,AT
75879,1700826960,1700844120,17160,143927,44902,US,US
125913,1699187820,1699197780,9960,144691,121128,IT,IT
182913,1699686660,1699720080,33420,79226,158703,TR,TR
67720,1700296560,1700318880,22320,147959,105943,BR,BR
198955,1699774440,1699796640,22200,71933,35833,PL,NL
130263,1700788680,1700792280,3600,45260,73123,GB,DE
77497,1700222700,1700257140,34440,61068,134531,TR,TR
142133,1700617620,1700670660,53040,65373,87342,BG,DE
91336,1699259400,1699271340,11940,193994,63613,IT,IT
53277,1700236260,1700265480,29220,35906,18943,TR,TR
132144,1700710860,1700744580,33720,16189,175122,TR,TR
170911,1699879560,1699908720,29160,183266,125536,TR,TR
184405,1699637880,1699671720,33840,174607,23476,TR,TR
85555,1699998120,1700030100,31980,145700,112677,TR,TR
12346,1700172060,1700200560,28500,188861,155126,DE,DE
27013,1700557440,1700561040,3600,110131,64972,NL,NL
141347,1700230860,1700261220,30360,180063,28309,TR,TR
44486,1700294760,1700306460,11700,166360,146743,AT,AT
43863,1699946520,1699978740,32220,108718,111705,TR,TR
103660,1700467620,1700481900,14280,70061,185290,IT,IT
179533,1699527600,1699534620,7020,165565,131274,GB,GB
114675,1699547940,1699551540,3600,9752,122770,NL,NL
166115,1699393140,1699407480,14340,11758,159260,HR,HR
137668,1699435620,1699445280,9660,28064,9121,IT,IT
90077,1700781180,1700816460,35280,81517,15851,TR,TR
148915,1700458620,1700493780,35160,143222,119858,TR,TR
94957,1699609500,1699662720,53220,84657,87904,BG,DE
15915,1700645040,1700675520,30480,46420,1832,TR,TR
1311,1700101740,1700127900,26160,79149,147903,BR,BR
119130,1700475600,1700491440,15840,189722,146949,CZ,PL
70342,1700366580,1700399040,32460,154079,195891,TR,TR
4408,1699514940,1699527060,12120,127271,36023,US,US
43522,1699582140,1699613220,31080,163289,117575,TR,TR
193163,1699265220,1699297020,31800,184529,54299,TR,TR
144987,1700175000,1700208300,33300,35886,131493,TR,TR
28903,1699268040,1699297320,29280,195177,52146,TR,TR
94173,1700730780,1700737800,7020,15343,152064,GB,GB
59353,1700786580,1700790180,3600,41002,136356,GB,GB
6472,1700354760,1700385000,30240,79872,18255,TR,TR
11484,1700603760,1700611200,7440,65378,75857,PT,PT
131394,1699377060,1699393140,16080,14295,191306,US,CA
99652,1700815380,1700849280,33900,58405,126868,TR,TR
41619,1700805360,1700809260,3900,2145,12042,GB,GB
115051,1700816160,1700824920,8760,63694,103622,IT,IT
133077,1699941480,1699954500,13020,82287,135899,IT,IT
19080,1700611860,1700642820,30960,90819,55516,TR,TR
50815,1700629260,1700657640,28380,128721,76543,DE,FR
70264,1700013780,1700023200,9420,108696,99959,IT,IT
188255,1699586160,1699616400,30240,99294,28959,TR,TR
59672,1699520400,1699524120,3720,28522,75681,GB,GB
198076,1700576400,1700609280,32880,6723,17253,TR,TR
151919,1698842940,1698878400,35460,165666,167216,TR,TR
78793,1699419480,1699450440,30960,179409,120418,TR,TR
84323,1700181660,1700199240,17580,56304,150062,RS,RS
109480,1700180820,1700194560,13740,92449,121456,IT,IT
105304,1700838180,1700870400,32220,67228,9189,TR,TR
186694,1698829920,1698862080,32160,40977,137663,TR,TR
34080,1698947460,1698979200,31740,68074,19086,TR,TR
175748,1700241420,1700249820,8400,191778,157530,IT,IT
11414,1700492580,1700503260,10680,12785,167636,IT,DE
138674,1699800540,1699811460,10920,182603,20467,HR,HR
85961,1699375320,1699388640,13320,45702,136050,US,US
194679,1699970940,1699979820,8880,64246,72689,IT,IT
116237,1699586580,1699610520,23940,139599,45179,PL,PL
156605,1699881420,1699905540,24120,143320,190637,ME,RS
123994,1699634520,1699668180,33660,190943,126080,TR,TR
98123,1700156220,1700163720,7500,166111,195058,PT,FR
59174,1700610900,1700623320,12420,31097,191084,US,US
104543,1700371200,1700382720,11520,135523,172841,SK,AT
152762,1698928020,1698959280,31260,198324,141892,TR,TR
122446,1698886920,1698915780,28860,114971,12073,TR,TR
5200,1700709060,1700734080,25020,4929,138426,BR,BR
55174,1700556240,1700563380,7140,177669,182205,GB,GB
182803,1700741580,1700758380,16800,54486,1088,FR,DE
104190,1699356600,1699370940,14340,95948,153513,US,US
190779,1700354880,1700386200,31320,180055,41452,TR,TR
59225,1699003200,1699033380,30180,58474,152993,TR,TR
156037,1699176780,1699212300,35520,10770,82816,TR,TR
135719,1699799280,1699830720,31440,93566,97640,TR,TR
145132,1699930320,1699949640,19320,134581,135719,FR,FR
36947,1699994760,1699998360,3600,136391,55742,GB,GB
158997,1700045100,1700077680,32580,48839,112293,TR,TR
181793,1700802660,1700810940,8280,168215,199605,PT,PT
10503,1700612760,1700617440,4680,198288,5621,GB,GB
189460,1700673660,1700703480,29820,36795,116322,TR,TR
51873,1700658780,1700694300,35520,144901,38687,TR,TR
93687,1700692200,1700709120,16920,84753,142820,SE,SE
122301,1700258760,1700293320,34560,43295,95877,TR,TR
179609,1700275860,1700287320,11460,192350,88484,IT,IT
80314,1700157420,1700184120,26700,89896,98288,PL,FR
171202,1700165220,1700195880,30660,78896,156443,TR,TR
98295,1699468260,1699477080,8820,133661,48083,HR,HR
39977,1700395980,1700399880,3900,17236,110560,GB,GB
14011,1698934440,1698948360,13920,143331,21526,IT,IT
197057,1700272740,1700302680,29940,132091,171334,TR,TR
124699,1700556480,1700590680,34200,181713,31973,TR,TR
106410,1699009500,1699015500,6000,184386,59563,NL,NL
188448,1700740740,1700753580,12840,131742,73980,IT,IT
189200,1700199840,1700231580,31740,154022,195788,TR,TR
118927,1700233440,1700240280,6840,143099,89890,AD,ES
184473,1699342380,1699378320,35940,169345,107123,TR,TR
92371,1699679220,1699708620,29400,90073,35078,TR,TR
152584,1700601180,1700617320,16140,103237,78803,US,US
45798,1699774560,1699791900,17340,68012,108672,US,CA
163782,1699665660,1699683420,17760,154375,61252,CZ,CZ
109137,1700451780,1700455380,3600,156004,29523,GB,GB
21031,1700121600,1700125200,3600,28571,95570,GB,GB
60438,1700427840,1700441640,13800,112348,148655,HR,HR
121939,1699986900,1700004180,17280,2864,133966,AT,AT
22390,1700092140,1700125200,33060,129844,14821,TR,TR
157142,1700496540,1700530260,33720,196417,109775,TR,TR
35308,1700710920,1700738100,27180,138053,24205,BA,HR
95913,1700741280,1700771340,30060,109895,9021,TR,TR
161191,1700564400,1700579940,15540,108179,137487,US,US
79642,1699518660,1699553040,34380,193644,186391,MX,MX
144337,1700073840,1700080740,6900,127077,28724,GB,GB
29055,1699211940,1699225740,13800,122641,154219,US,US
44516,1699270620,1699284000,13380,27400,97858,CA,CA
132441,1698936780,1698947940,11160,7319,23760,US,US
62114,1700315160,1700321460,6300,87919,182230,NL,BE
10586,1700414100,1700432700,18600,35485,43787,BE,NL
143921,1700551740,1700562600,10860,43504,127908,IT,IT
76035,1699174980,1699178580,3600,191676,112179,NL,NL
115430,1700234460,1700266560,32100,53159,41303,TR,TR
47017,1699216380,1699220340,3960,49537,2552,GB,GB
77191,1700571540,1700585040,13500,26697,150865,HR,HR
180318,1700013480,1700017260,3780,140651,130928,GB,GB
36966,1699080180,1699110600,30420,112881,69716,TR,TR
5027,1700737440,1700741040,3600,98895,154724,GB,GB
172598,1699156560,1699172220,15660,189193,164271,BE,NL
196088,1700676960,1700712900,35940,38791,140103,MX,MX
32878,1700112360,1700140860,28500,102070,114363,PL,PL
24139,1700766480,1700778060,11580,125137,72298,US,US
138198,1699376220,1699407120,30900,167092,15394,TR,TR
150740,1700494320,1700528820,34500,76191,85085,TR,TR
150904,1699866360,1699882080,15720,114353,89049,US,US
123539,1700328660,1700357760,29100,88358,147498,TR,TR
69892,1699805100,1699808700,3600,177079,153061,GB,GB
137180,1700067660,1700071260,3600,116064,29402,NL,FR
186967,1699996080,1700007000,10920,97912,135791,US,US
61294,1699254000,1699267020,13020,115458,35718,US,US
137239,1698967080,1698991440,24360,147826,186380,PL,PL
11954,1700773740,1700790360,16620,188524,64907,RS,SI
155266,1699256280,1699259880,3600,65230,178026,GB,GB
130685,1699574340,1699607820,33480,40979,111609,TR,TR
188520,1700004060,1700007660,3600,120074,178274,NL,NL
185587,1699213320,1699220760,7440,8970,107797,IT,IT
175056,1700565060,1700570700,5640,134720,31206,GB,GB
13589,1700130420,1700162460,32040,95224,182319,TR,TR
30865,1699692660,1699702020,9360,102097,159317,IT,IT
112669,1700659440,1700689680,30240,154760,87659,TR,TR
192768,1699843740,1699858620,14880,86986,179794,US,US
4514,1699444200,1699456200,12000,103618,127266,HR,HR
199627,1699699380,1699704780,5400,150338,87043,NL,NL
27247,1699370580,1699405860,35280,31063,105193,TR,TR
80299,1699399020,1699421100,22080,159493,94474,DE,DE
110331,1699302360,1699333200,30840,92532,35500,BA,HR
63313,1699243260,1699255260,12000,35653,35003,AT,AT
775,1698995580,1699026180,30600,192884,184615,TR,TR
36124,1700710500,1700716080,5580,131539,7902,NL,NL
9609,1698952560,1698974460,21900,176313,135516,DE,DE
178539,1700572560,1700585100,12540,21451,97114,IT,IT
23134,1700286060,1700316240,30180,31783,31319,TR,TR
150872,1699833960,1699849320,15360,40193,17701,BE,FR
127345,1699520400,1699524000,3600,125116,82597,GB,GB
74024,1700526780,1700561640,34860,98136,127145,TR,TR
125296,1700142000,1700175180,33180,61633,121037,TR,TR
161973,1699065720,1699095180,29460,41672,126507,TR,TR
72298,1700266020,1700297820,31800,153900,13581,TR,TR
17127,1700654040,1700664600,10560,44281,67242,HR,HR
152020,1700129580,1700133180,3600,33321,94136,GB,GB
6214,1699794720,1699803960,9240,63183,97358,IT,IT
4392,1699281540,1699317960,36420,148744,129606,MX,MX
91470,1699848780,1699877700,28920,152991,149024,TR,TR
108684,1699076400,1699085640,9240,92234,178627,AD,ES
34627,1699956960,1699960560,3600,75768,55101,NL,NL
176124,1699548060,1699551660,3600,99850,195824,GB,GB
67827,1699885500,1699909920,24420,48783,154907,DK,DK
95129,1700733600,1700755860,22260,192257,143669,SI,RS
39395,1699592340,1699601340,9000,132921,32083,EE,EE
101627,1700019000,1700044680,25680,174358,42245,BA,HR
99446,1699762080,1699774800,12720,142533,74113,US,US
138151,1699200240,1699216980,16740,74396,118881,CZ,DE
32511,1699668120,1699700940,32820,141190,12805,TR,TR
162825,1699862640,1699895520,32880,30155,67705,TR,TR
51317,1699194480,1699199220,4740,184702,133460,GB,GB
24914,1700047500,1700052840,5340,42421,92865,EE,FI
106617,1699996020,1700025300,29280,169544,180979,TR,TR
69655,1700605320,1700641140,35820,108511,73098,TR,TR
91410,1700023620,1700039880,16260,77188,183315,US,US
10784,1699988820,1699997940,9120,32729,168079,IT,IT
15358,1699326840,1699332420,5580,149519,112096,GB,GB
83915,1698984960,1699004040,19080,78371,162048,FR,BE
35958,1700416800,1700420400,3600,19645,9362,NL,NL
101305,1700818260,1700829060,10800,50117,11112,AT,AT
90401,1700044860,1700061720,16860,71298,88891,US,US
129005,1699394820,1699411920,17100,30667,106241,RS,RS
72446,1700697900,1700710620,12720,168169,89810,IT,IT
162903,1699902180,1699941720,39540,91149,168962,MX,MX
80313,1700252580,1700270040,17460,93098,1670,AT,SK
106189,1699455480,1699472880,17400,97346,36807,FR,IT
179272,1699808520,1699842780,34260,29285,92799,MX,MX
109889,1699669980,1699700160,30180,46277,72710,TR,TR
135339,1699681800,1699708320,26520,29279,134330,HU,DE
15083,1699990980,1700020740,29760,62737,170728,TR,TR
97517,1699649880,1699678980,29100,159907,129102,TR,TR
83692,1700496900,1700518320,21420,185373,153134,SE,SE
793,1700638560,1700659740,21180,190254,22615,FR,BE
24657,1699592760,1699620120,27360,10683,89277,BR,BR
159114,1699891860,1699924920,33060,160192,175028,TR,TR
96693,1699312620,1699325760,13140,95218,63850,IT,IT
86727,1700669220,1700682480,13260,16283,73985,US,US
87006,1700769660,1700801460,31800,96111,198578,TR,TR
82659,1700144820,1700175780,30960,34197,152203,TR,TR
110007,1699990140,1700024640,34500,157281,97167,TR,TR
198189,1698873600,1698900420,26820,184877,165652,PL,PL
163508,1700656740,1700672400,15660,95133,144757,BE,NL
165858,1699109520,1699116000,6480,38039,56367,NL,AT
7773,1699324320,1699336920,12600,22188,2937,US,US
78732,1699069560,1699077060,7500,19490,23867,IT,IT
44038,1699912140,1699943640,31500,84867,68893,TR,TR
118753,1699905480,1699939440,33960,134161,120976,TR,TR
158713,1699945560,1699972920,27360,54929,114501,BR,BR
35314,1699116540,1699147500,30960,104819,64462,TR,TR
60852,1700421480,1700435700,14220,148461,52307,IT,IT
184032,1699339080,1699351200,12120,107320,140896,ES,ES
168361,1699755420,1699785360,29940,38801,160677,TR,TR
184677,1699790700,1699797180,6480,99723,144647,GB,GB
93055,1700245260,1700274000,28740,81042,140965,PL,PL
15686,1699116720,1699141200,24480,139761,95177,BR,BR
91493,1699753080,1699765980,12900,98396,61981,US,US
27474,1699596240,1699603800,7560,83450,94502,HR,BA
127713,1700063160,1700097240,34080,163742,133353,TR,TR
90559,1700279340,1700282940,3600,168513,113669,GB,GB
197901,1700107020,1700139720,32700,60768,11951,TR,TR
124219,1699843020,1699856040,13020,141344,133413,US,US
115776,1698988680,1699022580,33900,7401,117041,TR,TR
60642,1700666460,1700670060,3600,167513,196798,NL,NL
67733,1700123820,1700153520,29700,103970,139566,TR,TR
29847,1699400100,1699408920,8820,39387,111486,IT,IT
103681,1700762280,1700779080,16800,190236,138389,US,US
146005,1700495340,1700513520,18180,139798,109971,FR,DE
189423,1699804140,1699818300,14160,158669,669,CA,US
56328,1699490640,1699521180,30540,11191,177327,TR,TR
177992,1699146900,1699171320,24420,12605,178217,DE,AT
159531,1699246740,1699257780,11040,42969,147750,US,US
110406,1700514840,1700521020,6180,2739,67347,NL,NL
70143,1700569140,1700575500,6360,148976,94975,GB,GB
40136,1699863840,1699868040,4200,161657,90590,AD,ES
182221,1699551900,1699584480,32580,178950,41398,TR,TR
34268,1699271460,1699289340,17880,14478,151638,US,US
143924,1700723040,1700754840,31800,73488,153025,TR,TR
163665,1698853980,1698911280,57300,183029,178998,BG,BG
22137,1699272120,1699323000,50880,52097,9553,BG,AT
33427,1698968040,1698980940,12900,2228,67623,IT,IT
98677,1699413180,1699445520,32340,84895,189403,TR,TR
176070,1700693520,1700701980,8460,45142,58290,IT,IT
99256,1699195560,1699228080,32520,61544,199167,TR,TR
156996,1700628900,1700632500,3600,175622,95482,GB,GB
194463,1700523420,1700549040,25620,62729,76101,BA,CH
35329,1700492940,1700526780,33840,173787,54060,TR,TR
96296,1700570640,1700606040,35400,53105,170635,TR,TR
179838,1699265760,1699295460,29700,134096,32378,TR,TR
28700,1698920280,1698929640,9360,105044,141746,EE,EE
183389,1700813640,1700846040,32400,130463,29670,TR,TR
179389,1700854020,1700909760,55740,33527,199694,BG,BG
20708,1699031700,1699047120,15420,67950,152884,US,US
56322,1700187660,1700197680,10020,143633,117447,PT,PT
83352,1699989720,1699998900,9180,145696,68422,SK,SK
187668,1700611680,1700647260,35580,146092,73921,TR,TR
133156,1699536900,1699549500,12600,198685,74201,IT,IT
15958,1699182840,1699195920,13080,65740,91677,US,US
180243,1699460100,1699472460,12360,126746,70462,PT,PT
85464,1700557260,1700560860,3600,68717,199941,NL,PL
25074,1699207560,1699237500,29940,66901,116714,TR,TR
167558,1699242900,1699275600,32700,187070,39069,TR,TR
61155,1698924120,1698941580,17460,41621,158330,US,US
96813,1700072160,1700075760,3600,17167,146441,NL,BE
177873,1699588800,1699613940,25140,37162,15683,DE,BG
89561,1699603380,1699620300,16920,49201,96178,RS,RS
59280,1699970940,1699974540,3600,121355,77629,GB,GB
107768,1699806420,1699836540,30120,84765,175092,TR,TR
174494,1700594400,1700630460,36060,83288,199770,MX,MX
187445,1698828780,1698862740,33960,114093,93271,TR,TR
65263,1700004300,1700007900,3600,23644,64604,NL,NL
7576,1699719720,1699736820,17100,13791,124550,FR,FR
122014,1699962000,1699974180,12180,46488,32956,US,US
11777,1700622000,1700627640,5640,51580,101368,GB,GB
63285,1699017900,1699025340,7440,19084,165893,IT,IT
92565,1698803280,1698817140,13860,94447,116836,US,US
129927,1699677180,1699707360,30180,24724,26829,TR,TR
65949,1699883100,1699894200,11100,76158,70170,US,US
157844,1700408460,1700446320,37860,88112,127228,MX,MX
154346,1699499220,1699513680,14460,171875,20667,US,US
100282,1700058720,1700082300,23580,181945,168517,DE,NL
8144,1700531700,1700565300,33600,23569,107186,TR,TR
99486,1699084080,1699118940,34860,8919,51629,TR,TR
54600,1700065080,1700076480,11400,192739,147690,US,US
122317,1699941120,1699966920,25800,122455,159078,DE,IT
192125,1700109900,1700113500,3600,308,131314,GB,GB
88190,1700412120,1700423100,10980,86265,53576,HR,BA
65862,1700285700,1700293860,8160,134173,191885,IT,IT
146697,1699663920,1699680720,16800,59420,103797,SE,SE
51394,1700373840,1700377440,3600,187585,140537,NL,DE
51338,1700151060,1700172960,21900,48126,126678,ME,BA
77972,1699785180,1699799160,13980,160311,86901,CZ,CZ
173257,1699793640,1699817340,23700,105076,59236,PL,PL
11980,1700624940,1700657100,32160,7583,149288,TR,TR
193791,1700697540,1700710740,13200,73277,11136,US,US
109468,1699552320,1699585440,33120,189463,10701,TR,TR
153339,1699110180,1699121520,11340,146544,46070,CZ,CZ
59891,1699975740,1700003520,27780,35252,30004,DE,DE
156395,1700817000,1700836920,19920,37157,185834,FR,FR
34969,1700114760,1700128560,13800,185346,145144,AT,SK
4894,1700461980,1700474640,12660,199180,57208,US,US
34479,1699194240,1699207380,13140,91187,118101,AT,AT
137194,1699688400,1699696560,8160,106078,62306,HR,HR
170122,1700300400,1700336280,35880,105922,166484,TR,TR
184666,1700479680,1700490900,11220,122360,24658,IT,FR
14906,1699272900,1699276500,3600,100142,190641,GB,GB
24537,1699842600,1699877340,34740,147353,164564,MX,MX
115866,1699669140,1699672740,3600,136614,73250,NL,NL
13332,1698873000,1698904680,31680,10497,51766,TR,TR
162587,1699246080,1699276140,30060,106183,105453,TR,TR
73325,1700817720,1700831040,13320,86,62623,ES,IT
44761,1699692060,1699721760,29700,130639,51449,TR,TR
2382,1699846680,1699882260,35580,14665,110662,TR,TR
178201,1698950040,1698975660,25620,27277,22034,RO,RO
104950,1700141700,1700149980,8280,80812,182517,IT,IT
153406,1699799160,1699831560,32400,81184,98132,TR,TR
183925,1700526360,1700529960,3600,181148,170657,GB,GB
171767,1700010840,1700043840,33000,101956,188964,TR,TR
21146,1699973340,1700008740,35400,110809,175980,TR,TR
131395,1700519940,1700529660,9720,123485,24362,SK,SK
130363,1698819900,1698830580,10680,183565,86882,IT,IT
190562,1700081460,1700109180,27720,85367,5644,DE,FR
76536,1699305960,1699309560,3600,127899,59221,NL,NL
173996,1699784880,1699819320,34440,135834,169182,TR,TR
40945,1700109960,1700139060,29100,10075,193095,TR,TR
107046,1699031460,1699035540,4080,45571,199461,GB,GB
64764,1700043600,1700075520,31920,101805,137945,TR,TR
83597,1700360400,1700375160,14760,73141,169241,US,US
121649,1699544280,1699553280,9000,30931,116094,HR,HR
101739,1699943760,1699975320,31560,62787,68952,TR,TR
194611,1698927240,1698941940,14700,49450,23814,US,US
136936,1700656560,1700661780,5220,164975,91300,GB,GB
124274,1699447800,1699454580,6780,158793,95521,GB,GB
176221,1700279280,1700293860,14580,135527,7884,US,US
136914,1699638780,1699655820,17040,98439,101784,RS,RS
73673,1699271940,1699276140,4200,148018,78424,GB,GB
147174,1700758920,1700791860,32940,157971,151117,TR,TR
56261,1700553960,1700571360,17400,146178,25908,FR,FR
150737,1699232760,1699270560,37800,184500,199613,MX,MX
57998,1699801440,1699812540,11100,51246,65654,AT,AT
165659,1700095620,1700104440,8820,53775,84790,IT,IT
118529,1700842440,1700862180,19740,148741,124326,FR,FR
80571,1700366100,1700378280,12180,179054,179116,IT,IT
157456,1699082280,1699090800,8520,111918,52167,PT,PT
38929,1700543580,1700580000,36420,197850,170259,MX,MX
149210,1699545060,1699555560,10500,95350,24755,IT,IT
158254,1700130300,1700159220,28920,98561,59091,TR,TR
179860,1699880220,1699889520,9300,194011,162172,PT,PT
1377,1699651140,1699680840,29700,15637,43134,TR,TR
177632,1700746380,1700781840,35460,37272,46435,TR,TR
17071,1700277180,1700280780,3600,8734,124892,NL,NL
41481,1700698800,1700732220,33420,115487,32823,TR,TR
99689,1699568580,1699604520,35940,56283,185223,TR,TR
119062,1699095360,1699102800,7440,38397,32127,HR,HR
135183,1699927560,1699943340,15780,158106,116422,US,US
103434,1700254200,1700265420,11220,144375,112334,IT,IT
116467,1700587320,1700599620,12300,25415,19581,US,US
50192,1699389780,1699397220,7440,150341,191720,HR,HR
125427,1699990980,1700000040,9060,66449,7695,SK,FR
93310,1698853260,1698865740,12480,183445,94812,HR,HR
102269,1699814640,1699842660,28020,81500,19388,PL,PL
166395,1700328960,1700333460,4500,174395,142041,GB,GB
197629,1700130420,1700141700,11280,192248,164812,US,US
32307,1700469420,1700503080,33660,148996,188550,TR,TR
10403,1700043420,1700047080,3660,28702,194790,GB,GB
138073,1699531260,1699535400,4140,62839,36834,GB,GB
132717,1700557440,1700592540,35100,134734,41760,TR,TR
194574,1700290980,1700324880,33900,5245,99863,TR,TR
36821,1698805440,1698809820,4380,51948,131800,NL,NL
26757,1699467960,1699483380,15420,177617,193836,BE,FR
194587,1698963480,1698983940,20460,41793,53817,SE,SE
110832,1700356380,1700375280,18900,5891,173320,FR,FR
130472,1700327460,1700359740,32280,90789,71952,TR,TR
84258,1700479800,1700491500,11700,8047,180225,PT,PT
78447,1698997920,1699032660,34740,129226,93819,TR,TR
50955,1699256880,1699265460,8580,138216,121041,FI,EE
33915,1700150160,1700162940,12780,199729,79742,IT,IT
55505,1700412600,1700424540,11940,160814,31315,IT,IT
83538,1700811120,1700846700,35580,64604,46876,TR,TR
164005,1700709540,1700718300,8760,126644,47672,PT,ES
85912,1700563860,1700577600,13740,100516,173768,US,US
111938,1700572320,1700587500,15180,125671,73989,US,CA
52467,1700805660,1700817780,12120,168000,50837,US,US
114214,1700316120,1700324100,7980,121023,191923,PT,PT
80321,1699898760,1699932600,33840,42478,170509,TR,TR
152338,1699135860,1699170120,34260,77889,143185,TR,TR
109927,1700434080,1700466660,32580,13378,80927,TR,TR
152159,1700023680,1700030340,6660,86672,64807,NL,NL
16421,1700839320,1700856360,17040,8840,106888,FR,FR
87230,1700826120,1700858640,32520,13374,186061,TR,TR
140418,1700624340,1700659560,35220,167539,79028,TR,TR
73853,1700141940,1700146440,4500,78643,9336,GB,GB
65884,1699385880,1699418640,32760,111214,130880,TR,TR
30886,1699321080,1699335480,14400,88984,146751,AT,UA
48256,1700845080,1700872080,27000,14518,112658,BR,BR
69381,1700045100,1700073240,28140,33377,199296,BR,BR
164815,1700377620,1700390280,12660,22709,146511,SK,SK
63,1700180580,1700215200,34620,12765,140233,TR,TR
146852,1699544460,1699579860,35400,155669,185283,TR,TR
50350,1699120140,1699143660,23520,111018,187133,HU,DE
178747,1700370960,1700405820,34860,49745,127759,TR,TR
108402,1699605180,1699638720,33540,102028,64878,TR,TR
179079,1699815840,1699828320,12480,128382,135278,US,US
150465,1699795920,1699831140,35220,145331,109375,TR,TR
21859,1699264740,1699294200,29460,73136,43968,TR,TR
66127,1700462700,1700500740,38040,122080,149791,MX,MX
77783,1700495100,1700511420,16320,103410,198197,RS,AT
117376,1698989040,1699024920,35880,140469,58849,MX,MX
102690,1699394940,1699426020,31080,196256,106928,TR,TR
15817,1700369040,1700402820,33780,129959,5928,TR,TR
81027,1698921900,1698931500,9600,152303,162757,IT,IT
7914,1699474680,1699505580,30900,29132,164087,TR,TR
85936,1699749360,1699752960,3600,145875,23374,GB,GB
181181,1699398600,1699430580,31980,189814,57657,TR,TR
16905,1700136300,1700139900,3600,52237,86596,GB,GB
164451,1700325420,1700357640,32220,36370,131418,TR,TR
30622,1698860760,1698895620,34860,106594,88473,TR,TR
36974,1699962420,1699999200,36780,83126,69629,MX,MX
191792,1699910220,1699924260,14040,57066,31136,RS,RS
45724,1700597040,1700626920,29880,118173,38586,TR,TR
149060,1700382060,1700421360,39300,39965,159090,MX,MX
107545,1698829260,1698863460,34200,104395,173667,TR,TR
44273,1700505840,1700517240,11400,175728,14568,US,US
128130,1699977840,1699993260,15420,85270,27280,FR,FR
72030,1700167740,1700192460,24720,83889,157701,PL,PL
108984,1700769300,1700774220,4920,87454,168890,NL,NL
87936,1700534760,1700562660,27900,109186,191886,DE,AT
38138,1700120580,1700127960,7380,92734,16466,IT,IT
46784,1700232720,1700260020,27300,34304,40916,BA,HR
162251,1700152920,1700188380,35460,160584,63006,MK,RS
121258,1699902120,1699919640,17520,184712,29027,US,US
178139,1699327500,1699337580,10080,136899,169582,PT,PT
92206,1700830380,1700853960,23580,3719,140000,PL,PL
38238,1699603920,1699607940,4020,108621,196736,GB,GB
186968,1699187520,1699191120,3600,54368,3113,GB,GB
86133,1700689620,1700693640,4020,157112,136952,NL,NL
181072,1700366400,1700382480,16080,112830,43887,US,US
104834,1700455080,1700458680,3600,132395,151745,NL,NL
197673,1699905960,1699933620,27660,89033,181357,CH,DE
46890,1699779960,1699786740,6780,159026,196433,NL,NL
156151,1699390680,1699396440,5760,119824,170099,NL,NL
138829,1698854040,1698874980,20940,26041,102838,FR,GB
1806,1700814660,1700827200,12540,10880,159714,SK,DE
130568,1699880160,1699914900,34740,37728,34848,TR,TR
52547,1700081520,1700085120,3600,21627,119627,NL,NL
190589,1700516280,1700551260,34980,28998,182664,TR,TR
40580,1699979820,1699983420,3600,167494,19222,GB,GB
193135,1699116180,1699119900,3720,75376,196712,NL,NL
184223,1699096680,1699106520,9840,32180,66959,AD,ES
163155,1700837160,1700871300,34140,160623,62882,TR,TR
40221,1700432580,1700467320,34740,40333,44658,TR,TR
53731,1700317200,1700348880,31680,49439,4036,TR,TR
72920,1698973020,1698984060,11040,195362,106975,AT,AT
121335,1699863480,1699881660,18180,198020,194137,FR,BE
156913,1700823780,1700827380,3600,132761,1116,NL,NL
37827,1699295940,1699299540,3600,107585,54101,GB,GB
11472,1700194500,1700202840,8340,68048,56593,EE,EE
14604,1699800300,1699815240,14940,34142,70720,FR,FR
13907,1700483100,1700496960,13860,87314,113523,HR,BA
132280,1698843360,1698851640,8280,123009,5387,IT,IT
199981,1699824240,1699854240,30000,83984,180593,TR,TR
190627,1699862820,1699866420,3600,53564,192708,GB,GB
44179,1700554080,1700560020,5940,14936,97877,GB,GB
106451,1700834340,1700866680,32340,146769,151288,TR,TR
140130,1700157540,1700165820,8280,35001,111634,EE,EE
188207,1700030820,1700034480,3660,154573,163802,NL,NL
57425,1698870120,1698886920,16800,194074,181886,US,US
143661,1699562940,1699574640,11700,40527,189178,AT,AT
112745,1698961680,1698970020,8340,3847,145217,EE,FI
121487,1700632140,1700682840,50700,196834,119794,BG,AT
183731,1698907440,1698938460,31020,160936,79425,TR,TR
144212,1700736360,1700740620,4260,84138,155882,GB,GB
161164,1700116860,1700131980,15120,22532,5586,RS,FR
99352,1700269740,1700274960,5220,108456,125361,NL,NL
186570,1700767800,1700774580,6780,86851,170807,NL,NL
77706,1699435320,1699451040,15720,58396,184099,US,US
194169,1699689180,1699692780,3600,199273,132182,GB,GB
67131,1700139720,1700144400,4680,90486,123697,GB,GB
2328,1700277120,1700286060,8940,141028,84669,IT,IT
148792,1699486020,1699515900,29880,92058,40923,TR,TR
174861,1700815620,1700824140,8520,149,96770,IT,IT
96287,1700392320,1700401440,9120,8942,113911,SK,AT
29625,1700768700,1700783340,14640,174012,115836,CZ,CZ
186090,1700336040,1700361180,25140,108040,72836,DE,IT
25849,1700172360,1700186040,13680,160022,181132,IT,IT
197060,1699252500,1699271400,18900,150158,57398,FR,FR
65968,1700778840,1700810340,31500,36753,170550,TR,TR
121660,1699970820,1699983180,12360,15390,78795,US,US
62890,1700751420,1700759520,8100,168415,57121,IT,IT
163834,1700222460,1700254020,31560,73491,57948,TR,TR
76158,1698955680,1698987360,31680,41869,185313,TR,TR
198857,1699560780,1699567980,7200,138500,886,PT,PT
147885,1700406300,1700429160,22860,93546,128316,RO,RO
3678,1699333860,1699337460,3600,118622,139654,GB,GB
11818,1700735160,1700767920,32760,169437,119440,TR,TR
185328,1699866360,1699900380,34020,40716,104443,TR,TR
15907,1700500980,1700505000,4020,68985,179819,NL,NL
69311,1700771580,1700784540,12960,27350,190807,IT,IT
111890,1699803600,1699816800,13200,131452,55762,US,US
14615,1699129260,1699150500,21240,156449,8187,FR,FR
38176,1700544840,1700577240,32400,48440,139493,TR,TR
114419,1699258620,1699271700,13080,131455,21219,PT,ES
113693,1700371740,1700405640,33900,197355,105454,TR,TR
96640,1699282920,1699298100,15180,120325,180568,CZ,CZ
84316,1699839060,1699847760,8700,190484,105580,IT,IT
122373,1699944540,1699978380,33840,113566,19782,TR,TR
32226,1699760100,1699790760,30660,98170,155443,TR,TR
125455,1699885380,1699900140,14760,179077,16286,US,US
154342,1700553120,1700563500,10380,35525,178224,IT,IT
117285,1700240820,1700255160,14340,156395,178147,IT,IT
16903,1700452440,1700486460,34020,37859,4784,TR,TR
188537,1700725500,1700758980,33480,105318,65206,TR,TR
138949,1699494480,1699507440,12960,51736,16240,CZ,SK
196471,1700540100,1700552400,12300,38900,144118,IT,IT
17282,1700439720,1700445780,6060,2002,51700,GB,GB
96700,1700753220,1700768580,15360,40956,97584,FR,FR
138527,1699052280,1699068240,15960,170594,131912,US,US
181129,1700856540,1700890740,34200,11528,196347,TR,TR
177288,1699586400,1699591320,4920,45502,41778,NL,NL
181724,1698906780,1698912420,5640,121891,74155,GB,GB
107658,1700277480,1700306940,29460,111532,130195,TR,TR
93075,1699289460,1699321140,31680,16210,129048,MK,DE
167830,1700556120,1700565240,9120,119949,32842,HR,HR
80709,1699062960,1699083780,20820,161093,147068,MD,RO
91919,1699096860,1699120260,23400,109869,85030,DE,MK
97278,1699402320,1699435740,33420,170384,57759,TR,TR
198031,1699292580,1699300080,7500,159602,137865,ES,ES
107037,1700633460,1700651280,17820,95698,40930,US,MX
186,1700713920,1700723640,9720,144969,111089,ES,AD
193471,1700361120,1700378940,17820,35114,188541,FR,FR
32870,1699714740,1699742700,27960,43559,154141,BR,BR
45460,1700522340,1700530260,7920,153377,136956,AD,ES
25097,1699745700,1699753200,7500,113309,14147,HR,HR
97978,1700009760,1700019780,10020,12464,199098,IT,IT
131385,1699554660,1699580460,25800,59156,33099,RO,RO
50412,1698847380,1698859320,11940,196703,109404,HR,HR
95916,1698814560,1698824760,10200,86446,89056,IT,IT
135557,1699791900,1699827180,35280,2150,50454,TR,TR
9195,1699405620,1699438620,33000,189051,178873,TR,TR
42003,1699199400,1699215540,16140,44596,103101,BE,HR
41646,1699529820,1699565700,35880,124037,69045,TR,TR
25375,1699288860,1699321680,32820,51761,193373,TR,TR
53742,1699573680,1699597740,24060,20332,196463,PL,DE
133818,1700135460,1700155260,19800,67072,151931,SI,RS
162286,1700292000,1700295960,3960,34540,46632,GB,GB
162114,1699334820,1699360380,25560,109552,159692,PL,PL
40096,1699374300,1699390560,16260,163001,84021,FR,FR
187766,1699938660,1699944240,5580,12417,16449,GB,GB
98830,1699745040,1699757700,12660,39666,21416,US,US
85766,1700627640,1700661960,34320,172589,4218,TR,TR
174834,1699473240,1699502400,29160,54089,182172,TR,TR
143041,1700659080,1700662740,3660,52843,34864,GB,GB
7788,1699329120,1699362540,33420,91591,191818,TR,TR
45288,1700132580,1700168340,35760,52894,21761,TR,TR
90668,1700435160,1700438760,3600,139239,49527,NL,NL
113562,1700806260,1700838240,31980,74117,155998,TR,TR
43461,1700135040,1700161680,26640,12016,38874,DE,DE
47480,1700325600,1700357640,32040,149307,170976,TR,TR
50950,1700815560,1700832540,16980,179024,184621,FR,NL
171725,1698871140,1698903960,32820,67095,162240,TR,TR
127921,1699726920,1699730520,3600,40278,117691,GB,GB
26578,1699507560,1699529700,22140,87813,187545,BR,BR
73940,1699038120,1699073700,35580,50083,199887,TR,TR
67809,1699905720,1699925580,19860,78722,83554,FR,FR
119162,1700582220,1700593560,11340,147725,113064,US,US
106986,1699792080,1699803720,11640,75579,172904,CA,US
84607,1700300400,1700312340,11940,29702,127020,PT,PT
23028,1698955500,1698966540,11040,199369,46823,AT,AT
46004,1699187820,1699201740,13920,176045,163517,CA,CA
172224,1699586820,1699600320,13500,49635,73890,RS,RS
84880,1698956580,1698984720,28140,103398,101405,PL,PL
7564,1699052520,1699065180,12660,153118,108157,ES,ES
60884,1699505340,1699510020,4680,197417,7209,GB,GB
55259,1700337420,1700370720,33300,148801,46625,TR,TR
62019,1699174740,1699204380,29640,161876,111413,TR,TR
37715,1699477740,1699507920,30180,94485,190967,TR,TR
45939,1698840720,1698871680,30960,5479,65222,TR,TR
3547,1699177860,1699194840,16980,169542,117078,US,US
128073,1700759940,1700793360,33420,149575,115601,TR,TR
55273,1699064700,1699080900,16200,126143,194406,US,US
130591,1700773140,1700802000,28860,146140,195497,TR,TR
199258,1699792200,1699798860,6660,194472,38348,GB,GB
67680,1700809980,1700845500,35520,80936,40418,TR,TR
46988,1699776600,1699810080,33480,34683,5845,TR,TR
30667,1699313520,1699327380,13860,154241,61366,US,US
113404,1699481760,1699512480,30720,175990,187458,TR,TR
129893,1700236680,1700268900,32220,83683,185365,TR,TR
71027,1700706180,1700717220,11040,30912,149108,US,US
27406,1699819140,1699852380,33240,146292,119279,TR,TR
144688,1700191320,1700196480,5160,145028,36170,GB,GB
132403,1700635800,1700670060,34260,180753,175539,TR,TR
198172,1699788840,1699799580,10740,7191,84184,PT,PT
196113,1699798380,1699832700,34320,4973,135883,TR,TR
34643,1700819340,1700852520,33180,189137,62044,MX,MX
186889,1699963740,1699967340,3600,142121,110902,GB,GB
135824,1698914160,1698943560,29400,75583,90820,TR,TR
130690,1700021160,1700028060,6900,188687,105556,NL,NL
130207,1700694360,1700707980,13620,19216,147010,IT,IT
122074,1700260920,1700268060,7140,19091,54491,AD,ES
99050,1700197560,1700228040,30480,1487,72682,TR,TR
184798,1699292520,1699301640,9120,70077,184678,ES,ES
48146,1700604360,1700609040,4680,76651,46015,NL,NL
66372,1700504520,1700540220,35700,68641,7464,TR,TR
119501,1699510140,1699525380,15240,171663,16075,US,US
178195,1699494240,1699497840,3600,19496,124915,NL,NL
138873,1699790040,1699819380,29340,144742,25670,TR,TR
116055,1700346600,1700350200,3600,129871,126891,NL,BE
152339,1700802300,1700806140,3840,86670,51623,GB,GB
172875,1699434360,1699449120,14760,176110,60008,US,US
118967,1700512740,1700523780,11040,92862,41655,RS,RS
113152,1699325760,1699333680,7920,145455,26359,IT,IT
147623,1699974060,1699992240,18180,63492,174250,BE,FR
52050,1700601780,1700634060,32280,43734,139177,TR,TR
105832,1700844000,1700872320,28320,193897,49818,DE,CH
108267,1698830340,1698842280,11940,100988,44156,IT,IT
43575,1700099400,1700110740,11340,123664,167065,US,US
34131,1700117160,1700123220,6060,16975,137580,GB,GB
4919,1700626800,1700661420,34620,86333,52001,TR,TR
30956,1699974360,1700031540,57180,32894,41554,BG,TR
158749,1700564760,1700595900,31140,165861,68673,TR,TR
43840,1699632600,1699656900,24300,57481,75410,MD,UA
61382,1699911780,1699920360,8580,145576,83281,SK,AT
11497,1700278980,1700286000,7020,188250,163654,GB,GB
8176,1698833820,1698837420,3600,124669,36083,GB,GB
61202,1700210100,1700220360,10260,62879,1058,HR,HR
77978,1699312020,1699347060,35040,29746,75492,TR,TR
68107,1698981660,1699020060,38400,36494,93499,MX,MX
53395,1699197060,1699214280,17220,186841,10636,US,US
7222,1700421480,1700453580,32100,6735,69026,TR,TR
55464,1699441920,1699470840,28920,108256,44405,TR,TR
157476,1699540680,1699550700,10020,6419,54645,HR,HR
31817,1699748880,1699761360,12480,188654,187052,IT,IT
24725,1699138740,1699145340,6600,131673,81948,NL,BE
35257,1699144860,1699157880,13020,197288,166735,US,MX
151533,1698887340,1698917820,30480,87144,637,TR,TR
25972,1700772300,1700798100,25800,44108,176287,DE,DE
34504,1699344180,1699362120,17940,119453,48261,US,US
128590,1699314540,1699329600,15060,38509,153775,US,US
45475,1699814820,1699852560,37740,1426,81419,MX,MX
178402,1700575680,1700579280,3600,162419,110552,NL,PL
80705,1700092260,1700095860,3600,47202,63414,GB,GB
133001,1699988640,1700012640,24000,67693,147431,DE,AT
4222,1699786560,1699821000,34440,20858,196832,TR,TR
79830,1699338480,1699343460,4980,29286,59940,NL,NL
99187,1699386300,1699400880,14580,160835,139350,CZ,CZ
104046,1700088180,1700122380,34200,72895,166340,TR,TR
56677,1700289420,1700318760,29340,195035,16832,TR,TR
74332,1699352640,1699384080,31440,180047,4717,TR,TR
75300,1700264220,1700267820,3600,191407,123359,NL,NL
76540,1700821920,1700851080,29160,194467,17528,TR,TR
178588,1699271700,1699286700,15000,194900,15654,US,US
8122,1699832460,1699864500,32040,171317,38193,TR,TR
5856,1700454240,1700465880,11640,181760,79813,US,US
179988,1699029060,1699064100,35040,92958,79429,TR,TR
104809,1700342580,1700372400,29820,141233,186035,TR,TR
71753,1700611920,1700643180,31260,111073,78144,TR,TR
10323,1699297920,1699325820,27900,94444,56119,PL,DE
59851,1700445480,1700451240,5760,143943,92879,GB,GB
185799,1699242360,1699249740,7380,19112,109917,HR,HR
10857,1698963960,1698999300,35340,69683,129173,TR,TR
107102,1700210220,1700248140,37920,146095,186168,MX,MX
122488,1700108460,1700125920,17460,37229,21787,US,US
19638,1700293260,1700318880,25620,152811,81960,PL,HR
162572,1700605800,1700637120,31320,169085,63922,TR,TR
25705,1699406940,1699442640,35700,54671,95077,TR,TR
105957,1699745760,1699751400,5640,46745,72544,NL,NL
61450,1700849940,1700864100,14160,139596,61510,US,US
17896,1699953720,1699983000,29280,121946,164112,TR,TR
110785,1700077680,1700087700,10020,102250,42648,ES,AD
119283,1700446200,1700471700,25500,139289,85544,RO,RO
185837,1699110900,1699134720,23820,55558,87910,PL,DE
119707,1700633220,1700643060,9840,115240,3342,IT,IT
6337,1698938100,1698968700,30600,128276,78788,TR,TR
84701,1699590600,1699603800,13200,17123,115153,IT,IT
32193,1699539900,1699570680,30780,55110,181845,TR,TR
31753,1699239840,1699243440,3600,196438,18729,GB,GB
164706,1700535300,1700564760,29460,184525,168497,TR,TR
182721,1700634840,1700664120,29280,69047,101243,TR,TR
23133,1699867320,1699886340,19020,179173,170889,FR,FR
20067,1700326800,1700338080,11280,116879,128600,HR,DE
40753,1700576640,1700590020,13380,67736,30412,IT,IT
44724,1698847320,1698880680,33360,125061,65507,TR,TR
138050,1700454600,1700471700,17100,153395,151218,CZ,CZ
137910,1699209660,1699243380,33720,27781,46699,TR,TR
53707,1700077320,1700111820,34500,172200,97923,TR,TR
171004,1700550960,1700554560,3600,142394,111142,NL,NL
13826,1699984020,1699988700,4680,368,113041,GB,GB
180832,1700815320,1700829480,14160,172285,22370,AT,AT
168052,1700120400,1700124900,4500,121558,27110,NL,RS
96095,1699903020,1699938420,35400,78486,137025,TR,TR
8274,1700585520,1700596320,10800,66870,152284,CZ,UA
132633,1699923180,1699926780,3600,57147,65150,GB,GB
171891,1700607540,1700614920,7380,144204,137561,IT,IT
137915,1699160340,1699173660,13320,121841,25814,IT,IT
122520,1700102940,1700127060,24120,140685,27383,DE,IT
89096,1699638060,1699649040,10980,52221,24219,IT,IT
141350,1699001400,1699033980,32580,180447,55431,TR,TR
61239,1699260000,1699281240,21240,85196,93030,BE,FR
27672,1698864420,1698875580,11160,7659,113970,IT,NL
35830,1699540620,1699553160,12540,190047,193982,RS,RS
37968,1699361460,1699396860,35400,181235,62309,TR,TR
30655,1699629000,1699661160,32160,105095,54073,TR,TR
109133,1699223640,1699229520,5880,185023,100719,NL,FR
67362,1699731780,1699742880,11100,122500,57550,US,US
198808,1700272140,1700308680,36540,177594,77263,MX,MX
197984,1700674740,1700707380,32640,71557,149165,TR,TR
198573,1699435920,1699447080,11160,17262,44484,AT,PL
140708,1700591280,1700594880,3600,143654,163110,GB,GB
111322,1700225460,1700238480,13020,81391,136210,HR,RS
111354,1698959460,1698972360,12900,199927,58765,US,US
127314,1699224060,1699231200,7140,122355,140346,GB,GB
149198,1699870500,1699904460,33960,43404,172823,TR,TR
85794,1699657260,1699689060,31800,143292,148424,TR,TR
81327,1700817900,1700847240,29340,81444,35004,TR,TR
124102,1699477680,1699503240,25560,44963,101835,DE,FR
22623,1700374200,1700386800,12600,65521,3591,US,US
191134,1699821960,1699849020,27060,188660,49034,DE,DE
117147,1700053140,1700086200,33060,172229,13225,TR,TR
181194,1699435620,1699468320,32700,89100,178458,TR,TR
82075,1699066980,1699099140,32160,127577,195670,TR,TR
5101,1699821180,1699838160,16980,170563,102547,FR,FR
114757,1700690100,1700720820,30720,165609,62828,TR,TR
94032,1698935520,1698947700,12180,146618,165240,ES,ES
141400,1699837500,1699842900,5400,31472,148657,GB,GB
86122,1700039700,1700046840,7140,146057,41004,NL,NL
172467,1699313640,1699332960,19320,159048,145127,FR,FR
54377,1699849920,1699880160,30240,8240,37991,TR,TR
174112,1700491620,1700506500,14880,13035,100787,US,US
181140,1699972740,1699982220,9480,84820,88919,HR,HR
123016,1699205880,1699235940,30060,111540,151463,TR,TR
183609,1700418060,1700422800,4740,198221,181396,GB,GB
99583,1699152960,1699156560,3600,56643,115486,GB,GB
122701,1700767080,1700793840,26760,56627,122022,DE,BG
176414,1699631760,1699636740,4980,48786,196597,GB,GB
149284,1698870720,1698884100,13380,42621,26941,US,US
2889,1698829080,1698850020,20940,178071,87522,BE,NL
142260,1700340420,1700375940,35520,107539,66977,TR,TR
89430,1698975480,1698992520,17040,60783,84755,FR,FR
150747,1700698380,1700731140,32760,120312,13648,MX,MX
90641,1698964800,1698969960,5160,77574,166870,GB,GB
158012,1700088000,1700108640,20640,38342,41561,FR,DE
107301,1700454900,1700490660,35760,110529,31518,TR,TR
119703,1700480040,1700488080,8040,183148,44959,IT,SK
116793,1699762260,1699765860,3600,50208,22255,GB,GB
166248,1700701380,1700735580,34200,158117,82731,TR,TR
52531,1699877040,1699900800,23760,3239,8944,RO,FR
165965,1699921080,1699971780,50700,150271,76222,BG,TR
5294,1700696460,1700704680,8220,183613,90464,IT,IT
108788,1700509620,1700538600,28980,87904,23749,TR,TR
17804,1700847900,1700860920,13020,137190,129133,CZ,CZ
174644,1700638020,1700673540,35520,24322,34446,TR,TR
120561,1699765140,1699799940,34800,155365,158755,TR,TR
13786,1698865320,1698876840,11520,66777,161382,IT,IT
186972,1699381800,1699413600,31800,82503,136778,TR,TR
45073,1699937880,1699941480,3600,185049,120599,GB,GB
130337,1700738100,1700772540,34440,175667,80476,TR,TR
17129,1700406300,1700416980,10680,122382,136707,IT,IT
167621,1700323740,1700355120,31380,139452,74166,TR,TR
70422,1699354020,1699389420,35400,94818,198852,TR,TR
92619,1699188360,1699213800,25440,75257,139002,BR,BR
109771,1700203860,1700220300,16440,116275,143390,FR,NL
27537,1699516980,1699520580,3600,144828,107526,GB,GB
91241,1699889520,1699896240,6720,68215,119644,NL,BE
52372,1698828720,1698861120,32400,36126,91658,TR,TR
150509,1699413660,1699448220,34560,86328,128274,TR,TR
110274,1699571400,1699582560,11160,196314,15957,IT,LU
165777,1700298420,1700333760,35340,8472,117422,TR,TR
44196,1699994400,1700017200,22800,70107,53644,PL,PL
73408,1699119180,1699130220,11040,147719,179188,PT,PT
124017,1699025640,1699056000,30360,43001,145308,TR,TR
175438,1700517660,1700551920,34260,58342,142241,TR,TR
6132,1700752200,1700764560,12360,6108,180680,US,US
10870,1700323860,1700353860,30000,17152,30976,TR,TR
79749,1699993620,1700026800,33180,76796,94724,MX,US
106612,1700028360,1700037420,9060,189520,39317,ES,ES
32909,1699643880,1699647480,3600,53104,23353,GB,GB
176526,1698969420,1698998520,29100,33290,166515,TR,TR
368,1700099940,1700125500,25560,89489,12682,BR,BR
77625,1699748100,1699757580,9480,169053,164614,PT,PT
78787,1700448660,1700459880,11220,58637,170184,IT,IT
158865,1699802580,1699832880,30300,117020,40427,TR,TR
530,1699037880,1699041480,3600,168355,116133,GB,GB
59761,1698804420,1698820860,16440,175807,51375,US,US
35296,1699822140,1699857420,35280,175506,192123,TR,TR
160786,1699208640,1699236900,28260,125687,134716,PL,PL
172503,1700546220,1700575860,29640,7884,96594,TR,TR
111614,1700175000,1700182140,7140,58876,16715,GB,GB
100052,1699223940,1699233420,9480,31364,15000,IT,IT
4372,1700461260,1700485380,24120,180734,115991,DK,DK
170043,1699855080,1699867620,12540,114010,149117,PT,PT
73767,1700591940,1700606880,14940,125726,196053,AT,AT
33895,1698988020,1699004520,16500,107752,39030,FR,FR
87687,1699815480,1699849260,33780,48218,138084,TR,TR
43979,1700658900,1700689560,30660,85462,96726,TR,TR
77943,1699332960,1699342980,10020,34616,163701,IT,IT
93508,1698880380,1698910620,30240,51174,33832,TR,TR
172456,1698882180,1698894240,12060,148665,141707,AT,AT
178795,1700165760,1700182200,16440,192354,59274,US,US
75547,1699194480,1699205640,11160,42802,33005,PT,PT
128925,1699885920,1699919400,33480,189687,112894,MX,MX
135915,1699066920,1699077660,10740,111612,45194,HR,HR
32635,1699231980,1699266180,34200,52886,184893,TR,TR
162118,1700320020,1700349900,29880,62145,5454,TR,TR
2394,1699640460,1699644060,3600,125208,193497,GB,GB
34486,1700857980,1700864700,6720,97559,130477,NL,NL
137803,1698927300,1698930900,3600,100761,47767,NL,NL
97295,1700415900,1700439900,24000,161053,34441,PL,CH
112993,1699513200,1699569540,56340,74994,163906,BG,DE
68882,1700457600,1700461200,3600,91594,165910,NL,NL
39813,1700200140,1700229060,28920,97350,127157,TR,TR
141970,1698892620,1698907800,15180,84017,174523,US,US
173148,1699332600,1699350180,17580,142325,3542,US,MX
62166,1699594740,1699608120,13380,96382,145560,US,US
158538,1698888240,1698923460,35220,34328,107763,TR,TR
113448,1699466760,1699479120,12360,4911,50507,PT,ES
108403,1699933440,1699937040,3600,131147,115145,GB,GB
33317,1700465700,1700473260,7560,120106,126602,IT,CH
152126,1700428860,1700434740,5880,150747,88222,GB,GB
172185,1700623980,1700627580,3600,100797,195994,GB,NL
67798,1700799720,1700811180,11460,115082,93355,HR,HR
141275,1699992780,1700009640,16860,63564,14006,CA,CA
136295,1699189680,1699214280,24600,61023,33539,MD,RO
17728,1700643480,1700672880,29400,89177,50,TR,TR
115571,1700685060,1700691180,6120,102596,196095,GB,GB
163912,1700309580,1700316180,6600,141277,66961,NL,NL
183462,1700370120,1700391540,21420,76626,130907,FR,FR
169314,1700844600,1700880420,35820,154102,196074,TR,TR
162846,1699288740,1699316520,27780,157310,21138,DE,NL
178816,1698975840,1698982260,6420,2079,10524,GB,GB
125621,1698814140,1698847680,33540,56212,74246,TR,TR
170481,1699548660,1699558620,9960,19371,192512,IT,IT
199192,1698954180,1698983340,29160,161799,45116,TR,TR
25679,1699574340,1699586160,11820,118300,174863,CZ,HU
121727,1700022480,1700031180,8700,144013,168088,IT,IT
144365,1700331180,1700343780,12600,169094,119419,US,US
156425,1699528740,1699539720,10980,77272,16127,IT,IT
61503,1699418340,1699432380,14040,151919,99765,PT,PT
110182,1699920780,1699955400,34620,121129,163325,TR,TR
23514,1700127720,1700152920,25200,186310,79821,PL,PL
37621,1700800320,1700828280,27960,101313,8086,BA,DE
154668,1700264760,1700268360,3600,186755,81407,GB,GB
138711,1698867120,1698898980,31860,21647,38926,TR,TR
181924,1699479360,1699495500,16140,66169,40473,US,US
114788,1700461860,1700478420,16560,175317,125683,US,US
163414,1699903200,1699929060,25860,1650,107862,DE,DE
158273,1699272960,1699289040,16080,33251,16758,AT,DE
125062,1700710920,1700740620,29700,89097,188351,TR,TR
99304,1700545380,1700597880,52500,17561,128743,BG,BG
18695,1699668420,1699683180,14760,144182,35366,US,US
153936,1700706480,1700720640,14160,125888,199369,US,US
72657,1698994800,1699009500,14700,157837,41026,FR,DE
57269,1700050260,1700061540,11280,162292,127427,IT,IT
44570,1700390400,1700394780,4380,130684,151088,GB,GB
126728,1699254300,1699270740,16440,102892,39787,AT,PL
82660,1700145360,1700179620,34260,8884,53221,TR,TR
109531,1699460100,1699489920,29820,152409,21197,TR,TR
140743,1698880380,1698931920,51540,152632,61968,BG,DE
156517,1700098200,1700128560,30360,22542,103683,TR,TR
171302,1698872940,1698889860,16920,38322,123011,FR,NL
90307,1700065920,1700097180,31260,50973,45165,TR,TR
35184,1698956460,1698971520,15060,150834,33827,US,US
80886,1700731080,1700760120,29040,156931,122862,TR,TR
156040,1700196720,1700209320,12600,38655,44691,IT,IT
92885,1699844760,1699875300,30540,18965,185060,TR,TR
99094,1700807760,1700820000,12240,109112,49231,HR,HR
142413,1699028700,1699041360,12660,195152,76469,ES,ES
139353,1699972560,1699976160,3600,142946,96037,NL,DE
155435,1700144940,1700157120,12180,84774,44088,PT,PT
38148,1699935900,1699943160,7260,38990,130766,HR,RS
145872,1699175460,1699205820,30360,91093,99697,TR,TR
126241,1700172660,1700206140,33480,140458,136545,TR,TR
15812,1699501260,1699513440,12180,160837,76334,US,US
149219,1700400180,1700412780,12600,188136,36242,IT,IT
57234,1700537520,1700544360,6840,135012,14495,GB,GB
106150,1699522680,1699555140,32460,191644,143216,TR,TR
185477,1700158620,1700170140,11520,39658,60303,ES,ES
69236,1699165500,1699199880,34380,140107,148475,TR,TR
199294,1700330760,1700381340,50580,64076,186753,BG,TR
196634,1698986520,1698990120,3600,154805,7214,GB,GB
32896,1699291500,1699326480,34980,79546,22745,TR,TR
146421,1699402260,1699417440,15180,117794,96823,US,US
157384,1699834740,1699868220,33480,132723,104935,TR,TR
176345,1699624320,1699656900,32580,168228,48854,TR,TR
13373,1700554260,1700578080,23820,32166,43918,DE,FR
102328,1699164780,1699196640,31860,160901,59824,TR,TR
172222,1700667060,1700677200,10140,193789,70763,IT,IT
78120,1700020740,1700056080,35340,59534,157083,TR,TR
179160,1699044480,1699058820,14340,56587,63819,US,MX
81704,1699842300,1699858980,16680,195702,102338,US,US
52222,1700441520,1700447820,6300,161488,92196,NL,PL
45294,1698970980,1698999900,28920,109796,47616,TR,TR
80109,1699010040,1699042800,32760,54831,171078,TR,TR
150690,1699514460,1699518840,4380,127951,112941,GB,GB
151988,1700148600,1700185800,37200,60314,11142,MX,MX
197477,1700174160,1700185740,11580,185532,12874,US,US
1990,1699325040,1699356360,31320,133312,72439,TR,TR
41864,1699291200,1699320120,28920,102962,168287,TR,TR
104371,1699426140,1699460940,34800,177317,97062,TR,TR
96528,1699538400,1699572780,34380,27992,107080,TR,TR
12255,1699074780,1699090800,16020,141336,148588,FR,PL
98516,1699613820,1699629060,15240,197011,77703,US,US
125937,1699014240,1699042740,28500,151333,190149,DE,NL
179729,1698903960,1698929400,25440,165023,68725,DE,RS
167452,1699095720,1699107960,12240,31958,99388,IT,IT
198047,1700122260,1700156640,34380,1600,121085,TR,TR
182762,1699598940,1699632720,33780,144769,154581,TR,TR
64771,1700697540,1700704620,7080,32959,40183,GB,GB
100108,1699100880,1699131960,31080,16812,15145,TR,TR
93063,1699314180,1699326840,12660,2877,57916,SK,SK
112768,1700575560,1700589660,14100,183513,83567,IT,IT
162742,1700832600,1700836200,3600,8081,174401,GB,GB
53441,1699243140,1699261800,18660,88768,44840,FR,FR
16670,1700835240,1700852460,17220,39389,51252,US,US
56583,1700471520,1700507280,35760,48429,13054,TR,TR
23319,1699777020,1699780980,3960,10615,70252,GB,GB
68793,1700652300,1700682720,30420,40842,159340,BA,DE
39643,1700719080,1700754660,35580,124545,125178,TR,TR
74747,1699943460,1699979100,35640,100228,81138,TR,TR
66923,1700494320,1700526120,31800,118386,9839,TR,TR
109882,1700357820,1700387100,29280,190528,23818,TR,TR
41841,1699331220,1699364580,33360,83512,50036,TR,TR
3433,1700619060,1700633760,14700,30344,101727,US,US
51431,1700659200,1700694540,35340,29472,63586,TR,TR
24711,1699504680,1699514820,10140,19678,117555,PT,PT
25302,1699636260,1699669080,32820,525,161900,TR,TR
174036,1699229160,1699245660,16500,62363,168910,AT,DE
130691,1699738620,1699768440,29820,105836,44416,TR,TR
158475,1699705320,1699716600,11280,135309,14834,US,US
84049,1699318680,1699322820,4140,30762,30592,NL,NL
101138,1700255880,1700267160,11280,109570,136366,IT,IT
186749,1699132680,1699162800,30120,53806,55392,TR,TR
62989,1699477080,1699510200,33120,198163,127470,TR,TR
147354,1699215480,1699219080,3600,56721,80941,GB,FR
15179,1699055880,1699069320,13440,38249,104853,AT,AT
86943,1699896720,1699929000,32280,55152,57694,TR,TR
3144,1700060160,1700093280,33120,115783,54572,TR,TR
174598,1699984380,1700014800,30420,176393,126913,TR,TR
107339,1700160540,1700164140,3600,146289,140647,GB,GB
114244,1699657800,1699671420,13620,179224,192185,CZ,SK
81097,1699666980,1699673820,6840,116374,163728,NL,BE
170106,1699212420,1699228500,16080,43632,65985,US,US
98125,1700775900,1700791860,15960,42091,73125,SE,NO
14060,1700421480,1700436840,15360,6941,176925,AT,AT
104784,1700851620,1700885580,33960,168989,124731,TR,TR
104295,1699391460,1699403340,11880,56702,31169,PT,PT
30093,1700808300,1700843220,34920,194081,12041,TR,TR
74071,1700377200,1700399760,22560,40004,156222,RO,RO
163492,1699504680,1699519440,14760,151479,149756,US,US
93867,1700054100,1700058420,4320,97512,196746,NL,NL
43814,1700757300,1700768220,10920,32642,5300,US,US
6517,1698943080,1698949620,6540,33544,128915,GB,GB
103048,1700413980,1700437080,23100,183480,25018,DE,DE
150189,1700848860,1700865480,16620,152972,97823,SE,SE
23627,1699540740,1699570920,30180,55651,35479,TR,TR
73927,1700171880,1700178600,6720,123338,129001,NL,NL
116625,1699146120,1699149720,3600,149088,51588,NL,NL
45861,1698796140,1698829680,33540,162747,65959,TR,TR
83778,1698934920,1698947520,12600,118266,40090,US,US
133912,1698956700,1698984540,27840,41853,183906,BR,BR
21387,1698812040,1698841860,29820,167408,155447,TR,TR
22248,1700477700,1700510880,33180,44288,64381,TR,TR
146549,1699264140,1699274580,10440,85157,112312,IT,IT
161321,1699713060,1699739040,25980,102085,41984,DE,DE
3669,1700652720,1700684100,31380,22876,172886,TR,TR
176027,1700436180,1700449620,13440,118925,174026,IT,IT
168398,1700673240,1700676840,3600,82896,110091,GB,GB
81619,1699930380,1699934520,4140,114369,19122,GB,GB
149471,1700684580,1700697660,13080,115668,135687,ES,ES
115693,1699782000,1699815540,33540,108310,19163,TR,TR
66073,1699731720,1699763160,31440,66703,86920,TR,TR
59950,1699916580,1699944780,28200,117145,86639,DE,DE
139254,1699902720,1699908240,5520,18897,135147,GB,GB
115412,1700788320,1700820360,32040,49212,170904,TR,TR
60545,1699352340,1699387740,35400,173888,73404,TR,RO
52836,1700051940,1700064000,12060,96618,43627,IT,IT
130661,1700694000,1700706480,12480,21681,24002,US,US
34836,1700136840,1700140440,3600,85564,115845,GB,GB
19119,1699818780,1699823400,4620,37609,96627,NL,NL
132928,1699547580,1699578240,30660,129101,80788,TR,TR
7697,1700137200,1700140800,3600,57570,70477,GB,GB
95321,1700738340,1700756160,17820,110768,167313,US,US
196715,1700130000,1700133600,3600,115914,56596,GB,GB
86895,1699955940,1699963500,7560,32433,86679,HR,HR
45520,1699736340,1699765260,28920,87498,155081,TR,TR
130387,1699154100,1699165140,11040,179575,149568,RS,RS
30691,1699752540,1699784340,31800,180855,88301,TR,TR
109112,1699369260,1699372860,3600,126754,189536,GB,GB
10423,1699218060,1699232280,14220,184898,134315,US,US
169907,1699474020,1699485840,11820,42406,179466,ES,ES
43672,1700616780,1700634600,17820,39352,2607,RS,IT
168231,1700672820,1700683440,10620,36728,159582,IT,IT
41672,1698987480,1699019160,31680,193911,171580,TR,TR
143275,1700058000,1700081460,23460,190986,105660,PL,PL
76902,1700356680,1700389140,32460,1330,276,TR,TR
45602,1700133000,1700140260,7260,159108,47006,IT,IT
90525,1699124820,1699157520,32700,81469,23150,TR,TR
193861,1700166480,1700182200,15720,185002,30860,FR,SK
69377,1700848800,1700880540,31740,159620,142563,TR,TR
46359,1699310520,1699349400,38880,178783,129279,MX,MX
180648,1698974460,1698990780,16320,113155,134194,US,US
179145,1700840880,1700844480,3600,64690,140413,GB,GB
137276,1699153560,1699161060,7500,23200,7954,IT,FR
160882,1699238280,1699267740,29460,108724,75769,TR,TR
133827,1699356420,1699360020,3600,165194,163304,NL,FR
6835,1700148420,1700179140,30720,116701,169368,TR,TR
86143,1699397700,1699414320,16620,5874,176502,RS,RS
129426,1699078500,1699112100,33600,72200,11807,TR,TR
82646,1700801700,1700829240,27540,185060,25620,RO,MD
173291,1700636160,1700648760,12600,94202,144807,IT,IT
191213,1699326180,1699350660,24480,194585,155304,BR,BR
19730,1700802780,1700812260,9480,174823,102376,PT,PT
56423,1700124660,1700154960,30300,47918,61038,TR,TR
80989,1700159940,1700191980,32040,132019,122533,TR,TR
48597,1700676780,1700682540,5760,171894,73286,NL,DE
91042,1700383740,1700419560,35820,139808,129725,TR,TR
135157,1699397460,1699401060,3600,96305,157317,GB,GB
155343,1699057020,1699087080,30060,84872,83838,TR,TR
52044,1698824100,1698827700,3600,21791,185718,GB,GB
47214,1698860820,1698887520,26700,80977,46816,PL,DE
10722,1700247960,1700278200,30240,156277,160103,TR,TR
134312,1699678920,1699710960,32040,41832,164425,TR,TR
138322,1700270520,1700276880,6360,124038,14843,NL,NL
8,1700204880,1700235780,30900,134562,160383,TR,TR
66900,1700158860,1700177640,18780,161314,49963,FR,FR
197367,1699946580,1699950180,3600,193675,42488,GB,GB
53709,1700013960,1700072160,58200,143716,23745,UA,PL
112785,1698960840,1698995700,34860,79909,14810,TR,TR
197226,1700223900,1700239500,15600,39438,127944,FR,FR
6932,1699748520,1699779660,31140,182458,189521,TR,TR
41578,1699855140,1699860720,5580,56938,22940,NL,NL
44986,1699053240,1699064580,11340,164610,134702,IT,IT
9291,1700053740,1700064780,11040,195910,198055,HR,HR
154045,1700568660,1700580720,12060,159777,84458,US,US
172682,1700736840,1700753040,16200,49195,136398,US,US
62996,1699474440,1699485480,11040,99713,160591,PT,PT
198698,1699009980,1699026540,16560,55278,56310,US,US
48615,1700181300,1700213520,32220,88864,185304,TR,TR
199920,1700123880,1700137680,13800,124414,132631,RS,MK
89797,1700656680,1700685180,28500,34373,154287,DE,CH
76768,1699981440,1700012100,30660,140482,189814,TR,TR
66870,1699479600,1699491240,11640,154979,74970,US,US
143349,1699708620,1699740300,31680,109571,33886,TR,TR
12256,1700408220,1700443080,34860,185466,190284,TR,TR
123494,1700469120,1700485440,16320,169088,146766,US,US
173670,1700537880,1700576820,38940,1576,3478,MX,MX
157049,1699063320,1699096740,33420,757,162468,TR,TR
134207,1699179300,1699186260,6960,158970,5085,NL,NL
55596,1699818420,1699852200,33780,41516,191462,MX,MX
3526,1698876180,1698906420,30240,142876,35410,TR,TR
65798,1699923600,1699948740,25140,166457,23654,DE,AT
147281,1699981740,1699993740,12000,45871,17584,US,US
63497,1698895140,1698925080,29940,163692,44522,TR,TR
194565,1698799920,1698825540,25620,176468,104638,RO,RO
122422,1700418660,1700449380,30720,143495,95398,TR,TR
147677,1698891060,1698920040,28980,97833,11053,TR,TR
144729,1700087820,1700101080,13260,77727,45180,AT,DE
55525,1699829340,1699841760,12420,47257,126407,US,CA
95187,1699398000,1699403220,5220,187099,182811,NL,NL
10681,1699585800,1699589400,3600,104666,48566,GB,GB
76411,1700236140,1700247960,11820,44934,8745,IT,IT
111991,1700062560,1700093400,30840,21823,145388,TR,TR
92062,1700419920,1700423520,3600,7487,184349,GB,GB
139888,1700754420,1700772000,17580,186994,120856,US,US
108166,1700490540,1700505120,14580,102276,48962,US,US
76707,1699086360,1699100820,14460,75569,114240,SE,SE
58606,1700788380,1700823120,34740,39932,85801,TR,TR
51405,1700673360,1700677620,4260,68172,45457,NL,NL
11273,1699453980,1699483920,29940,144616,196045,TR,TR
185396,1699024620,1699048800,24180,7981,88630,DE,HU
78035,1700544420,1700548560,4140,144098,60739,GB,GB
49078,1700447640,1700480580,32940,135263,111680,TR,TR
18528,1700162880,1700169240,6360,35774,34542,GB,GB
137990,1699549740,1699583340,33600,48576,43303,TR,TR
160948,1699327440,1699336920,9480,156059,187580,IT,FR
66406,1698823560,1698856260,32700,118057,25183,TR,TR
146902,1698864180,1698894360,30180,128420,132977,TR,TR
37019,1699356900,1699368900,12000,45118,77821,US,US
194791,1699738080,1699771140,33060,125651,66772,TR,TR
100861,1700483280,1700512500,29220,104148,167692,TR,TR
167498,1700478180,1700481780,3600,181770,118253,NL,NL
118093,1700510880,1700544720,33840,105349,126617,TR,TR
84777,1699467420,1699474140,6720,85963,134550,GB,GB
33929,1700506320,1700517240,10920,143289,122070,US,US
120590,1700681820,1700716320,34500,103221,73647,TR,TR
110256,1700790480,1700822400,31920,164157,10043,TR,TR
39908,1699060680,1699078440,17760,28971,104370,US,US
135171,1700283480,1700287320,3840,154641,48688,FI,EE
170294,1699226760,1699238400,11640,111844,99239,PT,PT
105555,1700349960,1700360580,10620,108436,115016,IT,IT
47953,1699203840,1699214520,10680,169980,15495,IT,IT
4619,1699692240,1699702920,10680,80162,183594,IT,IT
18009,1700460120,1700481780,21660,45095,67973,RO,RO
107258,1700366700,1700378580,11880,95372,104006,IT,IT
83823,1700068020,1700080740,12720,13839,15075,US,US
144439,1700492280,1700505960,13680,106261,166226,IT,IT
177620,1699802280,1699832940,30660,105450,96946,TR,TR
169983,1700100960,1700104560,3600,95142,64128,GB,GB
95516,1699367220,1699426380,59160,167403,50828,UA,CZ
587,1698960240,1698966300,6060,98070,50109,NL,NL
175276,1700816280,1700829120,12840,144230,121228,US,US
122872,1700381520,1700387580,6060,33491,163912,GB,GB
22198,1700227740,1700242860,15120,110547,67931,US,US
151367,1699547100,1699551180,4080,102971,54220,NL,NL
18636,1700056980,1700062680,5700,199812,146327,GB,GB
216,1700555580,1700574720,19140,52552,1948,FR,DE
137386,1699956180,1699985040,28860,53432,118933,TR,TR
35522,1700121660,1700150820,29160,177037,64581,TR,TR
55080,1699722300,1699751100,28800,45786,47576,TR,TR
141256,1700673480,1700707920,34440,4056,148377,TR,TR
151452,1699565520,1699596180,30660,137568,160195,TR,TR
84287,1700117940,1700152380,34440,57523,120767,TR,TR
40281,1699869600,1699873200,3600,90874,4098,NL,NL
18317,1700849940,1700867580,17640,8728,157978,FR,IT
129657,1700002020,1700015100,13080,48111,112189,AT,AT
165175,1699183200,1699193160,9960,182383,58084,HR,HR
56839,1700364900,1700400720,35820,122074,131747,TR,TR
89172,1700465220,1700494200,28980,6345,144264,TR,TR
177737,1699813140,1699816740,3600,157613,89988,NL,NL
106634,1700105940,1700138940,33000,193804,93833,TR,TR
12122,1700062200,1700096700,34500,93205,90175,TR,TR
106600,1700094240,1700104500,10260,79265,80789,HR,HR
109502,1698940080,1698957540,17460,76072,68254,US,US
40850,1699181760,1699197300,15540,48018,179999,AT,DE
110490,1699330320,1699344360,14040,129866,4102,US,US
89056,1700149500,1700153100,3600,53254,32485,GB,GB
30332,1699923240,1699926840,3600,8788,98055,NL,NL
8428,1699235580,1699267140,31560,147621,186159,TR,TR
104979,1698873960,1698877560,3600,184414,105735,NL,NL
13524,1699006080,1699012080,6000,66327,128198,NL,NL
64104,1700246100,1700268600,22500,196104,40294,PL,PL
133743,1698857160,1698885780,28620,2930,12929,CH,DE
181007,1700672520,1700689800,17280,2533,190064,US,US
193511,1699812900,1699835340,22440,40974,17597,HU,AT
28071,1699686660,1699696020,9360,126426,37572,IT,IT
73256,1699529700,1699552020,22320,5468,196041,DE,CZ
40000,1700290800,1700300700,9900,124625,46425,PT,PT
20269,1698961860,1698968220,6360,60505,18333,GB,GB
20932,1700571300,1700577420,6120,47614,138402,NL,NL
63408,1700775360,1700786700,11340,12281,48078,US,US
175479,1699847340,1699878240,30900,75980,24355,TR,TR
152956,1700692680,1700702520,9840,124868,51489,EE,FI
168133,1699408440,1699412340,3900,57291,170202,GB,GB
97066,1699261500,1699274100,12600,24523,89207,US,US
117087,1699171800,1699180620,8820,10048,55772,PT,PT
42031,1700026680,1700031780,5100,70441,70684,GB,GB
144362,1700539620,1700550660,11040,140660,75466,US,US
35547,1700585640,1700596260,10620,34602,158090,IT,IT
110431,1699315560,1699321980,6420,56414,168330,NL,NL
126047,1699216320,1699230060,13740,139824,132831,ES,ES
149476,1699081080,1699107960,26880,63637,61890,CH,DE
110932,1700789100,1700801340,12240,115638,38558,IT,IT
49975,1700126940,1700162220,35280,183281,137379,TR,TR
84602,1699905240,1699911900,6660,160475,123240,NL,BE
116008,1700432760,1700464380,31620,147005,51473,TR,TR
160749,1699192620,1699198560,5940,9295,111905,NL,RS
9719,1699246440,1699301280,54840,95256,190910,BG,AT
71308,1700018280,1700053380,35100,102229,91920,MK,RS
174736,1699111020,1699146180,35160,31725,134075,TR,TR
135017,1700617860,1700649000,31140,40494,184415,TR,TR
36688,1700227500,1700258520,31020,165234,70156,MK,RS
41268,1699158000,1699168320,10320,11081,104101,HR,HR
137851,1698900960,1698910920,9960,10516,150444,ES,ES
144079,1699578540,1699614300,35760,188613,12917,TR,TR
50725,1699325340,1699329600,4260,103976,115223,GB,GB
45466,1699065000,1699095180,30180,51875,113430,TR,TR
72115,1699544460,1699559940,15480,128115,151002,US,US
114897,1700669100,1700684460,15360,77383,147613,CZ,AT
92723,1700421120,1700427240,6120,58652,20894,GB,GB
133907,1699843080,1699860180,17100,125702,9936,US,US
141264,1698975180,1699008480,33300,83057,136412,MX,MX
72522,1698994800,1699024980,30180,110165,58371,TR,TR
43680,1699800000,1699827840,27840,158785,168921,RO,RO
29062,1700700900,1700715840,14940,193860,29070,US,US
153405,1699183740,1699196820,13080,125645,48106,US,US
133532,1699637820,1699672200,34380,160856,61305,TR,TR
132516,1699951260,1699977600,26340,85867,98012,DE,FR
48285,1699691040,1699721040,30000,194090,174667,TR,TR
26592,1700207760,1700219400,11640,103103,90341,US,US
143848,1699871640,1699905900,34260,129229,20162,TR,TR
33068,1699881420,1699890180,8760,191881,196193,IT,IT
195845,1700714760,1700726640,11880,120276,176180,US,US
27165,1700244120,1700278260,34140,165608,32436,TR,TR
24091,1700064540,1700099700,35160,5976,76024,TR,TR
168309,1700488320,1700501460,13140,80741,179501,IT,IT
152188,1700638740,1700649480,10740,199984,139055,ES,ES
194872,1699336320,1699366440,30120,176059,133034,TR,TR
164780,1699477920,1699501320,23400,26502,35936,DE,PL
151807,1699296840,1699306620,9780,114577,27854,IT,IT
117163,1699235340,1699274400,39060,82331,110233,MX,MX
194063,1699092600,1699122600,30000,53985,15039,TR,TR
153532,1698965580,1698969960,4380,93581,108288,GB,GB
82916,1699121880,1699155660,33780,73976,43403,TR,TR
147374,1699768680,1699792320,23640,142969,46180,RO,RO
194908,1700174040,1700186160,12120,130440,126918,US,US
158728,1699224120,1699227720,3600,110045,108665,GB,GB
102158,1699678320,1699705740,27420,11585,168229,DE,DE
143346,1700548080,1700561880,13800,66352,124097,US,MX
191501,1699070580,1699100160,29580,190509,180364,TR,TR
99016,1700475480,1700510640,35160,63948,157048,TR,TR
14222,1700063640,1700093160,29520,34293,25675,TR,TR
167015,1700084460,1700089740,5280,173391,196667,NL,HR
138536,1700525040,1700528640,3600,153701,57658,GB,GB
22994,1700389080,1700420820,31740,87769,173634,TR,TR
146853,1699346580,1699361100,14520,126442,144455,AT,RS
6119,1699677180,1699694220,17040,90627,68174,US,US
74059,1700786460,1700790060,3600,12342,59181,NL,NL
149086,1700183640,1700200140,16500,17241,74266,US,US
56844,1700358480,1700369940,11460,102642,108655,CZ,CZ
162270,1700664000,1700696340,32340,16470,68095,TR,BG
45517,1699092300,1699095900,3600,31499,43848,GB,GB
74349,1699776780,1699789200,12420,35808,15512,ES,FR
174502,1699008000,1699037520,29520,102516,86200,TR,TR
179611,1699636140,1699651020,14880,114891,3527,US,US
145650,1700715480,1700719320,3840,66658,114614,NL,NL
43348,1699885260,1699922160,36900,167988,178165,MX,MX
105103,1699575540,1699604400,28860,179793,34985,TR,TR
57197,1700432880,1700457660,24780,118528,26886,PL,FR
135872,1700225640,1700261340,35700,17475,140685,TR,TR
60242,1699962300,1699994340,32040,119652,135550,TR,TR
53725,1699540560,1699573080,32520,155658,158306,TR,TR
96910,1699494240,1699529400,35160,52381,80964,TR,TR
20219,1699701780,1699726020,24240,136489,23324,DE,DE
186750,1699086900,1699111560,24660,5774,16912,PL,DE
175292,1699824120,1699854780,30660,162347,109221,TR,TR
117581,1700292720,1700322660,29940,173493,182676,TR,TR
194371,1699223700,1699227300,3600,81620,21689,GB,GB
90448,1699475040,1699488540,13500,14353,44523,HR,HR
104229,1700158740,1700175660,16920,12596,159891,US,US
40698,1699611720,1699638960,27240,171189,185917,HU,HR
66561,1700192100,1700206380,14280,49098,31099,HR,HR
135880,1698873000,1698906780,33780,102232,120407,TR,TR
33825,1699086000,1699111080,25080,61840,161829,BR,BR
130520,1699296780,1699307220,10440,116283,107788,IT,IT
20737,1699510980,1699523880,12900,31072,95433,US,US
62653,1700155560,1700185500,29940,188975,172440,TR,TR
2623,1699070340,1699077540,7200,136816,63403,IT,IT
65699,1699127100,1699152960,25860,167927,118424,BR,BR
162380,1699552380,1699567080,14700,117677,185919,BE,FR
56687,1700808540,1700820480,11940,126482,24830,RS,RS
162305,1699692300,1699729860,37560,142286,167388,MX,MX
113061,1699694160,1699714620,20460,171535,100902,BE,PL
190181,1699117260,1699121280,4020,91036,3476,GB,GB
53024,1700414100,1700425380,11280,136590,58953,HR,PL
16750,1699381980,1699405440,23460,161840,63222,DE,IT
65833,1699474680,1699509060,34380,152489,157355,TR,TR
29696,1700749260,1700777400,28140,101147,102411,DE,PL
35638,1700716680,1700720280,3600,106517,101042,GB,GB
169351,1699541280,1699571700,30420,12478,117459,TR,TR
68836,1698969180,1698981540,12360,191241,135704,AT,BG
2285,1700267100,1700283420,16320,195986,74836,US,US
3276,1699560720,1699590180,29460,2320,190894,TR,TR
39064,1698925980,1698960060,34080,189434,82714,TR,TR
146103,1700160660,1700173980,13320,142354,101256,IT,IT
54449,1699140120,1699175820,35700,141694,181042,TR,TR
66674,1699499280,1699534380,35100,157623,161092,TR,TR
184155,1700451420,1700455020,3600,90683,180264,NL,NL
192481,1699383780,1699438920,55140,163386,73487,BG,HU
150033,1699238640,1699298220,59580,162567,176999,UA,PL
84642,1700287140,1700290740,3600,87433,152781,GB,GB
184639,1700514540,1700549400,34860,8987,194074,TR,TR
24747,1700606460,1700615940,9480,54522,51284,IT,IT
185032,1699993020,1700026680,33660,58330,88444,TR,TR
23102,1700333700,1700343240,9540,169774,146864,HR,HR
72846,1698799620,1698821760,22140,96599,43711,BR,BR
146930,1699742520,1699749240,6720,16458,189499,NL,DE
190655,1700842560,1700865540,22980,195388,119757,HU,RS
188077,1698798180,1698817740,19560,165920,182556,BE,NL
160516,1700231520,1700267160,35640,19068,154835,TR,TR
196870,1699287000,1699311420,24420,35303,25115,PL,PL
160177,1700636940,1700671380,34440,121333,31833,MX,MX
162924,1700235060,1700264700,29640,144938,23512,TR,TR
174621,1699533900,1699562940,29040,69875,99766,TR,TR
198775,1700538300,1700541900,3600,24976,118754,NL,NL
156223,1700266980,1700270580,3600,122550,41894,NL,NL
134842,1699696320,1699713120,16800,136361,182089,US,US
138897,1700712780,1700723520,10740,25230,11830,PT,PT
163585,1699373220,1699388040,14820,40800,13594,US,US
5831,1699013940,1699021020,7080,168960,160292,NL,BE
23701,1699882260,1699915080,32820,59904,164409,TR,TR
78990,1700073720,1700104560,30840,100520,122812,TR,TR
123524,1700275620,1700279220,3600,172311,137038,GB,GB
127942,1698825420,1698859140,33720,179798,130239,TR,TR
112055,1698936660,1698940260,3600,196231,26864,GB,GB
89177,1699313340,1699345980,32640,166387,59555,TR,TR
145893,1700172360,1700185380,13020,157556,111916,US,US
83479,1699950120,1699953720,3600,38897,108846,GB,GB
116651,1699863540,1699876380,12840,72745,191222,US,US
155957,1699804680,1699821120,16440,86344,161559,US,US
124653,1700828220,1700857560,29340,189923,80151,TR,TR
150545,1700782800,1700796780,13980,10421,62825,AT,AT
116995,1698950220,1698964020,13800,91234,100633,IT,IT
36188,1699052100,1699065120,13020,158661,155626,HR,DE
177828,1699684260,1699712520,28260,91829,198293,BA,ME
45550,1699641540,1699674180,32640,191615,177174,TR,TR
47435,1700709600,1700744640,35040,189478,26335,TR,TR
97047,1699086060,1699092360,6300,165226,61843,GB,GB
121065,1700375400,1700406240,30840,151069,33839,TR,TR
198192,1700347020,1700350620,3600,104302,120358,GB,GB
118018,1700670300,1700702700,32400,103244,16170,TR,TR
175950,1699583400,1699615800,32400,50858,81627,TR,TR
39206,1699126500,1699160520,34020,127472,165054,TR,TR
87067,1698867300,1698874980,7680,83689,64825,IT,IT
70400,1698798600,1698822420,23820,138247,36620,DE,DE
40849,1700453340,1700466120,12780,139125,48713,US,US
37572,1700776380,1700783160,6780,49240,132041,NL,NL
76518,1699013940,1699027860,13920,43783,5231,US,CA
165020,1699822140,1699834980,12840,140905,33838,US,US
143862,1700537760,1700544600,6840,165961,162589,GB,GB
146394,1700194080,1700205420,11340,166084,96071,US,US
62636,1700671140,1700686800,15660,58406,177626,US,US
85473,1699248660,1699277520,28860,133522,30780,TR,TR
170175,1699651860,1699661040,9180,51228,137889,IT,IT
151544,1699144140,1699159980,15840,29763,93298,US,CA
19570,1699183080,1699189260,6180,199381,131495,GB,GB
73480,1699493100,1699505520,12420,38329,82200,US,US
155441,1700441580,1700471400,29820,192748,152295,TR,TR
173774,1699837860,1699847820,9960,88760,18805,IT,IT
8438,1700111520,1700115120,3600,166949,132365,GB,GB
100053,1698936420,1698971880,35460,119575,187182,TR,TR
139480,1699964580,1700002920,38340,165884,120473,MX,MX
19107,1699137600,1699167360,29760,20574,145011,TR,TR
112854,1699093920,1699129020,35100,119923,152292,TR,TR
94979,1699699680,1699728780,29100,144203,163981,TR,TR
198347,1700378820,1700391480,12660,131130,96504,IT,IT
55657,1699560300,1699565520,5220,33626,71436,NL,NL
196867,1699306740,1699340760,34020,177358,113438,TR,TR
101103,1699440120,1699443720,3600,663,150299,GB,GB
157657,1700267760,1700271360,3600,172766,169221,GB,GB
5574,1700700960,1700708040,7080,135563,29629,AD,ES
132842,1700448420,1700456880,8460,366,192195,IT,IT
131546,1700013720,1700042220,28500,86789,35482,CH,IT
119024,1699641000,1699676040,35040,1607,188563,TR,TR
95895,1699390800,1699395240,4440,93295,25625,GB,GB
94259,1700589960,1700599500,9540,169596,122814,PT,PT
81247,1700406660,1700463840,57180,182867,49759,BG,RS
72127,1699395960,1699418340,22380,95924,40253,DE,DE
139797,1699191840,1699226400,34560,129155,188232,TR,TR
39914,1700701980,1700730840,28860,173993,57800,TR,TR
129737,1699614960,1699626960,12000,21504,77385,US,US
58996,1700574180,1700587920,13740,66312,142998,US,US
64695,1699571400,1699575000,3600,53066,63845,GB,GB
76625,1700672460,1700684340,11880,126419,56130,US,US
142937,1699771200,1699800060,28860,180780,44700,TR,TR
99897,1700421000,1700454360,33360,103381,170204,TR,TR
111233,1699056900,1699087140,30240,94129,429,TR,TR
24422,1700187660,1700194920,7260,40383,21921,IT,IT
177950,1700061300,1700091480,30180,55546,143805,TR,TR
183136,1699401000,1699413600,12600,123322,8553,US,MX
123234,1699665480,1699697580,32100,9620,158141,TR,TR
142018,1700380800,1700408460,27660,71112,136938,HU,IT
31016,1699166460,1699200360,33900,11358,11353,TR,TR
150731,1698923160,1698936240,13080,93140,198727,US,US
85580,1700505960,1700509560,3600,2834,160272,NL,NL
104624,1699123800,1699135200,11400,105937,165052,US,US
27203,1699945740,1699971300,25560,163122,14629,DE,DE
141959,1699640220,1699651740,11520,155530,182789,IT,IT
31116,1699048500,1699081440,32940,13341,103493,TR,TR
55239,1698899460,1698912420,12960,19320,49398,US,US
62684,1700560920,1700581620,20700,82399,153076,IN,IN
6134,1698838200,1698845160,6960,130111,122192,NL,NL
59435,1700610180,1700625840,15660,138850,172773,US,US
187025,1699654020,1699662360,8340,25197,22922,IT,IT
130719,1699828920,1699858440,29520,65271,145137,TR,TR
170940,1699498380,1699510140,11760,124111,62023,IT,IT
107129,1699762380,1699775700,13320,157797,38438,IT,IT
8403,1698967740,1698992220,24480,68514,199103,PL,PL
37910,1700612880,1700640540,27660,165680,189337,DE,DE
110635,1699891620,1699906020,14400,22519,118964,US,US
97201,1699357020,1699363440,6420,47538,2836,GB,GB
171361,1700070960,1700101080,30120,72817,131140,TR,TR
34323,1700538120,1700567580,29460,35756,118589,TR,TR
189843,1699657800,1699690500,32700,161846,192303,TR,TR
186126,1698841140,1698864480,23340,153380,78782,DE,DE
100110,1700105940,1700141340,35400,105356,98941,TR,TR
198326,1699973340,1699997520,24180,131816,144998,PL,PL
18983,1700240100,1700252820,12720,15324,32497,AT,SK
110211,1699195680,1699199280,3600,148566,83801,NL,NL
183559,1699684260,1699714920,30660,2790,183577,TR,TR
166211,1699240200,1699270500,30300,142689,60259,TR,TR
199989,1700559900,1700577840,17940,94033,64812,AT,BA
115755,1699181040,1699191000,9960,4978,104660,IT,IT
58952,1699118040,1699131660,13620,56129,138567,US,US
65923,1699435320,1699438920,3600,106761,76480,GB,GB
177666,1700225940,1700233740,7800,110146,152898,IT,IT
120610,1700311740,1700342520,30780,64573,146957,TR,TR
108214,1700226780,1700234100,7320,153385,20398,IT,IT
68179,1700851800,1700877360,25560,73230,26492,DE,SE
180217,1700643000,1700677140,34140,134846,88890,TR,TR
50671,1698859380,1698884040,24660,34824,58540,DE,AT
35339,1699300980,1699304580,3600,30030,5423,NL,NL
17913,1699678260,1699709400,31140,187307,76643,TR,TR
57196,1700268120,1700298120,30000,91885,93021,TR,TR
17821,1700137320,1700154000,16680,35552,164664,FR,RS
60604,1699806000,1699841160,35160,129196,55636,TR,TR
166861,1699749900,1699768560,18660,138182,180559,FR,BE
124589,1700509140,1700521020,11880,126836,93054,IT,IT
146263,1700470080,1700485380,15300,6037,104550,CZ,FR
138887,1700326500,1700342760,16260,34986,34737,US,US
164262,1699245900,1699278600,32700,39771,169243,TR,TR
67878,1700021760,1700025360,3600,53167,14518,NL,BE
18276,1699665180,1699697340,32160,9866,77235,TR,TR
81028,1698833340,1698846000,12660,62872,5051,IT,IT
145468,1699913580,1699939500,25920,119351,53855,DE,DE
78086,1699270500,1699305600,35100,16564,68532,TR,TR
104142,1700828880,1700854860,25980,67915,85000,RO,RO
195791,1699846380,1699879200,32820,133762,24482,TR,TR
193797,1699460700,1699470000,9300,143138,69903,IT,IT
7813,1700054400,1700069460,15060,10580,81890,US,US
162009,1700695620,1700720760,25140,47951,49314,DE,RS
99908,1700259900,1700265840,5940,104834,54083,GB,GB
55822,1700838960,1700870220,31260,125914,167517,TR,TR
80495,1700004720,1700021820,17100,157888,135069,FR,IT
173858,1699768680,1699775340,6660,10849,194807,GB,GB
10972,1700246580,1700257800,11220,61052,17631,HR,HR
62983,1699259700,1699269360,9660,137584,39088,HR,HR
68576,1700260440,1700293440,33000,11478,32999,TR,TR
126591,1699515600,1699547820,32220,173420,78196,TR,TR
154689,1698810660,1698827940,17280,59787,159693,CZ,CZ
14969,1700627100,1700638440,11340,124058,153241,US,US
21897,1699217340,1699238940,21600,18486,67281,LT,EE
56207,1699373040,1699387500,14460,177917,45593,US,US
59520,1698952320,1698971160,18840,194024,173161,SE,SE
107955,1699788180,1699798140,9960,170413,124720,IT,IT
20134,1699866420,1699901760,35340,102023,171107,TR,TR
110189,1700792160,1700795760,3600,14394,197697,GB,GB
191602,1699137240,1699169280,32040,101125,120965,TR,TR
24559,1700007120,1700015220,8100,173756,18040,ES,ES
63110,1699982220,1700017980,35760,32923,161833,TR,TR
188743,1700811300,1700830800,19500,199336,137380,BE,PL
167971,1700682780,1700697780,15000,127937,26837,US,US
31238,1699198500,1699204260,5760,77849,104992,NL,NL
152048,1699328220,1699341840,13620,190789,118720,US,US
128993,1700225760,1700238720,12960,105480,182527,IT,IT
64704,1699813440,1699844940,31500,63531,179512,TR,TR
183642,1699044960,1699076340,31380,60841,170271,TR,TR
117130,1700420400,1700453160,32760,84781,103354,TR,TR
26883,1699405260,1699429620,24360,82060,70601,DE,DE
71085,1699420800,1699455660,34860,193208,86433,TR,TR
117500,1699585560,1699619700,34140,180516,70756,TR,TR
144817,1699705740,1699733040,27300,26926,103118,PL,PL
20251,1700866620,1700897340,30720,9442,118823,TR,TR
85622,1698817740,1698850500,32760,29992,39822,TR,TR
157226,1700701980,1700736960,34980,139455,130417,TR,TR
159072,1700487840,1700522760,34920,41997,51014,TR,TR
173192,1700244960,1700256480,11520,182586,180184,US,US
146744,1700050920,1700054520,3600,46915,136616,GB,GB
8242,1699691820,1699725180,33360,20796,199582,TR,TR
90157,1700143500,1700152620,9120,32625,20048,IT,IT
91186,1699686540,1699716720,30180,100598,146090,TR,TR
102749,1700696880,1700711040,14160,165837,39423,CZ,CZ
108572,1699120080,1699137660,17580,71975,124846,US,CA
155958,1699004400,1699016880,12480,167597,25591,ES,AD
48961,1699519620,1699553340,33720,103846,99032,TR,TR
185989,1699466040,1699498020,31980,156833,180208,TR,TR
196785,1699593600,1699625160,31560,119394,149953,TR,TR
29303,1700251740,1700283360,31620,6565,1569,TR,TR
174781,1699938180,1699949880,11700,185749,55219,IT,FR
55383,1699849740,1699885080,35340,3308,194808,TR,TR
185769,1700548980,1700581440,32460,73649,174721,TR,TR
91553,1699735680,1699750620,14940,185920,22356,US,US
35577,1700639700,1700700360,60660,21795,26341,UA,PL
170572,1699099860,1699129740,29880,109725,187926,TR,TR
89761,1699099800,1699103400,3600,159369,84471,GB,GB
99568,1699452660,1699457580,4920,50670,144172,NL,NL
73925,1700430360,1700448180,17820,93873,55014,US,US
121984,1698838200,1698849720,11520,41259,8122,IT,IT
88607,1699529040,1699555440,26400,36772,189043,PL,UA
101564,1699196580,1699209000,12420,71329,190981,US,US
128589,1698833820,1698844980,11160,128264,27253,CA,CA
102143,1700224320,1700257620,33300,98583,34055,TR,TR
159867,1699834680,1699843080,8400,153742,34540,IT,IT
71166,1700865840,1700895780,29940,46034,190803,TR,TR
112966,1699135380,1699156860,21480,23311,76677,FR,FR
127520,1700619840,1700650200,30360,151314,67077,TR,TR
100640,1699724940,1699751100,26160,196203,194263,HU,IT
57165,1700601960,1700625420,23460,8142,73358,PL,HR
9770,1699771740,1699800600,28860,121657,115059,TR,TR
8806,1700759940,1700768340,8400,119141,141173,ES,FR
20962,1700205900,1700209500,3600,108934,29906,GB,GB
188726,1699741320,1699774380,33060,24917,85764,MX,MX
34952,1698915420,1698926040,10620,178595,96590,IT,IT
54989,1698896700,1698913920,17220,114570,131371,AT,CZ
20386,1700274720,1700289720,15000,104298,113891,US,US
188334,1700010240,1700041140,30900,99162,183063,TR,TR
6000,1698793500,1698811680,18180,48580,106663,FR,BE
66361,1699290960,1699322640,31680,134319,188673,TR,TR
57859,1698850740,1698859980,9240,123538,11756,IT,HU
14233,1699019400,1699033200,13800,196079,113355,ES,ES
83880,1700727720,1700731320,3600,93510,30170,GB,GB
37721,1700257560,1700290740,33180,91155,52533,TR,TR
46919,1700089140,1700098380,9240,148057,11280,IT,FR
3478,1699176780,1699208280,31500,20452,175132,TR,TR
175631,1699310580,1699315980,5400,34843,159879,NL,NL
113102,1699344600,1699378680,34080,24405,29427,TR,TR
58495,1700152980,1700186400,33420,78924,97571,MX,US
5236,1700862240,1700893560,31320,84049,62373,TR,TR
79740,1698855480,1698889680,34200,193594,81860,TR,TR
154536,1699477620,1699504080,26460,139964,37595,PL,DE
23265,1700549040,1700552640,3600,21905,198435,GB,GB
77668,1700277120,1700280720,3600,14101,143083,NL,NL
177923,1700027880,1700044440,16560,180476,158102,FR,FR
175831,1700058300,1700083620,25320,22103,70649,DE,FR
171093,1700106120,1700128740,22620,56948,106588,PL,PL
71455,1698910680,1698915120,4440,172206,118005,NL,NL
91981,1700512920,1700544540,31620,23203,108798,TR,TR
2818,1700702160,1700709120,6960,190931,44647,GB,GB
22203,1700813880,1700817480,3600,56648,25325,GB,GB
191280,1700136480,1700153100,16620,38845,110072,US,US
522,1699055580,1699061040,5460,97262,103221,GB,GB
105476,1700731620,1700766540,34920,130477,114375,TR,TR
138183,1698948900,1698973680,24780,33595,30402,HU,AT
158046,1700234820,1700249040,14220,175609,157384,IT,IT
31687,1699612440,1699645140,32700,68016,15183,TR,TR
115831,1699306980,1699337820,30840,112534,174373,TR,TR
3990,1699207080,1699240260,33180,2293,27314,TR,TR
109532,1700163060,1700188200,25140,61743,104159,BR,BR
20748,1698930300,1698961320,31020,156083,12786,TR,TR
24104,1700415300,1700433660,18360,65300,43906,SE,SE
72856,1700519640,1700549940,30300,171030,155928,TR,TR
139068,1699128900,1699132500,3600,165850,47765,NL,NL
134754,1699886100,1699892340,6240,50629,135831,GB,GB
34022,1699888800,1699892400,3600,25655,115137,NL,NL
103039,1699404600,1699408200,3600,93266,103242,NL,NL
45404,1699352400,1699362660,10260,23871,166228,IT,IT
125775,1699780020,1699810140,30120,30867,150829,TR,TR
120489,1699935000,1699969020,34020,194631,106500,TR,TR
133021,1699821300,1699831800,10500,94136,133161,EE,EE
124306,1699948260,1699962540,14280,154253,54325,US,US
32871,1699838160,1699869300,31140,197821,56973,TR,TR
81494,1700819280,1700841480,22200,86045,123267,PL,PL
22079,1699032780,1699066860,34080,73637,168654,TR,TR
47615,1700563860,1700577720,13860,25792,106348,US,US
180504,1699399380,1699413720,14340,149522,148543,IT,IT
186996,1700109960,1700113560,3600,128270,144361,GB,GB
190022,1700141160,1700148780,7620,18201,127471,IT,IT
184370,1699628940,1699633560,4620,124423,191798,GB,GB
9942,1698943560,1698949140,5580,193423,32601,GB,GB
197126,1700251320,1700261460,10140,35180,113018,IT,IT
184081,1699172340,1699177980,5640,127971,180632,GB,GB
114372,1699517580,1699532160,14580,117077,4003,SE,SE
184147,1700830260,1700841000,10740,166794,118822,HR,BA
134420,1699477680,1699506900,29220,9995,142381,TR,TR
82327,1700725800,1700759820,34020,76058,7233,TR,TR
89516,1699272960,1699283460,10500,157777,75575,ES,AD
114131,1699088700,1699122420,33720,148487,66843,TR,TR
180541,1700645640,1700681100,35460,124216,100498,TR,TR
64052,1699700220,1699730940,30720,113192,116281,TR,TR
27199,1699110180,1699133100,22920,138321,68233,DE,PT
189741,1700704380,1700732220,27840,119715,137583,BA,HR
13043,1700307240,1700313660,6420,134564,143184,GB,GB
36841,1699346820,1699369860,23040,144298,104399,DE,BG
85141,1700590800,1700623800,33000,118615,117177,TR,TR
58474,1700320920,1700351580,30660,105976,67340,TR,TR
144136,1700616180,1700627940,11760,89211,57202,ES,ES
15494,1700647740,1700673540,25800,127350,96713,DE,DE
64184,1699234560,1699269360,34800,175041,96284,TR,TR
94771,1700003820,1700039280,35460,143956,114413,TR,TR
30487,1700315160,1700349480,34320,163103,123739,TR,TR
25755,1700444940,1700475720,30780,87778,23231,TR,TR
98532,1700797920,1700832900,34980,103810,21433,TR,TR
110800,1700032920,1700062680,29760,98374,126096,TR,TR
7996,1700400900,1700435580,34680,20371,8304,TR,TR
90536,1700501700,1700533440,31740,144585,148080,TR,TR
127251,1699204200,1699234200,30000,147496,11357,TR,TR
75802,1700248380,1700273280,24900,49239,90111,DE,DE
10127,1700500260,1700530140,29880,33047,144511,TR,TR
49249,1699053000,1699083540,30540,45371,111798,TR,TR
125199,1700600280,1700620140,19860,55806,58554,SE,SE
80603,1700170020,1700178420,8400,57365,79524,IT,IT
108859,1700863980,1700899440,35460,59509,60905,TR,TR
68310,1700591280,1700600340,9060,182131,189545,IT,IT
181783,1699876860,1699893660,16800,75012,38068,SE,SE
67466,1700788920,1700802000,13080,43906,99095,US,US
30981,1700559780,1700595240,35460,27660,17374,TR,TR
66299,1699178280,1699181880,3600,33021,88899,NL,NL
151965,1699320660,1699350720,30060,40765,84242,TR,TR
112277,1699539120,1699572540,33420,75467,73545,TR,TR
128531,1699869000,1699904820,35820,84685,55277,TR,TR
62281,1700082240,1700089260,7020,69111,121058,NL,NL
125438,1700001060,1700030340,29280,123032,160201,TR,TR
87128,1700408160,1700424720,16560,95886,84418,US,US
25759,1699977780,1700003220,25440,132979,57920,PL,CZ
68429,1699682820,1699717620,34800,61441,184475,TR,TR
177600,1699813080,1699848600,35520,168785,168201,TR,TR
184256,1700321400,1700355540,34140,187162,100551,MX,MX
82375,1698820680,1698853200,32520,16836,53711,TR,TR
89029,1698954660,1698990060,35400,86930,105871,TR,TR
168921,1700751660,1700786820,35160,128747,154191,TR,TR
85724,1699629120,1699641720,12600,87600,44987,US,US
89808,1700449140,1700468700,19560,58792,30194,FR,DE
149414,1700044860,1700065980,21120,136918,175328,FR,ES
141250,1700718600,1700751720,33120,143730,81747,TR,TR
60566,1700255820,1700269920,14100,129853,148167,PT,PT
11785,1700650680,1700666160,15480,22458,163030,US,US
157143,1699934040,1699962420,28380,10509,155280,DE,DE
89479,1699590360,1699602840,12480,69316,4309,US,US
139807,1698956280,1698986400,30120,149043,160409,TR,TR
28353,1699881960,1699912440,30480,13328,77359,TR,TR
58058,1700142060,1700153820,11760,6674,96208,US,US
46905,1699438800,1699471080,32280,105918,41130,TR,TR
140932,1700017680,1700050920,33240,29559,139846,TR,TR
57943,1699801380,1699826100,24720,113301,15175,PL,DE
182643,1700830500,1700837700,7200,103472,179812,HR,HR
106763,1698881040,1698910560,29520,97889,103501,TR,TR
82125,1699403280,1699406880,3600,75894,181602,GB,GB
70300,1700032740,1700046360,13620,122035,98245,US,US
88291,1699792380,1699827240,34860,187277,77780,TR,TR
190924,1700746140,1700781240,35100,28618,63698,TR,TR
63652,1699846740,1699881120,34380,91516,156738,TR,TR
77448,1700300460,1700327520,27060,67357,37755,DE,DE
101897,1700355120,1700390400,35280,101888,173942,TR,TR
110391,1699021080,1699055760,34680,147666,104270,TR,TR
149269,1698933360,1698940980,7620,109021,118285,IT,IT
65331,1699068960,1699074120,5160,93639,18756,GB,GB
140129,1699665660,1699669620,3960,93886,115662,NL,NL
75277,1699555320,1699588740,33420,27756,103165,TR,TR
114217,1699336740,1699343880,7140,9674,21328,GB,GB
114968,1699009020,1699043580,34560,194000,168358,TR,TR
128389,1700355720,1700368980,13260,139649,118781,IT,IT
119551,1699428360,1699461360,33000,177647,111800,TR,TR
176934,1699159260,1699162860,3600,91742,96270,GB,GB
179558,1699463520,1699475400,11880,115088,44822,AT,BG
128119,1699473420,1699508520,35100,4262,82074,TR,TR
70713,1698807480,1698842700,35220,105564,79154,TR,TR
170023,1699092420,1699116240,23820,77302,114958,DE,DE
161647,1700494320,1700505660,11340,65778,66284,US,US
32843,1699196760,1699203180,6420,139311,94499,GB,GB
76086,1700471820,1700506740,34920,82456,78027,TR,TR
70186,1699773660,1699780980,7320,145819,33006,SK,SK
158798,1700079540,1700109300,29760,72072,124683,TR,TR
13561,1700720100,1700737740,17640,1527,45345,AT,HU
173937,1700605860,1700636040,30180,116109,162803,TR,TR
17199,1700522940,1700553060,30120,9591,33696,TR,TR
129643,1699839840,1699845360,5520,174202,77716,NL,NL
65668,1700064420,1700100000,35580,15724,147491,TR,TR
121916,1700457120,1700460720,3600,47242,120291,NL,BE
157018,1699024680,1699054500,29820,48294,140843,TR,TR
170652,1700557620,1700572860,15240,185164,136972,US,US
193838,1699851240,1699880160,28920,100112,28228,TR,TR
45655,1699098660,1699110420,11760,6274,157851,US,US
56682,1699572600,1699576920,4320,70662,75305,GB,GB
92358,1698798660,1698804720,6060,163706,81468,NL,NL
78071,1699067640,1699080360,12720,152011,150564,US,US
51365,1700520960,1700541360,20400,7665,84212,BE,NL
63847,1700381760,1700385360,3600,145024,89465,GB,GB
190677,1698794520,1698829380,34860,188923,102149,TR,TR
15110,1700705700,1700719500,13800,85145,118769,US,US
39019,1700673480,1700695860,22380,50743,189291,PL,PL
109193,1700653560,1700665260,11700,45294,20580,IT,FR
84119,1698904980,1698908580,3600,94574,138394,GB,GB
85042,1700086560,1700101380,14820,125325,92950,BE,FR
125771,1700497260,1700517840,20580,149625,61091,BE,CH
14059,1700136900,1700168100,31200,85329,177398,TR,TR
117745,1700139960,1700162160,22200,180122,7460,PL,UA
50731,1699592340,1699602240,9900,63729,178640,IT,IT
98296,1699419060,1699447860,28800,14173,50640,TR,TR
167089,1699074840,1699086840,12000,193864,101269,US,US
4402,1700104500,1700137080,32580,49518,57565,MX,MX
185826,1699756560,1699785720,29160,195871,17456,TR,TR
170577,1699774980,1699805700,30720,15820,163313,TR,TR
164377,1699363140,1699392060,28920,163974,11809,TR,TR
134004,1700773320,1700807820,34500,73728,112145,TR,TR
25496,1700146020,1700160240,14220,54769,143761,IT,IT
43659,1699152840,1699164600,11760,17636,60501,ES,CZ
13858,1699965060,1699969920,4860,37763,58934,GB,GB
196372,1700284140,1700311980,27840,102533,182218,PL,PL
148976,1698955380,1698958980,3600,46590,30324,GB,GB
178819,1700526600,1700540040,13440,135487,190145,IT,IT
103915,1699308480,1699316880,8400,145010,127666,IT,IT
25123,1699223760,1699257540,33780,191535,132552,TR,TR
129437,1700209080,1700212680,3600,53050,143263,NL,NL
93865,1700052840,1700065740,12900,34092,96915,US,US
61744,1700595420,1700601900,6480,164807,181332,GB,GB
130055,1700070840,1700102280,31440,135310,169253,TR,TR
147747,1699818420,1699829700,11280,191006,91806,HR,BA
14646,1699909200,1699944360,35160,168703,131446,TR,TR
156663,1699592640,1699597860,5220,132558,81555,CL,CL
56107,1699242720,1699272060,29340,83202,144665,TR,TR
23283,1699052400,1699081260,28860,22286,39356,TR,TR
117287,1700350080,1700376000,25920,50115,79713,DE,AT
172946,1698887100,1698896940,9840,147475,100642,IT,IT
139839,1700769300,1700788140,18840,48385,195401,FR,BE
107657,1700238540,1700247180,8640,130552,111993,IT,IT
57858,1700688840,1700702820,13980,176127,28254,PT,PT
162620,1699746900,1699776120,29220,172391,128976,TR,TR
23780,1700835240,1700848740,13500,77634,74273,US,MX
42727,1699540080,1699543680,3600,73537,44611,GB,GB
109522,1698856860,1698891720,34860,130419,113014,MX,MX
63920,1700456220,1700461980,5760,2319,104148,NL,NL
21957,1700127480,1700161560,34080,122971,114902,TR,TR
41312,1700809800,1700823840,14040,166424,161660,AT,BA
80999,1700170140,1700177760,7620,118278,97993,SK,SK
135986,1699903140,1699938060,34920,38584,78190,TR,TR
198064,1699594860,1699628880,34020,129994,118104,TR,TR
15120,1700529180,1700553840,24660,4572,168190,PL,DE
27629,1699861320,1699872240,10920,124916,185257,US,US
182524,1700756340,1700776980,20640,76255,160294,FR,DE
185316,1699063980,1699067580,3600,186370,32744,GB,GB
197022,1699342860,1699351860,9000,69007,56607,IT,HR
198145,1699049580,1699054800,5220,183074,141632,GB,GB
196390,1700266140,1700272440,6300,192096,194737,GB,GB
131227,1699628640,1699659780,31140,164595,39046,TR,TR
165770,1700763480,1700771820,8340,55941,163436,ES,ES
28637,1699772700,1699806240,33540,3184,28109,TR,TR
170798,1700816460,1700832300,15840,107929,135394,FR,DE
48293,1699046460,1699054140,7680,83906,30867,IT,IT
59508,1698940140,1698966540,26400,161191,50126,DE,DE
189005,1699644600,1699679460,34860,64056,104620,TR,TR
81486,1699013820,1699046820,33000,32610,187360,TR,TR
88131,1700088120,1700112360,24240,177960,103857,DK,SE
95884,1699907220,1699928340,21120,157979,186763,SE,SE
55312,1700436780,1700441340,4560,118708,1699,GB,GB
107961,1699741020,1699744620,3600,123408,15984,NL,BE
50173,1699404420,1699438560,34140,156588,29880,TR,TR
567,1699617180,1699672260,55080,194525,70394,BG,BG
143393,1699165860,1699198200,32340,144766,154261,TR,TR
152067,1699848480,1699887540,39060,152783,38197,MX,MX
112253,1700684340,1700716020,31680,171948,78950,TR,TR
106292,1699423380,1699437480,14100,16904,12819,US,US
19758,1699659240,1699688640,29400,131518,107574,TR,TR
131591,1700551800,1700566680,14880,196547,60537,US,US
65148,1700706360,1700727300,20940,115778,28144,BE,FR
133686,1699055880,1699088880,33000,153121,168314,TR,TR
59737,1700822880,1700833920,11040,28380,119020,US,US
33710,1700068500,1700097540,29040,1518,135794,TR,TR
38639,1699407300,1699420200,12900,130767,111068,US,US
161905,1700144520,1700148120,3600,162102,77234,GB,GB
48518,1700305560,1700311440,5880,61752,43618,GB,GB
122306,1699284360,1699318320,33960,179307,192448,TR,TR
116034,1700108160,1700119380,11220,160121,141355,US,US
179658,1699999800,1700008980,9180,193175,88238,IT,FR
88667,1699440240,1699464900,24660,23122,147901,PL,PL
46105,1699104540,1699114200,9660,97775,193223,IT,IT
67137,1698970920,1698988260,17340,70080,103626,RS,MK
109370,1700434980,1700464800,29820,83886,3080,TR,TR
21920,1700433720,1700468280,34560,156533,135588,TR,TR
112671,1700787780,1700796840,9060,55236,11664,CL,CL
67411,1699862220,1699873860,11640,63282,166828,IT,FR
169046,1700299380,1700302980,3600,14568,38570,GB,GB
13550,1700066940,1700083260,16320,144934,100501,US,US
127993,1700444340,1700452920,8580,14770,62706,IT,IT
82429,1700569440,1700574780,5340,172259,46270,GB,GB
172723,1699531560,1699565400,33840,186286,65878,TR,TR
148869,1700470140,1700473740,3600,53648,87372,NL,NL
155620,1700490780,1700495940,5160,56811,10682,AD,FR
194386,1699014540,1699044060,29520,58154,85366,TR,TR
186060,1698883560,1698887160,3600,105986,169013,NL,NL
156119,1699370700,1699403280,32580,95650,9627,TR,TR
8068,1700784960,1700797200,12240,46381,40241,US,US
101643,1700776860,1700807040,30180,182526,194616,TR,TR
50634,1700432340,1700446440,14100,47824,140864,US,US
15052,1700541180,1700572440,31260,144269,106229,TR,TR
134676,1698941460,1698974460,33000,43106,137449,TR,TR
144581,1700018820,1700039520,20700,32534,8753,FR,FR
174202,1699623960,1699658280,34320,163572,142483,TR,TR
47056,1699720140,1699732320,12180,4523,47936,US,US
193783,1699181940,1699235880,53940,192054,137237,BG,RO
24578,1699777560,1699810920,33360,130899,163137,TR,TR
33333,1699480200,1699496160,15960,47763,156957,US,US
194360,1700185200,1700202120,16920,93010,70751,FR,BE
15480,1699789920,1699803480,13560,195221,41255,IT,IT
12043,1700139600,1700170080,30480,127249,120066,TR,TR
155495,1700331060,1700345820,14760,141492,132335,BE,FR
119497,1699836360,1699869120,32760,196444,192730,TR,TR
125222,1699408260,1699417200,8940,82428,191258,CL,CL
42615,1699781700,1699814040,32340,53391,1632,TR,TR
172157,1699521120,1699538640,17520,129351,120174,US,US
150533,1700262360,1700284680,22320,26031,180477,RO,RO
15896,1698959940,1698983580,23640,150821,172048,BR,BR
193704,1700611860,1700644920,33060,192992,39845,TR,TR
24369,1699191120,1699221840,30720,87089,199729,TR,TR
106059,1700497740,1700524980,27240,18501,131789,DE,NL
88873,1700051280,1700083800,32520,57599,2568,TR,TR
163481,1699403220,1699406820,3600,41160,143672,NL,NL
105975,1699539480,1699551060,11580,130469,197398,US,US
189131,1699159380,1699187100,27720,88323,14506,HU,BG
56823,1699046040,1699079280,33240,64685,112666,TR,TR
10237,1699199880,1699214100,14220,25513,148884,IT,IT
192394,1699500960,1699536180,35220,141007,187309,MX,MX
113757,1699136220,1699150320,14100,127064,61494,AT,DE
181425,1699763580,1699775700,12120,73899,132206,US,US
92776,1700433840,1700447700,13860,164200,68210,HR,HR
132104,1700091720,1700101380,9660,178546,151673,IT,IT
66056,1700564160,1700574420,10260,152235,41979,IT,IT
2492,1698919380,1698954960,35580,131208,121621,TR,TR
22386,1699172100,1699175700,3600,40844,198407,GB,GB
167929,1699918080,1699932660,14580,53260,175409,US,US
6353,1699062000,1699083420,21420,59868,146295,SE,SE
29063,1699395840,1699399440,3600,122648,126466,NL,NL
182589,1700267280,1700275200,7920,65884,148410,PT,PT
70968,1698908340,1698914340,6000,89474,127612,NL,NL
32949,1699575660,1699582380,6720,64043,112860,GB,GB
75753,1699502940,1699509660,6720,25750,75290,GB,GB
128583,1700048460,1700057460,9000,74768,79176,EE,EE
144266,1699635660,1699660920,25260,46647,165025,PL,CH
102535,1699922760,1699941420,18660,155431,160170,FR,FR
53184,1699310220,1699339620,29400,75566,109822,TR,TR
136193,1699187100,1699218120,31020,114267,160263,TR,TR
145160,1700643120,1700659800,16680,51673,185963,BE,FR
177965,1699992780,1700016780,24000,156904,87303,RO,RO
139010,1699167120,1699171980,4860,129988,34303,NL,NL
195937,1700068920,1700082300,13380,119636,105603,IT,IT
52584,1699197060,1699204560,7500,170032,17581,IT,IT
70522,1700077740,1700092080,14340,40255,143284,SK,SK
77590,1700562480,1700570100,7620,115650,136095,IT,IT
165458,1700324400,1700328000,3600,17268,59753,GB,GB
95540,1700485380,1700514180,28800,35049,144291,TR,TR
151356,1699894860,1699908180,13320,112724,92390,US,US
23272,1700812740,1700844360,31620,65677,117878,TR,TR
105625,1700355120,1700358720,3600,115849,104389,GB,GB
151429,1700818920,1700823360,4440,175145,30372,GB,GB
27538,1700045340,1700076000,30660,77206,167173,TR,TR
170771,1699605180,1699655880,50700,38790,105774,BG,AT
37446,1700220300,1700253360,33060,46536,37796,TR,BG
85089,1699585740,1699599600,13860,68952,166147,AT,AT
194988,1699719240,1699730160,10920,179019,184250,US,US
167723,1700717280,1700742120,24840,187553,182347,AL,MK
180588,1699078740,1699112160,33420,13198,177609,TR,TR
131322,1699516200,1699528140,11940,194134,127039,RS,NL
100509,1700310660,1700333160,22500,165500,50370,DE,DE
130541,1700215260,1700225460,10200,35717,70892,HR,HR
119603,1699837080,1699858440,21360,89330,57117,SI,RS
138544,1700821980,1700825580,3600,89075,170679,GB,GB
114598,1698991260,1699021620,30360,65226,149819,TR,TR
91500,1699060440,1699079940,19500,49843,7826,FR,IT
129938,1698944460,1698967740,23280,24028,167180,PL,FR
125611,1699809000,1699813740,4740,15522,74063,NL,NL
173561,1700863140,1700883480,20340,37652,54781,FR,FR
7176,1700641740,1700653740,12000,72943,178386,PT,PT
45333,1700341140,1700370060,28920,74542,59561,TR,TR
35297,1700308140,1700338920,30780,173574,28359,TR,TR
100755,1700418540,1700440440,21900,156011,132854,DE,HR
142259,1698965700,1698969300,3600,28662,3682,GB,GB
88628,1700688120,1700718780,30660,75171,74745,TR,TR
102208,1700743440,1700768880,25440,171121,19891,BA,HR
82012,1699165560,1699199940,34380,65581,4384,TR,TR
127724,1698818040,1698829080,11040,65162,23908,IT,IT
166600,1699536180,1699549620,13440,48065,9856,AT,SK
91530,1698835020,1698866940,31920,37210,62782,TR,TR
46210,1699788600,1699818720,30120,175338,85514,TR,TR
175911,1699546500,1699581180,34680,47121,44654,TR,TR
132347,1699697760,1699708020,10260,35777,47488,PT,PT
42254,1700489040,1700507760,18720,148881,40687,FR,IT
66265,1700165220,1700195040,29820,169308,70363,TR,TR
8284,1699044120,1699078380,34260,73358,77256,TR,TR
71225,1700851380,1700859600,8220,126995,168771,IT,IT
161960,1699591620,1699620720,29100,173106,105922,TR,TR
110508,1699608480,1699612080,3600,184738,47930,GB,GB
18155,1699352580,1699364640,12060,172848,198296,HR,HR
87750,1700178360,1700194320,15960,184202,58533,AT,AT
140452,1700555520,1700559120,3600,138959,87615,GB,GB
82754,1698980700,1698985080,4380,121801,28324,GB,GB
14093,1700396640,1700400240,3600,96284,93057,GB,GB
15899,1699442760,1699454460,11700,146003,166057,CZ,CZ
117206,1700366100,1700398080,31980,73053,136358,TR,TR
61575,1699149900,1699176180,26280,2634,169788,DE,BA
135811,1700399280,1700410140,10860,97661,170555,US,US
108705,1699652880,1699676160,23280,124197,68790,HU,PL
26818,1700475420,1700505660,30240,122759,60178,TR,TR
26142,1699883640,1699914180,30540,23428,22103,TR,TR
129503,1698938520,1698961680,23160,108172,63118,RO,RO
145776,1700373480,1700377080,3600,41972,150840,GB,GB
194231,1698822660,1698852000,29340,12081,156617,TR,TR
142407,1699815600,1699829340,13740,144519,116580,PT,PT
170462,1700357280,1700373780,16500,185523,166896,US,US
98763,1699315020,1699350000,34980,52501,138374,TR,TR
117291,1700727360,1700760720,33360,50010,135693,TR,TR
121919,1699859580,1699892460,32880,25300,34098,TR,TR
44996,1699567320,1699582860,15540,64980,197502,US,US
99302,1700386620,1700400180,13560,124087,12926,IT,IT
25374,1700072340,1700102640,30300,157582,120141,TR,TR
111566,1699662660,1699666260,3600,177086,54146,GB,GB
166555,1700173980,1700226120,52140,108821,129728,BG,DE
61308,1699599660,1699611180,11520,28144,124507,US,US
133746,1699554540,1699570200,15660,155463,159185,US,US
125710,1699907880,1699920780,12900,157424,59532,CZ,PL
115294,1698834360,1698856320,21960,197827,87277,DE,AT
90075,1698949140,1698963840,14700,112739,30598,FR,BE
2422,1700811060,1700823900,12840,113487,64038,US,US
5370,1700255940,1700288280,32340,151430,155136,TR,TR
42488,1699979940,1699995540,15600,150455,64397,FR,PT
195714,1699387380,1699420440,33060,163050,42076,TR,TR
55817,1700517780,1700553540,35760,86056,147287,TR,TR
19717,1700240520,1700271000,30480,30457,58623,TR,TR
197136,1700037480,1700072640,35160,112777,98803,TR,TR
45616,1700739660,1700774880,35220,107523,15173,TR,TR
156098,1700392260,1700395860,3600,16645,4343,GB,GB
175487,1700030340,1700041740,11400,137313,171388,PT,PT
154186,1700444400,1700449980,5580,15514,189650,GB,GB
60174,1700800620,1700814180,13560,67045,14496,IT,IT
48437,1700267700,1700301780,34080,184350,124918,TR,TR
23692,1699795260,1699803540,8280,58725,124005,IT,IT
26748,1699408200,1699411800,3600,30594,20934,NL,NL
157738,1699314540,1699346100,31560,88684,5431,TR,TR
57245,1699426500,1699456380,29880,21679,183109,TR,TR
172402,1700331060,1700348460,17400,10156,4615,US,US
159941,1700672820,1700687820,15000,32509,180946,AT,SK
56163,1699167420,1699183620,16200,100021,60562,CZ,DE
70072,1700086020,1700122920,36900,120657,188907,MX,MX
152316,1700588160,1700625780,37620,20919,153903,MX,MX
56242,1699670640,1699702740,32100,9079,26529,TR,TR
150569,1700483220,1700495820,12600,9566,125952,US,US
11709,1699335120,1699369020,33900,64870,154645,TR,TR
64903,1700833800,1700864760,30960,112675,134649,TR,TR
81590,1699438680,1699464960,26280,183911,97400,RO,RO
181013,1700526240,1700536680,10440,73226,126487,ES,AD
2115,1699785780,1699792800,7020,98038,123146,GB,GB
2761,1700795940,1700813640,17700,191172,171597,US,US
153871,1699661340,1699697160,35820,148736,114535,TR,TR
123575,1700150520,1700184300,33780,114016,49652,TR,TR
186395,1699579080,1699612680,33600,67801,18663,TR,TR
81988,1700684400,1700715420,31020,34927,42790,TR,TR
37187,1700058780,1700062380,3600,129307,89935,GB,GB
21100,1699841880,1699845480,3600,113328,107190,NL,NL
122416,1700210820,1700218200,7380,92474,101126,IT,IT
56522,1699812540,1699820520,7980,129504,109567,PT,PT
70296,1700105460,1700119560,14100,180015,194857,AT,CZ
16232,1699341060,1699365960,24900,72969,183634,DE,NL
67387,1699877880,1699889520,11640,194375,181702,IT,IT
81423,1699396500,1699410840,14340,63776,193832,AT,AT
120657,1699199280,1699235040,35760,195996,186772,TR,TR
12024,1699687560,1699701900,14340,164758,145090,US,MX
41298,1700431500,1700454480,22980,76037,135546,CH,FR
66229,1699967220,1699970820,3600,17590,173045,NL,NL
187430,1699273920,1699303140,29220,192608,179537,TR,TR
41198,1698804900,1698822600,17700,34642,182425,US,US
67178,1699337760,1699352820,15060,15939,197076,US,US
142892,1700654580,1700688780,34200,162651,47303,TR,TR
149374,1699992780,1700024520,31740,65102,41243,TR,TR
147069,1700729940,1700733540,3600,138805,57086,GB,GB
26583,1699335780,1699339380,3600,89453,26951,GB,GB
101589,1699254780,1699290660,35880,41726,1566,TR,TR
64605,1700077560,1700131080,53520,87341,175196,BG,BG
178459,1700343420,1700355840,12420,195602,65184,IT,IT
124902,1700465880,1700481060,15180,76175,85683,US,US
141962,1700522400,1700534100,11700,4864,18110,CZ,CZ
117667,1700467740,1700483340,15600,189186,27220,AT,CZ
78252,1699457400,1699475340,17940,111794,148881,FR,FR
50919,1700351880,1700357160,5280,164592,51192,GB,GB
210,1699691640,1699697700,6060,171694,183269,GB,GB
156379,1700114100,1700145840,31740,98545,10856,TR,TR
120703,1700762280,1700765880,3600,134487,765,NL,NL
107968,1699105080,1699139280,34200,163603,140581,TR,TR
118576,1699255500,1699259100,3600,72903,79197,NL,NL
51348,1698851700,1698865620,13920,192152,56895,US,US
137945,1700823900,1700851200,27300,189128,78853,DE,NL
178246,1699642380,1699678260,35880,127300,17320,TR,TR
89659,1698925320,1698955740,30420,12577,48326,TR,TR
169362,1700857200,1700889480,32280,72076,96783,TR,TR
124225,1700850060,1700870520,20460,78606,104177,FR,GB
154505,1700163840,1700196420,32580,63519,94469,TR,TR
60323,1700492160,1700504580,12420,107833,109205,HR,HR
8906,1698981600,1699013280,31680,153458,119495,TR,TR
176643,1699255320,1699261800,6480,63943,82910,NL,NL
507,1700263560,1700292540,28980,69013,4786,TR,TR
79852,1700736300,1700771880,35580,12977,103788,TR,TR
65540,1699442400,1699477140,34740,121770,91939,TR,TR
83291,1698990960,1699002060,11100,105000,6768,PT,PT
23310,1699702500,1699707000,4500,187005,61665,GB,GB
163731,1700114940,1700143860,28920,143897,105538,TR,TR
108979,1699873920,1699884600,10680,34416,174496,PT,PT
110778,1699534560,1699547460,12900,190874,149240,ES,ES
113931,1699093440,1699108860,15420,7868,58478,RS,MK
146666,1699934940,1699964640,29700,191785,114592,TR,TR
14314,1699918440,1699950240,31800,82669,77715,TR,TR
92259,1700748360,1700780460,32100,186521,184032,TR,TR
3570,1698893700,1698922320,28620,47555,55262,PL,DE
136962,1698983220,1699015440,32220,133046,108587,TR,TR
155184,1700039760,1700057340,17580,171989,96679,US,US
17285,1700086800,1700100600,13800,24252,1963,CZ,CZ
49505,1699290900,1699326720,35820,137050,114573,TR,TR
163262,1699497120,1699528860,31740,38866,100462,TR,TR
78434,1700674620,1700681880,7260,23100,50580,IT,IT
9398,1700175600,1700183580,7980,160538,64093,EE,EE
196191,1699606860,1699636140,29280,94797,84030,TR,TR
88103,1698959760,1698972360,12600,124069,188809,IT,IT
107444,1700630760,1700664900,34140,78689,192789,TR,TR
186818,1699272720,1699276320,3600,166792,196774,GB,GB
197104,1700770500,1700784540,14040,131167,177475,AT,BG
134967,1698895440,1698912780,17340,158239,136763,US,US
138852,1700506740,1700510340,3600,100093,130656,GB,GB
189151,1700184420,1700195580,11160,28650,165383,US,US
8745,1699714680,1699747440,32760,176361,125405,TR,TR
191469,1699467300,1699496640,29340,37007,70092,TR,TR
34526,1699361220,1699364820,3600,153560,49035,GB,GB
151783,1699043520,1699056120,12600,6898,60448,CZ,CZ
58976,1699130640,1699146720,16080,187170,110478,US,US
37116,1699403700,1699437900,34200,93656,86266,TR,TR
193339,1699561620,1699565460,3840,16804,48155,GB,GB
50988,1699776780,1699811580,34800,153920,45970,TR,TR
106448,1700215380,1700250540,35160,47867,158449,TR,TR
159946,1698867000,1698899460,32460,11447,50855,TR,TR
41530,1700204760,1700219640,14880,40047,176252,US,US
148888,1700273400,1700278440,5040,33458,186577,NL,NL
82923,1700058420,1700062020,3600,138732,15309,GB,GB
5853,1699764720,1699775520,10800,163609,119704,CA,CA
115385,1698842040,1698874680,32640,182928,86415,TR,TR
113351,1699823760,1699843920,20160,155761,14135,SE,SE
28045,1700613900,1700636220,22320,126547,120704,BR,BR
24017,1700559720,1700590860,31140,5677,127089,TR,TR
128660,1699408860,1699421820,12960,122118,113615,US,US
51824,1700013120,1700046360,33240,70820,194479,TR,TR
14593,1699852620,1699884780,32160,137622,90777,TR,TR
86490,1700572380,1700602740,30360,105201,104374,TR,TR
67535,1700179920,1700185200,5280,198502,108915,NL,NL
122366,1700599680,1700626080,26400,78625,92898,NO,SE
117716,1699314000,1699347300,33300,189679,46831,TR,TR
149667,1699078200,1699105620,27420,69006,34960,BA,BA
50175,1700128500,1700135520,7020,85614,170065,GB,GB
132168,1700480100,1700512980,32880,166934,39554,TR,TR
113619,1700764560,1700797560,33000,155398,102336,TR,TR
170917,1700827380,1700857560,30180,139306,84248,TR,TR
117678,1700172000,1700186160,14160,14281,37605,US,US
130857,1699350960,1699358160,7200,121626,74690,IT,FR
828,1699543500,1699556880,13380,67642,75207,ES,ES
168428,1700469060,1700475600,6540,92046,78539,NL,NL
15540,1699662900,1699680360,17460,69021,147946,FR,FR
61851,1700155440,1700159040,3600,114571,39963,GB,GB
116246,1699096320,1699104240,7920,125989,7434,IT,IT
101065,1700802240,1700818140,15900,6964,37682,US,US
196003,1700763720,1700793960,30240,91007,55705,TR,TR
161387,1700070780,1700083440,12660,89323,148099,PT,PT
110194,1700790780,1700823600,32820,39703,104369,TR,TR
110231,1699137360,1699171260,33900,581,21087,TR,TR
134246,1700082120,1700104260,22140,174788,193971,DE,DE
12263,1698992100,1699023780,31680,135624,128903,TR,TR
194480,1700760480,1700794620,34140,70976,29657,TR,TR
122330,1699352400,1699382220,29820,105805,198334,TR,TR
80783,1699530600,1699541160,10560,194431,75817,ES,AD
84315,1700232900,1700263620,30720,107270,93944,TR,TR
136220,1700718900,1700753040,34140,66575,115160,TR,TR
175338,1699351140,1699356120,4980,164503,189340,NL,NL
109117,1700588520,1700622960,34440,82626,55815,TR,TR
131087,1699347120,1699379520,32400,29668,74933,TR,TR
139178,1699242540,1699276860,34320,110703,67848,TR,TR
15363,1699601520,1699612560,11040,193690,10007,US,US
73441,1699429860,1699451880,22020,77787,99383,HU,DE
62335,1699166340,1699197120,30780,150917,183635,TR,TR
115901,1699267500,1699300020,32520,96085,44072,TR,TR
150590,1700113500,1700140980,27480,3832,141394,DE,PL
1492,1699126260,1699158060,31800,78794,23053,TR,TR
63826,1699132680,1699146240,13560,60069,188723,US,US
104351,1698971100,1698977460,6360,163275,95435,GB,GB
31139,1700004300,1700011440,7140,31166,156856,GB,GB
118389,1699249260,1699272720,23460,139725,21165,BR,BR
46060,1699414860,1699419720,4860,93513,42211,GB,GB
146172,1700229720,1700244000,14280,105857,40731,US,US
199479,1699828740,1699857540,28800,123092,13596,TR,TR
64850,1700720040,1700743920,23880,169243,62551,PL,AT
37771,1699740000,1699754520,14520,103116,104569,US,US
74721,1700235360,1700267580,32220,115003,37451,TR,TR
38430,1699725060,1699760040,34980,88352,31131,TR,TR
171375,1699041300,1699047840,6540,176575,18979,NL,NL
171163,1700073180,1700085480,12300,178295,131897,PT,PT
52193,1698860460,1698864060,3600,37986,69203,GB,GB
15411,1699736160,1699743540,7380,98395,4421,HR,HR
180693,1699194540,1699223700,29160,4882,31144,TR,TR
16964,1699758900,1699775400,16500,185094,102691,US,US
176979,1700316240,1700327040,10800,131461,78491,IT,IT
47874,1698823560,1698858960,35400,10237,19555,TR,TR
50429,1699261860,1699277400,15540,199663,42432,RS,RS
102555,1699747560,1699760700,13140,181375,124706,CZ,DE
59249,1700798400,1700802000,3600,154295,60373,GB,GB
154112,1700652060,1700664840,12780,156003,78587,IT,IT
158832,1699983120,1700000280,17160,194775,54700,US,US
156615,1700626080,1700654940,28860,10205,310,TR,TR
79162,1699753200,1699782240,29040,69767,137056,TR,TR
111427,1700048580,1700084700,36120,186221,19565,MX,MX
60734,1699216020,1699228500,12480,150847,63978,IT,IT
165168,1699047120,1699082700,35580,25645,81084,TR,TR
173828,1699887600,1699892400,4800,37150,110642,AD,FR
193784,1700561040,1700593800,32760,146397,105292,TR,TR
199955,1698891300,1698925620,34320,180321,30108,TR,TR
157004,1700701920,1700735220,33300,189279,56650,TR,TR
197463,1698981840,1699014420,32580,96215,134308,TR,TR
95292,1699340940,1699344540,3600,173186,171630,GB,GB
4041,1700524260,1700557560,33300,167304,151557,TR,TR
86725,1699664220,1699693080,28860,146653,66561,TR,TR
80016,1699570680,1699596900,26220,189089,94104,PL,PL
155836,1699045860,1699081380,35520,144389,167910,TR,TR
160499,1698818940,1698828840,9900,14219,1023,PT,PT
16120,1700428320,1700431920,3600,86920,167287,GB,GB
190536,1699446360,1699468380,22020,77541,127129,DE,DE
40052,1699466580,1699501440,34860,196423,199643,TR,TR
160275,1699239480,1699272360,32880,64370,63212,TR,TR
83908,1698821760,1698849060,27300,63706,107907,PL,PL
31244,1698829200,1698840000,10800,133268,170013,US,US
167994,1699577580,1699612980,35400,74338,194173,TR,TR
181956,1700275800,1700309220,33420,77983,106132,TR,TR
21141,1700098740,1700134500,35760,118908,20148,TR,TR
101926,1699480620,1699490940,10320,871,111603,IT,IT
110424,1700734680,1700770200,35520,71205,3557,TR,TR
179764,1698931740,1698942540,10800,117601,126171,US,US
59789,1700389500,1700395800,6300,2544,150256,GB,GB
69331,1699819260,1699831800,12540,98699,164930,US,US
179049,1699923360,1699929900,6540,42950,73892,GB,GB
198968,1699779960,1699787400,7440,146960,49900,IT,IT
190128,1700299020,1700326140,27120,121452,125256,PL,PL
102293,1700182140,1700194200,12060,121880,189206,US,US
3001,1700152380,1700186040,33660,18509,63428,TR,TR
199689,1698874200,1698905520,31320,26963,2902,TR,TR
139683,1700254800,1700286300,31500,193606,19322,TR,TR
9754,1699464360,1699493820,29460,40599,132736,TR,TR
40037,1698841500,1698852600,11100,191246,191330,US,US
49394,1698815040,1698849720,34680,76773,37537,TR,TR
193996,1698842280,1698878040,35760,14441,120478,TR,TR
81317,1699454880,1699462560,7680,64194,130917,PT,PT
24090,1699878720,1699910760,32040,161780,172350,TR,TR
67690,1699939920,1699973700,33780,78864,124173,MX,MX
33738,1699403940,1699417320,13380,87354,64590,US,US
23428,1700628480,1700645160,16680,44247,124967,FR,ES
129677,1698835680,1698848100,12420,99956,153587,IT,IT
13019,1699118880,1699132440,13560,59877,40011,IT,IT
33639,1699903920,1699938600,34680,27497,156193,TR,TR
46095,1699011420,1699050000,38580,35772,149443,MX,MX
123252,1699628100,1699661520,33420,129672,102052,TR,TR
89563,1699842900,1699865700,22800,109604,65121,DE,PL
96642,1700816220,1700838540,22320,137064,139192,DE,PL
191394,1699187340,1699223100,35760,112235,121477,TR,TR
15660,1700270880,1700302440,31560,48252,125000,TR,TR
144728,1700823480,1700837640,14160,86685,1129,HR,HR
164794,1700128500,1700142720,14220,164115,174174,US,US
14554,1699000500,1699029540,29040,78932,140327,TR,TR
20794,1700657640,1700672820,15180,153891,156477,US,US
130290,1700245800,1700280840,35040,151542,187970,TR,TR
37206,1700860620,1700864220,3600,89466,193483,GB,GB
94775,1699639020,1699655580,16560,7947,51374,US,US
42886,1700250780,1700282700,31920,82827,38896,TR,TR
166941,1699842900,1699873020,30120,169422,177287,TR,TR
36323,1700448960,1700478000,29040,119972,3614,TR,TR
162816,1699117560,1699147560,30000,47837,129209,TR,TR
113174,1699078860,1699114680,35820,136055,240,TR,TR
3791,1700229120,1700242860,13740,108482,183446,US,US
40379,1699806780,1699828860,22080,23641,194618,DK,DK
188728,1700703540,1700737020,33480,116274,1640,TR,TR
69667,1699914300,1699918140,3840,85174,107747,NL,NL
182809,1699445940,1699475580,29640,199762,87578,TR,TR
83321,1699631460,1699636800,5340,166499,163669,NL,NL
3525,1699374840,1699409340,34500,46353,12468,TR,TR
114935,1699570320,1699573920,3600,169812,105462,GB,GB
190429,1699384680,1699420320,35640,73409,37569,TR,TR
70728,1700768760,1700781300,12540,77011,142757,US,US
98612,1699787880,1699822620,34740,131983,25175,MX,MX
64092,1698843180,1698855300,12120,55696,53889,IT,IT
88647,1700517720,1700527380,9660,78349,186745,IT,DE
118685,1699603440,1699637220,33780,198120,136868,TR,TR
10031,1700846280,1700874900,28620,16274,117412,CH,CZ
181186,1700601480,1700605080,3600,170767,39693,GB,GB
118495,1699455300,1699489380,34080,15085,38578,TR,TR
134843,1699550400,1699563360,12960,44607,37125,IT,IT
56511,1700829240,1700858400,29160,11188,154680,TR,TR
191277,1699730760,1699734360,3600,157745,123647,NL,NL
185310,1699900500,1699928760,28260,166546,32115,PL,DE
121806,1700254140,1700265600,11460,101467,79042,IT,IT
197751,1700506680,1700539620,32940,48191,48241,TR,TR
92388,1699641720,1699676520,34800,151072,49049,TR,TR
90550,1699016520,1699045920,29400,61627,94634,TR,TR
34790,1699420440,1699437180,16740,156167,140536,US,US
84470,1699920360,1699951680,31320,119506,191811,TR,TR
148204,1700472000,1700478360,6360,34626,190305,GB,GB
126465,1700382540,1700416800,34260,11716,78031,TR,TR
109432,1699088460,1699117440,28980,106879,92830,TR,TR
158732,1700774160,1700807640,33480,142840,140820,TR,TR
142085,1699171920,1699176960,5040,49122,111934,NL,NL
16694,1699077360,1699090500,13140,176404,551,US,US
181323,1700266620,1700283420,16800,116406,45890,SE,SE
84782,1700524740,1700528340,3600,37290,162864,GB,GB
92868,1700078640,1700111400,32760,193383,129512,TR,TR
133384,1699287840,1699301340,13500,113911,153254,AT,AT
69969,1700398680,1700432700,34020,76415,150623,TR,TR
175432,1699691580,1699703400,11820,28541,53275,IT,IT
5596,1699418700,1699440900,22200,77283,47114,BR,BR
169054,1699473720,1699481280,7560,162504,15036,IT,IT
40397,1700482260,1700517240,34980,11950,73953,TR,TR
19928,1699995480,1700026320,30840,11949,121116,TR,TR
38381,1699733820,1699763640,29820,80921,140181,TR,TR
141017,1700004180,1700034060,29880,61946,112405,TR,TR
178751,1699652640,1699685460,32820,195100,37504,TR,TR
21423,1700377860,1700406780,28920,148989,29512,TR,TR
134739,1698840900,1698875160,34260,63859,21700,TR,TR
59772,1698907500,1698915420,7920,128470,86148,IT,IT
137875,1699776900,1699784040,7140,80801,56288,GB,GB
69853,1700840400,1700847180,6780,14336,185014,GB,GB
88433,1700670960,1700704020,33060,32358,72798,TR,TR
163463,1699528620,1699560060,31440,153656,68842,TR,TR
83181,1700652660,1700687340,34680,120859,107298,TR,TR
100918,1699094940,1699127400,32460,108157,144594,TR,TR
108853,1700070660,1700085960,15300,114183,176079,US,US
106057,1700637780,1700671080,33300,190237,101325,TR,TR
121312,1699195140,1699227180,32040,127638,151533,TR,TR
190736,1700091120,1700125560,34440,107801,59517,TR,TR
130452,1699673400,1699705440,32040,61929,169360,TR,TR
87991,1700000040,1700021100,21060,63371,7037,AL,MK
93350,1698884100,1698917280,33180,116129,94086,TR,TR
3182,1699776840,1699790940,14100,63026,107394,US,US
146414,1699797360,1699823460,26100,20749,75955,CH,BE
24049,1699715940,1699738500,22560,116323,110573,DE,BA
157409,1699540020,1699545900,5880,143645,195830,GB,GB
23564,1700203200,1700235720,32520,123699,152041,TR,TR
114999,1700749260,1700767740,18480,140525,44635,FR,BE
93691,1700202660,1700215800,13140,177103,116353,IT,IT
138801,1699586400,1699597440,11040,65964,96317,US,US
87269,1699219260,1699252260,33000,43319,186677,TR,TR
59012,1700435580,1700489640,54060,32129,119814,BG,AT
148254,1699023960,1699041240,17280,122142,24673,US,US
152839,1700447100,1700460600,13500,173722,70642,ES,ES
26786,1699598220,1699632480,34260,45554,40297,TR,TR
130038,1700591820,1700606940,15120,60829,37536,BE,FR
179941,1700734020,1700767500,33480,11912,36943,TR,TR
7355,1698998520,1699011180,12660,71168,184821,US,US
160712,1699548540,1699581300,32760,147345,84984,TR,TR
116536,1700829420,1700864160,34740,53861,77880,TR,TR
155912,1700505120,1700534460,29340,90360,114435,TR,TR
131792,1699699260,1699734120,34860,180167,193909,MX,MX
63773,1700121480,1700155440,33960,111160,34910,TR,TR
49136,1700109960,1700140500,30540,181875,67479,TR,TR
165760,1700191500,1700198580,7080,88380,93275,NL,NL
28796,1700747040,1700762040,15000,97221,96541,US,US
57254,1699900680,1699914540,13860,186545,174157,US,US
141543,1700595780,1700627760,31980,43553,73071,TR,TR
1638,1700568720,1700572320,3600,69183,161347,GB,GB
119571,1699523700,1699537860,14160,14855,93869,HR,HR
74788,1700387640,1700405460,17820,56498,35406,US,US
136471,1700626140,1700630280,4140,1185,100807,GB,GB
20562,1699869720,1699873320,3600,71243,164826,NL,NL
158911,1699329600,1699347120,17520,12101,25068,FR,FR
22223,1698979440,1698989040,9600,137811,77559,PT,PT
43236,1699532820,1699568160,35340,50554,41507,MK,RS
9384,1700442840,1700459820,16980,116093,23793,US,US
69506,1700074680,1700080560,5880,106187,56712,GB,GB
110054,1699122960,1699134120,11160,45908,72734,ES,PT
130982,1700278200,1700308980,30780,88124,181028,TR,TR
92143,1700053680,1700065800,12120,181863,86278,PT,PT
147993,1699046700,1699080720,34020,45359,178266,TR,TR
63700,1700621760,1700656380,34620,72875,69062,TR,TR
101449,1699059180,1699070580,11400,156439,92686,US,US
191063,1700365800,1700398200,32400,105928,48340,MX,MX
134181,1700626380,1700650680,24300,194312,157752,PL,DE
94346,1700408940,1700417220,8280,130933,94504,IT,IT
73549,1700277000,1700309280,32280,90366,23487,TR,TR
161430,1699913340,1699948560,35220,42356,106874,TR,TR
27097,1699781520,1699801500,19980,81912,40911,BE,FR
52418,1700174400,1700228760,54360,47603,165106,BG,RS
146487,1700447580,1700480040,32460,100159,72574,TR,TR
170026,1699377420,1699412280,34860,60932,161754,TR,TR
168077,1698930060,1698941880,11820,143197,195719,IT,IT
174827,1699476960,1699500960,24000,60407,122236,DE,BG
55405,1700456100,1700477280,21180,162144,114098,FR,FR
16351,1699538280,1699543860,5580,163855,119840,EE,EE
47626,1699743420,1699757880,14460,138819,71840,AT,AT
32840,1700559360,1700568960,9600,161791,190279,PT,PT
23201,1699348980,1699360860,11880,181291,46296,US,US
92319,1699047780,1699061220,13440,40479,13699,IT,IT
163569,1699300260,1699303860,3600,182836,160348,GB,GB
129206,1699289460,1699296960,7500,148110,28719,PT,PT
28343,1700491020,1700524980,33960,67401,182908,TR,TR
76049,1699349400,1699374960,25560,72691,197832,DE,AT
18598,1700530020,1700559900,29880,158445,152413,TR,TR
191517,1698981420,1698992400,10980,4027,103060,PT,PT
53899,1699498920,1699502520,3600,103488,152485,GB,GB
93647,1699702560,1699706160,3600,90611,62794,GB,GB
138771,1699515780,1699531020,15240,153328,78710,US,US
181807,1699776420,1699800720,24300,19087,71705,DE,BG
47443,1700089740,1700124540,34800,103126,150440,TR,TR
147873,1700163420,1700189220,25800,166338,179407,PL,DE
29149,1700843520,1700872380,28860,86447,83425,TR,TR
63085,1700776320,1700810040,33720,54884,84101,TR,TR
159968,1699276800,1699289940,13140,183015,161621,SK,AT
60650,1700218380,1700248020,29640,29386,107434,TR,TR
28400,1699351320,1699378860,27540,178077,181978,DE,DE
111545,1699960200,1699973760,13560,191340,10848,US,US
47428,1699999620,1700010840,11220,170187,45414,PT,PT
184333,1699757700,1699770180,12480,104978,199835,AT,AT
155761,1699477500,1699486740,9240,53182,100804,PT,PT
10015,1699256100,1699263780,7680,113527,1443,HR,HR
113642,1700765160,1700773740,8580,114606,150656,HR,HR
199499,1699212000,1699221300,9300,180705,580,PT,PT
49717,1698900300,1698914160,13860,178314,191520,IT,IT
193904,1700464260,1700467860,3600,192381,111205,NL,BE
88351,1699967520,1699980000,12480,183706,178310,HR,HR
133987,1699746720,1699750320,3600,83082,122602,GB,GB
53689,1699177980,1699186860,8880,113076,148763,IT,IT
113074,1700497080,1700511120,14040,147105,91542,US,US
184378,1700571120,1700585760,14640,133719,26137,US,US
129623,1699390080,1699393680,3600,150870,17387,GB,GB
120872,1700830980,1700865300,34320,143808,42622,TR,TR
70131,1699932960,1699944960,12000,81440,101595,US,US
142165,1700092560,1700123400,30840,46050,117458,TR,TR
11693,1700044560,1700075580,31020,12445,116308,TR,TR
172159,1700051580,1700063460,11880,15126,73319,IT,IT
174976,1700189820,1700213580,23760,195556,90776,DE,DE
149577,1699432500,1699464600,32100,23037,183601,TR,TR
84855,1699694340,1699697940,3600,197597,162241,NL,NL
173271,1699446840,1699475940,29100,110133,170597,TR,TR
90208,1698879060,1698909720,30660,39283,104896,TR,TR
43653,1699936080,1699951500,15420,169156,114127,FR,FR
73477,1699161900,1699166100,4200,75493,34839,NL,NL
65604,1699846200,1699879800,33600,16410,39509,TR,TR
164865,1698999720,1699016820,17100,119679,166494,US,US
110200,1700776260,1700789160,12900,145285,79021,US,US
117047,1699763100,1699778100,15000,176662,52388,CZ,CZ
138060,1699565760,1699595400,29640,52117,42651,TR,TR
43897,1699654200,1699665420,11220,10564,8588,IT,IT
67454,1699258800,1699273560,14760,20518,163958,US,US
72227,1700403000,1700415000,12000,14112,193766,ES,ES
124337,1699135680,1699167900,32220,197805,112702,TR,TR
153176,1699334880,1699348260,13380,77586,9626,IT,IT
34986,1700048820,1700073900,25080,148033,69098,DE,DE
187944,1700396460,1700407740,11280,76183,117591,IT,IT
155901,1699992240,1700023800,31560,62292,160028,TR,TR
123526,1700199600,1700225340,25740,12120,156740,RO,PL
100393,1699889460,1699923300,33840,68340,150747,TR,TR
160159,1698937620,1698941220,3600,71393,48045,GB,GB
131423,1700545080,1700580120,35040,165999,134676,TR,TR
137700,1700538960,1700550360,11400,97781,119765,AT,AT
145155,1699147020,1699180080,33060,174172,83154,TR,TR
62406,1699934460,1699959000,24540,103601,55208,DE,CH
144304,1699686900,1699690500,3600,18207,24966,NL,NL
34620,1699099380,1699135200,35820,76382,199377,TR,TR
89805,1700058300,1700073240,14940,108825,38893,FR,FR
94379,1699206060,1699214400,8340,30447,146929,HR,HR
78330,1699518180,1699521960,3780,94812,57239,NL,NL
122907,1699728900,1699759440,30540,93397,187647,TR,TR
64036,1699732320,1699746060,13740,88541,176317,RS,SI
143343,1700671500,1700705400,33900,24300,183226,TR,TR
39781,1699813740,1699844940,31200,168789,16757,TR,TR
98046,1698875520,1698911040,35520,155961,9372,TR,TR
101950,1699557180,1699572420,15240,61412,115478,CZ,CZ
116828,1700326980,1700337840,10860,147553,16005,IT,IT
71214,1699233180,1699239180,6000,18679,8129,GB,GB
142768,1699412040,1699427040,15000,18776,57524,RS,RS
118915,1699320720,1699350720,30000,94749,15638,TR,TR
98765,1698843360,1698873720,30360,195331,161914,TR,TR
18032,1700119020,1700128140,9120,87288,186012,IT,IT
50297,1700065920,1700085720,19800,8858,128595,BE,NL
116494,1699262820,1699294620,31800,60937,60708,TR,TR
142444,1699326060,1699340460,14400,5387,191552,AT,MK
3128,1699898940,1699910100,11160,190148,44268,CZ,CZ
26217,1700452740,1700487300,34560,61903,50255,TR,TR
77630,1698919380,1698933300,13920,14562,170579,US,US
159704,1699770420,1699774020,3600,75022,165360,GB,GB
52719,1700658300,1700691240,32940,178388,60017,TR,TR
130718,1699579920,1699611600,31680,41838,15102,TR,TR
99703,1699948440,1699966320,17880,122771,120653,US,US
42356,1700843280,1700848500,5220,48253,176080,GB,GB
94689,1700808060,1700811660,3600,72539,153887,NL,DE
135349,1698830520,1698837060,6540,141771,89269,NL,NL
10976,1698873900,1698888120,14220,140025,62182,US,US
137271,1699709760,1699742820,33060,185863,150888,TR,TR
146415,1699380240,1699415460,35220,160869,157024,TR,TR
153868,1700690400,1700696280,5880,148093,49403,GB,GB
197994,1699510560,1699524000,13440,128174,82280,US,US
129037,1699152240,1699185900,33660,3731,88162,TR,TR
138371,1700506800,1700517180,10380,123598,159143,EE,FI
128145,1700384460,1700393400,8940,68372,178315,IT,IT
184863,1700214240,1700249040,34800,110326,37746,TR,TR
158558,1700068800,1700090520,21720,35223,37310,PL,UA
190789,1698949320,1698987240,37920,181000,86748,MX,US
46563,1700301600,1700319840,18240,153746,17955,FR,FR
192287,1700410560,1700423520,12960,193414,190991,IT,IT
82618,1698847440,1698882840,35400,81224,41501,TR,TR
23974,1698967680,1698983700,16020,148872,6255,US,CA
38364,1699631760,1699657500,25740,13399,191892,DE,NL
18367,1699016760,1699050240,33480,39488,80035,TR,TR
149275,1700396400,1700420160,23760,107377,25469,BR,BR
92423,1698900720,1698930960,30240,20007,90532,TR,TR
119087,1700404920,1700436000,31080,130683,858,TR,TR
164033,1700615280,1700618880,3600,59529,25069,GB,GB
173442,1699479240,1699514400,35160,156863,152997,TR,TR
172571,1699363680,1699402500,38820,166954,112613,MX,MX
188034,1700275800,1700292480,16680,171278,49063,FR,DE
65678,1699582680,1699593840,11160,114297,112718,IT,IT
139856,1700684640,1700718360,33720,197560,110105,TR,TR
145696,1699566240,1699578720,12480,166099,56678,US,US
147376,1699599360,1699635000,35640,146755,1760,TR,TR
20567,1700287560,1700294340,6780,139632,87458,GB,GB
106896,1698997380,1699015380,18000,112295,152778,SE,SE
149716,1699276500,1699288140,11640,109574,4621,IT,IT
92369,1700812920,1700841360,28440,170503,104892,PL,DE
132476,1700007660,1700038980,31320,26576,2706,TR,TR
103877,1699469160,1699501020,31860,176138,139217,TR,TR
97982,1698886500,1698890100,3600,176398,191147,NL,NL
139424,1699999260,1700029800,30540,101344,174637,TR,TR
71017,1699868880,1699895400,26520,38570,73288,BR,BR
35805,1699209240,1699213920,4680,125795,89578,GB,GB
32354,1698910140,1698921480,11340,83959,58825,IT,IT
82478,1699012140,1699015740,3600,145799,113143,GB,GB
103770,1698885960,1698917520,31560,192899,149048,TR,TR
12516,1699266480,1699290960,24480,39218,152860,RO,RO
33275,1698940920,1698956460,15540,166447,199631,US,US
176914,1700491560,1700517600,26040,18992,98398,DE,AT
26890,1699452000,1699466100,14100,126851,153078,SK,DE
102267,1700476020,1700505180,29160,29484,21763,TR,TR
150340,1700630520,1700663700,33180,54090,65074,TR,TR
188608,1700117760,1700147760,30000,176658,119616,TR,TR
4492,1700158440,1700193720,35280,165910,122164,TR,TR
117830,1698938580,1698945420,6840,27873,164662,GB,GB
154705,1699916460,1699931880,15420,86058,6074,AT,DE
17773,1698893880,1698922860,28980,163543,160296,TR,TR
188621,1700172540,1700185680,13140,134144,197154,US,US
178442,1700008620,1700042100,33480,173897,169189,TR,TR
185054,1700544780,1700561280,16500,107420,168481,AT,AT
61513,1699896720,1699900320,3600,59665,187718,GB,GB
30424,1699676100,1699702020,25920,161365,3473,DE,FR
106115,1699778460,1699786260,7800,20643,93601,PT,PT
100107,1700108220,1700141280,33060,199205,62861,TR,TR
196518,1700231640,1700267460,35820,97023,134123,TR,TR
154009,1700550960,1700604360,53400,181142,15096,BG,DE
124022,1698875460,1698879060,3600,158425,178661,NL,NL
119698,1700141520,1700170500,28980,145563,49291,TR,TR
193215,1699228800,1699245360,16560,42507,63364,RS,RS
110384,1698838620,1698873660,35040,86160,122631,TR,TR
185289,1698977100,1699005900,28800,116429,143375,TR,TR
10614,1700839320,1700872320,33000,178664,73201,TR,TR
197889,1700861520,1700892540,31020,16594,57961,TR,TR
40019,1700615700,1700623140,7440,94424,5756,PT,PT
7777,1700559300,1700593320,34020,24470,167519,TR,TR
119919,1700191080,1700222640,31560,10934,129858,TR,TR
180731,1700603640,1700638920,35280,155991,192244,TR,TR
98706,1699307640,1699340880,33240,111877,19268,TR,TR
159184,1700588100,1700622660,34560,121889,175116,TR,TR
111602,1700347560,1700377980,30420,133249,43517,TR,TR
55824,1700658600,1700662200,3600,177682,135826,NL,NL
52559,1699117260,1699147620,30360,11360,164113,TR,TR
90936,1698835620,1698847980,12360,108041,177753,US,US
37937,1700324700,1700334120,9420,98010,155768,EE,EE
58862,1699715460,1699725720,10260,195330,122436,SK,SK
154174,1699021320,1699053120,31800,89305,172679,TR,TR
198714,1700031000,1700059500,28500,26943,89503,PL,PL
51127,1700609880,1700630400,20520,9335,65405,BE,FR
14040,1698830820,1698834420,3600,42173,120715,GB,GB
49568,1699673520,1699705500,31980,124513,122005,TR,TR
134593,1698944280,1698950460,6180,155213,157784,GB,GB
121430,1699802040,1699818420,16380,85770,75080,US,US
74691,1698988380,1699004580,16200,146302,40919,US,MX
152143,1699731300,1699737300,6000,15735,106437,NL,NL
176320,1699438380,1699470240,31860,45339,187900,TR,TR
63899,1700178120,1700213460,35340,82058,18630,TR,TR
31113,1700099760,1700114640,14880,62216,76459,US,US
197211,1699292880,1699318560,25680,20958,136187,DE,DE
7520,1699945440,1699980000,34560,149024,168740,TR,TR
31815,1700033580,1700037180,3600,158021,184946,GB,GB
107910,1700228700,1700241120,12420,134013,105347,IT,IT
173276,1700616540,1700639100,22560,111335,77274,PL,PL
122723,1700449920,1700483940,34020,196902,147580,MX,MX
14573,1698852900,1698856500,3600,108637,146658,GB,GB
4025,1699830660,1699834260,3600,165540,45080,GB,GB
159761,1700843940,1700849580,5640,141970,27086,GB,GB
11235,1699208040,1699241760,33720,88996,87123,TR,TR
177381,1700044140,1700050200,6060,21017,63939,NL,NL
118918,1700842800,1700877780,34980,148581,122632,TR,TR
92067,1700672460,1700676300,3840,26378,117036,GB,GB
83999,1700668500,1700698320,29820,181899,28177,TR,TR
88898,1700203800,1700239380,35580,109807,110835,TR,TR
131934,1699485900,1699516740,30840,113315,89148,TR,TR
163824,1699216320,1699240080,23760,151900,85166,PL,PL
121816,1699440000,1699468680,28680,141186,102192,RO,RO
142546,1699848600,1699883340,34740,119483,29783,TR,TR
67226,1699767420,1699794240,26820,26319,46746,PL,DE
191471,1700769540,1700773140,3600,75654,32069,NL,NL
154984,1699638000,1699641600,3600,28475,186213,GB,GB
124665,1699071060,1699074660,3600,180555,68780,NL,BE
45821,1700833500,1700866140,32640,63134,6685,TR,TR
44907,1700146740,1700150340,3600,186745,197200,NL,NL
130245,1699182660,1699188060,5400,101406,97291,NL,NL
14489,1699356360,1699387800,31440,101996,74577,TR,TR
183340,1700286600,1700321100,34500,93443,115964,TR,TR
89839,1700445060,1700475600,30540,125576,68543,TR,TR
76278,1700228280,1700265240,36960,28710,71592,MX,US
158696,1699791480,1699823100,31620,147311,66820,TR,TR
3903,1699368540,1699387740,19200,571,173484,FR,DE
22789,1698982140,1698985740,3600,76534,114280,GB,GB
47499,1699236420,1699243680,7260,128357,188358,IT,IT
65015,1700365620,1700377800,12180,25635,56908,US,US
66587,1699909140,1699922700,13560,106345,53592,PT,PT
180808,1700847660,1700860200,12540,53431,190448,IT,IT
140870,1699014360,1699017960,3600,117277,191749,GB,GB
83527,1699392720,1699406520,13800,73816,97169,US,US
193024,1700166900,1700202720,35820,167857,83936,TR,TR
63157,1699334760,1699367340,32580,189968,120050,TR,TR
109712,1700193900,1700226660,32760,27203,151091,TR,TR
141073,1700467320,1700484960,17640,38067,30408,US,US
25179,1699960320,1699989180,28860,164919,41559,TR,TR
64523,1698847500,1698856380,8880,69459,194653,PT,PT
73144,1700794200,1700809560,15360,1323,19360,FR,NL
50771,1700703300,1700712780,9480,107424,143638,IT,IT
128975,1700428440,1700445060,16620,112727,21089,FR,ES
161959,1698898080,1698907020,8940,53302,110191,IT,IT
75414,1699525860,1699557600,31740,28886,53931,TR,TR
153999,1698868080,1698902700,34620,42113,27117,MX,MX
167980,1699115640,1699119240,3600,68732,127673,GB,GB
88383,1699961580,1699966320,4740,39415,95508,GB,GB
190882,1699857060,1699866900,9840,63202,20623,IT,IT
60488,1699489020,1699495500,6480,47444,164781,NL,NL
79087,1700151120,1700163480,12360,31482,70752,IT,IT
118469,1700175420,1700204880,29460,83378,91893,TR,TR
178954,1699728420,1699735860,7440,130498,93011,IT,IT
194755,1698925740,1698938100,12360,64325,185012,ES,BE
15115,1700484780,1700508540,23760,186793,160924,DK,DK
48217,1700119320,1700132520,13200,87192,137539,RS,RS
134661,1698996300,1699014900,18600,103689,188815,FR,FR
27023,1698971520,1698979440,7920,34287,168943,IT,IT
150730,1699950960,1699959720,8760,60547,93973,PT,PT
35358,1699138200,1699149360,11160,190686,124666,US,US
103186,1699092960,1699107900,14940,145590,44200,US,US
148486,1698976740,1698988800,12060,104880,147633,US,US
174295,1699446540,1699476300,29760,82996,58417,TR,TR
184783,1700690520,1700704200,13680,188624,61136,AT,AT
15400,1699142640,1699149660,7020,151982,150258,GB,GB
8222,1699393500,1699406400,12900,65430,4397,PT,ES
135266,1699535400,1699546380,10980,5753,42489,IT,IT
179088,1699966380,1699977180,10800,44329,129104,IT,IT
155519,1700550780,1700582460,31680,194682,186185,TR,TR
187909,1699029840,1699045800,15960,140643,50472,US,US
110401,1700786280,1700803500,17220,63481,91692,FR,BE
128206,1699626480,1699660020,33540,123986,191859,TR,TR
106172,1699854660,1699860420,5760,44416,167146,GB,GB
96403,1700820840,1700824440,3600,111384,123320,NL,NL
156366,1699240140,1699243740,3600,88750,123476,NL,NL
15433,1700109540,1700117460,7920,8238,90868,PT,ES
172095,1699856160,1699873620,17460,115560,39859,US,US
150281,1700601420,1700632740,31320,143202,177250,TR,TR
116951,1699019820,1699036980,17160,69968,92297,RS,RS
17183,1699512600,1699524120,11520,13501,198164,IT,IT
76281,1698794700,1698817620,22920,171704,94815,DE,CH
84503,1699515060,1699530600,15540,29105,60042,AT,CZ
117695,1699535640,1699546800,11160,81964,192618,IT,IT
184231,1699759860,1699774080,14220,172550,193977,US,US
52798,1699818900,1699851360,32460,63059,6717,TR,TR
147670,1700505600,1700537880,32280,192880,95838,TR,TR
186728,1699146240,1699181340,35100,73712,43354,TR,TR
139523,1699093380,1699108200,14820,195309,100818,US,MX
57678,1698939900,1698975120,35220,133993,104045,TR,TR
47932,1699614420,1699623420,9000,134566,188188,IT,IT
1981,1699969680,1699973400,3720,52630,53673,NL,NL
116220,1699927620,1699939080,11460,54563,62692,US,US
68866,1699060500,1699095960,35460,120270,175735,TR,TR
59792,1700384340,1700390160,5820,191170,91168,GB,GB
183947,1699912800,1699944180,31380,186707,113659,TR,TR
75883,1699520340,1699555920,35580,146078,121070,TR,TR
26200,1700719740,1700749800,30060,66018,194138,BA,DE
147434,1698910320,1698913920,3600,91797,15600,GB,GB
54333,1699293420,1699328760,35340,39297,107662,TR,TR
118663,1700580840,1700617440,36600,144074,56423,MX,US
67134,1698899340,1698909600,10260,152933,37792,HR,HR
129058,1698800160,1698835260,35100,20010,191361,TR,TR
146071,1699956780,1700016120,59340,159727,138145,UA,CZ
83136,1700351280,1700385300,34020,88456,23925,TR,TR
105658,1699785540,1699820280,34740,145532,62945,TR,TR
126043,1698976680,1698980280,3600,117552,163064,GB,GB
156918,1699242240,1699274280,32040,99233,68096,TR,TR
134563,1699688340,1699699380,11040,56774,117202,HR,HR
42775,1698974700,1699004280,29580,126510,64822,TR,TR
183135,1698995760,1699009980,14220,81826,188839,PT,PT
110236,1700263200,1700298120,34920,47720,136531,TR,TR
31067,1700337060,1700341560,4500,166766,155130,NL,NL
196351,1699525680,1699555620,29940,193299,128727,TR,TR
74525,1699417800,1699423020,5220,29564,43971,AD,FR
199450,1700483340,1700514540,31200,90921,179877,TR,TR
3896,1699363620,1699367220,3600,185454,185812,GB,GB
7249,1700445060,1700478720,33660,67634,113795,TR,TR
96832,1699138620,1699142880,4260,194962,156629,GB,GB
48878,1700342100,1700345700,3600,18363,186632,GB,GB
42764,1699991880,1700009640,17760,51728,197541,FR,FR
187009,1699823340,1699856760,33420,134692,136996,TR,TR
81912,1700455500,1700468400,12900,189115,44413,CZ,CZ
39067,1700622000,1700638980,16980,172078,27749,US,US
121246,1700326320,1700329920,3600,118629,30684,NL,NL
23588,1700403780,1700434920,31140,8245,12309,TR,TR
142598,1699730100,1699762740,32640,96448,117675,TR,TR
11833,1700318880,1700335260,16380,122186,24331,AT,LV
69663,1699537680,1699570380,32700,781,103249,TR,TR
45872,1700601000,1700616960,15960,101528,95134,US,US
181532,1699642080,1699655940,13860,109491,197910,US,US
15773,1700028060,1700045220,17160,90507,197085,FR,FR
138936,1699049400,1699079340,29940,39895,171071,TR,TR
133322,1699138380,1699141980,3600,22678,29749,NL,NL
31566,1700164680,1700169360,4680,44409,153720,GB,GB
171253,1699993680,1700008500,14820,87638,150806,US,US
17973,1699276260,1699289820,13560,110438,153911,PT,PT
24763,1700598900,1700634480,35580,133114,49788,MX,MX
91103,1698852600,1698867480,14880,40343,59336,FR,CZ
165474,1699835280,1699850280,15000,52825,148441,FR,FR
138565,1699488180,1699521960,33780,57123,19538,TR,TR
30063,1700345520,1700363340,17820,20757,82028,FR,FR
89998,1700234040,1700244660,10620,20310,9423,ES,RO
142912,1699203780,1699234860,31080,29441,3093,TR,TR
165074,1700862000,1700873340,11340,16169,111115,PT,PT
81561,1699859400,1699886100,26700,13440,138163,DE,DE
134372,1700049960,1700054220,4260,84764,158996,GB,FR
93222,1699434180,1699439280,5100,16745,120532,GB,GB
95554,1700103240,1700107080,3840,21672,156595,NL,NL
91212,1699034820,1699047180,12360,30485,114688,RS,RS
182318,1699385760,1699414800,29040,173287,97813,TR,TR
106247,1699626840,1699638420,11580,35878,143958,PT,PT
44883,1700676780,1700687880,11100,144856,116192,ES,FR
142250,1699994760,1700030640,35880,113335,108122,TR,TR
59019,1699548360,1699566300,17940,187074,84449,FR,FR
75959,1700267100,1700278200,11100,39876,188715,US,US
79308,1700702820,1700735280,32460,140889,122363,TR,TR
62982,1698987780,1698998400,10620,61028,189044,IT,IT
81061,1699304760,1699323480,18720,149499,173520,FR,FR
146805,1699444380,1699455840,11460,7715,37439,US,US
41615,1699949040,1699959660,10620,135878,165084,IT,IT
14565,1700855040,1700885940,30900,189551,142493,TR,TR
58468,1700193480,1700224680,31200,105556,197362,TR,TR
176333,1699940400,1699955340,14940,185026,84999,US,US
117572,1699111500,1699141260,29760,117597,33568,TR,TR
166526,1700017740,1700029140,11400,190297,46350,CZ,CZ
152173,1700057820,1700092140,34320,116592,163047,TR,TR
36652,1699658760,1699670580,11820,83696,191091,US,US
18741,1700206440,1700210040,3600,15038,167335,GB,GB
94225,1699615020,1699632120,17100,85834,55801,US,US
108600,1700385540,1700396400,10860,177614,159124,US,US
174762,1698887400,1698899100,11700,993,86213,US,US
170623,1700219640,1700232180,12540,171173,83997,US,US
134043,1699335960,1699347900,11940,82226,101442,RS,MK
106589,1698894480,1698915720,21240,13928,181694,AL,BA
86931,1699631400,1699644540,13140,141401,155458,HR,HR
87210,1699076940,1699112640,35700,53077,36483,TR,TR
191482,1700720820,1700734080,13260,24680,122518,HR,HR
158178,1699671000,1699698540,27540,159375,60155,RO,MD
8230,1699416900,1699420500,3600,31185,184983,GB,GB
45887,1699270320,1699284120,13800,148020,88977,HR,BA
126303,1699937640,1699950540,12900,116960,41495,IT,IT
124663,1700592840,1700603880,11040,30997,134886,PT,PT
115710,1700200200,1700234460,34260,140937,166055,TR,TR
22008,1699173420,1699203840,30420,104263,123503,TR,TR
185705,1699851720,1699873560,21840,97308,103845,NO,PL
178831,1700567100,1700573820,6720,32035,188284,GB,GB
155498,1699933260,1699950720,17460,48803,65288,US,US
40279,1699013520,1699025280,11760,83713,14015,PT,PT
40701,1699944780,1699961880,17100,26938,147243,US,US
142568,1699070040,1699103760,33720,92348,69761,TR,TR
48539,1700404800,1700411340,6540,170265,189949,GB,GB
25792,1698921240,1698955260,34020,15584,111984,TR,TR
157135,1700408640,1700438640,30000,66717,51609,TR,TR
123582,1700707200,1700720760,13560,37955,57896,HR,HR
95482,1699462320,1699466280,3960,193143,104668,GB,GB
175275,1698802740,1698834480,31740,147474,5185,TR,TR
170150,1700569680,1700574960,5280,44684,65591,GB,GB
118569,1699707660,1699724940,17280,163779,157853,SE,SE
143274,1699934760,1699951740,16980,100367,106768,US,US
164707,1699094700,1699104300,9600,195746,117536,IT,SK
125986,1699806480,1699819860,13380,47690,159451,CA,US
51356,1699402260,1699436220,33960,34114,178395,TR,TR
69310,1699656060,1699679760,23700,4950,85556,DE,HR
27734,1700058840,1700070900,12060,148380,90239,HR,HR
133370,1699490160,1699523160,33000,21301,181386,TR,TR
105987,1699417320,1699453140,35820,181355,175823,TR,TR
8809,1700597700,1700610900,13200,104833,113529,ES,ES
41529,1699162620,1699172820,10200,85124,162663,HR,HR
153621,1698997080,1699011240,14160,135643,112376,ES,ES
135865,1699522620,1699544580,21960,43541,53454,PL,DE
160603,1699667760,1699672140,4380,79765,7767,GB,GB
150579,1698935340,1698946260,10920,162749,23847,ES,FR
106067,1699676520,1699714620,38100,23693,46567,MX,MX
135680,1699204320,1699212540,8220,141973,32428,IT,IT
94997,1699220700,1699232940,12240,106287,145938,US,US
132985,1700293020,1700304540,11520,99992,15461,IT,IT
136656,1699399620,1699415820,16200,43228,177001,AT,DE
80329,1700180880,1700213040,32160,139477,131812,TR,TR
78080,1700621340,1700633700,12360,18042,56060,US,US
168957,1699672020,1699701660,29640,104480,129640,TR,TR
140123,1699560720,1699587720,27000,119492,115618,DE,DE
45229,1700550720,1700555580,4860,145855,50527,GB,GB
18998,1700633640,1700652660,19020,196168,110226,FR,NL
129461,1699365420,1699404660,39240,25323,94184,MX,MX
127045,1700068680,1700072280,3600,184560,179055,NL,NL
172220,1699329840,1699352160,22320,178886,33212,SI,RS
100691,1700141520,1700165940,24420,19800,65079,DE,DK
171935,1698985740,1698999240,13500,68686,148577,US,US
160686,1698851400,1698855000,3600,144921,101432,NL,NL
155424,1700587320,1700611860,24540,198550,160778,DE,DE
82742,1699747800,1699751400,3600,168257,70358,GB,GB
178777,1699474080,1699498080,24000,150448,51559,HU,DE
140261,1699797720,1699801320,3600,74665,155936,GB,DE
10788,1700412000,1700418720,6720,14768,54177,GB,GB
171466,1699003560,1699009140,5580,60468,11988,GB,GB
170708,1698918420,1698954240,35820,44348,18131,TR,TR
147404,1700592060,1700626620,34560,84983,122227,TR,TR
39121,1700707500,1700727240,19740,10192,121173,FR,FR
126187,1700136420,1700168880,32460,92598,1191,TR,TR
184696,1700777700,1700797560,19860,27235,145958,FR,FR
140369,1700371080,1700401980,30900,8627,166679,TR,TR
189186,1699705560,1699740000,34440,158582,66149,TR,TR
182536,1700831820,1700844180,12360,176273,2750,SK,SK
162963,1700737500,1700773440,35940,37853,90896,TR,TR
6120,1700257560,1700289540,31980,113414,45425,TR,TR
41273,1699178580,1699195980,17400,151656,46941,CA,US
57816,1699277100,1699289820,12720,186614,152960,US,US
92994,1699927800,1699931400,3600,24390,49202,NL,NL
99262,1699044060,1699080000,35940,182846,96388,MK,BG
196636,1700604660,1700637060,32400,147073,75811,TR,TR
17758,1700251440,1700259960,8520,178031,92253,HR,HR
146584,1700488740,1700524140,35400,130091,86547,TR,TR
62031,1698800160,1698812580,12420,131286,12247,HR,HR
47703,1700686560,1700718840,32280,76148,26207,TR,TR
183620,1700363280,1700397480,34200,116607,132647,MX,MX
170753,1698844980,1698857100,12120,159105,72859,US,US
14098,1698982680,1699009920,27240,73834,150249,DE,AT
89653,1700572440,1700588040,15600,60081,101534,US,US
57546,1698977460,1699007460,30000,46419,33965,TR,TR
107789,1700164440,1700196780,32340,145157,121239,TR,TR
7736,1700410440,1700443860,33420,51320,60920,TR,TR
186680,1699094100,1699108320,14220,130323,41280,PT,PT
41547,1699921680,1699933020,11340,42619,63031,CA,CA
22601,1699757880,1699788540,30660,176274,141477,TR,TR
193441,1699470180,1699487280,17100,21815,151354,CA,CA
160290,1698894420,1698898020,3600,43904,59663,GB,GB
73905,1699528320,1699563840,35520,193963,104858,TR,TR
173158,1698985560,1698994920,9360,185586,159625,IT,IT
129108,1699450200,1699480200,30000,79615,68452,TR,TR
152425,1698962940,1698992340,29400,73031,1991,TR,TR
168545,1700404740,1700437320,32580,141831,117296,TR,TR
57137,1699605540,1699618380,12840,30074,50402,IT,IT
98584,1699660080,1699663680,3600,199587,77906,GB,GB
141299,1699245240,1699261500,16260,66686,69206,US,US
109082,1699075260,1699081200,5940,80001,27057,GB,GB
31706,1699030860,1699036980,6120,104624,154453,GB,GB
140939,1700519160,1700555040,35880,187472,66668,TR,TR
53075,1699557480,1699590180,32700,117289,99050,TR,TR
92937,1700247420,1700266920,19500,46768,101083,FR,FR
65310,1700758680,1700788560,29880,32728,160611,TR,TR
97420,1699139820,1699143420,3600,89512,191857,NL,NL
133033,1700063760,1700070060,6300,145333,7135,GB,GB
163987,1699025880,1699031460,5580,163658,151176,GB,GB
70793,1699234800,1699266900,32100,11895,23163,TR,TR
146343,1700779380,1700782980,3600,125550,51282,GB,GB
104750,1699044240,1699077540,33300,141374,3382,TR,TR
94213,1699582800,1699590300,7500,11956,103251,IT,IT
45730,1700818440,1700852460,34020,196783,71467,TR,TR
118723,1700213280,1700227620,14340,60472,15820,US,US
119343,1699843020,1699858740,15720,69445,11268,US,US
161094,1700815680,1700819580,3900,158340,163833,NL,NL
92934,1699925220,1699936560,11340,140941,176212,IT,IT
72063,1699069200,1699084920,15720,176767,117448,CZ,CZ
12815,1699000380,1699004280,3900,171963,199897,GB,GB
187311,1700778420,1700782860,4440,51453,16883,GB,GB
159047,1700419800,1700454000,34200,23760,104234,TR,TR
96034,1699958760,1699962360,3600,192778,93350,GB,GB
81658,1698876720,1698880920,4200,78506,192069,GB,GB
44851,1699705920,1699741500,35580,137332,62089,TR,TR
179919,1700351880,1700366160,14280,17785,111280,US,US
119690,1700474640,1700506080,31440,151436,140345,TR,TR
498,1698813960,1698821460,7500,182983,14992,IT,IT
139188,1700787300,1700821500,34200,183425,128798,TR,TR
106143,1700446860,1700457720,10860,57662,154503,HR,HR
176028,1700502240,1700508000,5760,104615,141565,GB,GB
169403,1699889100,1699918320,29220,48706,123085,TR,TR
96911,1698835860,1698867780,31920,114394,96911,TR,TR
187177,1700206860,1700221920,15060,105393,98,US,US
62301,1700526720,1700536380,9660,28854,145543,IT,IT
154713,1699755900,1699764600,8700,64328,179694,IT,IT
27208,1700251680,1700284020,32340,9612,44591,TR,TR
64705,1700499720,1700533560,33840,17197,143724,TR,TR
79837,1700300760,1700328360,27600,161764,140064,DE,DE
137397,1700732100,1700737020,4920,173802,31386,GB,GB
188061,1699992540,1700022900,30360,37661,6232,TR,TR
185406,1699417020,1699420620,3600,145112,43151,GB,GB
90080,1699220040,1699223640,3600,177784,119136,GB,GB
29357,1700372940,1700407140,34200,119302,78574,TR,TR
65857,1699459860,1699491180,31320,114784,92947,TR,TR
15941,1700770920,1700806320,35400,50266,168812,MX,MX
14602,1699678800,1699695900,17100,113302,79083,CZ,CZ
174939,1699353900,1699357680,3780,191260,136020,NL,NL
61904,1699363020,1699374180,11160,59431,47262,RS,RS
5175,1699253040,1699264860,11820,41413,147107,AT,AT
193068,1700158140,1700169780,11640,124636,51318,US,US
124450,1699548300,1699582500,34200,81565,120928,TR,TR
168947,1699343700,1699358940,15240,189805,184119,US,US
184334,1699752600,1699767360,14760,20502,3474,CA,CA
183986,1699747920,1699763820,15900,97286,173658,AT,CZ
165596,1700580720,1700594400,13680,68646,175567,IT,IT
191297,1700349240,1700367000,17760,84761,113637,AT,AT
22782,1699021380,1699052160,30780,168007,32412,TR,TR
59822,1700450940,1700463000,12060,112234,178729,IT,IT
173431,1699995060,1700025900,30840,12176,2244,TR,TR
139434,1700598000,1700606040,8040,22003,149435,IT,FR
19959,1700774760,1700792100,17340,45062,154886,US,US
75657,1700314560,1700346780,32220,105581,30742,TR,TR
195257,1700369100,1700376600,7500,56356,44162,IT,NL
133985,1699482540,1699513140,30600,121133,32030,TR,TR
164145,1699128900,1699140180,11280,10535,52040,PT,PT
120929,1699984680,1700010300,25620,92281,184398,PL,UA
183341,1700760180,1700792880,32700,94077,168721,TR,TR
149608,1698867240,1698902760,35520,5041,137411,TR,TR
139447,1700499840,1700507940,8100,85338,46276,IT,IT
26160,1700472720,1700501460,28740,163805,97012,DE,CH
14235,1699742280,1699774020,31740,168353,118171,TR,TR
158592,1699507920,1699541760,33840,48985,74565,TR,TR
14675,1699293960,1699325160,31200,3869,119191,TR,TR
187768,1698844320,1698877200,32880,178095,140041,TR,TR
146111,1698838860,1698848820,9960,76698,131393,IT,IT
16022,1700482740,1700494500,11760,24991,96069,HR,HR
2904,1700507400,1700514300,6900,100318,110383,GB,GB
145889,1699591980,1699602960,10980,143078,87243,HR,HR
81267,1700460240,1700484000,23760,58078,72063,SI,RS
165195,1700551260,1700583120,31860,88659,93507,TR,TR
17809,1700601060,1700604660,3600,88410,128423,NL,NL
182894,1699821960,1699829760,7800,190169,112479,IT,IT
199632,1700295360,1700299260,3900,70869,98737,NL,NL
74547,1700190840,1700196900,6060,91688,125840,GB,GB
150395,1699749480,1699761060,11580,65113,109622,PT,PT
137362,1699218180,1699226220,8040,166520,191090,HR,HR
155289,1699076880,1699110540,33660,197099,20310,TR,TR
199771,1700241360,1700278380,37020,109218,55572,MX,MX
146219,1698800640,1698818040,17400,193762,34430,US,US
98099,1700723340,1700735160,11820,127282,84457,AT,AT
27714,1699594620,1699605720,11100,113795,179946,US,US
93847,1699865820,1699923840,58020,12279,96296,UA,PL
115114,1700340180,1700345940,5760,101042,47953,GB,GB
157500,1699448400,1699452000,3600,92340,98161,NL,NL
127205,1699797780,1699807020,9240,47345,3140,IT,IT
6284,1699603200,1699632960,29760,147663,77919,TR,TR
155631,1698831660,1698836220,4560,196369,183335,GB,GB
179267,1700242380,1700245980,3600,141479,92298,GB,GB
185911,1699722840,1699730460,7620,23916,144586,IT,IT
80849,1699524180,1699558680,34500,149310,127297,TR,TR
117866,1700734740,1700748360,13620,187405,147360,HR,BA
44216,1700012880,1700029320,16440,89752,44034,US,US
35538,1698897060,1698909720,12660,95341,170149,IT,IT
160519,1700530740,1700566320,35580,181923,80801,TR,TR
152910,1700014680,1700020800,6120,17757,24147,NL,NL
110209,1700233080,1700245800,12720,191901,135150,AT,DE
44595,1699425960,1699440600,14640,84029,189703,US,US
37540,1699533540,1699567200,33660,155527,99762,TR,TR
150250,1699477080,1699491360,14280,193612,161871,US,US
15509,1699509720,1699541820,32100,31989,58811,TR,TR
185512,1700127600,1700138580,10980,46372,2577,HR,IT
178054,1700433480,1700459340,25860,164810,96674,PL,FR
115817,1700050080,1700083140,33060,71480,90361,TR,TR
125765,1700596560,1700632080,35520,83630,176470,TR,TR
82506,1699412820,1699440180,27360,67186,25678,BR,BR
99325,1699721280,1699754160,32880,27550,23166,TR,TR
144461,1699870920,1699906140,35220,144096,22349,TR,TR
49143,1699384740,1699388340,3600,80847,137526,GB,GB
131418,1700100300,1700119320,19020,61502,146682,AL,MK
6167,1700471220,1700501940,30720,18098,27429,TR,TR
140280,1698998400,1699030320,31920,125624,160954,TR,TR
137345,1700386440,1700415540,29100,104707,86369,TR,TR
153025,1699410840,1699422780,11940,161385,34847,IT,IT
89321,1700512140,1700536260,24120,126337,166379,BR,BR
139742,1700252820,1700256420,3600,152751,172420,NL,NL
107181,1699342200,1699354380,12180,171605,138368,AT,AT
14844,1700175540,1700186880,11340,163377,198779,US,US
94742,1699584060,1699613100,29040,63466,44378,TR,TR
109942,1699196280,1699212180,15900,88627,11769,US,US
46743,1699579980,1699609860,29880,197271,122872,TR,TR
194548,1700044740,1700080500,35760,160187,137000,TR,TR
2923,1700032080,1700061120,29040,169553,61110,TR,TR
158343,1700385780,1700419560,33780,82958,69694,TR,TR
60143,1699577100,1699588860,11760,64998,198726,US,US
92542,1700301660,1700331960,30300,163663,131349,TR,TR
58120,1699740900,1699763460,22560,189774,28253,DE,DE
175312,1699994160,1700011920,17760,53838,79273,US,US
26228,1699213740,1699217340,3600,22667,150187,GB,GB
132697,1699638720,1699647480,8760,33811,61554,IT,HR
24076,1700004000,1700037180,33180,102300,118240,MX,MX
148925,1700391720,1700400960,9240,144360,58614,HR,HR
151037,1700152140,1700155740,3600,185876,124544,GB,GB
148249,1699279140,1699285560,6420,180056,88328,GB,GB
5239,1698833940,1698844620,10680,133597,190775,IT,IT
133130,1699026420,1699040460,14040,104019,83634,IT,IT
84921,1699549560,1699583340,33780,111275,64471,TR,TR
114149,1699829700,1699833300,3600,145828,127938,GB,GB
47749,1699631340,1699648560,17220,193613,95940,US,US
164737,1699892100,1699895700,3600,98401,167029,NL,NL
86041,1700156700,1700172900,16200,154644,118482,US,US
158707,1699617600,1699651560,33960,18920,196609,TR,TR
83412,1700120640,1700146440,25800,152681,33567,DE,DE
79107,1699450500,1699505040,54540,14959,87640,UA,HU
124539,1700779620,1700815260,35640,25713,63999,TR,TR
121890,1699629780,1699644900,15120,86903,101680,FR,FR
172528,1699358040,1699361640,3600,80606,58801,GB,GB
146735,1700656440,1700691300,34860,34528,61947,TR,TR
11761,1699951080,1699959780,8700,54490,115910,PT,PT
156380,1699680720,1699709700,28980,75387,24883,TR,TR
53102,1700438400,1700472840,34440,84524,161995,TR,TR
144367,1699343280,1699353420,10140,74122,16348,IT,IT
194758,1700583180,1700613600,30420,9409,142065,TR,TR
73575,1699258620,1699271220,12600,62993,168028,AT,AT
31715,1699515660,1699550640,34980,180013,183206,MX,MX
109215,1700572800,1700589360,16560,161246,178587,CZ,CZ
113965,1700860980,1700871960,10980,36849,171733,IT,IT
132849,1698971820,1698992880,21060,77664,56326,MD,RO
73128,1699130820,1699145760,14940,178338,158823,US,US
131151,1700851080,1700883240,32160,36559,134733,TR,TR
65590,1700093880,1700126940,33060,179734,155203,TR,TR
41216,1699322520,1699334580,12060,52897,126032,US,US
129681,1699112220,1699127580,15360,139575,170171,US,US
53919,1699176900,1699192200,15300,173292,68914,US,US
153381,1700104800,1700108400,3600,128105,187139,GB,GB
75096,1700667660,1700697000,29340,2113,99938,TR,TR
74033,1700028840,1700038320,9480,57674,86653,IT,IT
66417,1700108760,1700113680,4920,10412,130946,GB,GB
34264,1698995880,1699014840,18960,109368,46916,AL,HR
8290,1700768220,1700778060,9840,156784,181981,IT,IT
190096,1699757820,1699793760,35940,163232,141479,MX,MX
171526,1699790580,1699796100,5520,128268,175264,NL,NL
38939,1699791780,1699819800,28020,2840,196512,DE,DE
174876,1699438740,1699473420,34680,143395,83266,TR,TR
53322,1698906420,1698917820,11400,188962,32214,IT,IT
177057,1699288680,1699295160,6480,87317,107182,GB,GB
72011,1699414440,1699430460,16020,7490,145084,FR,FR
66358,1700627340,1700661300,33960,156388,173044,TR,TR
166908,1699438560,1699442460,3900,54575,639,CL,CL
164747,1700020980,1700054820,33840,109667,26843,TR,TR
26097,1699590180,1699602900,12720,110543,97247,HR,HR
73884,1700770320,1700773920,3600,193278,115257,GB,GB
109768,1699113240,1699123980,10740,60362,164534,PT,PT
176625,1699159260,1699190280,31020,44581,1765,TR,TR
101885,1700491620,1700501820,10200,129529,91337,PT,PT
157274,1699350360,1699378320,27960,6662,151545,RO,SE
75960,1700804580,1700838480,33900,189181,57332,TR,TR
18654,1699059360,1699070280,10920,155462,62560,IT,IT
71533,1700250420,1700287560,37140,195033,54707,MX,MX
38089,1699930380,1699961520,31140,47317,46787,TR,TR
74642,1700256840,1700289000,32160,124849,7792,TR,TR
45881,1698955440,1698962040,6600,177167,180200,NL,BE
150054,1699087620,1699091220,3600,65811,162464,GB,GB
11043,1700037000,1700057640,20640,162120,94515,SI,PL
124648,1699225860,1699235280,9420,42242,152657,IT,IT
61253,1699114440,1699167780,53340,185695,119910,BG,DE
49618,1699098780,1699102380,3600,15179,58220,NL,NL
150043,1699095600,1699106940,11340,88227,55125,HR,BA
11748,1699688220,1699694100,5880,35558,61737,GB,GB
181220,1699161420,1699194960,33540,57110,121952,TR,TR
143811,1699948080,1699969080,21000,54356,131510,FR,FR
110721,1699981680,1700014860,33180,59117,93282,TR,TR
186644,1699694580,1699715880,21300,195835,171544,FR,FR
42666,1699864560,1699898160,33600,158071,7769,TR,TR
69103,1700217060,1700224140,7080,44401,89388,NL,NL
129656,1700317620,1700346960,29340,91933,9186,TR,TR
1778,1698845460,1698862200,16740,87838,172485,US,US
129468,1700044500,1700048100,3600,19031,140108,GB,GB
130154,1699857600,1699873140,15540,138708,185218,US,US
186625,1700814600,1700847240,32640,163839,138157,MX,MX
36185,1700559840,1700574000,14160,163645,25928,IT,IT
69260,1699083780,1699119600,35820,68921,175943,TR,TR
100852,1699360200,1699389720,29520,184697,38770,TR,TR
189634,1699648320,1699653960,5640,22543,163795,GB,GB
83812,1700613240,1700634240,21000,189750,144498,FR,NL
182816,1700346660,1700378460,31800,31476,70643,TR,TR
195757,1700522640,1700555340,32700,116839,39681,TR,TR
7731,1699539480,1699547340,7860,140076,59528,IT,IT
28794,1699151640,1699187520,35880,49806,68954,TR,TR
165759,1699721100,1699724700,3600,63640,163426,NL,DE
46538,1699387620,1699394580,6960,144100,61026,GB,GB
198223,1699997700,1700023980,26280,163856,46619,PL,PL
134117,1699694880,1699698480,3600,177367,53295,GB,GB
118426,1698832800,1698844260,11460,33921,79723,IT,IT
87756,1700391720,1700425620,33900,107387,90790,TR,TR
165090,1700369820,1700393640,23820,75389,80590,DE,AT
96685,1700409660,1700418900,9240,65067,73869,ES,ES
193562,1699600860,1699635180,34320,12797,14396,TR,TR
99445,1699660380,1699676940,16560,53696,111481,AT,AT
137011,1699930620,1699935120,4500,4910,4747,GB,GB
104768,1700312100,1700323560,11460,56001,20693,US,US
96007,1699300020,1699312920,12900,103856,98184,US,US
63174,1698878880,1698910680,31800,11194,20739,TR,TR
31628,1700573760,1700586840,13080,162719,6856,IT,IT
81614,1699601820,1699632540,30720,11972,8556,TR,TR
78734,1699192680,1699214880,22200,115412,151133,DE,BA
155680,1700729220,1700752440,23220,1354,170527,CH,FR
38890,1699975980,1700005800,29820,68081,47685,TR,TR
60235,1700813700,1700821980,8280,111116,154245,EE,EE
108917,1699004700,1699024440,19740,187644,151053,FR,FR
19763,1700259720,1700275200,15480,176204,144672,US,US
80869,1700422740,1700455680,32940,121395,100431,TR,TR
102771,1699551000,1699563300,12300,193833,73472,CZ,DE
167800,1699502640,1699513260,10620,92634,18941,PT,PT
94241,1699359900,1699389180,29280,177535,179180,TR,TR
188848,1699688700,1699693680,4980,62497,47565,GB,GB
171378,1700859600,1700882520,22920,26916,24729,AL,ME
194271,1699629060,1699658760,29700,55191,9924,TR,TR
188111,1698997020,1699012920,15900,182637,186359,US,US
117511,1699462200,1699495260,33060,153280,72137,TR,TR
43638,1700550240,1700575440,25200,107498,188345,BR,BR
5125,1700026740,1700030340,3600,146996,130348,NL,NL
90535,1700593740,1700604420,10680,92698,83178,PT,PT
27459,1700503440,1700507040,3600,148593,24365,NL,BE
13998,1700841420,1700855700,14280,176569,26740,PT,PT
98824,1699498380,1699536720,38340,34989,7817,MX,MX
197192,1700054040,1700085960,31920,74488,90174,TR,TR
161790,1700022180,1700053320,31140,147933,49953,TR,TR
191041,1699970460,1699974060,3600,15615,94875,GB,GB
173055,1699389300,1699423980,34680,63795,13324,TR,TR
187460,1699263600,1699274400,10800,183649,126335,IT,IT
134052,1698896820,1698926640,29820,105359,16772,TR,TR
197711,1700573460,1700606760,33300,44751,166754,TR,TR
104975,1700834580,1700870160,35580,157819,135285,TR,TR
1452,1699100940,1699118880,17940,111437,84162,US,US
133595,1699886340,1699889940,3600,68216,88015,GB,GB
96479,1699842600,1699875300,32700,26921,191801,TR,TR
124484,1699138800,1699169880,31080,87943,152865,TR,TR
154643,1698858600,1698891120,32520,157110,114489,TR,TR
60529,1700150100,1700164680,14580,97667,627,BE,GB
198308,1700586960,1700624160,37200,52069,199493,MX,MX
173423,1699772940,1699792800,19860,51210,67946,FR,FR
27492,1700238900,1700272320,33420,53020,88282,TR,TR
55606,1699898040,1699931520,33480,96863,98776,TR,TR
32219,1699458180,1699490520,32340,4390,181440,TR,TR
169033,1699200420,1699235040,34620,47876,163544,TR,TR
105340,1699650660,1699659720,9060,141845,36547,IT,IT
23140,1700154660,1700158260,3600,42765,95711,GB,GB
122846,1700186700,1700190300,3600,131308,116616,GB,GB
36907,1699467840,1699471440,3600,197296,155050,GB,GB
118215,1700765700,1700801880,36180,84958,56077,MX,MX
177534,1699415160,1699452180,37020,12674,2818,MX,MX
111507,1699515780,1699548060,32280,52643,199279,TR,TR
158055,1700613180,1700616780,3600,24720,75841,NL,NL
191864,1698907380,1698943020,35640,188782,149816,TR,TR
85002,1700862180,1700879700,17520,44006,124806,AT,SK
133000,1700764680,1700793840,29160,22944,171678,TR,TR
83726,1699250640,1699254540,3900,11732,40725,GB,GB
58753,1700188200,1700203440,15240,172952,90352,FR,CZ
152083,1699575240,1699606860,31620,62195,66265,TR,TR
72019,1700642520,1700660640,18120,172283,64855,FR,BE
156573,1700860620,1700880840,20220,117785,19895,FR,CH
69858,1698924840,1698959400,34560,137034,39101,TR,TR
96270,1700474700,1700510340,35640,112844,19535,TR,TR
169249,1700866500,1700894220,27720,70649,180038,DE,AT
155570,1699071360,1699082640,11280,114665,56882,US,US
155069,1699490820,1699494420,3600,165294,58963,GB,GB
94749,1699748400,1699752000,3600,105511,116741,NL,NL
93190,1698885540,1698897720,12180,142985,10218,US,US
139599,1699998720,1700002560,3840,123308,186654,NL,NL
101359,1700332860,1700336880,4020,111988,29997,GB,GB
124170,1699371180,1699382160,10980,149646,129359,US,US
150769,1700092080,1700125680,33600,150371,122808,TR,TR
157222,1699529700,1699542060,12360,186704,69779,IT,IT
100699,1700837700,1700863260,25560,149202,107915,BR,BR
17946,1699513200,1699516800,3600,116719,119263,GB,GB
129113,1700563200,1700566800,3600,77923,18405,GB,GB
99222,1699616520,1699632840,16320,61608,8880,AT,PL
131590,1699671240,1699705380,34140,118088,174312,TR,TR
185734,1700378580,1700413860,35280,184145,132704,TR,TR
9430,1700182980,1700217720,34740,187487,127940,TR,TR
170068,1699405080,1699425900,20820,6502,106104,SE,SE
179349,1699027080,1699042740,15660,161495,31295,FR,FR
190350,1700733900,1700747700,13800,32409,93002,US,US
61618,1699181280,1699214400,33120,3125,95496,TR,TR
63989,1699971360,1699978380,7020,184642,69679,EE,CZ
73974,1699528200,1699541160,12960,86539,182853,IT,IT
135784,1700810220,1700841780,31560,136468,173565,TR,TR
96329,1699763460,1699796940,33480,14155,108936,TR,TR
160737,1700345400,1700380260,34860,120268,2510,TR,TR
100225,1699414200,1699444800,30600,177823,142453,TR,TR
63788,1700784660,1700788260,3600,125822,59759,GB,GB
173706,1699408440,1699443360,34920,199455,21262,TR,TR
87440,1700654760,1700684340,29580,103407,199570,TR,TR
37538,1699282080,1699294200,12120,128655,29890,US,US
90529,1699410300,1699419840,9540,163426,151035,IT,IT
726,1699052940,1699065420,12480,184863,99934,CZ,FR
26634,1699784160,1699797420,13260,151248,41855,IT,IT
112777,1699893360,1699918260,24900,122230,191504,BR,BR
72877,1700556900,1700578140,21240,160707,196702,FR,FR
57397,1699231440,1699235040,3600,118193,121355,GB,GB
143842,1699482060,1699494060,12000,59068,125413,US,US
48669,1698797160,1698829320,32160,198469,55576,TR,TR
25575,1700127600,1700156460,28860,187704,108358,TR,TR
189185,1699017660,1699045020,27360,135776,174097,BR,BR
10141,1699327860,1699363140,35280,99382,189518,TR,TR
95282,1700161800,1700190780,28980,174926,121478,TR,TR
3392,1698888600,1698923700,35100,99360,91061,TR,TR
102192,1700474340,1700509440,35100,86604,41439,TR,TR
153976,1700767560,1700795640,28080,146792,194360,DE,NL
24663,1700312940,1700324160,11220,122880,39156,PT,PT
130349,1698809460,1698813060,3600,176619,1641,GB,GB
44443,1698898020,1698911520,13500,4427,26857,HR,HR
50117,1700400600,1700435880,35280,87132,74062,TR,TR
148666,1699919220,1699945920,26700,61204,167734,DE,AT
182503,1700183640,1700218440,34800,61182,49171,TR,TR
8794,1700475180,1700488620,13440,60299,157053,CZ,PL
69903,1699528140,1699531740,3600,108999,187735,GB,GB
58867,1699478940,1699508100,29160,68053,48749,TR,TR
11890,1700233200,1700262900,29700,168082,42470,TR,TR
122868,1699105560,1699118160,12600,111435,22546,IT,IT
30211,1699148700,1699152300,3600,72397,65570,NL,NL
179066,1699415160,1699421400,6240,36605,83471,GB,GB
140188,1700062860,1700070060,7200,125106,148,EE,FI
87419,1700436540,1700441340,4800,55758,131051,NL,NL
16836,1699342200,1699374960,32760,149982,27162,TR,TR
173124,1699565340,1699600800,35460,125523,22478,TR,TR
25414,1699984440,1699991100,6660,177440,159645,NL,NL
142237,1700528760,1700549580,20820,122649,5890,BE,FR
152280,1699145700,1699179120,33420,29317,52994,TR,TR
17561,1699532820,1699541880,9060,30380,51277,HR,HR
168972,1700156160,1700189220,33060,91260,113098,TR,TR
136915,1699066620,1699080900,14280,172248,123998,US,US
77163,1698946860,1698950460,3600,74832,104398,GB,GB
117621,1700222100,1700250000,27900,136336,173263,DE,AT
30636,1699592640,1699626420,33780,166301,95024,MX,MX
150936,1699199460,1699208880,9420,17513,59661,IT,IT
55440,1699577220,1699608960,31740,151515,130108,TR,TR
47813,1699808700,1699813500,4800,78180,134853,NL,NL
85410,1699273140,1699283460,10320,14262,180575,IT,IT
127152,1700833860,1700866440,32580,23480,133204,TR,TR
102289,1700509620,1700521980,12360,91330,196145,SK,SK
128310,1700073540,1700108100,34560,63509,85169,TR,TR
122638,1700736240,1700752320,16080,197502,182738,US,US
39100,1700598960,1700614620,15660,70360,3147,US,US
19675,1699913040,1699928820,15780,46415,128478,FR,FR
100709,1700826960,1700862540,35580,716,73247,TR,TR
170155,1700211600,1700226420,14820,173809,44879,AT,AT
198618,1699396260,1699429620,33360,143829,193166,MX,MX
112422,1699418700,1699427100,8400,183320,116984,SK,SK
182290,1699227420,1699261920,34500,126424,186041,TR,TR
139864,1699942260,1699976940,34680,21700,66385,TR,TR
98615,1699413000,1699445280,32280,97846,172289,TR,TR
136443,1700256660,1700267880,11220,194910,25050,PT,PT
11234,1700230380,1700261040,30660,97471,74681,TR,TR
162907,1699547340,1699580100,32760,27022,191870,TR,TR
47146,1700738100,1700748720,10620,63899,179169,IT,IT
8703,1699508880,1699522320,13440,218,2938,HR,HR
193543,1699570500,1699576020,5520,56210,31519,NL,NL
159983,1700670000,1700675100,5100,97929,110670,NL,NL
145850,1700539920,1700563860,23940,118414,61140,DK,DK
194860,1699242240,1699276440,34200,155240,71310,TR,TR
63399,1699044300,1699076520,32220,59846,69935,TR,TR
43745,1699917900,1699930020,12120,196667,171646,IT,IT
114713,1698997380,1699021500,24120,57816,63798,PL,PL
191380,1700323140,1700340720,17580,145751,50872,US,US
190817,1699548120,1699578540,30420,85006,56350,TR,TR
127060,1699184580,1699219080,34500,98560,98923,MX,MX
82932,1699821000,1699854180,33180,90491,160308,TR,TR
123898,1699877940,1699907040,29100,2946,31695,TR,TR
1408,1700299800,1700312580,12780,164448,111960,IT,CH
59385,1700418660,1700448240,29580,14239,158829,TR,TR
120842,1700736840,1700758860,22020,157293,89305,BR,BR
65881,1700559180,1700573280,14100,8693,179379,US,US
86488,1700034300,1700045760,11460,33410,130443,SK,CZ
100120,1700558340,1700568480,10140,106964,27988,PT,PT
10134,1700704020,1700723400,19380,53935,23826,FR,FR
133900,1700358000,1700374380,16380,172780,166928,US,US
65547,1699777140,1699793580,16440,31643,107195,CZ,UA
111420,1699058640,1699091700,33060,172523,10830,TR,TR
183377,1699947840,1699955760,7920,127698,122705,IT,IT
114495,1699111320,1699124460,13140,166017,194562,RS,FR
158792,1699606620,1699610220,3600,145264,108036,NL,NL
79576,1700417580,1700421180,3600,166309,147217,NL,NL
51109,1700054520,1700059500,4980,29061,60399,NL,NL
9075,1700670420,1700683200,12780,68760,41696,US,MX
144926,1700566440,1700600760,34320,66997,194784,TR,TR
151002,1699092600,1699096200,3600,124781,138435,NL,NL
56652,1700750520,1700784360,33840,74681,93462,TR,TR
162192,1699639680,1699663200,23520,142291,3700,RO,RO
122310,1700392320,1700421840,29520,74635,82650,TR,TR
78220,1699245300,1699276920,31620,113270,32856,TR,TR
98449,1699337820,1699369500,31680,113621,186737,TR,TR
37048,1699847040,1699882200,35160,101131,149033,TR,TR
4519,1699354440,1699389240,34800,45851,184863,TR,TR
174849,1700473320,1700505360,32040,78327,120467,TR,TR
37857,1700643180,1700654700,11520,147599,148360,CZ,CZ
129829,1699378560,1699389300,10740,159985,33828,IT,IT
141418,1698825000,1698857640,32640,151549,37455,MX,MX
17582,1700660880,1700689500,28620,144689,85719,DE,AT
125959,1700644500,1700668800,24300,73393,152477,ME,BA
67955,1699500660,1699505880,5220,164665,36851,GB,GB
39154,1699444140,1699479540,35400,182807,178124,TR,TR
171865,1700347320,1700378400,31080,39791,17122,TR,TR
95967,1700810880,1700846460,35580,147275,24155,TR,TR
153246,1700568000,1700597400,29400,144035,178982,TR,TR
11017,1698948840,1698978000,29160,117412,21222,TR,TR
30450,1699371540,1699410360,38820,55214,183721,MX,US
36851,1699387680,1699393980,6300,11424,169476,NL,NL
96053,1700021820,1700032860,11040,75242,90044,US,US
188270,1699392180,1699420980,28800,48209,104057,TR,TR
45562,1699706280,1699737540,31260,93826,10771,TR,TR
1517,1699022280,1699054920,32640,196250,37053,TR,TR
13329,1700247180,1700278020,30840,137152,96075,TR,TR
118658,1699464120,1699468380,4260,6793,118618,NL,NL
51279,1700432880,1700467680,34800,63077,65853,TR,TR
108515,1699966260,1699969920,3660,194119,147261,NL,NL
181075,1699285620,1699310160,24540,138236,42746,DE,RS
95903,1699953120,1699985760,32640,31489,177110,TR,TR
41283,1699848420,1699878540,30120,97341,18426,TR,TR
150902,1700376300,1700406420,30120,69706,28780,TR,TR
1356,1700465580,1700474160,8580,108060,160156,HR,DE
100582,1700751540,1700782740,31200,71780,168670,TR,TR
127595,1698876840,1698881760,4920,105586,187704,GB,GB
143859,1700841720,1700871840,30120,77955,104310,TR,TR
72747,1698907140,1698940860,33720,36080,19763,TR,TR
138327,1699733580,1699768920,35340,132245,7542,TR,TR
85783,1698948180,1698980400,32220,142092,120686,TR,TR
66519,1698958020,1698988620,30600,69587,98274,TR,TR
106030,1700603340,1700633580,30240,142074,140913,TR,TR
143311,1700840040,1700853720,13680,91204,37306,HR,AL
114789,1700111580,1700120880,9300,145993,17522,ES,NL
27543,1700071740,1700104380,32640,184121,7401,TR,TR
47766,1698987780,1699022580,34800,98079,124310,TR,TR
64285,1699273500,1699288680,15180,14973,142619,US,US
176866,1699281120,1699311420,30300,113421,170848,TR,TR
77890,1700826240,1700838060,11820,104589,197061,IT,IT
115588,1698911700,1698940560,28860,50529,115944,TR,TR
34313,1700589840,1700624340,34500,5781,105831,TR,TR
12233,1700427060,1700449860,22800,18445,100147,DE,HR
178558,1700677980,1700707020,29040,142880,5494,TR,TR
146156,1700133480,1700150280,16800,39891,163727,AT,AT
185081,1700555340,1700558940,3600,4905,156795,GB,GB
4737,1699291140,1699323780,32640,88076,166723,TR,TR
31606,1699220580,1699254000,33420,123808,18782,TR,TR
148994,1700012880,1700040840,27960,103721,128374,BA,AT
170219,1699481400,1699485000,3600,80904,133820,GB,GB
115688,1699243020,1699252080,9060,3518,131337,IT,IT
139235,1700268480,1700300880,32400,142521,56779,TR,TR
67119,1698815640,1698840600,24960,36916,98062,DK,DK
128304,1700452920,1700479440,26520,126504,68757,DE,DE
122247,1699986240,1700015340,29100,199492,41847,TR,TR
19256,1699854180,1699885260,31080,14511,163953,TR,TR
114880,1699634520,1699653720,19200,191572,78878,FR,FR
190253,1699143840,1699161660,17820,42139,21707,US,US
56877,1699465020,1699469520,4500,182607,5366,GB,GB
156279,1700594580,1700598180,3600,193165,92271,NL,NL
60892,1699847400,1699851000,3600,161278,80968,NL,NL
26127,1699001760,1699015020,13260,169680,189730,IT,IT
195599,1699973160,1699989600,16440,104415,91521,US,US
43925,1700808360,1700843400,35040,120193,33543,TR,TR
4672,1699621500,1699650780,29280,148618,154316,TR,TR
116433,1700845620,1700849220,3600,90641,88755,NL,NL
180418,1699296060,1699329720,33660,96168,187601,TR,TR
159311,1700081880,1700085480,3600,83618,20084,NL,NL
105650,1699671840,1699675440,3600,193943,2388,NL,NL
80984,1700169900,1700177100,7200,11090,68256,HR,DE
83715,1698927900,1698961020,33120,117110,42677,TR,TR
168520,1700406840,1700434260,27420,192010,184479,RO,AT
121640,1699080000,1699088160,8160,1444,48276,IT,IT
198825,1698946920,1698979860,32940,53438,26279,TR,TR
1190,1699747440,1699799820,52380,145437,62003,BG,AT
57352,1699815840,1699829940,14100,16319,153364,IT,IT
91582,1700859300,1700877240,17940,150602,82646,US,US
138421,1698961080,1698973440,12360,145317,107692,ES,ES
108389,1699993080,1699997580,4500,182434,13942,GB,GB
191712,1698940920,1698944520,3600,64242,92657,NL,NL
83470,1699874580,1699886700,12120,109531,192387,US,US
1577,1700063280,1700078040,14760,166405,16477,CZ,CZ
234,1699582560,1699618320,35760,39229,92597,TR,TR
199521,1699961640,1699995480,33840,190073,137239,TR,TR
172208,1699857780,1699874160,16380,3146,73359,FR,HR
150669,1700256660,1700285760,29100,176434,125526,TR,TR
85705,1699837920,1699851720,13800,165054,76681,HR,HR
122106,1699414260,1699449480,35220,98253,87112,TR,TR
98254,1698824640,1698831060,6420,124130,104087,GB,GB
103422,1700637420,1700643960,6540,44888,28698,GB,GB
162210,1700726940,1700739120,12180,28587,6288,US,US
124767,1699584300,1699618860,34560,167882,150009,TR,TR
14631,1700084580,1700089380,4800,147891,81095,NL,NL
90202,1700410980,1700445240,34260,101592,19041,TR,TR
178785,1699520400,1699531680,11280,198347,70486,US,US
168124,1700408700,1700419980,11280,48166,69374,US,US
101450,1699600080,1699614180,14100,68377,141991,US,US
147143,1698981720,1698994380,12660,115789,5724,ES,ES
42518,1699363020,1699396740,33720,61389,70900,TR,TR
125202,1698843840,1698857280,13440,158631,172560,IT,ES
160379,1699085820,1699115940,30120,195699,85045,TR,TR
141685,1700807160,1700819160,12000,107939,186682,US,US
126321,1700591700,1700595300,3600,113538,46884,NL,NL
178096,1700346840,1700379300,32460,116764,105528,MX,US
192766,1699700460,1699711980,11520,10481,85890,IT,IT
130211,1700329560,1700336760,7200,19102,184232,PT,PT
105810,1699356480,1699387260,30780,113187,143587,TR,TR
50455,1700198940,1700208600,9660,109242,146740,IT,IT
191590,1700058120,1700093160,35040,109511,196679,TR,TR
8634,1699918980,1699954740,35760,143666,163096,TR,TR
15056,1699714860,1699746660,31800,20781,42738,TR,TR
50827,1698868560,1698872160,3600,193866,12563,GB,GB
181314,1699574220,1699603980,29760,103203,165488,TR,TR
18199,1700857680,1700892720,35040,86269,174935,TR,TR
47908,1700143800,1700147400,3600,107471,195087,GB,GB
165006,1699451100,1699483140,32040,133489,56849,TR,TR
124133,1700652780,1700685300,32520,85201,199672,MX,MX
52714,1699769700,1699773300,3600,75653,24556,NL,NL
72942,1699451460,1699468680,17220,16501,77477,US,US
147902,1699020120,1699023720,3600,28367,136992,GB,GB
93349,1699101420,1699114020,12600,14995,162421,US,US
5891,1698972300,1699001700,29400,46208,183444,TR,TR
96091,1699311000,1699314600,3600,71982,196246,NL,NL
62125,1700646300,1700678340,32040,180586,162422,TR,TR
166392,1700016060,1700048700,32640,51256,104432,TR,TR
170603,1699466160,1699481580,15420,46737,61661,US,US
108055,1700150640,1700167200,16560,59562,43219,FR,ES
177830,1699143960,1699170300,26340,95659,51496,DE,PL
115735,1699029000,1699063020,34020,154378,188312,TR,TR
109783,1699695600,1699726680,31080,133600,46609,TR,TR
190195,1700335800,1700363100,27300,104208,118915,RO,RO
181298,1699882680,1699900440,17760,137437,194483,US,US
70338,1700442900,1700453280,10380,188783,10987,IT,IT
117486,1699204080,1699207680,3600,70387,39250,GB,GB
61553,1700847300,1700862420,15120,190440,114632,US,US
110638,1698996120,1699001520,5400,150182,18993,NL,NL
95502,1700801160,1700834220,33060,14303,114978,TR,TR
190488,1699230900,1699236600,5700,114634,89788,NL,LU
28105,1699512540,1699544280,31740,14899,88026,TR,TR
107319,1700419020,1700442180,23160,56846,195152,RO,RO
13362,1700334600,1700348100,13500,120753,139783,RS,SI
179855,1700752980,1700787060,34080,123966,184212,TR,TR
77107,1699583760,1699598940,15180,144405,43838,FR,FR
66824,1699691700,1699700280,8580,72605,157086,IT,IT
58987,1700331120,1700360220,29100,48266,196021,TR,TR
187018,1700032740,1700048880,16140,114081,198642,US,US
2440,1699042560,1699076700,34140,143722,34590,TR,TR
21846,1699576920,1699580520,3600,123302,123438,GB,GB
110710,1699308180,1699312080,3900,82917,184758,NL,NL
199195,1700694960,1700725620,30660,17857,118485,TR,TR
99976,1700755860,1700786700,30840,50068,144919,TR,TR
197690,1699134840,1699145940,11100,147206,18161,IT,IT
39819,1700480280,1700491980,11700,128955,85874,IT,IT
79026,1699399440,1699429800,30360,184458,21936,TR,TR
69434,1699643040,1699671240,28200,185270,142494,HU,PL
78221,1699558440,1699570680,12240,99065,82735,ES,ES
34906,1700598480,1700607600,9120,83842,57469,ES,ES
78840,1700154420,1700189640,35220,186354,35627,TR,TR
163070,1698954360,1698971040,16680,88103,193020,US,US
27090,1700674800,1700689860,15060,79632,28369,CZ,CZ
98734,1699082760,1699118280,35520,137310,155545,TR,TR
67811,1700181240,1700197320,16080,89140,161575,RS,RS
12752,1700676300,1700681040,4740,157598,97100,GB,GB
193269,1700277120,1700300340,23220,166892,10251,PL,DE
157376,1700120280,1700154900,34620,133794,95185,TR,TR
185876,1699133520,1699166280,32760,51202,160300,TR,TR
126929,1699604100,1699631820,27720,170005,33386,DE,EE
53451,1700747100,1700754480,7380,464,39271,IT,IT
79874,1700448480,1700452080,3600,124013,95022,GB,GB
166974,1699075680,1699080420,4740,18190,90753,GB,GB
54274,1699904640,1699936140,31500,160160,178447,TR,TR
120420,1699087020,1699093860,6840,187027,114181,GB,GB
5453,1700299140,1700310540,11400,102003,72759,IT,IT
41457,1699646880,1699652040,5160,178614,135925,GB,GB
84096,1699685640,1699716060,30420,194222,94893,TR,TR
61103,1699162800,1699171980,9180,199367,186863,PT,PT
111730,1699199460,1699234140,34680,195243,90914,TR,TR
152300,1699062960,1699074180,11220,24838,70412,US,US
13447,1699399980,1699417800,17820,61463,91232,FR,FR
82303,1699226340,1699240920,14580,37546,22268,FR,IT
68396,1700423460,1700454240,30780,5806,122354,TR,TR
91942,1699501380,1699517820,16440,154465,124784,BE,DE
191364,1699635960,1699644660,8700,10799,5828,IT,IT
129954,1699758420,1699793220,34800,79633,180886,TR,TR
95804,1700587260,1700614020,26760,95866,69783,PL,PL
6748,1699478100,1699513200,35100,174040,91917,TR,TR
108641,1698864120,1698881580,17460,40471,42338,US,US
134998,1699203360,1699232460,29100,96922,18763,TR,TR
120902,1700219160,1700234700,15540,195103,24268,US,US
197944,1699214220,1699227240,13020,140014,114581,US,US
32332,1700537700,1700541300,3600,165134,197816,GB,GB
179672,1700334360,1700343840,9480,48603,38263,IT,IT
123926,1698800520,1698804120,3600,147352,47648,NL,NL
28638,1699227000,1699257120,30120,77015,197318,TR,TR
67821,1699591140,1699616700,25560,193577,143984,BA,HR
16745,1700434800,1700446440,11640,16004,195103,IT,IT
122891,1700072820,1700076420,3600,169220,67850,NL,NL
320,1700360100,1700395800,35700,103942,80088,TR,TR
5176,1699177620,1699186140,8520,150134,184249,HR,HR
183601,1700629860,1700660160,30300,173551,21326,TR,TR
1484,1700265660,1700294880,29220,8582,95532,TR,TR
52128,1700336340,1700342760,6420,85938,116052,NL,NL
108041,1698850200,1698864960,14760,126633,117891,US,US
40827,1700285940,1700317440,31500,124886,162049,TR,TR
168419,1698869040,1698875040,6000,42933,97317,GB,GB
9639,1700676000,1700687100,11100,106360,158110,IT,IT
50489,1700118660,1700123460,4800,158052,167959,NL,NL
56533,1699054080,1699092300,38220,185265,102466,MX,MX
6088,1698947400,1698963180,15780,88403,146131,US,US
106034,1699851540,1699878660,27120,85149,110620,PL,PL
49862,1699043940,1699061700,17760,67148,12695,FR,FR
72418,1700157720,1700172480,14760,106739,87799,AT,AT
167111,1699482360,1699495500,13140,173526,191333,US,US
38753,1699882500,1699908720,26220,43785,125298,RO,RO
570,1700447880,1700459520,11640,127907,76340,US,MX
58192,1698884760,1698898260,13500,96799,193749,PT,PT
141777,1699741560,1699774800,33240,191928,66404,MX,MX
89502,1699455840,1699468680,12840,134239,42876,US,US
191591,1700285220,1700289780,4560,39493,70101,GB,GB
47267,1700008800,1700017620,8820,151669,120374,HR,HR
61212,1698986700,1699017300,30600,139406,34774,TR,TR
105481,1699155600,1699188060,32460,53892,102033,TR,TR
163221,1698983040,1698999780,16740,124662,76377,US,US
105724,1699324140,1699341300,17160,31210,199524,FR,AD
79947,1699526760,1699537560,10800,36621,75610,IT,IT
114692,1700440500,1700457420,16920,84086,164089,FR,FR
197876,1699198140,1699201740,3600,97277,158760,GB,GB
33213,1700596740,1700631000,34260,128422,167699,TR,TR
39327,1699001940,1699037400,35460,35123,105079,TR,TR
162735,1700812980,1700844900,31920,180082,105351,TR,TR
77830,1699703520,1699728360,24840,5000,128521,DE,IT
81208,1700760060,1700771760,11700,98308,102174,AT,AT
71634,1699954080,1699957680,3600,68182,54067,GB,GB
178810,1699731120,1699748160,17040,14088,188116,US,US
15743,1699626240,1699638900,12660,98574,116174,HR,HR
130196,1699062360,1699093680,31320,112258,148900,TR,TR
89601,1700270280,1700282520,12240,26629,149013,CZ,CZ
195995,1698811680,1698823440,11760,122871,29846,IT,IT
44388,1699604520,1699636740,32220,122013,105436,TR,TR
120087,1700124060,1700138880,14820,41402,110292,BE,FR
28965,1700322000,1700358660,36660,99575,66136,MX,US
51935,1700379960,1700395800,15840,66607,127723,FR,BE
81651,1700544600,1700578200,33600,158316,159458,TR,TR
38006,1699904640,1699915440,10800,6605,111545,US,US
175973,1699631220,1699639980,8760,93263,76946,HR,FR
146588,1699875480,1699909200,33720,194996,199323,TR,TR
49288,1699603800,1699638900,35100,2668,13824,TR,TR
61305,1699222800,1699237440,14640,182358,82892,US,US
67423,1699501800,1699505400,3600,157605,179991,GB,GB
110805,1699387380,1699390980,3600,25280,183643,GB,GB
118714,1699432080,1699462200,30120,14532,35196,TR,TR
155666,1698869100,1698872700,3600,135877,176537,NL,NL
195925,1700432880,1700455620,22740,105169,180724,PL,PL
188777,1699118760,1699153920,35160,102512,56080,TR,TR
140097,1698970260,1698983340,13080,109204,41157,US,US
93913,1700808840,1700820660,11820,75519,174515,US,US
26915,1700763000,1700772420,9420,517,24981,ES,ES
195038,1699718340,1699725000,6660,79090,29691,GB,GB
113878,1700689560,1700702220,12660,85516,170064,PT,PT
29920,1699958940,1699992780,33840,137649,151739,TR,TR
98506,1699262640,1699294680,32040,144857,105546,TR,TR
13534,1699708320,1699713240,4920,184652,65319,GB,GB
165365,1699835040,1699870140,35100,171552,29582,MX,MX
10465,1700141100,1700150400,9300,102644,88485,PT,PT
70085,1699544280,1699557360,13080,173981,99490,US,US
171038,1699441800,1699452960,11160,68621,194745,AT,AT
46230,1699835220,1699854600,19380,88548,3413,FR,FR
194967,1699188240,1699219500,31260,31269,144008,TR,TR
9671,1699149060,1699167600,18540,13351,86295,BE,FR
115643,1700061840,1700094960,33120,77381,70887,TR,TR
87074,1700170800,1700202360,31560,25575,156907,TR,TR
72229,1699667340,1699706160,38820,54163,194839,MX,MX
19190,1698797640,1698807600,9960,183989,176764,PT,PT
104629,1700849160,1700868060,18900,183519,122020,FR,FR
120147,1698836700,1698844200,7500,118366,148759,IT,IT
81973,1699763820,1699770960,7140,142178,82724,GB,GB
198530,1700763900,1700791860,27960,72146,11022,DE,DE
165129,1699421100,1699435920,14820,68640,8999,FR,FR
108903,1699989600,1700003100,13500,135630,195016,RS,RS
33967,1700132520,1700136120,3600,54309,140834,GB,GB
15943,1700649120,1700662380,13260,49579,15485,IT,DE
97678,1699837020,1699841640,4620,97253,186435,GB,GB
59414,1700222700,1700250720,28020,10902,44669,DE,BG
16925,1700323260,1700352900,29640,11913,173319,TR,TR
199957,1699472880,1699493760,20880,7637,199604,SE,SE
175440,1699078380,1699092660,14280,175042,117490,IT,IT
155942,1699209240,1699241760,32520,137662,28848,TR,TR
104933,1700417220,1700452380,35160,107645,58594,TR,TR
101570,1698975600,1698986640,11040,104867,25483,AT,AT
136539,1699980600,1699986300,5700,136602,193054,GB,GB
110078,1700690820,1700694420,3600,155858,176806,GB,GB
49103,1699636620,1699669320,32700,128740,139830,TR,TR
9885,1699541340,1699570620,29280,76928,11900,TR,TR
46679,1699437960,1699445820,7860,199771,104139,HR,RS
177980,1699910520,1699928340,17820,41188,164786,US,US
137342,1699343880,1699375080,31200,86299,75505,TR,TR
115970,1699569660,1699585140,15480,158447,12761,BE,NL
20930,1699335540,1699369020,33480,82158,96794,TR,TR
181123,1700845500,1700857380,11880,58926,76316,US,US
22933,1699875360,1699891560,16200,77309,81477,US,US
140469,1699064220,1699072440,8220,53885,68835,FI,EE
117800,1699963860,1699977540,13680,63358,98467,US,US
193706,1698877260,1698909960,32700,73391,84632,TR,TR
110594,1699923000,1699933260,10260,80465,134751,IT,IT
134882,1699799100,1699834620,35520,52000,180500,TR,TR
6760,1699989300,1700000820,11520,33169,48787,US,US
149912,1700179980,1700185860,5880,54598,197380,GB,GB
29449,1699728660,1699765680,37020,3845,51211,MX,MX
59842,1699008660,1699046640,37980,53243,141122,MX,MX
38466,1700301960,1700331600,29640,168046,173323,TR,TR
70584,1700252100,1700255700,3600,113992,131883,GB,GB
99774,1700587380,1700592660,5280,184715,4300,GB,GB
171258,1700446020,1700459700,13680,80051,45143,IT,RO
125752,1699423500,1699433400,9900,154579,101646,HR,HR
117138,1699969380,1699972980,3600,180059,149544,GB,GB
36020,1698878700,1698907140,28440,68420,85554,DE,DE
79964,1699782420,1699796580,14160,72787,113362,RS,MK
63544,1699252500,1699275900,23400,198226,150488,CH,ES
105262,1699133760,1699144020,10260,14645,84428,PT,PT
7538,1698921660,1698927240,5580,118006,29226,AD,ES
40060,1699035120,1699042920,7800,76476,14953,HR,HR
119637,1699860180,1699889760,29580,187858,175412,TR,TR
197569,1700062920,1700066520,3600,62354,190500,GB,GB
102323,1699645860,1699679760,33900,190380,77668,MX,MX
192077,1699026540,1699030140,3600,24062,128593,GB,GB
26081,1699394640,1699423680,29040,162038,154059,TR,TR
75494,1699819620,1699845240,25620,74697,118428,DE,BE
2155,1700106600,1700157240,50640,162501,92695,BG,DE
42184,1700157480,1700161080,3600,193351,90744,GB,GB
186457,1700737020,1700743860,6840,32697,51941,NL,DE
160758,1698921000,1698954120,33120,28643,156582,TR,TR
143695,1700678100,1700689920,11820,183873,19801,US,US
27544,1700194800,1700212380,17580,13662,158476,US,US
163207,1699954560,1699978020,23460,42869,198854,HU,AT
139810,1698900360,1698914040,13680,123129,170010,PT,PT
185559,1700801220,1700807880,6660,189542,24241,NL,NL
74710,1699970940,1700006760,35820,93582,55997,TR,TR
144157,1699848180,1699858020,9840,6645,44666,IT,IT
165077,1700048040,1700052900,4860,68715,63217,GB,GB
6210,1698829980,1698864660,34680,84091,148581,TR,TR
131866,1699407720,1699411320,3600,191387,40417,NL,NL
110600,1699316280,1699348920,32640,191436,166532,TR,TR
10398,1700076840,1700111160,34320,42464,175565,TR,TR
13393,1700711100,1700746380,35280,65402,71471,TR,TR
125617,1700079840,1700090220,10380,180911,61813,EE,LT
36075,1700683200,1700715960,32760,140958,100868,TR,TR
168450,1700348760,1700380800,32040,21448,101195,TR,TR
12006,1699349340,1699365780,16440,23865,129566,CZ,AT
2392,1700329800,1700334180,4380,26331,89706,NL,NL
10563,1700342400,1700349300,6900,23737,196569,GB,GB
145459,1700389440,1700419320,29880,159731,26792,TR,TR
161571,1699539960,1699574580,34620,127008,85189,TR,TR
91690,1700266740,1700299140,32400,129020,35886,TR,TR
105400,1700599920,1700624040,24120,32346,175187,RO,RO
48914,1700404440,1700416320,11880,111935,130300,US,US
45498,1700429460,1700463360,33900,186757,34183,TR,TR
950,1699741680,1699771560,29880,134279,119585,TR,TR
65697,1699621920,1699648860,26940,158567,47840,DE,DE
104954,1699188360,1699191960,3600,117900,143091,GB,GB
48691,1699700280,1699734900,34620,16116,54975,TR,TR
183913,1700086620,1700090220,3600,102118,138744,GB,GB
59227,1699340040,1699371840,31800,163558,11684,TR,TR
25813,1699186200,1699189800,3600,35708,163044,NL,NL
159588,1699041120,1699053360,12240,17022,167945,US,US
190941,1700116320,1700149020,32700,81639,182103,TR,TR
155259,1699152420,1699156020,3600,71643,21941,GB,GB
17859,1699030620,1699034220,3600,195448,81064,NL,NL
94886,1699742940,1699774320,31380,7207,79884,TR,TR
32882,1700500080,1700535480,35400,117225,80800,TR,TR
97841,1698946800,1698959640,12840,120924,17120,PT,PT
94571,1699105140,1699108740,3600,117614,131485,GB,GB
41997,1700262420,1700277180,14760,37153,40906,US,US
126741,1699645020,1699680900,35880,191186,39896,MX,MX
77423,1699691760,1699713840,22080,198906,25339,RO,TR
165246,1699474740,1699488720,13980,4176,120193,IT,IT
81439,1700238780,1700274120,35340,92264,73211,TR,TR
166022,1699394220,1699405260,11040,131800,169440,IT,IT
110684,1700708100,1700720160,12060,30319,31047,ES,ES
126240,1700755680,1700777460,21780,170172,107865,CH,FR
46907,1699819320,1699850100,30780,159820,106324,TR,TR
56597,1698895680,1698928620,32940,55797,86401,TR,TR
93008,1700486520,1700512800,26280,5301,12843,BR,BR
103991,1700286180,1700321880,35700,62455,146400,TR,TR
33206,1700541060,1700562060,21000,134973,148027,FR,AD
164717,1699783680,1699818000,34320,78364,68460,TR,TR
43255,1698953700,1698987360,33660,35801,81520,TR,TR
20660,1699887960,1699916400,28440,126248,111591,PL,CZ
73807,1700175660,1700208420,32760,59801,55659,TR,TR
89230,1699440900,1699470180,29280,46924,73303,TR,TR
33793,1699152540,1699158600,6060,58783,26907,NL,NL
159425,1699519620,1699523700,4080,182817,9092,GB,GB
122115,1699569120,1699598400,29280,62730,42282,TR,TR
1491,1699510380,1699544880,34500,190278,118419,TR,TR
142849,1700695560,1700709000,13440,184351,168764,US,US
137058,1699307400,1699316880,9480,110745,136551,IT,IT
197851,1700652900,1700686260,33360,55336,40728,TR,TR
84923,1699209300,1699212900,3600,71727,30057,NL,BE
185857,1700624160,1700651160,27000,26699,171386,BA,BA
7475,1699908720,1699914300,5580,39430,56084,GB,GB
133983,1699969440,1699973880,4440,27416,94771,NL,NL
81989,1700414220,1700446320,32100,130946,72619,TR,TR
25015,1699089300,1699111980,22680,183371,176246,PL,PL
154003,1699977960,1699990440,12480,165257,48501,AT,SK
142594,1700093040,1700096640,3600,17208,48342,NL,NL
164960,1699429380,1699440720,11340,179035,198827,US,US
112242,1699198800,1699230180,31380,98554,31091,TR,TR
14787,1700714220,1700727660,13440,114189,136802,US,US
108207,1700090640,1700123160,32520,87619,116038,TR,TR
179355,1699993440,1700022240,28800,175257,116708,TR,TR
90856,1699512360,1699547280,34920,130509,52558,TR,TR
30716,1700129940,1700163900,33960,78245,27724,TR,TR
169839,1699658040,1699690020,31980,105585,144470,TR,TR
171296,1698982860,1699013040,30180,2506,42867,TR,TR
110283,1700342700,1700373240,30540,74654,141671,TR,TR
191045,1700276220,1700311560,35340,108612,28911,TR,TR
185803,1699252140,1699279260,27120,157438,49787,PL,PL
116751,1700307840,1700340240,32400,14596,66200,TR,TR
156849,1699459320,1699485600,26280,157808,194982,RO,DK
126888,1699040340,1699051020,10680,56858,46861,HR,HR
153635,1698947460,1698978420,30960,99827,74078,TR,TR
150999,1700290980,1700326620,35640,139956,54164,MX,MX
194135,1699955520,1699982940,27420,80856,152494,RO,RO
164171,1700829240,1700849040,19800,59978,36200,FR,FR
136814,1699391280,1699408860,17580,38150,115283,RS,NL
123971,1698865860,1698889740,23880,154680,19901,PL,PL
71460,1700419140,1700429400,10260,179834,182404,HR,FR
34536,1700009340,1700020920,11580,138693,106446,IT,IT
34160,1700690340,1700723100,32760,39606,167395,TR,TR
131923,1698983940,1698996300,12360,176279,34264,IT,IT
160929,1699319040,1699329120,10080,121414,116443,PT,PT
177725,1699814460,1699818060,3600,96458,156033,GB,GB
99828,1700600400,1700620800,20400,83657,58723,FR,IT
51949,1699085820,1699097760,11940,102101,81409,SK,PL
10363,1700203680,1700216400,12720,14279,44015,IT,IT
71345,1699111140,1699137060,25920,106230,6173,DE,IT
39073,1699958700,1699971600,12900,142953,31847,IT,IT
74571,1699149180,1699152780,3600,87770,154577,GB,GB
30882,1700769000,1700800560,31560,71849,160086,TR,TR
110993,1699890480,1699905000,14520,162116,5215,FR,FR
94217,1700248800,1700280420,31620,129869,175880,TR,TR
179434,1700257080,1700287140,30060,58400,102565,TR,TR
128443,1699213800,1699225860,12060,54323,116774,US,US
19703,1699531740,1699543200,11460,162341,38103,US,US
29595,1700767680,1700797620,29940,169692,131918,TR,TR
183909,1700268540,1700272140,3600,170879,22468,GB,GB
154954,1700256420,1700267280,10860,121959,120481,IT,IT
183392,1698862440,1698876360,13920,653,110247,US,US
85890,1699516260,1699548540,32280,108720,42356,TR,TR
119991,1699569720,1699577640,7920,126966,34054,IT,IT
129717,1699882380,1699918320,35940,189531,31968,TR,TR
99401,1699182300,1699197120,14820,78886,199278,FR,FR
160459,1700313480,1700317080,3600,150531,99000,GB,GB
32380,1700828940,1700855400,26460,168580,25538,PL,PL
158879,1699854120,1699866960,12840,157028,163924,US,US
116173,1699682580,1699694640,12060,163667,24664,IT,IT
119346,1700323560,1700359260,35700,167517,161343,TR,TR
114395,1700475540,1700490720,15180,165730,72042,US,US
129320,1699253880,1699287180,33300,60355,115133,TR,TR
91710,1699728180,1699741260,13080,186630,108953,ES,FR
176674,1700299620,1700331720,32100,51129,25428,TR,TR
28,1699928820,1699961100,32280,13439,70097,TR,TR
7119,1698996120,1699008960,12840,25349,172431,IT,IT
199366,1700080560,1700133060,52500,166433,66248,BG,DE
64618,1699644420,1699657380,12960,65393,130384,IT,IT
151563,1699619820,1699623420,3600,154443,58729,NL,NL
119055,1700804280,1700817480,13200,28311,15537,US,US
57468,1699869840,1699898760,28920,175966,76667,TR,TR
413,1699749720,1699784700,34980,136890,172213,MX,MX
71856,1700610780,1700620020,9240,113292,152316,SK,AT
149287,1699487220,1699520460,33240,194203,187411,TR,TR
190654,1700472780,1700476860,4080,165107,96427,GB,GB
176579,1700852040,1700855640,3600,114920,156005,NL,NL
197590,1699567740,1699582260,14520,40615,182288,US,US
126692,1699132860,1699146960,14100,27488,115491,US,US
171965,1699899600,1699904520,4920,159975,122572,NL,NL
80759,1700358240,1700393340,35100,153893,20027,TR,TR
76725,1699576320,1699589940,13620,180634,37370,US,US
191464,1700107440,1700120280,12840,86178,86394,IT,IT
145204,1699297800,1699328220,30420,148921,174808,TR,TR
133209,1700131980,1700143020,11040,12813,157840,PT,PT
142625,1699212780,1699239060,26280,82401,12118,PL,PL
46027,1699014780,1699023600,8820,137391,65824,IT,IT
146467,1699913940,1699926300,12360,175160,71257,IT,IT
136422,1699187040,1699204320,17280,84430,124739,CZ,CH
175165,1699899840,1699931040,31200,169594,57243,TR,TR
85103,1700369100,1700400600,31500,39976,182051,TR,TR
18952,1699562820,1699592760,29940,94178,34357,TR,TR
140975,1699031700,1699043220,11520,52822,136522,HR,BA
94715,1699773180,1699787280,14100,71453,92172,IT,IT
50229,1699535640,1699546740,11100,154003,72539,ES,ES
145116,1700866740,1700878080,11340,88789,171565,AT,AT
42519,1699947240,1699958700,11460,60504,126646,IT,CH
180554,1700285700,1700299560,13860,157433,92432,HR,HR
75040,1699820160,1699851420,31260,67587,92136,TR,TR
72498,1699053660,1699080720,27060,142940,63114,DE,BG
64737,1699213140,1699246080,32940,91658,85980,TR,TR
71855,1699805580,1699840440,34860,37760,65886,TR,TR
88036,1699418520,1699422120,3600,95847,134021,NL,NL
107855,1699237680,1699253820,16140,123138,188305,AT,BG
153308,1699506960,1699540680,33720,171557,91191,TR,TR
185440,1700713500,1700730600,17100,68659,93205,BE,FR
152601,1699421820,1699433940,12120,37969,76991,HR,HR
111544,1699237380,1699245180,7800,53115,113230,IT,CH
156268,1700040360,1700069340,28980,17381,147637,TR,TR
3179,1699660080,1699710900,50820,123121,199060,BG,DE
14005,1700723220,1700735700,12480,137071,35557,US,US
2484,1699609080,1699641180,32100,133852,151484,TR,TR
57038,1700584620,1700605800,21180,167275,186313,DK,RO
37640,1700167200,1700183520,16320,68437,17706,FR,BE
16787,1700801760,1700830860,29100,90421,41503,TR,TR
71468,1699581120,1699598700,17580,37237,12996,CZ,CZ
105761,1700392200,1700408640,16440,68316,126278,FR,FR
117077,1699977300,1700011800,34500,183073,179900,TR,TR
53654,1700720520,1700735820,15300,10850,115419,US,US
38188,1699904040,1699937460,33420,136121,68495,TR,TR
65099,1699231320,1699236780,5460,184018,14475,GB,GB
39523,1699477020,1699491000,13980,43798,68058,IT,IT
36196,1699272120,1699277880,5760,177839,186458,GB,GB
159834,1700574900,1700588940,14040,163351,159360,IT,IT
17553,1699977360,1700007480,30120,173063,121716,TR,TR
66142,1699501560,1699536180,34620,47386,170880,MX,MX
96935,1699748760,1699752360,3600,114726,156094,NL,NL
80074,1699464420,1699500000,35580,127738,129908,MX,MX
132275,1699244760,1699270020,25260,11485,101370,DE,FR
197066,1698901320,1698915300,13980,124917,147226,IT,IT
144768,1700177460,1700206500,29040,186200,52457,TR,TR
138830,1699151640,1699155240,3600,150714,93578,GB,GB
73345,1700302800,1700327280,24480,37745,86060,PL,PL
90706,1700283300,1700313060,29760,158535,71072,TR,TR
161512,1699049820,1699083300,33480,88955,151225,TR,TR
95121,1700384040,1700397420,13380,90407,21661,PT,PT
128579,1700561160,1700580000,18840,44430,30139,SE,SE
115457,1699712340,1699738200,25860,130988,50781,DE,NL
65383,1699529640,1699558500,28860,10667,154110,TR,TR
198497,1700184720,1700201100,16380,91388,48918,FR,FR
193922,1700214540,1700231400,16860,141871,21798,US,US
99060,1700663820,1700698260,34440,183714,138719,MX,MX
49007,1700356020,1700380320,24300,99322,100872,NO,DK
165101,1699464840,1699472880,8040,186623,59664,IT,IT
31622,1699793400,1699828980,35580,86774,186443,TR,TR
124876,1699597020,1699620300,23280,152859,51141,BR,BR
60370,1699931460,1699946220,14760,6249,73529,US,US
32782,1699880760,1699884360,3600,31414,12833,NL,NL
136951,1700261340,1700293620,32280,134220,55849,TR,TR
182187,1700110500,1700114100,3600,160974,142844,GB,GB
43538,1700116980,1700130060,13080,48426,69141,US,US
134918,1700667240,1700681520,14280,1127,104254,US,US
17264,1699262580,1699297380,34800,14486,17289,TR,TR
172169,1700313000,1700337480,24480,97464,64173,CH,IT
13969,1700386380,1700399220,12840,108756,124025,US,US
22224,1699766100,1699769700,3600,3788,101978,NL,NL
40202,1699654500,1699658100,3600,161613,31767,NL,NL
56718,1698922620,1698954840,32220,18070,111523,TR,TR
56304,1699454280,1699485120,30840,16853,175112,TR,TR
8450,1699203480,1699229100,25620,44201,32004,DE,DE
93553,1698811560,1698828120,16560,177383,36822,FR,FR
41207,1699585440,1699605000,19560,51679,175772,FR,FR
58493,1698941820,1698954600,12780,53854,50967,IT,IT
16595,1699358700,1699389600,30900,23185,185056,TR,TR
40248,1699755060,1699787520,32460,132914,50134,TR,TR
1836,1700253600,1700287140,33540,176812,174714,TR,TR
183260,1699927440,1699941420,13980,46866,57774,IT,IT
118709,1700595180,1700608500,13320,154494,191624,IT,IT
134283,1699891740,1699919580,27840,156193,89740,DE,DE
88029,1700504100,1700515020,10920,36625,178836,IT,IT
61185,1700660640,1700664240,3600,9727,184302,GB,GB
140991,1700434080,1700441940,7860,75900,152004,IT,IT
31600,1698943620,1698973380,29760,84385,69941,TR,TR
72393,1699482540,1699494900,12360,147791,28485,AT,AT
103320,1700519040,1700548020,28980,15695,9044,TR,TR
6208,1700516040,1700550480,34440,140590,94763,TR,TR
81156,1699051860,1699083960,32100,1249,96087,TR,TR
121063,1699072020,1699101900,29880,32494,172629,BA,HR
5704,1699566960,1699583640,16680,42805,83090,US,US
175889,1699187580,1699201740,14160,74812,37866,RS,ME
147381,1699588080,1699602240,14160,188019,82334,US,US
168013,1700860440,1700877480,17040,135677,85138,AT,RO
128169,1700545980,1700556180,10200,58093,188033,PT,PT
148352,1700455020,1700470260,15240,40493,124679,US,US
146633,1699444500,1699480080,35580,122499,121976,TR,TR
150377,1700389560,1700398020,8460,187694,40492,IT,FR
13096,1699895700,1699907400,11700,7726,151187,US,MX
92940,1699349400,1699373400,24000,185495,78604,BR,BR
131121,1700137500,1700172900,35400,105029,182608,TR,TR
173906,1699445340,1699478400,33060,50847,29881,MX,MX
31888,1698795720,1698829380,33660,168303,101390,TR,TR
170904,1700429340,1700446080,16740,80932,179015,FR,AD
192063,1699195020,1699211460,16440,80629,164138,CZ,CZ
45898,1698906480,1698921180,14700,108336,177589,US,US
169347,1700774760,1700803140,28380,145932,72358,DE,NL
109958,1700390880,1700402100,11220,108540,39907,PT,PT
40974,1700862960,1700872860,9900,196924,182819,IT,IT
178137,1700641920,1700669940,28020,192736,6987,DE,DE
37797,1699129140,1699140660,11520,196078,5964,US,US
32426,1700256000,1700268180,12180,14661,25033,PT,PT
110540,1699668000,1699671600,3600,182180,11919,GB,GB
33192,1700551620,1700555220,3600,180540,77130,GB,GB
183876,1700579700,1700583300,3600,169465,25781,NL,NL
186128,1700382660,1700418960,36300,35640,92566,MX,MX
165096,1699629540,1699661400,31860,157366,47725,TR,TR
128404,1700579460,1700594580,15120,116434,57523,FR,DE
95701,1700055840,1700067960,12120,25294,34820,US,US
197409,1700655660,1700668140,12480,110117,47479,IT,IT
167393,1699609980,1699625460,15480,184552,137745,CZ,CZ
136071,1700290680,1700321460,30780,155424,23539,TR,TR
10882,1700581680,1700599380,17700,63381,99794,US,US
11856,1700140860,1700153940,13080,36457,150099,IT,RO
101796,1700192640,1700209440,16800,134756,53828,US,US
152194,1698885900,1698912960,27060,77516,2289,PL,PL
9876,1700165040,1700198940,33900,155005,124728,TR,TR
115815,1700427060,1700460840,33780,73478,76869,TR,TR
48564,1699258740,1699292520,33780,108752,52836,TR,TR
167375,1699795620,1699826340,30720,134909,127513,TR,TR
9016,1698959640,1698994860,35220,78393,119846,TR,TR
14426,1698884640,1698900600,15960,189783,194822,US,US
173994,1700099820,1700135340,35520,58731,181454,TR,TR
177428,1698962340,1698976860,14520,189600,190002,FR,NL
73641,1700740260,1700775360,35100,162497,4867,TR,TR
168514,1698833280,1698836880,3600,57543,107894,GB,GB
122055,1699330620,1699346220,15600,56495,6082,US,US
181676,1699079160,1699090200,11040,197949,167528,SK,SK
177334,1699436640,1699462740,26100,45011,3060,DE,DE
21455,1700814780,1700826240,11460,97699,159128,IT,IT
36471,1699072740,1699085520,12780,78696,178663,US,US
103064,1699016100,1699031340,15240,176551,110976,FR,ES
136797,1700538360,1700547060,8700,147774,144101,IT,IT
120688,1698896820,1698929340,32520,58559,44590,TR,TR
167633,1699739280,1699752180,12900,143993,40214,IT,IT
83633,1699324800,1699336080,11280,58591,13642,HR,HR
34658,1700344140,1700374440,30300,94559,11088,TR,TR
146637,1700396880,1700409540,12660,143031,194843,IT,IT
138787,1699275900,1699288140,12240,74431,99447,IT,IT
25840,1699318860,1699353000,34140,176595,81366,TR,TR
199282,1698896700,1698916440,19740,127630,112992,FR,IT
52321,1700766600,1700802480,35880,109000,172060,TR,TR
25662,1698858000,1698893760,35760,27328,57467,TR,TR
168023,1699864020,1699903020,39000,30475,94998,MX,MX
157347,1699133340,1699136940,3600,12872,100985,NL,NL
40846,1700857860,1700893620,35760,53922,128370,TR,TR
63736,1700450280,1700463600,13320,93158,111959,US,US
41429,1700209560,1700218200,8640,70527,106756,PT,PT
113272,1699749480,1699753080,3600,123336,67075,GB,GB
30750,1699822560,1699836480,13920,47492,16855,US,US
146074,1699993980,1700001000,7020,145609,93549,GB,GB
10726,1699407840,1699418100,10260,92004,59423,IT,IT
72560,1700272800,1700306940,34140,157658,11435,TR,TR
171602,1699932600,1699960980,28380,81719,19421,PL,LV
61935,1698978660,1699008720,30060,190044,6435,TR,TR
3011,1700747280,1700757360,10080,147336,62504,IT,IT
95010,1700093580,1700125500,31920,38180,160961,TR,TR
112450,1699307820,1699321560,13740,62189,57906,US,US
60990,1699044540,1699058280,13740,95662,140873,US,US
20589,1700751540,1700757840,6300,49827,112274,NL,NL
36762,1698881820,1698913320,31500,144051,117531,TR,TR
158552,1699788720,1699805460,16740,92801,73441,US,US
110326,1700161860,1700173020,11160,181998,181138,US,US
40651,1698809340,1698814020,4680,131609,114380,NL,NL
61490,1700459760,1700474400,14640,3,44194,US,US
7580,1699535340,1699568760,33420,147262,79619,TR,TR
140037,1699973820,1699986420,12600,11283,41028,IT,IT
150104,1700436000,1700456220,20220,54061,195574,FR,FR
179012,1699520160,1699532220,12060,9204,164206,IT,IT
197671,1699197660,1699227060,29400,122725,86804,TR,TR
132088,1700193120,1700223720,30600,65596,26194,TR,TR
81782,1699759140,1699770060,10920,143311,15631,US,US
38209,1699693560,1699726800,33240,111731,144369,TR,TR
20869,1700326680,1700348340,21660,46665,197970,CH,DE
50505,1700412420,1700441700,29280,187901,35022,TR,TR
16136,1700684940,1700714220,29280,83519,41059,TR,TR
4031,1699629540,1699660740,31200,10611,47195,TR,TR
195702,1699818420,1699822320,3900,68587,97063,NL,NL
130364,1699217760,1699223160,5400,131422,149803,NL,NL
65275,1700848860,1700878020,29160,170218,131942,TR,TR
157160,1698804420,1698812580,8160,185367,73733,PT,PT
126191,1699399080,1699411500,12420,107917,139147,PT,PT
7799,1699689420,1699695960,6540,135276,18275,GB,GB
114000,1700640960,1700651820,10860,166096,40669,ES,ES
53150,1698978180,1698995340,17160,64432,79525,FR,FR
49365,1700578860,1700590740,11880,36326,166803,CZ,CZ
15442,1698976860,1698986460,9600,119814,169524,IT,IT
186072,1699250760,1699280460,29700,19386,175113,TR,TR
112936,1699849680,1699853280,3600,166264,10949,NL,NL
111445,1700544600,1700575260,30660,126376,52854,TR,TR
77821,1699595640,1699611240,15600,79078,50334,FR,FR
86110,1699059660,1699067460,7800,153601,107820,ES,ES
10749,1700184840,1700219340,34500,97552,49175,TR,TR
85480,1700027520,1700057100,29580,183815,39974,TR,TR
68828,1699176720,1699193340,16620,86864,193383,US,US
61890,1699906860,1699918020,11160,173382,46303,IT,IT
187843,1699984020,1699995420,11400,168739,162238,US,US
68418,1700099820,1700113680,13860,15980,80399,PT,PT
180473,1699860900,1699891620,30720,10258,61480,TR,TR
50077,1700484840,1700499900,15060,57741,12454,US,US
160849,1700301540,1700318940,17400,36410,7847,US,US
17923,1699293060,1699301160,8100,191717,152464,PT,PT
152025,1699159320,1699179000,19680,148569,49406,FR,FR
36241,1700224620,1700237700,13080,9576,193799,US,US
155846,1700445360,1700457120,11760,157509,33183,US,US
59327,1700262720,1700274720,12000,175843,87330,US,US
60553,1699021740,1699027800,6060,31931,104063,GB,GB
36916,1700115240,1700126700,11460,166968,8928,IT,IT
52932,1700782080,1700789100,7020,103683,98483,NL,NL
62514,1699668120,1699700040,31920,73455,144547,TR,TR
46191,1699049220,1699080000,30780,82268,141004,TR,TR
181695,1700639940,1700665440,25500,60119,194260,RO,RO
93819,1700348400,1700353140,4740,168479,81581,NL,FR
61396,1699801920,1699819860,17940,134307,178829,RS,RS
70387,1699373940,1699387440,13500,136998,119594,US,US
62708,1700667720,1700702100,34380,116001,161747,TR,TR
90809,1699280940,1699295940,15000,99446,157466,US,US
44929,1698817500,1698850200,32700,45624,112246,TR,TR
86117,1700468700,1700505540,36840,55556,99561,MX,MX
162624,1700847000,1700850600,3600,185672,99526,NL,FR
100789,1700550420,1700562300,11880,185278,51210,US,US
73013,1698951780,1698967500,15720,189027,165116,RS,HR
72756,1700841780,1700873220,31440,95625,23047,TR,TR
199477,1699950780,1699965180,14400,85176,132994,FR,FR
86494,1698818580,1698849120,30540,165219,36396,TR,TR
148324,1700145780,1700180040,34260,35586,56136,TR,TR
117339,1700264340,1700268960,4620,112921,48082,GB,GB
187280,1699960860,1699992540,31680,70574,100840,TR,TR
111721,1700656380,1700664780,8400,11767,93815,IT,IT
80982,1699225740,1699260960,35220,89792,21065,TR,TR
174895,1700809920,1700843160,33240,151727,5448,TR,TR
51681,1700786640,1700796120,9480,195720,40278,PT,PT
163917,1699864260,1699893180,28920,65406,80143,TR,TR
152142,1700126160,1700158800,32640,84059,98921,TR,TR
21308,1700794080,1700830020,35940,161048,180472,TR,TR
4988,1699327440,1699341420,13980,173920,145783,US,US
159584,1700519160,1700530380,11220,117613,78257,ES,PT
195275,1700579640,1700590500,10860,99989,12514,ES,ES
189372,1699079700,1699083300,3600,186828,197027,NL,DE
153622,1698863460,1698893640,30180,92905,92165,TR,TR
191994,1699491720,1699507740,16020,164834,57572,FR,FR
60962,1699524120,1699545420,21300,65910,130333,FR,FR
120974,1699960500,1699977780,17280,20079,192566,US,US
35751,1699458240,1699466100,7860,94520,145138,IT,IT
161834,1700679660,1700691720,12060,32338,38674,RS,RS
64835,1699278540,1699289700,11160,170039,198415,US,US
9544,1700389500,1700418780,29280,126523,186916,TR,TR
7655,1700736240,1700746620,10380,114281,73165,IT,IT
68704,1699695240,1699729860,34620,31575,102186,MX,US
64169,1700825160,1700855520,30360,109515,62711,TR,TR
189929,1698998940,1699031100,32160,60944,193387,TR,TR
106624,1699810140,1699840560,30420,28771,53214,TR,TR
28177,1700147340,1700180580,33240,50587,108683,TR,TR
80140,1700215140,1700243940,28800,126006,79567,TR,TR
160589,1700036160,1700053260,17100,176957,16169,US,US
18985,1699049760,1699066320,16560,44265,100198,US,US
36632,1699686900,1699690500,3600,160762,164114,GB,GB
74223,1700669280,1700698620,29340,195244,152513,TR,TR
93912,1700017680,1700028780,11100,77274,127573,AT,AT
88339,1699707960,1699722000,14040,139670,116866,US,US
77903,1700407440,1700411040,3600,76023,70070,NL,NL
92585,1699761540,1699775520,13980,86500,49945,US,US
117694,1699387500,1699409880,22380,123985,68281,DE,NL
46449,1698971160,1698981720,10560,180523,185439,IT,IT
184562,1700597040,1700631120,34080,156047,31045,TR,TR
150549,1700304060,1700319720,15660,186341,24758,RS,RS
401,1699960020,1699977240,17220,111691,36627,US,US
45226,1698933120,1698942240,9120,55994,152343,IT,IT
67484,1700660940,1700700360,39420,101059,115609,MX,MX
99280,1699761720,1699765320,3600,102600,93033,NL,NL
46909,1699931400,1699967340,35940,155778,44007,TR,TR
42362,1699906740,1699921500,14760,174821,47453,US,US
144038,1699098000,1699127460,29460,135612,187000,TR,TR
145324,1700653440,1700685420,31980,152485,190972,TR,TR
157412,1698987660,1699021500,33840,87891,141663,TR,TR
43647,1700728440,1700742120,13680,178257,101776,IT,IT
5922,1700842680,1700846280,3600,192570,82984,GB,GB
47763,1700599440,1700632980,33540,37773,180044,TR,TR
89751,1699342260,1699353720,11460,71293,195933,US,US
199255,1699482660,1699498500,15840,103756,86116,US,US
27299,1700624400,1700644500,20100,168510,126443,FR,FR
110432,1699271880,1699280160,8280,73917,137368,IT,IT
7061,1699732140,1699767180,35040,186900,94382,TR,TR
191584,1700151660,1700178900,27240,141086,132809,ME,RS
198186,1700551080,1700586840,35760,77402,39493,TR,TR
83672,1699565400,1699576200,10800,63067,122364,IT,IT
134168,1700430960,1700460000,29040,111823,7377,TR,TR
188641,1699835040,1699867140,32100,61393,20488,TR,TR
105381,1699813500,1699833900,20400,187432,97079,FR,FR
49868,1699784640,1699815780,31140,33368,131234,TR,TR
86470,1699843320,1699846920,3600,29765,151855,NL,NL
163168,1699475820,1699487640,11820,93698,7878,US,US
8833,1700066340,1700096760,30420,103371,46144,TR,TR
90060,1700412840,1700448180,35340,94330,149559,TR,TR
140407,1699683240,1699700220,16980,151590,195503,US,US
48922,1699678980,1699691880,12900,23785,92308,IT,IT
140015,1699287720,1699322220,34500,132,70213,TR,TR
151822,1699361160,1699368240,7080,74248,69786,GB,GB
110112,1699837860,1699867920,30060,156968,188920,MK,AT
154995,1698806100,1698816600,10500,86962,92058,ES,ES
32500,1699015080,1699018680,3600,43923,34907,GB,GB
137767,1700200200,1700203800,3600,151379,118830,NL,NL
195476,1700427600,1700431200,3600,108027,172781,NL,NL
105226,1699815240,1699836900,21660,141620,155860,DK,DK
155794,1699512000,1699525500,13500,16612,677,IT,IT
14732,1699861380,1699867560,6180,170043,76211,AD,ES
173229,1700651700,1700668800,17100,94451,229,US,US
129746,1699021980,1699034580,12600,78057,145976,US,US
50169,1700656500,1700660100,3600,142919,139300,GB,GB
121872,1700472420,1700481780,9360,43730,171708,IT,IT
145898,1699232880,1699262100,29220,35232,47390,TR,TR
157192,1700767500,1700783460,15960,35709,109705,US,US
104291,1699628580,1699636560,7980,59010,53370,HR,HR
35420,1699894080,1699908240,14160,85396,155826,HR,HR
88303,1699106220,1699135800,29580,155664,2982,TR,TR
157245,1698922740,1698949680,26940,130987,163105,DE,AT
62948,1699207920,1699240440,32520,32475,60400,MX,MX
170626,1699579020,1699607340,28320,179479,157332,DE,CH
189779,1700569200,1700597760,28560,176997,177823,DE,RS
156494,1700580900,1700596320,15420,9716,50478,US,US
139572,1700542500,1700566080,23580,199157,172649,BR,BR
189771,1700808240,1700811840,3600,138088,183138,NL,NL
10472,1699267560,1699283520,15960,25097,189270,US,US
68939,1699257300,1699260900,3600,194564,90702,GB,GB
23566,1700164500,1700196240,31740,111271,71127,TR,TR
176008,1698863100,1698889980,26880,150151,183792,DE,PL
128026,1699402200,1699411080,8880,30246,123864,HR,HU
75582,1700222700,1700255040,32340,50690,95850,TR,TR
46560,1699257540,1699290060,32520,181007,25041,MX,MX
167901,1700581920,1700611740,29820,40934,191492,TR,TR
123267,1699590240,1699619280,29040,6783,13185,TR,TR
27131,1700076300,1700107680,31380,184821,57298,TR,TR
135610,1699014840,1699018440,3600,114153,2509,NL,FR
181049,1698993780,1699019340,25560,66508,71543,BR,BR
127944,1699215720,1699250640,34920,171172,114155,TR,TR
45875,1698985140,1699019520,34380,149422,150037,TR,TR
172887,1700797320,1700804160,6840,174961,115194,GB,GB
105137,1700787720,1700802480,14760,71007,46287,US,US
138842,1700739060,1700768100,29040,91169,44990,TR,TR
177558,1700514900,1700539560,24660,163481,114488,HU,PL
115086,1699626660,1699630260,3600,110032,14244,GB,GB
73314,1700687280,1700698200,10920,122765,29278,IT,IT
121004,1700359020,1700385960,26940,162609,170127,DE,DE
83918,1699965540,1700001120,35580,23209,177222,TR,TR
139565,1700805120,1700817480,12360,19542,7197,AT,AT
86074,1700239800,1700275080,35280,60629,163043,TR,TR
44500,1700219580,1700255220,35640,135067,108129,TR,TR
172823,1698889020,1698902640,13620,23578,168173,AT,MK
170885,1700576820,1700612700,35880,75090,100824,TR,TR
11596,1700596380,1700599980,3600,116998,17453,GB,GB
105105,1699757280,1699775220,17940,57489,198430,US,US
121009,1700274600,1700280060,5460,32628,144628,GB,GB
71823,1700101980,1700108280,6300,73184,124175,NL,NL
180271,1699957560,1699964880,7320,180159,45144,IT,IT
183825,1699094100,1699097700,3600,77361,36797,GB,GB
143583,1699042560,1699058220,15660,89121,49317,US,US
190831,1700042520,1700053440,10920,161520,85833,IT,IT
10732,1699182960,1699186560,3600,46936,6091,GB,GB
166995,1699592880,1699600260,7380,83043,170268,IT,IT
67064,1700075280,1700078880,3600,175867,160137,NL,NL
126059,1699454700,1699487700,33000,146553,113584,TR,TR
76231,1699412460,1699427520,15060,77707,113953,US,US
81506,1698819360,1698822960,3600,67394,16324,NL,NL
87944,1700812560,1700827080,14520,133629,133396,RS,RS
53944,1699905000,1699940640,35640,155960,90729,TR,TR
75814,1700139660,1700166780,27120,161713,55006,BR,BR
74262,1699763280,1699766880,3600,6709,82031,GB,GB
148218,1699551000,1699563060,12060,124534,107880,CA,US
73994,1698994080,1699005180,11100,16426,15673,RS,RS
20336,1700852760,1700857500,4740,110794,57219,NL,NL
95203,1699187700,1699223580,35880,99420,1270,TR,TR
106317,1699181880,1699205400,23520,178440,130985,DE,NL
116687,1698961080,1698987720,26640,187189,94066,RO,RO
67229,1699569240,1699586820,17580,101318,65469,US,US
40958,1699702440,1699710180,7740,176002,151576,IT,IT
46329,1699127100,1699141380,14280,145278,41380,HR,HR
84890,1699286760,1699290360,3600,60176,14748,GB,GB
71543,1700545980,1700577720,31740,198263,120559,TR,TR
93078,1700153340,1700158440,5100,48727,190909,GB,GB
24640,1699844040,1699847640,3600,194047,128782,GB,GB
141483,1699651200,1699666260,15060,48254,31991,FR,DE
52746,1700523240,1700541120,17880,69796,143398,US,US
105559,1700547720,1700555520,7800,193088,167103,ES,ES
81163,1700252880,1700265300,12420,133984,133797,HR,HR
19995,1700167560,1700171520,3960,182757,129127,NL,BE
144151,1699957500,1699981260,23760,109935,129831,DE,FR
93767,1699635180,1699648800,13620,60126,195272,HR,HR
167183,1700358960,1700393520,34560,90913,13422,MK,RS
114988,1700649600,1700663820,14220,68266,185654,US,US
34301,1699913940,1699918380,4440,150227,116683,NL,GB
66233,1699973580,1700009040,35460,55118,48916,TR,TR
168876,1699526700,1699556820,30120,101909,67746,TR,TR
68236,1700519520,1700535720,16200,142331,127628,US,US
155317,1699121880,1699154640,32760,149767,186674,TR,TR
125376,1698851760,1698883740,31980,163704,133001,TR,TR
182887,1699822500,1699835040,12540,66303,111788,US,US
134391,1699682760,1699706520,23760,142721,19867,DE,IT
162819,1700246100,1700252820,6720,160297,89341,GB,GB
166821,1699312260,1699341780,29520,199750,123219,TR,TR
79764,1699831620,1699835220,3600,142705,172568,NL,NL
49742,1699973640,1700007000,33360,15198,169211,TR,TR
177129,1700590740,1700598840,8100,172925,46684,HR,HR
88804,1700544960,1700552760,7800,44373,42426,IT,IT
66862,1700060520,1700093580,33060,175428,168804,TR,TR
98065,1700242020,1700265840,23820,65060,23218,DE,UA
76998,1700630040,1700653380,23340,73570,189203,HU,HR
20672,1699505760,1699512660,6900,150381,132783,GB,GB
92618,1700424480,1700457060,32580,132270,142243,TR,TR
80830,1700791200,1700824380,33180,144937,10034,TR,TR
188428,1699180200,1699191960,11760,185773,57170,PT,PT
50962,1700324580,1700339580,15000,138052,196213,US,US
80559,1699271160,1699274760,3600,16913,28755,NL,NL
130822,1700183220,1700186820,3600,44486,60341,GB,GB
61055,1699576140,1699607580,31440,14618,84567,TR,TR
54836,1699794120,1699805160,11040,63947,121275,AT,AT
84128,1699999740,1700010840,11100,72826,159764,ES,ES
172215,1699787940,1699817100,29160,150763,23842,TR,TR
107383,1699206180,1699209960,3780,187196,41980,GB,GB
58112,1700731440,1700747400,15960,40042,60659,US,US
111677,1700343420,1700369640,26220,161472,6439,DE,DE
187662,1699314240,1699323720,9480,48399,69791,IT,IT
189361,1700822040,1700828340,6300,34998,174452,GB,GB
190121,1700833140,1700842500,9360,195731,36333,HR,HR
102092,1699922340,1699931400,9060,125317,40766,IT,IT
148231,1700786040,1700817840,31800,119382,54465,TR,TR
110392,1700443200,1700457900,14700,7349,192068,AT,AT
64144,1699210080,1699213680,3600,79826,181291,GB,GB
9571,1700442540,1700476140,33600,120124,57379,TR,TR
48380,1699765800,1699800120,34320,128796,99623,TR,TR
125612,1700326320,1700332920,6600,142692,70082,NL,NL
56963,1699037940,1699067640,29700,144365,187505,TR,TR
101285,1699632900,1699642920,10020,33930,136293,ES,FR
10702,1699584660,1699597560,12900,159139,198328,IT,IT
4612,1699787340,1699817100,29760,132507,83439,TR,TR
183747,1700077800,1700104920,27120,111792,74393,PL,AT
114564,1698992460,1699010460,18000,78561,104840,FR,FR
143686,1699384200,1699395000,10800,10736,163548,IT,IT
18704,1700019360,1700033520,14160,80522,36936,IT,IT
81081,1699143780,1699147380,3600,10881,133197,GB,GB
55740,1700193960,1700229480,35520,106247,153759,TR,TR
81623,1700266320,1700270220,3900,167841,39524,NL,NL
169486,1699006980,1699014180,7200,160453,22223,SK,SK
81087,1700540700,1700557140,16440,23880,59980,FR,FR
68956,1700075400,1700110200,34800,186676,137414,TR,TR
75840,1699192920,1699208820,15900,168552,136607,US,US
126784,1699249320,1699276800,27480,65002,59106,BA,BA
94079,1698916560,1698950040,33480,159979,137323,TR,TR
137256,1700827800,1700854380,26580,84558,49881,PL,PL
38061,1700627220,1700644680,17460,128868,176203,US,US
147819,1700155320,1700171400,16080,129568,196191,RS,RS
154275,1699943280,1699977240,33960,188721,166973,TR,TR
90755,1700808600,1700821620,13020,168865,149169,CZ,PL
104314,1699273380,1699291140,17760,186607,99035,US,US
45038,1699996440,1700025360,28920,123920,98784,TR,TR
166785,1700185440,1700197260,11820,154177,76791,IT,IT
170951,1699187280,1699196520,9240,67542,150998,IT,IT
142312,1699885080,1699920480,35400,36301,111098,TR,TR
161981,1700204040,1700216460,12420,141748,163162,HR,ME
139755,1700557200,1700609820,52620,63988,16158,BG,DE
173234,1700812980,1700843760,30780,24824,103654,TR,TR
150388,1700025660,1700029260,3600,159004,111232,GB,GB
95994,1699636140,1699639740,3600,61712,197314,GB,GB
180714,1700736540,1700768400,31860,4455,87317,TR,TR
90164,1700579760,1700583360,3600,142520,153676,GB,GB
154107,1698950040,1698960780,10740,148236,5641,IT,IT
129278,1698898620,1698902220,3600,112021,83686,GB,GB
80443,1698948840,1698983160,34320,52526,73308,TR,TR
111415,1699934520,1699968300,33780,156046,109296,TR,TR
58551,1699459740,1699463340,3600,52167,174207,GB,GB
51480,1700210280,1700239560,29280,162320,196857,TR,TR
156806,1699753140,1699786500,33360,98148,29114,TR,TR
26981,1700266620,1700284020,17400,13829,23966,US,US
45212,1699917180,1699946280,29100,2798,130425,TR,TR
177516,1700034180,1700048220,14040,112819,170406,HR,HR
189499,1699692540,1699704780,12240,39419,122179,US,US
102665,1699525860,1699540140,14280,167645,114390,PT,PT
14531,1700453460,1700469840,16380,127218,135909,US,US
23003,1700302080,1700314140,12060,98392,187760,CA,US
62744,1700581740,1700596260,14520,17389,190823,US,US
34740,1700769000,1700795760,26760,190202,70295,BR,BR
43914,1698854940,1698889500,34560,99483,26130,TR,TR
106978,1700236980,1700269380,32400,162560,20646,TR,TR
78328,1699689000,1699694760,5760,197158,100279,GB,GB
131330,1700553360,1700563980,10620,10336,15138,IT,IT
44055,1699654320,1699681860,27540,42472,18951,BR,BR
39328,1700140800,1700147760,6960,159714,102911,GB,GB
183711,1699482900,1699512300,29400,53117,6611,TR,TR
180348,1699450560,1699454160,3600,182304,63439,NL,NL
148248,1699646220,1699677600,31380,38879,98105,BA,DE
78811,1700269080,1700299320,30240,177312,22474,TR,TR
169095,1698795240,1698801720,6480,167450,10207,GB,FR
66145,1699000500,1699016160,15660,3042,62216,CA,CA
33377,1700419080,1700423820,4740,30711,51554,NL,FR
155774,1699671660,1699700760,29100,62522,122576,TR,TR
74197,1700122740,1700126340,3600,24121,15637,NL,NL
174626,1700229480,1700258640,29160,34625,52886,TR,TR
60897,1700553120,1700566200,13080,26454,67542,US,US
25801,1699793760,1699802220,8460,89057,46636,IT,IT
151956,1699253580,1699287900,34320,56814,180405,TR,TR
154596,1699990380,1700023740,33360,106605,34245,TR,TR
124688,1699844460,1699878900,34440,178584,21953,TR,TR
19139,1699972620,1699982280,9660,180457,121618,PT,PT
78202,1700806620,1700842260,35640,172302,9519,TR,TR
167124,1700302980,1700331900,28920,20087,28368,TR,TR
94266,1699994820,1700011140,16320,108691,138294,RS,RS
46876,1700052600,1700056200,3600,127210,47703,NL,NL
142375,1699055160,1699067940,12780,170072,144207,IT,IT
5350,1700467980,1700478960,10980,56321,134198,US,US
63151,1699398480,1699429800,31320,12936,49382,TR,TR
105561,1699215240,1699228500,13260,43002,34816,IT,IT
129738,1700831700,1700838300,6600,111248,78732,NL,NL
75552,1700753520,1700763540,10020,54021,74777,IT,IT
83338,1698994260,1699012920,18660,184806,190419,FR,FR
36165,1699887360,1699917360,30000,54284,181798,TR,TR
132456,1700677980,1700695320,17340,174330,76157,US,US
89237,1700736000,1700769060,33060,36807,80014,TR,TR
195054,1698830700,1698834300,3600,109340,123155,GB,GB
89992,1700842800,1700865780,22980,32393,113761,DE,SK
40419,1699946040,1699966860,20820,15688,99347,FR,FR
124628,1699342260,1699375800,33540,148570,106698,TR,TR
95939,1699644240,1699678860,34620,40474,71305,TR,TR
162164,1699271220,1699282260,11040,1160,3925,AT,RO
63149,1699887660,1699891860,4200,46090,128605,GB,GB
8772,1700193480,1700197080,3600,145357,53581,NL,NL
152251,1699870740,1699901880,31140,54946,183396,TR,TR
70651,1700390040,1700423460,33420,64347,192548,TR,TR
27062,1700496660,1700507820,11160,144504,89708,CZ,UA
188302,1700118960,1700174100,55140,30480,127122,BG,DE
96283,1699826700,1699835820,9120,107288,84246,IT,IT
25733,1700635380,1700665920,30540,135289,140217,TR,TR
168203,1699765320,1699796460,31140,130654,152307,TR,TR
48473,1699917360,1699943400,26040,125025,180345,BA,ME
190310,1699046880,1699079220,32340,174857,32923,TR,TR
5672,1698948840,1698954120,5280,10165,15530,NL,NL
176906,1699612620,1699628340,15720,125155,117229,FR,FR
100238,1700619420,1700633580,14160,42025,114634,RS,RS
118297,1700438880,1700474340,35460,45240,131100,TR,TR
59877,1699973700,1700003040,29340,173318,179543,TR,TR
126952,1700072340,1700101440,29100,159540,83620,TR,TR
104666,1699326300,1699341900,15600,181877,39205,US,US
17878,1699156260,1699167660,11400,106465,40455,IT,IT
160207,1699642800,1699659600,16800,154510,138936,CZ,HR
191842,1699564860,1699572240,7380,112051,10027,IT,DE
152553,1700842200,1700855640,13440,71650,177369,HR,HR
92356,1700623620,1700653020,29400,171885,39749,TR,TR
193213,1700859480,1700891520,32040,73632,52491,TR,TR
42862,1700538180,1700556420,18240,139527,143093,FR,FR
29496,1698840540,1698853260,12720,77460,30328,IT,IT
119483,1699359900,1699363500,3600,20073,54288,GB,GB
103456,1700516880,1700528760,11880,133100,166873,US,US
156597,1699410420,1699444800,34380,130331,70740,TR,TR
163107,1699107960,1699125060,17100,160949,175039,US,US
36374,1700108880,1700126220,17340,69101,183153,US,US
15076,1699827720,1699838940,11220,142122,167574,IT,IT
74253,1700075880,1700082060,6180,123069,139315,NL,NL
14486,1700310480,1700342760,32280,140378,195101,TR,TR
116666,1699369860,1699403520,33660,103491,99357,TR,TR
118757,1698976680,1698996480,19800,102261,71491,DK,DE
136692,1698859860,1698874440,14580,161561,167570,US,US
95990,1699817520,1699824600,7080,149968,122468,GB,GB
166838,1699358040,1699388640,30600,49091,171464,TR,TR
186268,1699687320,1699690920,3600,32606,23697,NL,PL
79984,1699026780,1699058460,31680,33103,98513,TR,TR
28622,1700724240,1700757480,33240,150935,31382,TR,TR
53790,1700384880,1700415420,30540,98412,45771,TR,TR
124506,1700803740,1700839680,35940,54898,49012,TR,TR
50856,1699164180,1699178280,14100,189073,120194,IT,IT
19682,1700126040,1700142420,16380,189580,130489,US,US
65199,1700734080,1700740620,6540,150631,149494,GB,GB
117366,1700864880,1700875020,10140,124634,61045,SK,AT
171920,1698894720,1698902040,7320,15560,39439,IT,IT
58765,1700520360,1700549640,29280,79851,77856,TR,TR
65505,1700370840,1700401800,30960,153428,178872,TR,TR
32600,1700677380,1700688240,10860,115090,9055,US,US
81876,1699085280,1699099740,14460,66272,56115,AT,BA
84866,1700694420,1700705580,11160,116875,61858,US,US
61355,1698947040,1698960900,13860,152422,60635,US,US
155023,1700061480,1700065800,4320,153022,66663,NL,NL
72482,1700614680,1700631360,16680,129571,31469,CZ,CZ
8024,1700510460,1700539860,29400,15830,44244,TR,TR
18440,1699256340,1699289580,33240,38810,174967,TR,TR
86549,1700043420,1700076300,32880,172628,65444,TR,TR
91094,1700236500,1700271240,34740,100934,195133,TR,TR
115327,1699478400,1699492140,13740,176113,193758,ES,ES
3458,1700863740,1700899140,35400,121021,133805,TR,TR
10703,1699085460,1699089480,4020,138138,23233,NL,NL
159797,1700249040,1700279580,30540,32258,91996,TR,TR
186234,1700411940,1700433180,21240,95590,36838,FR,DE
141616,1698916500,1698920100,3600,39465,193462,GB,GB
157889,1700489220,1700513040,23820,103462,188872,PL,PL
8446,1699027620,1699032300,4680,22976,181765,GB,GB
790,1699036920,1699072320,35400,136035,28342,TR,TR
43158,1700858940,1700865660,6720,119701,25437,GB,GB
163296,1699134720,1699147920,13200,55796,36238,PT,FR
10861,1699641600,1699650540,8940,27046,120848,HR,HR
170745,1698827100,1698837900,10800,160296,47515,US,US
3778,1700224800,1700253900,29100,163272,21657,TR,TR
39346,1700106060,1700142240,36180,121926,106946,MX,MX
29164,1699654440,1699671000,16560,62788,4145,AT,SK
137471,1700166480,1700200500,34020,189007,80781,TR,TR
185669,1700828280,1700862360,34080,189746,88079,TR,TR
175132,1700432100,1700435700,3600,74725,30862,NL,NL
129397,1700827260,1700861040,33780,69483,52049,TR,TR
65045,1699484400,1699488000,3600,33263,153551,GB,GB
197231,1700152500,1700185500,33000,18885,142459,TR,TR
20289,1699625220,1699644180,18960,196601,96458,BE,NL
340,1699634700,1699662840,28140,83192,8438,DE,DE
145135,1699902780,1699927380,24600,173970,71571,BR,BR
177333,1698997800,1699031040,33240,16593,167561,TR,TR
186546,1700450520,1700468220,17700,172097,96672,AT,AT
90344,1699293840,1699313580,19740,184041,190994,FR,FR
18917,1700157300,1700177760,20460,162721,114659,FR,FR
77985,1698982020,1698996300,14280,119285,126525,IT,IT
148509,1699375320,1699405380,30060,77615,23108,TR,TR
12254,1698853560,1698862320,8760,87798,72905,IT,HR
107810,1700398440,1700427960,29520,121454,52808,TR,TR
116269,1699884600,1699891800,7200,198616,85587,IT,IT
34055,1700313780,1700346240,32460,43995,130448,TR,TR
34930,1699336380,1699372200,35820,199809,182368,TR,TR
108120,1699721880,1699725480,3600,88699,128042,NL,NL
5080,1699799580,1699823220,23640,118171,15717,DE,DE
35356,1700364600,1700396640,32040,175081,125765,TR,TR
59069,1700471640,1700505180,33540,131589,48867,MX,MX
47672,1698801480,1698831660,30180,112768,171028,TR,TR
144256,1699365000,1699399980,34980,30516,44724,TR,TR
146522,1699591980,1699626540,34560,79557,46127,TR,TR
123496,1700014320,1700017920,3600,85730,127408,GB,GB
162452,1698875340,1698908760,33420,14677,173016,TR,TR
4171,1699491720,1699499340,7620,173213,1132,IT,IT
62479,1700160240,1700183580,23340,110680,92791,PL,DE
36362,1698899520,1698929220,29700,15879,185401,TR,TR
59090,1699662060,1699687020,24960,78125,82078,DK,DK
101593,1699383000,1699386660,3660,501,111207,NL,NL
131485,1699165440,1699174920,9480,88253,138515,IT,IT
6443,1698886680,1698912660,25980,171129,38160,DE,DE
1393,1698897900,1698901500,3600,184608,23499,GB,GB
63546,1699022640,1699033800,11160,187433,48912,US,US
115644,1700713560,1700743860,30300,171731,128415,TR,TR
195229,1700709840,1700741700,31860,50827,58452,TR,TR
12814,1699563960,1699596360,32400,132285,189138,TR,TR
183693,1698831540,1698863280,31740,170086,157732,TR,TR
135660,1699540200,1699552980,12780,140080,194432,HR,HR
5321,1699745940,1699777440,31500,197939,192824,TR,TR
22092,1700207040,1700240760,33720,60137,33790,MX,MX
109580,1700814960,1700844360,29400,153939,120877,TR,TR
121926,1699167420,1699184820,17400,108465,82710,AT,AT
82611,1699606680,1699642140,35460,77354,173150,TR,TR
92293,1699198500,1699221960,23460,158095,104527,PL,PL
116422,1699316700,1699345920,29220,140592,195093,TR,TR
48233,1700286900,1700316180,29280,48630,8905,TR,TR
47733,1699485120,1699520760,35640,158512,176318,TR,TR
156584,1699809840,1699840920,31080,109247,69929,TR,TR
86846,1700706120,1700740320,34200,195924,157593,TR,TR
107900,1699934820,1699951920,17100,157117,167367,US,US
65202,1700238000,1700254080,16080,88183,172624,FR,DE
87627,1699116720,1699125060,8340,117936,81956,HR,HR
140499,1700397000,1700413200,16200,28525,137336,US,US
166189,1699972200,1699989060,16860,114526,117544,US,US
16074,1700803500,1700807100,3600,11150,142207,GB,FR
103896,1700346840,1700361120,14280,102957,86067,HR,HR
51301,1700847900,1700878800,30900,88940,113563,TR,TR
99623,1699916820,1699929420,12600,78065,52260,IT,IT
146778,1700098260,1700130900,32640,14412,189094,TR,TR
7758,1700864340,1700880240,15900,27903,12504,US,US
91045,1699997820,1700030400,32580,198590,190291,TR,TR
54272,1699096740,1699111500,14760,158727,37283,US,US
48990,1700165940,1700198280,32340,69518,83066,TR,TR
186104,1699789200,1699807140,17940,154329,191395,SE,SE
5486,1699249380,1699256040,6660,106146,194952,NL,NL
58427,1698855540,1698861060,5520,97292,121606,NL,NL
168430,1700851980,1700870700,18720,20893,145875,FR,FR
132528,1699199640,1699205640,6000,89499,34813,FI,EE
19212,1699998300,1700001900,3600,112953,8756,NL,NL
183215,1700424060,1700429520,5460,60064,54788,GB,GB
110921,1700133900,1700167020,33120,60067,153609,TR,TR
96184,1700593140,1700614020,20880,194354,6280,FR,FR
101328,1700608860,1700619960,11100,145321,115735,AT,AT
107701,1700643480,1700673660,30180,19497,199406,TR,TR
34299,1699461060,1699488000,26940,139085,199679,BR,BR
181047,1699073580,1699108020,34440,107469,159086,TR,TR
6962,1700403540,1700437320,33780,65994,176220,TR,TR
17830,1700384580,1700418300,33720,65331,170557,TR,TR
151902,1699713420,1699729800,16380,181512,187186,FR,AD
62217,1699477020,1699511400,34380,141681,26794,TR,TR
125153,1699174560,1699187340,12780,77023,171497,ES,ES
45167,1698915780,1698931140,15360,60703,113339,US,US
61360,1700122620,1700156940,34320,15662,75782,MX,MX
92262,1698794460,1698819480,25020,30139,116674,DE,DE
88424,1698802500,1698813900,11400,115152,196809,US,US
116852,1699912920,1699939740,26820,85838,100087,DE,BG
152600,1700198460,1700227140,28680,69861,3241,BA,HR
56260,1699735980,1699747560,11580,159298,131280,SK,SK
113553,1699467240,1699499100,31860,20470,86139,TR,TR
50564,1699021860,1699054980,33120,125440,155024,TR,TR
2429,1699384140,1699387740,3600,93910,98188,GB,GB
35180,1699374660,1699379340,4680,64929,84426,NL,NL
126031,1699757040,1699779240,22200,50179,117514,BR,BR
170735,1699932480,1699965780,33300,10798,47950,TR,TR
195505,1700347140,1700360460,13320,12610,189559,IT,IT
106515,1700300820,1700312880,12060,97701,130139,US,US
173289,1700200740,1700209800,9060,87434,9738,IT,IT
171546,1699389480,1699396140,6660,195078,33601,EE,EE
146187,1699954800,1699987620,32820,163283,163856,MX,MX
30823,1700857080,1700874060,16980,33171,13603,US,US
91941,1698961920,1699014480,52560,94725,127377,BG,DE
113128,1700369820,1700404680,34860,92928,140244,TR,TR
26558,1699482300,1699488240,5940,115446,87166,GB,GB
65364,1699176000,1699210620,34620,20569,55099,TR,TR
187874,1700838420,1700859120,20700,55667,8336,FR,BE
4896,1699060200,1699089180,28980,42546,48640,TR,TR
15516,1699579620,1699593180,13560,171309,121543,IT,IT
93866,1700754720,1700773080,18360,119053,49330,FR,FR
138122,1700840220,1700873580,33360,136818,79512,TR,TR
107557,1699829880,1699844460,14580,144063,101039,FR,FR
145562,1699691520,1699695900,4380,12980,132319,NL,NL
58287,1700328900,1700349540,20640,153365,170878,DK,DK
66675,1699023300,1699053960,30660,131671,152035,TR,TR
41738,1700722560,1700740020,17460,114423,124086,US,US
158990,1700567520,1700578440,10920,116416,6083,PT,PT
50758,1699631100,1699664700,33600,108569,193838,TR,TR
106936,1699845540,1699875300,29760,36672,132665,TR,TR
102964,1699408800,1699438020,29220,64284,137527,TR,TR
68741,1699859460,1699894080,34620,48237,24400,TR,TR
145047,1699097040,1699103160,6120,152496,19662,NL,NL
162364,1699150500,1699179540,29040,5272,168470,TR,TR
197502,1700221800,1700227800,6000,44767,5791,NL,NL
167950,1700099520,1700134620,35100,159585,188500,TR,TR
81531,1699742100,1699753620,11520,191922,40286,US,US
86841,1699301280,1699311120,9840,14309,92190,ES,ES
37678,1700707680,1700725320,17640,97150,40014,US,US
150948,1699593360,1699626180,32820,185299,137144,TR,TR
77861,1700362080,1700397060,34980,32951,134946,TR,TR
192604,1699962900,1699967760,4860,17489,52002,NL,NL
181558,1699144920,1699150800,5880,60777,157495,GB,NL
160140,1699605840,1699609440,3600,54415,130636,GB,GB
192371,1699046580,1699077900,31320,194435,19336,TR,TR
65404,1700595240,1700625900,30660,52377,60732,TR,TR
197241,1699832100,1699865280,33180,195900,128957,TR,TR
24957,1699994820,1700027220,32400,38959,181031,TR,TR
182899,1699210080,1699239360,29280,137203,16553,TR,TR
14305,1698918960,1698947040,28080,197753,153413,DE,DE
15180,1699552920,1699583280,30360,106891,128354,TR,TR
67907,1699287120,1699303200,16080,54935,46240,US,US
31935,1699250280,1699263480,13200,105707,44002,US,US
11389,1699275240,1699288920,13680,124108,185215,IT,IT
98625,1699053660,1699086660,33000,102018,31009,TR,TR
140844,1699677840,1699690380,12540,90974,172982,IT,IT
120355,1700298060,1700312940,14880,126589,58206,US,US
168409,1699106820,1699124640,17820,6553,134812,CZ,PL
58099,1700162700,1700191560,28860,101749,39418,TR,TR
110607,1700299680,1700335080,35400,28082,160318,TR,TR
193059,1699488300,1699491900,3600,44778,142834,GB,GB
165412,1698922680,1698933360,10680,40909,162006,IT,IT
187706,1699094580,1699109820,15240,88672,140361,FR,BE
89712,1700102880,1700116380,13500,65391,32815,IT,CH
7063,1700028300,1700036340,8040,78907,199425,IT,IT
3893,1699700700,1699704300,3600,105491,172383,GB,GB
28488,1700856840,1700864400,7560,57686,90480,IT,IT
85749,1698850860,1698883320,32460,28235,32982,TR,TR
22772,1700451060,1700483340,32280,182563,150296,TR,TR
84139,1699493640,1699525320,31680,110600,80355,TR,TR
25795,1700652420,1700683080,30660,101723,167059,TR,TR
160727,1700493360,1700517120,23760,115884,157966,DE,IT
113136,1699144320,1699155240,10920,45131,193753,IT,IT
67997,1699791480,1699821120,29640,80849,22084,TR,TR
92025,1698900000,1698932100,32100,178484,31840,TR,TR
31895,1700793060,1700796660,3600,83052,81715,GB,GB
187146,1700621520,1700656260,34740,32820,151980,TR,TR
63808,1699846380,1699876140,29760,163626,176702,TR,TR
87878,1700738040,1700742660,4620,192368,98451,NL,NL
187754,1700600280,1700630760,30480,172745,8419,MK,AL
194312,1700600160,1700617080,16920,167107,43758,FR,FR
131559,1699038540,1699069200,30660,182679,35116,TR,TR
72928,1699183380,1699188240,4860,77765,163644,GB,GB
132765,1700796060,1700825940,29880,100392,139639,TR,TR
77401,1699246260,1699261980,15720,154272,64776,US,US
25907,1699792920,1699826640,33720,6370,173256,MX,MX
198608,1699671180,1699699020,27840,97980,42071,CH,FR
55317,1699231620,1699245960,14340,12846,38064,PT,PT
2406,1700469060,1700500860,31800,94774,118496,TR,TR
185639,1700288040,1700299200,11160,41479,34262,US,US
180238,1700674800,1700705040,30240,133373,11907,TR,TR
22207,1699369620,1699386840,17220,173631,17932,US,US
60219,1699697940,1699730160,32220,15404,94105,TR,TR
103851,1699824660,1699835700,11040,67399,163862,HR,HR
123458,1700364180,1700376480,12300,100449,39770,RS,DE
83281,1700626260,1700638380,12120,158822,14220,US,US
189213,1700729460,1700762100,32640,196155,92979,TR,TR
100955,1700539020,1700574840,35820,177416,185366,TR,TR
35786,1700172540,1700180460,7920,71923,69249,IT,IT
14854,1699892220,1699923480,31260,39829,186414,TR,TR
181786,1699566720,1699601160,34440,188460,111534,TR,TR
170625,1700259120,1700272500,13380,102835,62705,US,US
65564,1699051980,1699078080,26100,152562,160440,DE,BG
47612,1699005600,1699037820,32220,83036,171881,TR,TR
49409,1700464080,1700480700,16620,111297,50622,US,US
18920,1699927620,1699931220,3600,110563,119330,NL,NL
131595,1699719060,1699722660,3600,160458,117991,GB,GB
54061,1700005620,1700010900,5280,97165,20558,EE,EE
150204,1698952980,1698958320,5340,155132,7466,GB,GB
34088,1699616700,1699634640,17940,187178,171333,US,US
50619,1700009880,1700039220,29340,17584,195443,TR,TR
160296,1700670960,1700701260,30300,152649,185902,TR,TR
76486,1700328120,1700339880,11760,188461,91848,US,US
33474,1700050140,1700084700,34560,78200,176255,TR,TR
108850,1700487720,1700500080,12360,145812,34531,ES,AD
72239,1700828400,1700861580,33180,162187,145443,TR,TR
121824,1700635260,1700665320,30060,39679,143320,TR,TR
52854,1698859980,1698872220,12240,187479,78075,HR,DE
170587,1699813380,1699857960,44580,182718,180367,LU,IT
178441,1699849980,1699884660,34680,147746,33312,MX,MX
116044,1699746360,1699761000,14640,97479,31224,US,US
65178,1699166760,1699202640,35880,188004,127824,TR,TR
198429,1698969840,1698982080,12240,109013,122884,IT,IT
147426,1699373220,1699407060,33840,67935,15076,TR,TR
183132,1699696680,1699728060,31380,122028,55379,TR,TR
16520,1698920280,1698932100,11820,174742,52784,US,US
183577,1700038080,1700044560,6480,8397,139971,GB,GB
53604,1699198080,1699225500,27420,129248,140343,ME,RS
119156,1700773200,1700786040,12840,81772,158154,IT,IT
104302,1700469480,1700503440,33960,74824,85425,TR,TR
170451,1700298840,1700326560,27720,61167,54346,DE,DE
3168,1699721880,1699753800,31920,150606,98814,TR,TR
15448,1699331220,1699367580,36360,196137,166772,MX,MX
142657,1699607340,1699628760,21420,48057,29176,SE,DK
183782,1700503200,1700515920,12720,48602,189952,PT,PT
48367,1700159520,1700163120,3600,50256,137406,NL,NL
173614,1698949980,1698954180,4200,166160,21340,GB,GB
132325,1699368300,1699375440,7140,91198,15573,GB,GB
178775,1700439180,1700463960,24780,27585,172269,BR,BR
107847,1698841380,1698867360,25980,198999,30413,DE,HU
129987,1699959660,1699963260,3600,52085,89197,NL,NL
192437,1699956960,1699984380,27420,136036,47300,DE,DE
30990,1700421600,1700433600,12000,124194,141824,US,US
56133,1698950700,1698964440,13740,192649,168102,US,US
126701,1700556120,1700585040,28920,183560,182658,TR,TR
83724,1699094280,1699105920,11640,116415,162895,IT,IT
107458,1699305840,1699363260,57420,117603,86764,BG,AT
79383,1700159400,1700194980,35580,183394,193720,TR,TR
55957,1699110900,1699118940,8040,8589,3171,PT,PT
153885,1699763520,1699768980,5460,5802,130223,NL,NL
189650,1699507500,1699539900,32400,145699,92270,TR,TR
184037,1699175100,1699190160,15060,193373,189189,FR,PL
137415,1700382060,1700394600,12540,33164,9484,IT,IT
87173,1699684320,1699718340,34020,197429,138204,TR,TR
182857,1699911000,1699924380,13380,94241,76786,IT,IT
75014,1698881340,1698916980,35640,94933,102092,MX,MX
164799,1699184640,1699208820,24180,194566,84552,DE,FR
77877,1700043420,1700057580,14160,157210,49290,US,US
52903,1700431860,1700435460,3600,78597,87828,GB,GB
12876,1699785780,1699789380,3600,79049,3032,GB,GB
197,1700440080,1700471340,31260,47231,71603,BA,DE
36186,1700647020,1700679120,32100,96606,39198,TR,TR
44879,1699442400,1699465380,22980,147844,102959,PL,PL
196338,1699563720,1699596960,33240,25312,140477,TR,TR
188011,1700274660,1700281560,6900,17875,94477,NL,NL
20187,1699337100,1699340700,3600,145611,44155,GB,GB
78926,1700054040,1700082960,28920,115034,10874,TR,TR
115810,1699336320,1699368720,32400,136843,67822,TR,TR
84294,1699855860,1699884720,28860,106576,113660,TR,TR
4345,1700739780,1700743380,3600,58359,153754,GB,GB
181976,1699092420,1699108140,15720,121438,184134,US,US
190403,1700362920,1700390940,28020,64483,93894,DE,RS
105376,1698829980,1698841560,11580,199640,111340,US,US
4986,1699124040,1699159380,35340,30296,128467,TR,TR
28068,1699991100,1700022180,31080,169656,22675,TR,TR
105264,1699207260,1699231380,24120,173454,106795,DE,BG
54174,1699388460,1699397040,8580,87229,33153,IT,IT
125189,1699076520,1699084560,8040,93808,51764,AD,ES
178912,1700812200,1700817120,4920,135783,125011,GB,GB
102525,1699312080,1699325340,13260,56963,8947,US,US
108460,1700731860,1700755860,24000,64892,54722,DE,FR
70791,1700774760,1700778360,3600,80591,100157,NL,NL
127612,1699500060,1699528380,28320,25867,28502,PL,HR
32025,1699552500,1699558500,6000,118388,135454,GB,GB
52748,1700809320,1700812920,3600,91569,124015,NL,BE
59437,1700601360,1700636280,34920,149733,141966,TR,TR
75570,1699705560,1699709160,3600,188791,129645,NL,NL
171824,1698863400,1698897900,34500,47298,156113,TR,TR
77038,1699388700,1699420560,31860,43573,69103,TR,TR
141253,1700146080,1700175360,29280,87766,194977,TR,TR
48396,1700054820,1700109900,55080,100404,47977,BG,GR
32668,1700408880,1700442900,34020,15527,134959,TR,TR
180280,1699955520,1699961160,5640,54551,197277,GB,GB
6267,1699576140,1699600200,24060,111897,107239,PL,CZ
199666,1699910280,1699920540,10260,117207,139218,IT,IT
184318,1699270020,1699277100,7080,42883,145915,GB,GB
149029,1699694820,1699727760,32940,100116,84463,MX,MX
101490,1700373900,1700408400,34500,190412,137475,TR,TR
161297,1699346400,1699354740,8340,150654,98660,HR,BA
134037,1699358760,1699375920,17160,180907,3347,CA,US
68591,1698835560,1698850140,14580,25929,183589,US,US
82758,1700245560,1700253900,8340,34195,119133,SK,AT
99224,1699006500,1699035480,28980,4250,167253,TR,TR
43332,1699522740,1699538520,15780,142673,47448,US,US
196163,1699358580,1699383960,25380,39378,6086,RO,RO
70676,1699928460,1699962120,33660,40525,126481,MX,MX
150585,1699926840,1699947660,20820,55171,195996,LT,EE
195893,1699032840,1699042980,10140,136086,57260,IT,IT
167395,1700264100,1700276760,12660,40170,4618,IT,IT
129041,1700591220,1700605860,14640,40514,12233,US,MX
79591,1699666500,1699701060,34560,136503,174928,TR,TR
96382,1700205480,1700226120,20640,161351,122232,FR,FR
149062,1700272920,1700287860,14940,128345,46728,US,CA
110218,1700755080,1700784420,29340,138775,46073,TR,TR
94414,1698932100,1698939480,7380,1413,79178,IT,IT
199085,1700757780,1700769540,11760,132903,950,US,US
147010,1700467800,1700490120,22320,60712,162159,PL,PL
47355,1700493600,1700502300,8700,69711,10362,IT,IT
32528,1699289040,1699302780,13740,165977,89829,US,US
92480,1699435260,1699471140,35880,48473,44786,TR,TR
136047,1700455860,1700467500,11640,195020,49555,US,US
14187,1699463280,1699468020,4740,55859,94256,GB,GB
79869,1699935000,1699940400,5400,18994,49974,NL,NL
104799,1700603640,1700654400,50760,73774,83832,BG,AT
155476,1698879960,1698897840,17880,156763,12311,US,US
65,1700359560,1700376000,16440,7141,199020,US,US
114891,1698835260,1698861180,25920,178305,154535,CH,DE
170198,1700701680,1700732280,30600,68535,86606,TR,TR
29077,1698900480,1698908760,8280,96929,149961,SK,AT
98616,1700676540,1700683680,7140,174497,141820,GB,GB
3683,1700098680,1700131080,32400,54780,172330,TR,TR
103147,1700505780,1700539260,33480,174005,74844,TR,TR
108681,1699318500,1699336440,17940,102124,42197,US,US
125555,1698877380,1698906360,28980,132566,70633,TR,TR
24292,1700275680,1700279280,3600,197743,144153,GB,GB
25226,1700850840,1700886720,35880,141265,124534,TR,TR
155506,1699848480,1699852080,3600,75451,143457,NL,NL
186705,1699430160,1699433760,3600,116163,91007,GB,GB
171541,1698997080,1699032360,35280,31215,94356,TR,TR
12070,1700466960,1700491140,24180,74989,191962,DE,DE
12859,1698865740,1698881580,15840,121031,135837,US,US
75835,1700252280,1700255880,3600,5784,111742,NL,NL
36197,1699728060,1699731720,3660,108627,32135,NL,NL
20668,1700061840,1700089860,28020,18911,164674,PL,DE
184065,1700663220,1700699100,35880,68404,189065,TR,TR
19155,1699943280,1699965900,22620,5620,72827,RO,RO
197791,1700286360,1700317980,31620,57516,878,TR,TR
145180,1700274000,1700308860,34860,50434,183790,TR,TR
54795,1699064220,1699080120,15900,27044,115585,RS,RS
22435,1700091300,1700126100,34800,190995,10571,TR,TR
57739,1700767740,1700800620,32880,197733,120373,TR,TR
127310,1700448660,1700473560,24900,153304,24654,DK,DE
191116,1700196780,1700209140,12360,30342,198989,AT,AT
190339,1698899640,1698910200,10560,150422,67912,HR,IT
79809,1699081260,1699111440,30180,27956,78262,TR,TR
136428,1700361300,1700390700,29400,84338,119774,TR,TR
101090,1700660340,1700667660,7320,102029,154090,HR,DE
89194,1699887420,1699891020,3600,82451,16546,GB,GB
158383,1699505340,1699527840,22500,14542,47639,DE,CZ
125206,1699648980,1699658220,9240,115352,29720,IT,IT
188649,1699482300,1699517700,35400,174661,120573,TR,TR
21076,1699640460,1699651620,11160,31847,185461,US,US
87747,1699396440,1699404660,8220,159961,119346,IT,IT
64696,1698845940,1698857340,11400,28107,26496,SK,SK
35400,1700019900,1700028720,8820,49010,119048,IT,IT
21942,1699951800,1699962000,10200,146551,195998,PT,PT
107321,1699068000,1699085100,17100,4048,74847,CZ,CZ
61932,1699634340,1699670280,35940,177215,57889,TR,TR
81715,1699046340,1699075140,28800,32161,105398,TR,TR
26036,1699333620,1699369320,35700,130838,158324,TR,TR
154767,1700798640,1700827860,29220,181477,40782,TR,TR
162829,1700801460,1700810820,9360,48390,254,IT,IT
138892,1699857600,1699881480,23880,123435,128476,DE,DE
744,1699844340,1699855140,10800,32896,20577,US,US
103119,1699791960,1699819380,27420,104018,65512,BR,BR
40128,1699417980,1699427580,9600,115603,74404,ES,FR
68334,1699757640,1699790460,32820,181089,110820,TR,TR
21917,1699789740,1699793340,3600,157500,188682,GB,GB
166909,1699228800,1699260360,31560,64672,32675,TR,TR
109087,1699652940,1699689660,36720,123728,81340,MX,US
112998,1699444380,1699459200,14820,77365,83221,US,US
22083,1699730700,1699764960,34260,101458,44900,TR,TR
185671,1699849200,1699881480,32280,14060,21674,TR,TR
88162,1699755660,1699759260,3600,92179,154890,NL,NL
178396,1699237860,1699269420,31560,90430,121304,TR,TR
160557,1699874940,1699897920,22980,73424,101855,DE,FR
102675,1699011180,1699023300,12120,132594,27826,CA,US
74769,1700530200,1700534940,4740,102296,145611,GB,GB
94581,1699174140,1699186380,12240,159395,134339,IT,IT
12903,1699595820,1699628880,33060,25439,169533,TR,TR
89739,1699582440,1699595340,12900,197745,71494,PT,PT
41473,1699555680,1699591140,35460,119384,62704,TR,TR
19821,1699046280,1699049880,3600,23131,1961,GB,GB
75119,1698918120,1698949140,31020,146164,56980,TR,TR
86765,1700060820,1700083380,22560,82845,148873,BR,BR
78421,1699201620,1699235700,34080,66577,139042,TR,TR
177026,1700407380,1700410980,3600,178372,65952,GB,GB
77724,1700655300,1700666760,11460,116666,180614,PT,ES
128693,1700862900,1700892120,29220,181464,186375,TR,TR
21040,1700546220,1700579220,33000,83368,62733,TR,TR
129003,1698901080,1698904680,3600,142069,195918,GB,GB
65641,1698829980,1698839700,9720,250,47917,IT,IT
182343,1700510400,1700524440,14040,77551,116217,US,US
79279,1700506740,1700517480,10740,80566,41734,HR,HR
101590,1700539680,1700559600,19920,21413,108909,FR,FR
99572,1700509020,1700526780,17760,103495,21725,AT,AT
172092,1699829520,1699864140,34620,28303,174943,TR,TR
43301,1699803720,1699824720,21000,15862,11123,FR,NL
163881,1699579200,1699600740,21540,8515,146553,FR,IT
150592,1699180860,1699198260,17400,82386,119342,US,US
112228,1699274520,1699306920,32400,162870,21884,TR,TR
176882,1699059600,1699087680,28080,49626,81762,PL,PL
49433,1700765760,1700786640,20880,169330,152067,SE,SE
101733,1700623140,1700626740,3600,102751,68608,GB,GB
163372,1700416380,1700433960,17580,92336,74074,US,US
118580,1699926300,1699942020,15720,12235,145361,US,US
158058,1700232780,1700260500,27720,15978,23229,PL,PL
85798,1699434960,1699447200,12240,109917,76649,IT,IT
13909,1699587000,1699593480,6480,169762,109069,GB,GB
9643,1700849040,1700869440,20400,124533,180212,FR,FR
113737,1698996840,1699021440,24600,20221,134109,PL,PL
5601,1700360940,1700374560,13620,18595,39122,AT,HU
80824,1699043160,1699054080,10920,72754,168162,HR,HR
80848,1700189160,1700224920,35760,100064,69548,TR,TR
140678,1698828840,1698863820,34980,161008,65276,TR,TR
153584,1700716800,1700745600,28800,147295,14799,TR,TR
120815,1700572200,1700606280,34080,74875,104596,TR,TR
82889,1698867360,1698901200,33840,24247,199379,TR,TR
149779,1699779000,1699786980,7980,17273,177259,IT,IT
166853,1700360340,1700371440,11100,104250,32441,US,US
59769,1698992460,1698997860,5400,126764,129642,GB,GB
150313,1700541960,1700545560,3600,72457,126942,GB,GB
80734,1699020300,1699048320,28020,131129,88691,RO,RO
122790,1700645160,1700681100,35940,188788,84724,TR,TR
177423,1699994940,1700029500,34560,122875,40407,TR,TR
92342,1700203980,1700215620,11640,81742,28118,IT,IT
157191,1698801240,1698834480,33240,157359,15965,TR,TR
59635,1699561920,1699596120,34200,9114,123399,TR,TR
18433,1700393460,1700400060,6600,83340,28287,NL,NL
149159,1700177700,1700184000,6300,10989,130143,GB,GB
109317,1698803040,1698819240,16200,47436,162097,US,US
19440,1699537320,1699562820,25500,130647,126908,CH,FR
47506,1699335000,1699360980,25980,113163,17888,RO,RO
53089,1699475520,1699482780,7260,115465,73018,IT,FR
4034,1700326980,1700338860,11880,24447,190249,AT,AT
167679,1700770620,1700800440,29820,111578,162428,TR,TR
126260,1700312040,1700344500,32460,152125,181074,TR,TR
23962,1699725840,1699738560,12720,108231,166284,US,US
30158,1699491780,1699524300,32520,61641,48195,TR,TR
107380,1699940880,1699946220,5340,55792,78531,GB,GB
15820,1699874520,1699878120,3600,121138,65083,NL,NL
77211,1699427820,1699463700,35880,79999,152249,TR,TR
105182,1699535400,1699546800,11400,82211,106558,IT,IT
168743,1700338080,1700350260,12180,178870,9474,AT,DE
5412,1700555340,1700587440,32100,74163,91326,TR,TR
80879,1699488900,1699509960,21060,122231,14841,FR,FR
524,1699776900,1699812660,35760,143053,174847,TR,TR
121170,1700279340,1700302920,23580,10129,159474,DE,AT
6194,1699420800,1699434600,13800,9239,168678,HR,HR
38066,1698926940,1698930540,3600,173406,140967,GB,GB
80094,1699762200,1699765800,3600,68949,53753,NL,NL
158581,1700345100,1700378460,33360,173111,13143,TR,TR
12011,1699680060,1699692360,12300,100234,198177,PT,PT
93669,1698828720,1698832320,3600,137333,54929,GB,GB
187836,1699385400,1699399800,14400,143847,41657,US,US
78343,1699489440,1699519740,30300,88901,55370,TR,TR
41034,1700148840,1700155140,6300,137392,130884,NL,NL
184430,1699777140,1699804320,27180,78778,70960,PL,DE
182147,1699537860,1699570140,32280,180132,84776,TR,TR
65986,1700227800,1700259480,31680,156287,130767,TR,TR
134419,1699373100,1699387320,14220,149535,169402,US,US
33575,1699313880,1699332000,18120,181544,60943,BE,FR
168856,1700121780,1700144760,22980,136965,81002,DE,DE
104118,1698943080,1698982500,39420,197259,109334,MX,MX
103084,1700132220,1700146200,13980,18035,182863,US,US
115771,1698843240,1698874380,31140,51015,25637,TR,TR
143206,1699593960,1699597560,3600,96903,197107,GB,GB
129766,1698904380,1698927660,23280,103844,23510,DE,FR
126423,1699336980,1699362900,25920,82232,452,DE,FR
150332,1699558860,1699562460,3600,38184,121392,NL,NL
67694,1699664640,1699693740,29100,135971,76599,TR,TR
153746,1700849820,1700862480,12660,199519,163359,US,US
105735,1698871920,1698875520,3600,4237,64056,GB,GB
43277,1699046400,1699080540,34140,187460,81806,TR,TR
147588,1700369160,1700381040,11880,15989,183853,US,US
18213,1700592660,1700627040,34380,96058,172372,TR,TR
105763,1700018040,1700052300,34260,105748,86902,TR,TR
110030,1700026320,1700060460,34140,139893,11414,MX,MX
115188,1700261520,1700266800,5280,130047,189300,GB,GB
162287,1699510920,1699541100,30180,107971,173358,TR,TR
169445,1700100300,1700119500,19200,62010,159805,FR,RS
6156,1699977540,1699993080,15540,147642,76575,US,US
117994,1699006560,1699010520,3960,40486,129589,GB,GB
184805,1699078860,1699082460,3600,41189,38370,GB,GB
94178,1699332540,1699336140,3600,184499,126460,NL,NL
9146,1699928760,1699944000,15240,81326,153850,US,US
135975,1700138460,1700151720,13260,81853,176441,CZ,DE
43514,1699537860,1699545000,7140,158236,181136,NL,BE
189581,1700022780,1700026380,3600,186012,11446,GB,GB
133899,1699769340,1699808640,39300,140437,116048,MX,MX
20037,1699244280,1699260240,15960,60275,97956,FR,FR
23850,1700673600,1700709000,35400,90166,57794,TR,TR
111530,1699207200,1699241340,34140,69046,41684,TR,TR
131420,1700029080,1700058300,29220,160818,71071,TR,TR
143537,1700746140,1700750820,4680,48094,106677,NL,NL
32806,1699060680,1699064280,3600,50421,160698,NL,NL
24398,1699237800,1699261560,23760,113531,123941,HU,IT
169499,1700124540,1700142120,17580,198168,134297,CA,CA
106373,1699311240,1699345980,34740,185012,130107,TR,TR
64776,1699654800,1699685940,31140,170433,75704,TR,TR
119846,1699272720,1699285860,13140,37856,17946,US,US
167397,1700451120,1700455140,4020,111180,34186,GB,GB
171593,1699968000,1699980540,12540,4591,63435,US,US
185768,1700116800,1700128920,12120,15477,168616,US,US
1226,1699292160,1699305480,13320,139750,161040,US,US
132689,1699267500,1699302120,34620,21660,116747,TR,TR
133617,1699793340,1699808760,15420,189684,190084,US,US
134827,1700120160,1700134260,14100,9112,181916,PT,PT
23013,1699283640,1699294920,11280,159595,153951,CZ,PL
57751,1700607360,1700632440,25080,79057,96711,BR,BR
166921,1700621280,1700656560,35280,145897,59912,TR,TR
65453,1700103180,1700106780,3600,151967,69785,GB,GB
44336,1699515840,1699529040,13200,143834,74983,US,US
108760,1700556480,1700565120,8640,7894,128347,PT,ES
178151,1700723760,1700739660,15900,91440,101473,US,CA
103809,1700188440,1700219280,30840,111101,191765,TR,TR
43188,1699009440,1699013040,3600,64384,129360,NL,DE
65476,1700244300,1700256780,12480,41313,37032,CZ,CZ
180194,1699093800,1699098060,4260,73603,65869,NL,NL
129806,1700858820,1700863860,5040,81819,98020,GB,GB
176696,1699181280,1699204020,22740,79621,171552,BR,BR
30417,1699818720,1699826580,7860,46620,108321,IT,IT
15177,1700062020,1700113320,51300,130540,183692,BG,RS
3161,1699491540,1699520640,29100,179944,82445,TR,TR
198285,1699439880,1699470660,30780,126084,36407,TR,TR
94184,1699842240,1699876620,34380,63691,192997,TR,TR
166205,1699463520,1699497840,34320,57888,178785,TR,TR
35326,1698967740,1698990300,22560,93838,103568,PL,PL
83623,1699039620,1699052340,12720,85240,70347,HR,HR
108200,1699899000,1699912560,13560,90481,176417,PT,PT
194600,1700715720,1700721240,5520,87674,87383,GB,GB
34562,1699182900,1699211640,28740,30834,146004,DE,DE
167467,1699446120,1699481160,35040,1652,169359,TR,TR
116101,1700143740,1700156040,12300,51443,62730,IT,IT
89901,1700621220,1700650740,29520,136145,137211,TR,TR
51864,1700864820,1700896740,31920,63482,22055,TR,TR
119117,1699267920,1699304700,36780,61030,46757,MX,MX
106592,1700842500,1700859840,17340,6841,1490,US,CA
138485,1700268480,1700281860,13380,21382,123215,US,US
16255,1700056320,1700064840,8520,195433,162726,IT,IT
110845,1699169940,1699199940,30000,38750,127859,TR,TR
188568,1700673540,1700684280,10740,86907,175447,SK,CZ
1230,1699869780,1699882620,12840,170958,85490,US,US
70039,1699761360,1699791060,29700,96456,72582,TR,TR
67463,1700826840,1700856660,29820,180288,75768,TR,TR
95783,1699225380,1699259880,34500,15323,41123,TR,TR
27262,1699411680,1699442400,30720,188722,136359,TR,TR
88680,1700398980,1700411520,12540,39124,21948,US,US
77615,1700725200,1700759700,34500,167482,157470,TR,TR
35132,1699037820,1699047780,9960,89633,191820,IT,IT
83384,1700225160,1700259420,34260,86665,23300,TR,TR
53346,1700566560,1700599080,32520,173610,59549,MX,MX
49198,1699178220,1699207200,28980,176782,117713,TR,TR
109040,1700692200,1700711040,18840,26986,170958,FR,FR
90117,1699911420,1699947360,35940,78670,122010,TR,TR
96358,1699893840,1699906320,12480,116522,196551,PT,PT
125218,1700783220,1700838000,54780,144369,15450,BG,TR
182964,1699644180,1699647780,3600,178140,177109,GB,GB
44632,1700601720,1700608260,6540,155423,103070,NL,NL
148220,1700189760,1700205660,15900,151708,29888,US,US
56923,1700785860,1700821080,35220,70355,167399,TR,TR
154059,1699403520,1699431900,28380,114287,16115,CH,FR
49220,1699680960,1699716540,35580,59492,145221,TR,TR
147890,1700648520,1700677500,28980,182671,29759,TR,TR
160646,1699963740,1699988820,25080,93315,186260,DE,FR
15275,1699808640,1699812240,3600,83413,103600,GB,GB
142431,1699354980,1699370040,15060,25925,101550,US,US
190317,1700373540,1700399220,25680,155902,132267,DE,DE
26813,1699711740,1699717260,5520,143835,4056,GB,GB
107816,1698993120,1699002180,9060,11516,144228,EE,FI
78134,1698989280,1699024560,35280,193931,70874,TR,TR
50550,1699094040,1699109580,15540,109845,28673,FR,FR
13867,1698896820,1698929340,32520,94297,148766,TR,TR
173484,1699206120,1699241520,35400,183754,199448,TR,TR
128136,1699169520,1699192800,23280,87986,150962,PL,BE
156807,1699194720,1699223460,28740,123202,46141,DE,IT
198321,1699983360,1700016540,33180,33816,105238,TR,TR
125224,1699891740,1699915080,23340,11988,52191,BR,BR
99005,1699880820,1699913040,32220,80252,163038,TR,TR
182789,1699227120,1699257360,30240,77069,127520,TR,TR
45178,1699469100,1699493040,23940,109538,197044,DE,DE
125677,1700278860,1700293440,14580,152726,166409,US,US
22792,1698929160,1698957900,28740,36680,189004,DE,DE
106796,1700306580,1700339160,32580,81268,48551,TR,TR
152884,1700569560,1700601480,31920,46498,182982,TR,TR
64444,1700140260,1700156580,16320,142726,154744,RS,IT
110025,1700481420,1700494260,12840,6855,80255,US,US
91707,1699871460,1699875360,3900,103451,128308,GB,GB
108362,1698982140,1699017720,35580,34597,97644,TR,TR
140345,1700707080,1700738100,31020,102367,10301,TR,TR
196555,1698947340,1698977760,30420,113509,49244,TR,TR
24967,1699401000,1699414500,13500,29743,116906,CZ,CZ
9906,1700431140,1700452920,21780,73543,17979,DE,DE
114240,1699869960,1699898880,28920,66422,9301,TR,TR
142011,1699271160,1699274760,3600,153693,78417,GB,GB
38405,1699803780,1699810440,6660,196331,133511,GB,GB
123302,1698891600,1698922260,30660,105392,73908,TR,TR
80090,1700602920,1700618040,15120,10545,188315,FR,ES
62981,1699301400,1699306620,5220,65815,161417,NL,NL
108398,1700754300,1700782500,28200,135209,19501,PL,PL
49237,1698927120,1698962640,35520,189398,95455,TR,TR
84023,1700594100,1700629860,35760,172458,11963,TR,TR
91469,1700358600,1700387640,29040,95587,131442,TR,TR
138863,1700852040,1700863200,11160,182100,78686,IT,HR
125334,1700086680,1700108940,22260,102818,102135,DE,HR
63793,1699250700,1699284720,34020,97347,74753,TR,TR
46657,1700193240,1700199180,5940,140602,155266,GB,GB
149774,1699368000,1699375080,7080,47994,73066,NL,NL
182737,1700851560,1700887020,35460,150410,128883,TR,TR
53628,1699101720,1699135740,34020,42908,47945,TR,TR
63131,1699029780,1699042320,12540,30203,6652,IT,IT
67101,1700347440,1700351040,3600,27613,34175,NL,NL
66784,1700705400,1700730120,24720,80581,195170,DE,GB
178911,1699604640,1699613640,9000,137212,175006,IT,IT
158519,1699375620,1699406760,31140,137132,93980,TR,TR
177278,1699442880,1699476120,33240,55572,172899,TR,TR
89049,1700390160,1700419500,29340,146842,102342,TR,TR
180080,1699945200,1699957980,12780,181470,121979,US,US
153683,1700157060,1700170980,13920,70283,166392,IT,IT
132990,1699540320,1699548300,7980,6914,5361,PT,ES
85136,1698936960,1698952920,15960,18797,174135,FR,FR
195374,1699700580,1699732440,31860,160342,108773,TR,TR
131599,1700193420,1700227920,34500,4655,71740,MX,US
45779,1700849520,1700879160,29640,145188,65049,TR,TR
195220,1699226580,1699232580,6000,187821,181202,NL,NL
191536,1699544520,1699574820,30300,87265,151158,TR,TR
5914,1700650980,1700678160,27180,31845,140679,BR,BR
198197,1700344860,1700349300,4440,175929,50412,NL,NL
120787,1699364580,1699394700,30120,69986,129323,TR,TR
105926,1699647240,1699659780,12540,58366,146653,US,US
20783,1699899000,1699907580,8580,115589,162792,IT,DE
162483,1699574820,1699591020,16200,33286,40470,CZ,CZ
78132,1700415060,1700426580,11520,103733,191089,RS,RS
166164,1699922700,1699957920,35220,193531,17036,TR,TR
189576,1700750520,1700782980,32460,199148,94294,MX,MX
13083,1700268960,1700293080,24120,153205,43308,PL,PL
191130,1699383780,1699390740,6960,181097,94538,GB,GB
123886,1699318320,1699321920,3600,50746,52855,GB,GB
125324,1699796760,1699810260,13500,73666,186291,US,MX
31612,1699261800,1699295700,33900,4742,52544,TR,TR
154074,1699069080,1699078680,9600,118384,193695,IT,IT
141198,1700837880,1700865480,27600,86555,119751,HU,PL
189955,1700582580,1700614920,32340,59695,56632,TR,TR
87136,1698872580,1698876180,3600,73058,111515,GB,GB
128853,1700454540,1700486460,31920,22382,41379,TR,TR
179403,1699458120,1699484220,26100,142330,53281,RO,RO
7960,1699424040,1699427640,3600,50682,194531,GB,GB
3696,1699518120,1699533660,15540,152323,79791,RS,SI
98662,1699685760,1699716360,30600,189888,31964,TR,TR
142163,1700814120,1700828100,13980,149863,149605,US,US
92649,1698941280,1698973980,32700,36988,20955,TR,TR
108502,1699555740,1699569660,13920,173591,139494,US,US
26724,1700627040,1700635320,8280,160015,53559,PT,PT
54011,1699162560,1699187640,25080,138192,38760,PL,DE
119419,1699878720,1699888920,10200,28518,104337,IT,IT
145368,1699659900,1699684440,24540,22676,154228,DE,DE
4983,1698893340,1698900540,7200,61141,143126,PT,PT
61068,1700720700,1700743140,22440,46948,12844,BR,BR
145931,1700791380,1700801880,10500,95173,164261,PT,PT
180241,1700569860,1700595720,25860,138239,55948,DE,MK
149479,1700831280,1700845440,14160,127397,160025,US,US
47204,1699773720,1699778460,4740,110204,111050,NL,NL
128146,1700652660,1700656260,3600,192907,197201,GB,GB
123574,1700131500,1700145780,14280,81024,109385,ES,AD
178870,1699749300,1699753980,4680,183422,184268,GB,GB
144319,1700043660,1700079300,35640,99757,9253,TR,TR
77481,1699811460,1699825440,13980,42749,198778,IT,IT
132506,1699225500,1699236540,11040,14702,62065,HR,DE
149119,1699723500,1699735200,11700,3899,9650,IT,IT
157531,1699967160,1699970760,3600,105154,53226,NL,NL
163210,1699511100,1699523040,11940,90682,32066,US,US
143899,1700660280,1700720700,60420,42892,26797,UA,CZ
74381,1700217240,1700251980,34740,125889,177611,TR,TR
127008,1700782440,1700814180,31740,28581,164847,TR,TR
39381,1699026360,1699055880,29520,105509,134288,TR,TR
157011,1699881420,1699892400,10980,72331,172994,ES,ES
82917,1699566060,1699594620,28560,122091,142307,DE,DE
198564,1699758120,1699772760,14640,54403,100228,US,US
120697,1698860100,1698866100,6000,34136,70459,NL,NL
60520,1699475880,1699511700,35820,1190,94091,MX,MX
83604,1700296080,1700327100,31020,6625,157715,TR,TR
115471,1699108620,1699114380,5760,27217,52520,GB,GB
195202,1700328960,1700362740,33780,139223,176734,MX,MX
28041,1700282460,1700300280,17820,95594,55747,US,US
31840,1700391840,1700408340,16500,94679,198911,AT,BA
83531,1699147560,1699153200,5640,1415,185306,NL,NL
177258,1699021380,1699043280,21900,98032,15680,DE,DE
76010,1699621200,1699654800,33600,95668,105910,TR,TR
44225,1698921360,1698945060,23700,69971,168594,PL,NL
65009,1699091040,1699123260,32220,155119,18555,TR,TR
133310,1700374260,1700377860,3600,74897,102434,NL,NL
196898,1699084020,1699118460,34440,17478,44349,TR,TR
106127,1699422480,1699458360,35880,17923,125364,TR,TR
136456,1699438740,1699450500,11760,155809,18919,US,US
172325,1700660340,1700692140,31800,191739,17948,TR,TR
92411,1699007160,1699010760,3600,148595,24086,GB,GB
22566,1700814420,1700840160,25740,155634,28363,DE,DE
75143,1700293200,1700296800,3600,31107,193312,GB,GB
160914,1700315640,1700339520,23880,160007,176044,BR,BR
142608,1700796300,1700813220,16920,12623,166933,US,US
188031,1698954600,1698958200,3600,41406,63733,GB,GB
111577,1699279680,1699291260,11580,40768,115822,SK,SK
188191,1698967020,1699001340,34320,116436,93415,TR,TR
40475,1699120020,1699131000,10980,46396,99984,US,MX
66740,1700783160,1700795040,11880,168978,38708,IT,IT
146560,1699547580,1699555620,8040,146047,26461,HR,HR
70180,1700040600,1700044200,3600,711,142616,GB,GB
126792,1699937760,1699954380,16620,144931,73343,US,US
183148,1700427480,1700458860,31380,100156,116201,TR,TR
101529,1699807920,1699821900,13980,41619,31755,PT,PT
161480,1698821700,1698825300,3600,149893,84501,GB,GB
61363,1699026120,1699042500,16380,179276,159049,RS,ME
98647,1699203360,1699214880,11520,128141,117123,US,US
93121,1700252880,1700281380,28500,82815,54550,PL,BE
50218,1699594740,1699605540,10800,135267,78022,US,US
175523,1699272300,1699294560,22260,75868,155183,PL,HU
138997,1700763120,1700785740,22620,62994,142026,BR,BR
97474,1700351520,1700383980,32460,118207,167722,TR,TR
9749,1699695780,1699728720,32940,151784,58885,MX,MX
17825,1699300380,1699303980,3600,77231,128021,GB,GB
16559,1698915060,1698948720,33660,149897,11468,TR,TR
196389,1700073840,1700102400,28560,15550,53796,BR,BR
77128,1698983160,1698987000,3840,45516,41818,GB,GB
147360,1699446540,1699454100,7560,138673,153226,IT,IT
59136,1699177200,1699181160,3960,177667,7100,AD,ES
170112,1699827960,1699857900,29940,166171,19151,TR,TR
95703,1700180520,1700190000,9480,137100,148927,HR,HR
20730,1700757360,1700762160,4800,82992,124851,GB,GB
185873,1699582380,1699618140,35760,131737,8985,TR,TR
54488,1699892160,1699922940,30780,128214,51390,TR,TR
198441,1699581720,1699612800,31080,48795,135818,TR,TR
117279,1700479380,1700495820,16440,197926,14260,US,US
155507,1699293120,1699310220,17100,103915,56061,FR,FR
108963,1700163660,1700167260,3600,87585,44569,GB,GB
91333,1700510640,1700521140,10500,70255,102343,HR,HR
192304,1699971240,1699984980,13740,134829,87426,IT,IT
43553,1699814940,1699845600,30660,143819,69328,TR,TR
60348,1700152800,1700164500,11700,88632,193648,ES,PT
146988,1698839520,1698844020,4500,158215,123819,NL,NL
143612,1700422740,1700428200,5460,140228,114023,GB,GB
21997,1699988640,1700003340,14700,57644,27982,FR,IT
126568,1699653420,1699671300,17880,117430,174056,FR,DE
99046,1699725180,1699740780,15600,52194,44971,AT,AT
174279,1698842280,1698856680,14400,186691,8021,US,US
83351,1699085640,1699118520,32880,175605,153464,TR,TR
90882,1699525620,1699554120,28500,190063,51883,RO,MD
86916,1699335120,1699355760,20640,121844,30452,FR,IT
151515,1699632720,1699636320,3600,119361,38755,GB,GB
190233,1700027520,1700060460,32940,138300,87703,TR,TR
6711,1699118100,1699123620,5520,26150,84855,GB,GB
172718,1700063940,1700067540,3600,180420,143060,NL,NL
57988,1700703240,1700708340,5100,4329,35720,GB,GB
165583,1699443720,1699481160,37440,6981,46902,MX,MX
177116,1700851620,1700865900,14280,198305,130634,IT,IT
64185,1700188980,1700203860,14880,150003,110630,BE,NL
35872,1699907220,1699921320,14100,140792,21542,US,US
767,1700041920,1700074620,32700,92684,63500,TR,TR
32854,1700048280,1700073420,25140,28576,141116,RO,RO
74835,1700091720,1700109660,17940,45148,186001,US,US
86696,1699081380,1699113540,32160,96887,85982,TR,TR
79426,1700380740,1700414100,33360,181712,54677,TR,TR
195649,1699538040,1699549500,11460,180756,84571,US,US
124359,1700558940,1700572860,13920,120253,123297,IT,IT
104079,1699267860,1699301040,33180,10759,194120,TR,TR
89692,1699372860,1699393260,20400,196554,121563,FR,FR
18681,1700841960,1700845560,3600,136232,103858,GB,GB
124645,1699808760,1699840800,32040,143153,39409,TR,TR
128237,1699114260,1699148220,33960,115156,141370,TR,TR
66170,1700485980,1700499600,13620,173685,12813,US,US
11250,1698938400,1698973200,34800,195902,68538,TR,TR
87518,1699677540,1699703400,25860,116046,66877,RO,RO
19572,1699816080,1699847280,31200,41987,26441,TR,TR
27657,1699668660,1699698240,29580,59280,27886,TR,TR
33042,1700098440,1700123460,25020,147742,191140,PL,PL
31089,1699092420,1699109460,17040,44258,199808,US,US
62075,1698899460,1698928680,29220,198952,155530,TR,TR
143277,1700188500,1700223240,34740,152195,138286,TR,TR
21217,1700360160,1700383140,22980,166079,101929,DE,DE
97105,1698972780,1698985680,12900,141049,21215,IT,IT
88600,1699212360,1699223520,11160,166795,183149,RS,RS
11428,1699093140,1699108260,15120,17514,141229,FR,FR
180601,1699043880,1699076640,32760,154881,147683,TR,TR
152809,1699546320,1699581840,35520,35656,176774,TR,TR
168316,1699103700,1699137420,33720,135227,100313,TR,TR
10639,1700396100,1700421060,24960,38937,52646,DK,DK
143860,1700102880,1700119140,16260,17565,7528,US,US
74785,1699829460,1699841940,12480,40438,37445,IT,IT
166630,1699792920,1699827540,34620,26094,30923,TR,TR
71118,1699355040,1699370160,15120,190290,89661,CZ,CZ
195125,1698919320,1698951780,32460,47301,58178,TR,TR
89559,1699738140,1699773180,35040,177462,29761,TR,TR
94535,1699601280,1699617600,16320,165067,24549,FR,IT
54267,1699652040,1699655640,3600,141481,80779,GB,GB
97903,1699940820,1699948380,7560,143007,137047,ES,IT
49785,1699895760,1699929780,34020,56412,21982,TR,TR
199726,1699382820,1699406160,23340,7171,15593,DE,IT
191887,1699406580,1699414320,7740,156657,3893,HR,HR
131727,1699921200,1699936920,15720,96037,197162,FR,FR
18358,1700265900,1700269500,3600,24474,143468,NL,NL
85343,1699055820,1699081740,25920,187320,24724,DE,CZ
151021,1699046940,1699082460,35520,96613,158920,TR,TR
25361,1699991280,1700023080,31800,158682,88229,TR,TR
103961,1699873560,1699902480,28920,165679,39551,TR,TR
16989,1700607180,1700613360,6180,156327,58068,GB,GB
76356,1700082720,1700086860,4140,125887,188986,NL,NL
17414,1700362920,1700375820,12900,169438,16812,IT,IT
103913,1698805680,1698824520,18840,162082,168824,FR,BE
109751,1700403120,1700406900,3780,155111,18742,GB,FR
183624,1699773180,1699776780,3600,121579,181456,GB,GB
88604,1700352840,1700366100,13260,156711,179781,US,US
8589,1700141220,1700174220,33000,108779,157491,TR,TR
80569,1700575680,1700609400,33720,51902,153913,TR,TR
37855,1700205300,1700221920,16620,127621,33339,AT,PL
128458,1700381040,1700414880,33840,149144,167404,TR,TR
138563,1699021560,1699025700,4140,54056,126430,NL,NL
199021,1699570200,1699601100,30900,10477,138762,TR,TR
77653,1698971760,1699005120,33360,49914,59818,TR,TR
184494,1700489460,1700502780,13320,158612,115763,RS,RS
6401,1698939300,1698943380,4080,183620,162126,GB,GB
7151,1699486800,1699497780,10980,9056,182884,US,US
151743,1700018640,1700053140,34500,125561,149286,TR,TR
34399,1700250660,1700285400,34740,198242,25366,TR,TR
90589,1699170180,1699179600,9420,64144,183494,IT,IT
42779,1700459400,1700472240,12840,83356,176309,US,US
156341,1698910440,1698940560,30120,18818,141881,TR,TR
39258,1700009520,1700013840,4320,135254,189153,GB,GB
190311,1700219760,1700223360,3600,106311,168947,GB,GB
131078,1699600500,1699633500,33000,69290,194154,TR,TR
43311,1700105160,1700135160,30000,94092,160711,TR,TR
107061,1700523060,1700555100,32040,134208,198392,TR,TR
107199,1700145480,1700157600,12120,118200,69362,PT,PT
33561,1700266740,1700297460,30720,64277,80149,TR,TR
22866,1699066740,1699072560,5820,96742,186261,EE,EE
170774,1700697780,1700707800,10020,6631,57230,IT,IT
78148,1700202540,1700218440,15900,59294,93786,FR,FR
8424,1699318080,1699351020,32940,126500,158220,TR,TR
85508,1700450460,1700464440,13980,169615,193781,IT,IT
197788,1699009260,1699012860,3600,13716,59858,GB,GB
3281,1700030460,1700065680,35220,163028,101011,TR,TR
85294,1700860080,1700892900,32820,45617,198251,TR,TR
83683,1699702440,1699706040,3600,33039,104829,GB,GB
175174,1700138520,1700170200,31680,2487,8451,TR,TR
2378,1700686320,1700718540,32220,185621,91237,TR,TR
55829,1699169280,1699175400,6120,72854,104888,NL,NL
191454,1699839060,1699848180,9120,72775,97967,IT,IT
179836,1700678940,1700710380,31440,40183,38846,TR,TR
191260,1699161300,1699175400,14100,80085,86068,IT,IT
87744,1699241520,1699250700,9180,191474,46633,IT,IT
17689,1699296600,1699330800,34200,199504,175323,TR,TR
89095,1700434800,1700451360,16560,129559,35768,US,US
186078,1700587140,1700619480,32340,94906,109511,TR,TR
87393,1700790420,1700822040,31620,59012,50235,TR,TR
88051,1700676180,1700711940,35760,61651,73648,TR,TR
44999,1699554780,1699587300,32520,147205,122540,MX,MX
145870,1700135100,1700166900,31800,160653,69736,TR,TR
144280,1699132860,1699150440,17580,134120,9209,US,US
171623,1699502340,1699531380,29040,92931,192482,TR,TR
99666,1699644120,1699651200,7080,119690,105365,GB,GB
199197,1700113560,1700145300,31740,118268,127217,TR,TR
1992,1699238880,1699242480,3600,143339,135287,GB,GB
31073,1699239780,1699243380,3600,184723,166692,GB,GB
95512,1699490880,1699525080,34200,29503,133724,TR,TR
109444,1700629380,1700643300,13920,69904,159324,RS,MK
2310,1699993320,1700004480,11160,133934,172558,IT,IT
21171,1699719720,1699751100,31380,126758,17730,TR,TR
132836,1700447040,1700450640,3600,185059,190873,NL,NL
70091,1700422140,1700428740,6600,124407,184346,GB,GB
68586,1699490160,1699517340,27180,114767,184873,DE,UA
110393,1700847060,1700879220,32160,165771,46729,TR,TR
198327,1700612880,1700646540,33660,95656,17498,TR,TR
129419,1699420380,1699453260,32880,193863,103652,TR,TR
128336,1700334360,1700337960,3600,80851,45428,GB,GB
95402,1698909540,1698923040,13500,43999,42276,US,US
171083,1700857320,1700869500,12180,7849,184644,IT,IT
25850,1700475720,1700480220,4500,128827,170157,NL,NL
156428,1700401260,1700408340,7080,58826,97262,EE,EE
56365,1700469180,1700482920,13740,143056,13135,HR,HR
190319,1699116780,1699145220,28440,109318,83965,BR,BR
1843,1699841280,1699851540,10260,50518,33910,ES,AD
25295,1699752960,1699774980,22020,60885,114828,DE,SE
59187,1699855080,1699860000,4920,53987,112101,GB,GB
76525,1699578120,1699609020,30900,189724,54479,BA,HR
56371,1698989580,1699022040,32460,117327,120070,TR,TR
35680,1699083840,1699097040,13200,142508,43161,IT,IT
2304,1699651260,1699689480,38220,10345,38825,MX,MX
23708,1699945980,1699959720,13740,170279,19960,US,US
189571,1699165920,1699198740,32820,32191,44027,TR,TR
52099,1699341120,1699368600,27480,126798,90937,PL,PL
174807,1700395260,1700415540,20280,10406,168588,FR,FR
95051,1699390380,1699413360,22980,130415,151803,SI,HR
48093,1699294980,1699299060,4080,169269,176341,GB,GB
162864,1699373040,1699396860,23820,6993,180374,CH,IT
78142,1699943280,1699956720,13440,22908,177865,US,US
22838,1700274180,1700289660,15480,48422,114018,RS,SI
93890,1700860380,1700894040,33660,134821,52965,TR,TR
41253,1700523240,1700557140,33900,55689,41095,TR,TR
17034,1700820000,1700823600,3600,104789,187397,GB,GB
156759,1699155780,1699173300,17520,107070,54323,AT,AT
40288,1699197840,1699206120,8280,128242,64523,PT,PT
104547,1698866400,1698901440,35040,84891,180178,TR,TR
50451,1700186220,1700199420,13200,62722,30821,CA,CA
13588,1699581540,1699596000,14460,61577,33143,US,US
184084,1699565880,1699600080,34200,139154,5188,TR,TR
55170,1699983840,1700018940,35100,177391,168944,TR,TR
14452,1699149300,1699178880,29580,7178,172044,TR,TR
186300,1700233080,1700263320,30240,109643,97268,TR,TR
148299,1700260860,1700290680,29820,138571,136215,TR,TR
201,1699596420,1699632360,35940,194478,124649,TR,TR
11997,1699666680,1699682580,15900,127689,154858,US,US
109436,1700345220,1700376660,31440,129753,37258,TR,TR
103319,1700103540,1700133060,29520,89110,88685,TR,TR
147323,1700473200,1700486280,13080,124083,122898,IT,IT
54834,1700042820,1700046420,3600,197413,195629,GB,GB
189875,1699643520,1699647120,3600,51657,42847,NL,NL
111178,1699173300,1699207080,33780,63499,185153,TR,TR
47224,1699706340,1699713900,7560,96223,9940,HR,HR
5397,1700765100,1700784960,19860,132445,37452,FR,FR
108015,1699611900,1699622460,10560,28058,124417,HR,HR
123463,1698950820,1698966300,15480,115921,138650,US,US
30780,1699203720,1699217400,13680,112142,17751,IT,IT
67043,1700060880,1700072940,12060,134845,87260,IT,IT
9632,1699333680,1699356300,22620,171141,182670,CH,DE
13994,1698862140,1698895440,33300,5539,123124,TR,TR
67285,1700775120,1700801760,26640,186416,178984,RO,RO
39684,1700363760,1700397180,33420,31495,95592,TR,TR
158328,1699415220,1699452540,37320,27570,143097,LV,PL
148336,1700511180,1700517900,6720,129293,72474,NL,NL
169456,1698803520,1698832680,29160,113488,112683,TR,TR
189128,1699231860,1699269720,37860,121069,134090,MX,MX
84213,1698802380,1698810600,8220,13702,8315,CL,CL
45952,1699971180,1700027700,56520,56315,81237,UA,DE
35267,1700767260,1700802900,35640,127988,181123,TR,TR
21152,1699370940,1699402560,31620,83252,169770,TR,TR
131838,1700285400,1700297400,12000,4949,171406,IT,IT
115026,1700606340,1700623500,17160,174526,193861,IN,IN
110499,1698915600,1698933300,17700,5846,28659,CZ,HR
189193,1700051820,1700073900,22080,188995,8213,DE,NL
52738,1699488360,1699495200,6840,76320,167406,NL,NL
104240,1700336100,1700340540,4440,189875,191157,GB,FR
37021,1699289160,1699316160,27000,171297,154941,BR,BR
104620,1698927840,1698940020,12180,40261,122156,AT,AT
146499,1698886020,1698892380,6360,29720,84474,NL,NL
23156,1700174820,1700207460,32640,161960,73548,TR,TR
67005,1700392860,1700422800,29940,90412,129562,TR,TR
138934,1698990780,1699007280,16500,136034,167769,US,US
153890,1699099440,1699134120,34680,173361,192719,TR,TR
137297,1700300340,1700313000,12660,37159,185116,ES,ES
161866,1700161020,1700191440,30420,11916,193072,BA,HR
25974,1700767200,1700781960,14760,58837,111194,US,US
53483,1699919340,1699926480,7140,136332,32985,GB,GB
41398,1699819500,1699823400,3900,182181,143303,FI,EE
73343,1699942200,1699993200,51000,169694,179611,BG,DE
8316,1700858640,1700862960,4320,80360,173938,GB,GB
50588,1699235160,1699245600,10440,6011,125804,IT,IT
189814,1700154600,1700184480,29880,97408,184954,TR,TR
58283,1699767360,1699774860,7500,67161,169959,IT,FR
170343,1700692200,1700695800,3600,23240,188186,GB,GB
139392,1700416320,1700431980,15660,185036,168447,US,US
138792,1700059620,1700077080,17460,69240,147060,US,US
61240,1700767500,1700822040,54540,167753,89518,UA,CZ
29247,1700000280,1700029500,29220,82410,5099,TR,TR
121461,1700616540,1700646600,30060,63243,195533,TR,TR
111217,1699449480,1699453080,3600,111526,81969,GB,GB
105024,1700314140,1700317740,3600,76081,16368,GB,GB
27372,1698825240,1698839160,13920,157708,143117,IT,LU
1126,1700261400,1700292600,31200,18662,42087,TR,TR
141815,1699801920,1699819440,17520,171672,93865,CA,CA
137921,1699434420,1699455540,21120,126430,5891,FR,FR
60183,1700146500,1700158320,11820,62405,106021,IT,IT
4293,1700562180,1700618280,56100,58443,29862,BG,BG
154518,1699305540,1699328580,23040,91821,1865,DE,IT
119980,1700286720,1700322480,35760,100279,189136,TR,TR
23101,1699194720,1699207020,12300,143640,94339,CZ,CZ
118803,1699473780,1699491720,17940,119915,174748,US,US
52110,1699021500,1699047720,26220,169698,50728,PL,PL
118626,1700315640,1700345520,29880,71665,66497,TR,TR
49140,1700523180,1700528700,5520,112611,129962,GB,GB
187158,1700334120,1700363700,29580,192080,150939,TR,TR
141965,1698984300,1698989100,4800,64663,70458,GB,GB
138800,1699097940,1699128180,30240,30875,107271,TR,TR
176184,1699759020,1699794660,35640,114459,126821,TR,TR
72218,1699570620,1699580040,9420,88070,49506,IT,IT
60872,1700242620,1700276640,34020,61824,33579,TR,TR
47747,1699414140,1699436520,22380,163339,132209,DE,DE
33441,1700731080,1700760240,29160,2736,63938,TR,TR
17089,1700207760,1700211360,3600,48158,169223,GB,GB
162049,1700424600,1700452980,28380,79138,164494,PL,PL
57424,1699566300,1699596360,30060,25955,30511,TR,TR
126168,1700370480,1700399580,29100,17730,183795,TR,TR
118036,1698875820,1698911640,35820,79253,174169,TR,TR
154409,1698963660,1698975960,12300,175377,8574,US,US
149458,1700245680,1700274480,28800,163128,162865,TR,TR
64871,1700488260,1700515140,26880,136705,144512,PL,PL
196214,1699400820,1699404720,3900,16590,39498,NL,NL
167394,1699594020,1699597620,3600,57484,68810,GB,GB
93062,1699161360,1699192560,31200,45330,106850,TR,TR
75606,1700558340,1700588640,30300,190357,29719,TR,TR
193176,1700818440,1700850900,32460,7823,93114,TR,TR
24031,1699826940,1699839600,12660,32519,70991,US,US
26979,1700492400,1700525400,33000,39190,88805,TR,TR
162439,1700467740,1700489580,21840,61817,99752,DE,SE
178056,1700381220,1700387400,6180,144694,198073,NL,NL
20769,1699306200,1699316220,10020,74295,42439,HR,HR
106863,1699799160,1699810860,11700,157233,112251,US,US
191660,1700670840,1700674440,3600,1548,6366,GB,GB
115955,1699527840,1699541100,13260,168589,65625,HR,HR
10552,1699397340,1699409760,12420,70354,194030,US,US
71988,1700735460,1700739060,3600,93191,38827,GB,GB
34781,1699228080,1699259220,31140,99558,104982,TR,TR
192476,1700770560,1700806200,35640,53411,135985,TR,TR
54052,1699941120,1699944720,3600,93572,124251,GB,GB
17537,1700167560,1700194680,27120,24163,75405,CH,DE
109628,1700427540,1700438700,11160,141062,132451,HR,HR
28498,1700842020,1700845620,3600,12821,135275,GB,GB
132209,1700212500,1700225100,12600,80180,73978,IT,IT
17052,1699426980,1699430580,3600,120784,172436,GB,GB
25555,1698983940,1699016100,32160,101906,121198,TR,TR
70633,1698960900,1698989340,28440,154709,60500,PL,PL
194090,1700325840,1700358420,32580,20675,34569,TR,TR
166067,1699390260,1699402560,12300,149478,26750,IT,IT
166837,1698984660,1699009860,25200,56139,44478,BR,BR
11113,1699471860,1699481760,9900,191111,121924,IT,IT
91656,1699747380,1699780500,33120,194082,134001,TR,TR
124371,1699594740,1699603080,8340,171972,48947,ES,ES
115110,1700629860,1700633460,3600,98183,148469,GB,GB
153863,1700327280,1700357340,30060,1740,177512,TR,TR
112638,1700612400,1700624100,11700,138821,114162,IT,IT
194310,1699683420,1699691580,8160,16968,106694,IT,IT
157966,1700484840,1700502300,17460,88502,103377,US,US
92458,1698845160,1698876720,31560,76851,108535,TR,TR
110461,1699541400,1699548780,7380,179260,148520,IT,IT
60440,1700435400,1700459220,23820,49214,34614,PL,PL
97330,1700581620,1700610720,29100,202,96139,TR,TR
188331,1699488540,1699506000,17460,117426,154970,US,US
135050,1700775000,1700807880,32880,165793,37374,TR,TR
53467,1700835540,1700863140,27600,14846,88422,DE,DE
146090,1699421100,1699429560,8460,157297,170025,IT,IT
162124,1700411760,1700438280,26520,140132,58317,BA,HR
110957,1699675740,1699696080,20340,163134,104694,FR,ES
106070,1700469780,1700482500,12720,46223,85633,PT,PT
36052,1699197780,1699230480,32700,59015,40300,TR,TR
180792,1699719060,1699731120,12060,67615,60598,US,US
51971,1699571400,1699576860,5460,98222,56482,GB,GB
48262,1700380980,1700419740,38760,183611,180650,MX,MX
148383,1700483520,1700518680,35160,43759,198798,TR,TR
101963,1700683800,1700697960,14160,133356,113352,US,US
76690,1700819640,1700850420,30780,67732,37983,TR,TR
38996,1700020980,1700036580,15600,148198,83759,BE,NL
93028,1699387320,1699390920,3600,132649,166562,GB,GB
140521,1700695320,1700701440,6120,84538,50947,NL,NL
42276,1700509080,1700526600,17520,37449,30182,US,US
88874,1699757160,1699787760,30600,21686,69126,TR,TR
100772,1700536740,1700540340,3600,94531,73289,GB,GB
126778,1700863020,1700868660,5640,149180,159729,GB,GB
140358,1699866360,1699900860,34500,28709,53098,TR,TR
119332,1700816940,1700839620,22680,62190,41268,CH,IT
197264,1700669220,1700701200,31980,106573,77869,TR,TR
124917,1699890420,1699902720,12300,89215,68585,HR,HR
17454,1699188480,1699220760,32280,50296,161950,TR,TR
34049,1700253540,1700257740,4200,191140,120224,GB,GB
69708,1700833200,1700852040,18840,190348,92394,FR,FR
110477,1699955820,1699986780,30960,57726,60145,TR,TR
108112,1700102880,1700118600,15720,10696,40151,FR,FR
110313,1700489280,1700520960,31680,87230,66927,TR,TR
114034,1698881700,1698894660,12960,181407,88216,AT,AT
162475,1700373840,1700400660,26820,83470,75612,DE,DE
144268,1700092140,1700126100,33960,113300,103957,TR,TR
91580,1700605080,1700622900,17820,53835,49520,US,US
28610,1700168700,1700188740,20040,111659,34800,FR,FR
108473,1700517840,1700535540,17700,131704,88342,AT,AT
146901,1700833440,1700837040,3600,136733,27159,NL,IT
144816,1699127160,1699159260,32100,24281,199769,TR,TR
92576,1699893360,1699927860,34500,189177,139022,TR,TR
95195,1699424940,1699454760,29820,87215,29961,TR,TR
144489,1699994340,1700002620,8280,113393,47824,SK,SK
65715,1700810700,1700814300,3600,32374,73653,GB,GB
82896,1700731800,1700754540,22740,153150,105340,BR,BR
67889,1700597880,1700616480,18600,72310,29951,FR,IT
174757,1700040720,1700049780,9060,170141,172157,HR,BA
20654,1699334520,1699364940,30420,118695,3064,TR,TR
67022,1700719020,1700730660,11640,4518,137213,ES,FR
190749,1699212780,1699242180,29400,122402,133011,TR,TR
48314,1699084320,1699089480,5160,159183,105995,GB,GB
126756,1699411860,1699415460,3600,15721,16915,NL,NL
78396,1699683120,1699693380,10260,63909,34413,IT,IT
154916,1700077320,1700085660,8340,199992,81993,IT,IT
144450,1700830140,1700841360,11220,29352,49021,IT,IT
133415,1699443360,1699449780,6420,84942,99504,GB,GB
122686,1698830460,1698843780,13320,49969,19889,HR,HR
157800,1700630820,1700659740,28920,83918,150782,TR,TR
155790,1700749920,1700780940,31020,82445,18849,TR,TR
117746,1699460340,1699463940,3600,69203,90968,GB,GB
133864,1700259480,1700287080,27600,181534,155887,DE,DE
165623,1700824200,1700828640,4440,28478,3920,AD,ES
63303,1700723760,1700731080,7320,35832,88795,ES,ES
113603,1700576640,1700589060,12420,195841,5191,US,US
117431,1698865260,1698875640,10380,141967,125677,HR,HR
139035,1698967920,1698987180,19260,141466,80989,SE,NO
49556,1698829740,1698847500,17760,75223,125848,SE,DK
26742,1698882360,1698901260,18900,29196,159091,DK,DE
97997,1699075800,1699087380,11580,93243,162460,HR,HR
18814,1699009680,1699029240,19560,113386,151816,FR,FR
111127,1699911960,1699946040,34080,109433,94081,TR,TR
114222,1699000380,1699022040,21660,16972,134067,HU,IT
189512,1699166280,1699199400,33120,43023,28934,TR,TR
18018,1700233680,1700260920,27240,58641,163343,BR,BR
167736,1699112820,1699127880,15060,15841,22716,SE,SE
160386,1699346340,1699356540,10200,154303,31538,IT,IT
65430,1699668600,1699697880,29280,72411,118722,TR,TR
182424,1699495500,1699507560,12060,71075,27260,US,US
156787,1698848700,1698883320,34620,74138,177003,TR,TR
35371,1699142640,1699175700,33060,40559,96394,TR,TR
126974,1699950120,1699983000,32880,71084,154681,TR,TR
48096,1699529940,1699567740,37800,110882,28933,MX,MX
192737,1700340060,1700347140,7080,158676,178451,NL,NL
32490,1700355060,1700365860,10800,55931,87071,US,US
100412,1699229040,1699240680,11640,140826,68563,US,US
173426,1700360160,1700371380,11220,85343,52873,US,US
43654,1700110200,1700113800,3600,111497,28944,GB,GB
186816,1699202520,1699207200,4680,124745,184550,NL,NL
83520,1700248260,1700263320,15060,50652,33426,CZ,DE
74493,1699985040,1699998600,13560,195975,57352,US,US
34742,1700660400,1700670780,10380,65800,170497,ES,ES
98191,1699177080,1699185000,7920,153173,175665,IT,FR
18945,1700297460,1700327700,30240,87184,112500,TR,TR
47555,1700482200,1700493240,11040,73273,155994,US,US
23613,1699228500,1699260900,32400,178196,171441,TR,TR
185689,1699016280,1699042920,26640,37809,10910,DE,DE
118694,1700560260,1700595180,34920,68475,14734,TR,TR
18748,1699444620,1699480260,35640,66388,1592,TR,TR
38444,1699921020,1699937280,16260,57754,37169,AT,DE
58205,1700345700,1700358000,12300,95528,177145,HR,DE
167685,1700460480,1700476860,16380,160037,107067,US,US
61597,1700754840,1700758440,3600,45563,24728,NL,NL
152824,1700459700,1700476680,16980,3342,191340,US,US
139831,1700523960,1700533740,9780,155203,158614,IT,IT
163875,1699027020,1699030620,3600,85262,45259,GB,GB
43403,1699299780,1699304520,4740,52414,158059,NL,NL
191284,1700597460,1700624400,26940,112865,167750,DE,IT
7563,1699938660,1699951800,13140,133427,156758,IT,IT
130567,1700422800,1700445780,22980,19238,9913,DE,DE
78379,1698998880,1699012200,13320,11967,46717,PT,PT
126733,1699827480,1699861440,33960,61504,182928,TR,TR
5933,1699585200,1699614660,29460,145648,132587,TR,TR
190108,1699565220,1699593600,28380,32745,89707,DE,DE
95054,1700324460,1700347740,23280,38709,128321,HU,PL
81652,1699731900,1699756920,25020,150053,173293,PL,PL
54442,1700250840,1700265120,14280,144125,144887,PT,PT
126013,1699550700,1699583100,32400,112569,41650,TR,TR
1961,1698794880,1698830460,35580,36473,65866,TR,TR
138030,1699167120,1699170720,3600,155018,147634,GB,GB
181119,1700368200,1700380140,11940,175544,93634,US,US
177504,1699813920,1699847880,33960,36584,144272,TR,TR
18278,1698895860,1698905340,9480,183347,53443,HR,HR
141990,1698919320,1698957240,37920,147657,174241,MX,MX
4261,1700415960,1700438880,22920,87202,140458,RO,RO
172578,1700391600,1700395200,3600,25339,102396,NL,NL
53998,1700122320,1700154120,31800,60611,101348,TR,TR
90526,1699996140,1700012640,16500,65426,182936,CZ,CZ
147124,1699745040,1699778820,33780,106639,36070,TR,TR
150038,1699457220,1699491960,34740,161634,82088,TR,TR
89757,1699319640,1699351140,31500,69070,38694,TR,TR
162461,1698801000,1698813660,12660,21198,74410,HR,HR
52175,1699903980,1699934040,30060,193305,40309,TR,TR
64354,1700483820,1700495940,12120,18272,109864,RS,RS
3443,1700595240,1700612880,17640,134696,71992,RS,IT
168298,1699338720,1699356300,17580,29554,31869,US,US
85350,1700151480,1700174220,22740,1043,14958,RO,RO
87865,1699861080,1699883880,22800,151391,25958,NO,CZ
154179,1699671000,1699688220,17220,199851,197441,US,US
94247,1699287180,1699292460,5280,70127,190592,GB,GB
141621,1699060800,1699064940,4140,47854,159956,GB,GB
128658,1699589040,1699624680,35640,126575,115907,TR,TR
129227,1700687940,1700717640,29700,23288,155156,TR,TR
96962,1699979040,1700013120,34080,53386,164835,TR,TR
66135,1699705440,1699736820,31380,31763,92836,BA,BA
60735,1700148360,1700185260,36900,193530,46471,MX,MX
94567,1700151600,1700186340,34740,38334,91104,TR,TR
29475,1699953660,1699968240,14580,183773,86512,FR,FR
1983,1699781160,1699813920,32760,81752,111946,TR,TR
89435,1700413800,1700420820,7020,126189,183882,GB,GB
62792,1699643580,1699655940,12360,133058,49794,US,US
151939,1699548540,1699579920,31380,111734,25372,TR,TR
43911,1698940380,1698953820,13440,39296,128344,AT,AT
125415,1699374480,1699380180,5700,105072,129686,GB,GB
158864,1699398720,1699415040,16320,38221,76291,AT,AT
12515,1700242680,1700257020,14340,198966,161394,US,US
12538,1700394720,1700427960,33240,15006,84127,TR,TR
132023,1700322600,1700340060,17460,191419,160342,RS,RS
4342,1700673600,1700683260,9660,178098,103879,SK,AT
135240,1699226580,1699264620,38040,23606,166766,MX,MX
138287,1698796800,1698827220,30420,25501,129540,TR,TR
52877,1700628360,1700661720,33360,158816,158175,TR,TR
118981,1700215380,1700222700,7320,185976,115469,HR,HR
71847,1700753340,1700758560,5220,137631,85040,NL,NL
52712,1699970580,1700003340,32760,120660,152771,TR,TR
88420,1699920480,1699954920,34440,145162,91962,TR,TR
186379,1700225100,1700232000,6900,117195,164634,NL,NL
190513,1700207700,1700228040,20340,182575,163328,FR,BE
50609,1700841720,1700877000,35280,154106,161862,TR,TR
3193,1700459880,1700493600,33720,111510,146429,TR,TR
178689,1699818840,1699822440,3600,146850,182295,GB,GB
95210,1699056600,1699064040,7440,155191,18973,HR,DE
175419,1699491900,1699507920,16020,52435,164297,FR,FR
38682,1700664240,1700680020,15780,127356,11648,AT,HU
185426,1699327800,1699333140,5340,172301,126342,NL,NL
164267,1698933900,1698969360,35460,94290,6268,TR,TR
132742,1700156340,1700166660,10320,77677,139333,IT,IT
17521,1699078860,1699093200,14340,19828,20642,US,US
187818,1700205840,1700237640,31800,135912,37330,TR,TR
67342,1700331480,1700335080,3600,84102,137783,NL,NL
29668,1700830140,1700862780,32640,75690,50818,TR,TR
3256,1700468700,1700499780,31080,26586,180675,TR,TR
109291,1699120740,1699124340,3600,135448,165034,NL,NL
85733,1699949280,1699978080,28800,78036,72128,TR,TR
154924,1698834000,1698837600,3600,51346,75269,GB,GB
108070,1699507380,1699522500,15120,188245,34943,CZ,CZ
69694,1699252800,1699260240,7440,21109,158290,IT,IT
126212,1699621560,1699631760,10200,124499,98924,SK,SK
184055,1699793580,1699798140,4560,23198,171554,GB,GB
356,1700048940,1700058960,10020,98991,119639,CL,CL
122038,1699549020,1699563300,14280,166882,174066,IT,IT
24453,1699722780,1699740000,17220,147821,177042,US,US
118630,1700208960,1700241360,32400,29210,22595,TR,TR
124469,1700328060,1700333280,5220,165748,55150,GB,GB
184831,1699216860,1699220580,3720,67942,192396,NL,NL
32376,1700465820,1700492220,26400,75627,145002,DE,AT
145354,1700765460,1700791800,26340,152506,122637,DE,BG
153321,1699353060,1699367340,14280,174053,140969,IT,IT
44228,1699517640,1699530060,12420,54995,112942,US,US
21707,1699012020,1699034940,22920,95536,188237,HU,AT
156045,1700056500,1700086800,30300,186344,21366,MK,DE
157795,1698795540,1698824760,29220,134425,103085,TR,TR
60625,1700320200,1700327100,6900,82214,197439,GB,GB
31845,1699955160,1699966680,11520,22271,129430,ES,ES
135993,1699375140,1699379700,4560,33057,41766,NL,NL
170076,1700699880,1700714940,15060,188036,116332,US,US
98716,1700715120,1700724900,9780,127896,46160,ES,AD
130249,1699918080,1699934220,16140,86208,114300,FR,ES
18727,1699281540,1699311660,30120,25879,199849,TR,TR
87100,1699557120,1699568040,10920,101435,45722,US,US
80943,1699853700,1699863300,9600,100204,33949,IT,IT
13996,1700230380,1700233980,3600,100292,191378,GB,GB
163230,1700367300,1700396400,29100,114754,27393,TR,TR
86170,1699525680,1699537440,11760,86270,129753,HR,HR
184325,1699434960,1699447320,12360,124910,115598,IT,IT
65022,1699014000,1699025700,11700,35228,156972,US,US
78243,1700288400,1700299440,11040,129716,58212,HR,HR
136403,1699167120,1699197780,30660,137476,46852,TR,TR
113913,1699428360,1699450380,22020,43682,102199,DE,DE
136853,1699551840,1699565220,13380,183114,100684,IT,IT
178654,1700349480,1700356560,7080,151717,187440,GB,GB
87793,1700782860,1700812260,29400,71661,120614,TR,TR
82762,1699804860,1699815120,10260,166593,96471,PT,PT
36173,1700673420,1700706060,32640,137435,20417,TR,TR
122128,1699117260,1699120860,3600,72879,156986,GB,GB
108870,1699345680,1699352820,7140,147925,156326,NL,NL
164115,1700621100,1700630400,9300,168393,77767,IT,IT
192352,1699942080,1699972080,30000,79542,136588,TR,TR
71334,1700859120,1700898660,39540,116130,175836,MX,MX
113162,1699395060,1699399320,4260,119727,93312,NL,NL
128110,1700600580,1700617620,17040,157024,104859,US,US
86499,1700691840,1700721000,29160,46686,134169,TR,TR
187085,1699550520,1699554120,3600,70421,69424,NL,NL
88787,1700355480,1700386680,31200,38778,104446,TR,TR
47993,1699617660,1699622100,4440,95783,83985,NL,NL
118000,1699834860,1699865820,30960,108346,114290,TR,TR
178920,1699774740,1699811760,37020,141974,31155,MX,MX
82576,1699964040,1699988340,24300,116990,174856,BR,BR
59858,1699124700,1699137660,12960,193316,130728,PT,PT
124255,1700496780,1700500380,3600,61440,197324,GB,GB
59167,1698963720,1698993600,29880,183060,77946,TR,TR
95382,1698985500,1699015200,29700,67821,26392,TR,TR
130002,1699520760,1699531920,11160,135954,7555,PT,PT
104698,1700664900,1700679180,14280,196999,21253,AT,AT
24843,1698801180,1698834180,33000,61466,149637,MX,MX
137052,1699693800,1699726080,32280,137992,153352,TR,TR
67560,1700291880,1700324400,32520,80219,74168,TR,TR
125809,1700333220,1700365080,31860,46063,85408,TR,TR
43968,1700319780,1700343000,23220,20292,194629,NO,DE
8895,1700030220,1700062920,32700,181569,91750,TR,TR
63717,1698977580,1698981180,3600,66031,152358,NL,NL
77588,1699326420,1699356540,30120,2588,172101,TR,TR
198771,1700315520,1700322480,6960,75926,173824,NL,NL
164087,1700209740,1700242560,32820,197727,71652,TR,TR
12194,1699851120,1699888920,37800,183251,152246,MX,MX
62129,1700411280,1700440560,29280,197584,40247,TR,TR
133783,1699717080,1699746420,29340,140892,46836,TR,TR
198762,1699759800,1699793400,33600,194321,96936,TR,TR
166472,1700846340,1700876520,30180,157443,158159,TR,TR
189074,1699461240,1699492680,31440,175519,27712,TR,TR
47239,1699390560,1699425180,34620,42574,142690,TR,TR
22797,1699442700,1699473960,31260,15643,190810,TR,TR
13134,1699215660,1699219920,4260,136641,158571,NL,FR
163377,1699808640,1699845780,37140,144158,186305,MX,MX
169338,1699302240,1699308900,6660,84030,96286,GB,GB
142660,1700390580,1700404800,14220,109566,175195,US,US
170518,1699807440,1699836360,28920,66491,61879,TR,TR
22531,1699291320,1699301220,9900,105279,132757,IT,IT
82643,1699726200,1699740360,14160,95272,30103,ES,AD
16247,1698962340,1698974220,11880,66626,19665,US,US
50652,1700689560,1700706540,16980,101846,32612,US,US
161033,1698811260,1698846480,35220,96634,104427,TR,TR
173160,1700231820,1700258460,26640,162026,135433,HU,PL
32273,1700735760,1700743680,7920,190445,40821,EE,EE
188369,1700349240,1700362320,13080,18011,88886,HR,HR
174381,1700045640,1700050440,4800,28308,47554,GB,GB
80477,1699453680,1699483800,30120,148338,129965,TR,TR
129344,1700539740,1700552940,13200,53937,91901,US,US
83702,1699744740,1699766340,21600,198893,114332,DE,DE
173587,1699193340,1699229160,35820,179840,122111,TR,TR
192400,1699985760,1699993500,7740,168175,79100,IT,IT
134076,1698972240,1698977880,5640,9309,100813,GB,GB
107261,1700169240,1700201400,32160,31060,101331,TR,TR
33834,1699991460,1700021640,30180,147504,78679,TR,TR
15261,1700444820,1700458260,13440,44017,128320,CA,US
52988,1700453520,1700470500,16980,151080,18117,CZ,UA
62144,1699980420,1700017500,37080,119525,144918,MX,MX
189329,1699144980,1699178820,33840,53061,95698,TR,TR
98771,1699525740,1699535340,9600,167610,118708,ES,BE
109049,1700275980,1700307480,31500,41609,67611,TR,TR
111125,1700269800,1700280600,10800,111789,128926,US,US
75827,1700404440,1700433900,29460,81113,48211,TR,TR
85631,1698851040,1698884700,33660,142310,119055,TR,TR
31140,1699940160,1699956060,15900,91092,107266,US,US
17720,1699383240,1699387800,4560,96373,2487,GB,GB
74715,1699417020,1699423680,6660,31194,68927,GB,GB
124267,1698874800,1698904980,30180,138136,139395,TR,TR
89026,1700672940,1700708640,35700,63498,66301,TR,TR
28961,1699104000,1699109580,5580,165151,48525,NL,NL
61818,1700702520,1700706120,3600,172383,195009,GB,GB
11024,1698899940,1698922020,22080,13037,113095,DE,DE
4152,1698812880,1698848640,35760,197671,74297,TR,TR
26451,1699332060,1699338780,6720,184838,116222,GB,GB
43811,1700700720,1700712720,12000,180707,195186,US,US
18540,1699189380,1699212120,22740,134815,18578,DE,IT
132175,1700355780,1700388600,32820,159483,82754,TR,TR
135787,1700389320,1700410560,21240,40690,117704,BE,NL
13871,1698798900,1698831840,32940,22304,27701,TR,TR
108019,1699669020,1699672620,3600,173498,194975,GB,GB
69326,1699994460,1700005920,11460,143571,87534,SK,SK
83560,1700297940,1700301540,3600,68141,23365,GB,GB
140356,1700648760,1700665680,16920,89209,118385,US,US
193015,1699569000,1699580700,11700,141822,37611,IT,IT
57483,1699202340,1699205940,3600,32117,95558,NL,NL
114446,1700203140,1700210280,7140,3483,52738,NL,NL
5366,1699213200,1699246200,33000,26650,147784,TR,TR
127261,1699698840,1699702440,3600,132179,11573,GB,GB
19367,1698912840,1698946920,34080,121527,58385,MX,MX
89383,1698995940,1699023360,27420,64552,88583,DE,BE
125023,1700780940,1700816700,35760,172506,82484,TR,TR
31572,1700411940,1700450580,38640,84893,55710,MX,MX
49309,1699921980,1699950480,28500,62091,137921,BA,BA
123025,1698820920,1698834420,13500,6088,32507,IT,IT
31268,1700005500,1700009460,3960,37602,35782,GB,GB
57668,1699160460,1699195440,34980,90534,128681,TR,TR
74671,1699455900,1699465500,9600,36742,29148,IT,IT
4516,1700377440,1700401320,23880,177765,79207,RO,RO
114730,1699872360,1699875960,3600,189402,160734,NL,NL
72742,1700826720,1700862240,35520,127816,128835,MX,MX
129650,1699408980,1699438680,29700,79798,98406,TR,TR
148890,1700462400,1700467020,4620,186250,109317,GB,GB
27757,1699867200,1699883940,16740,73242,460,US,US
54701,1700653800,1700686740,32940,20943,114903,TR,TR
132334,1699394100,1699424700,30600,126341,189590,TR,BG
96639,1699918800,1699941780,22980,27769,105041,PL,UA
167027,1700074440,1700078520,4080,47912,35831,GB,GB
40814,1700825640,1700857860,32220,69436,9039,TR,TR
185397,1698885120,1698920460,35340,20582,57733,TR,TR
182858,1699734180,1699751700,17520,67456,197511,US,US
141680,1698815700,1698849600,33900,44802,48631,TR,TR
9017,1698810240,1698816840,6600,3196,13297,GB,GB
126123,1700190660,1700194260,3600,93100,121783,GB,GB
124307,1699225920,1699238040,12120,102940,10263,US,US
113246,1699480620,1699486500,5880,23614,194582,GB,GB
180450,1698948180,1698951780,3600,17477,1620,NL,NL
135241,1700379660,1700403840,24180,93997,76777,BR,BR
74581,1700346960,1700353080,6120,128185,35783,EE,EE
31302,1699140900,1699154460,13560,66141,118967,AT,SK
76137,1699858920,1699862520,3600,192388,58917,GB,GB
88731,1700667600,1700685960,18360,33015,37463,FR,FR
110397,1699878120,1699912200,34080,159881,81399,TR,TR
59123,1699878840,1699912740,33900,131345,117483,TR,TR
139237,1699567620,1699576620,9000,45047,139977,IT,IT
193905,1699881240,1699901460,20220,61489,45693,FR,DE
86385,1700651100,1700660340,9240,19058,155372,IT,IT
95409,1700847840,1700878020,30180,34053,10914,TR,TR
11201,1700497080,1700503980,6900,75001,3024,GB,GB
41451,1700803200,1700816580,13380,139699,5469,IT,IT
129047,1700525820,1700565000,39180,177861,21714,MX,MX
124264,1700096340,1700103540,7200,58146,170756,SK,SK
82855,1700646720,1700658420,11700,29110,155679,IT,IT
33489,1698888780,1698922200,33420,37708,31425,TR,TR
82397,1699422420,1699427820,5400,28849,7820,NL,NL
191627,1700237700,1700250300,12600,29511,87919,US,US
88490,1698963300,1698995280,31980,79776,99737,TR,TR
195160,1699492200,1699506660,14460,165661,110236,BE,FR
176275,1699931940,1699961580,29640,58571,5573,TR,TR
72866,1700526240,1700559720,33480,165970,67834,TR,TR
84339,1700179500,1700210280,30780,36400,46563,TR,TR
36845,1700389680,1700394360,4680,55904,162914,EE,EE
26644,1699503420,1699525020,21600,119627,101133,DK,DK
31957,1699404480,1699413900,9420,137646,100257,IT,IT
57358,1700616300,1700652120,35820,135751,130627,TR,TR
14778,1699873680,1699880520,6840,102748,81716,GB,GB
60821,1699410780,1699419600,8820,160546,55080,ES,ES
186969,1699551060,1699562880,11820,152205,175637,AT,DE
141396,1699473000,1699483560,10560,23440,184320,IT,IT
82106,1700437920,1700467380,29460,120272,63193,TR,TR
174290,1700841240,1700863800,22560,167866,198671,PL,PL
95148,1700746980,1700761740,14760,1940,30771,FR,FR
144460,1700659620,1700686740,27120,139065,91308,PL,SK
157267,1700471700,1700503920,32220,175,197504,TR,TR
114121,1699314900,1699348320,33420,94118,101196,TR,TR
59231,1700637480,1700651700,14220,108411,196046,IT,IT
119291,1699505820,1699538040,32220,73402,121399,TR,TR
140456,1698997800,1699021680,23880,62159,183272,DE,DE
77928,1699992600,1700002140,9540,81431,162729,HR,HR
122921,1699394100,1699406700,12600,132236,176090,RS,RS
190390,1700809200,1700825820,16620,144288,95310,US,US
19907,1700503440,1700511540,8100,73799,128128,HR,HR
112488,1699651800,1699664340,12540,34694,199271,US,US
97039,1699324680,1699353480,28800,33072,9098,TR,TR
57660,1700823720,1700857800,34080,133938,171862,TR,TR
129389,1699353840,1699385940,32100,11864,170459,TR,TR
8149,1699056780,1699074360,17580,8442,87844,FR,FR
56532,1700097120,1700100720,3600,645,148709,GB,GB
93418,1699209180,1699243500,34320,10172,139791,TR,TR
177694,1700709780,1700713380,3600,55345,58645,GB,GB
161962,1699116240,1699129920,13680,186620,164239,RS,RS
122858,1700232600,1700236200,3600,44252,106707,GB,GB
64960,1700641860,1700672400,30540,69692,26033,TR,TR
132414,1699356480,1699362720,6240,136522,17995,GB,GB
78591,1700194800,1700224080,29280,32330,197020,TR,TR
193655,1698813180,1698842400,29220,175927,46837,TR,TR
100740,1699953900,1699966260,12360,175508,86493,AT,AT
86746,1700113260,1700117880,4620,137776,188263,GB,GB
88971,1699262760,1699301400,38640,2205,56550,MX,MX
161289,1699907460,1699912740,5280,135269,177386,GB,GB
177140,1699752480,1699782300,29820,47889,10961,TR,TR
159092,1699772340,1699777680,5340,2493,121154,GB,GB
88650,1699503480,1699507440,3960,52313,60807,GB,GB
64152,1699098780,1699132260,33480,25759,122521,TR,TR
161976,1699873500,1699907100,33600,14221,86884,TR,TR
176582,1699508820,1699540620,31800,121155,26389,TR,TR
22545,1700780940,1700812920,31980,143964,15922,TR,TR
55303,1698905520,1698910740,5220,47645,6396,GB,GB
156742,1699607280,1699618140,10860,137195,51513,CA,US
199905,1699810740,1699828080,17340,70087,112955,AT,AT
62340,1698950400,1698964980,14580,48574,198083,US,US
109396,1700834640,1700868540,33900,142912,163163,TR,TR
70053,1699227420,1699233720,6300,61415,23552,GB,GB
118231,1699276500,1699311900,35400,25318,154759,TR,TR
83406,1698943560,1698947160,3600,103452,168153,NL,NL
45127,1700422320,1700454420,32100,48004,156534,TR,TR
75737,1699489500,1699525320,35820,165914,131940,TR,TR
5274,1700311020,1700345100,34080,190897,2854,TR,TR
198284,1699740960,1699770300,29340,166831,151867,BA,RS
82322,1699679340,1699682940,3600,52584,184222,GB,GB
187593,1699724040,1699747020,22980,82391,168380,HU,AT
133208,1699483620,1699493400,9780,106509,38529,PT,PT
90511,1699539300,1699542900,3600,130561,20748,NL,NL
184954,1698847260,1698850860,3600,85956,100556,GB,GB
103531,1698834000,1698849360,15360,88339,138706,US,US
38544,1700847960,1700851560,3600,57890,161698,NL,NL
60187,1699758180,1699788000,29820,193028,32532,TR,TR
117739,1699818480,1699825020,6540,128372,124530,AD,ES
21154,1700134920,1700149260,14340,140629,181878,PT,PT
151711,1699098480,1699128300,29820,37304,93493,TR,BG
153824,1699209120,1699237500,28380,64520,5363,PL,NL
132204,1698800040,1698830640,30600,92231,94884,TR,TR
122890,1700609760,1700624700,14940,188294,11092,CA,US
17102,1699845300,1699850100,4800,54720,119527,NL,AT
111341,1699710600,1699727100,16500,189557,133644,US,US
121936,1699709400,1699735080,25680,96307,58072,CH,DE
193661,1700131020,1700147100,16080,141820,182246,US,US
184402,1699883640,1699914840,31200,56991,127388,TR,TR
97624,1698885660,1698899940,14280,70259,143523,CZ,HR
110270,1700727300,1700738220,10920,136358,139745,HR,HR
8702,1699763580,1699792500,28920,168897,16959,TR,TR
162035,1698811200,1698816720,5520,33540,43669,GB,GB
61001,1699739040,1699746660,7620,55147,91266,IT,IT
187245,1699739040,1699746000,6960,98096,59866,NL,NL
7482,1699067820,1699099800,31980,121489,178556,TR,TR
51789,1699156020,1699170480,14460,57720,65864,US,US
135697,1698999000,1699008720,9720,146493,117451,ES,ES
164745,1699722420,1699729740,7320,2619,16007,ES,BE
66951,1699734180,1699746600,12420,107340,169282,CZ,PL
71215,1699552020,1699555620,3600,140373,98402,NL,NL
121965,1698931740,1698960960,29220,138703,86903,TR,TR
122039,1700400960,1700435220,34260,150439,169194,TR,TR
74461,1700461560,1700497920,36360,45412,12318,MX,MX
77127,1700538300,1700569740,31440,87121,119883,TR,TR
132942,1699419000,1699456020,37020,27556,192567,MX,MX
163816,1699805400,1699811160,5760,198179,195877,GB,GB
168431,1698865740,1698878760,13020,199861,157502,IT,IT
111687,1700258100,1700274420,16320,189350,197905,US,US
198431,1699105200,1699120260,15060,150876,99427,AT,BG
89212,1699436700,1699474740,38040,101395,131406,MX,MX
6606,1700371440,1700379900,8460,166013,61829,IT,IT
62704,1699662540,1699694940,32400,125158,66885,TR,TR
158498,1700855460,1700867340,11880,75866,96398,US,US
7102,1699700040,1699731780,31740,106532,198153,TR,TR
67654,1700832480,1700866980,34500,112162,78987,TR,TR
175373,1700200500,1700234400,33900,41594,83828,TR,TR
29826,1700388300,1700391900,3600,121261,181822,GB,GB
192961,1699354740,1699364580,9840,6566,89952,IT,IT
136287,1699986180,1700021100,34920,122189,199989,TR,TR
109706,1700233380,1700267580,34200,68225,187142,TR,TR
25046,1698847380,1698866580,19200,148506,102878,FR,NL
35381,1699446720,1699450740,4020,25708,23725,GB,GB
148774,1699488600,1699521780,33180,191963,85681,TR,TR
74737,1698820020,1698823620,3600,175224,96118,NL,NL
18273,1699045920,1699063260,17340,71682,1084,US,US
122769,1699903620,1699914480,10860,24926,57753,US,US
47631,1699026480,1699059960,33480,127852,88125,TR,TR
83663,1699026480,1699040220,13740,60846,164111,IT,IT
4336,1700227200,1700242980,15780,81328,66572,RS,RS
14761,1699390260,1699426020,35760,11208,199393,MX,MX
77355,1698925740,1698960420,34680,141659,142724,TR,TR
135928,1700743860,1700779020,35160,78546,23537,TR,TR
180717,1700547420,1700583180,35760,185796,46868,TR,TR
130069,1700584980,1700591760,6780,113651,54437,NL,NL
116271,1700712540,1700722680,10140,101701,197429,HR,HR
17424,1700546520,1700567340,20820,158253,88139,FR,FR
65320,1699409520,1699418700,9180,196641,115335,IT,IT
107751,1698818460,1698844020,25560,129833,114896,DE,DE
194669,1700286060,1700297880,11820,99583,78881,US,US
146934,1700357880,1700376060,18180,45813,172653,FR,FR
162268,1700611260,1700646480,35220,177076,148538,TR,TR
94304,1700764680,1700776440,11760,35910,13849,US,US
157976,1700370000,1700383200,13200,34614,161227,US,US
122661,1700021160,1700024760,3600,111414,139682,NL,NL
847,1699949460,1699982580,33120,193204,87573,TR,TR
102295,1699766160,1699799040,32880,65341,24637,TR,TR
67929,1699254060,1699279860,25800,198804,28577,PL,FR
65295,1699787340,1699820760,33420,108292,147377,MX,US
29285,1699038480,1699069380,30900,93829,111373,TR,TR
7088,1700033520,1700049240,15720,84180,65583,FR,FR
53090,1699153260,1699187160,33900,118946,62855,TR,TR
41536,1699188180,1699220340,32160,65219,86757,TR,TR
72944,1700508000,1700512020,4020,179237,20872,GB,GB
45613,1699981620,1700011740,30120,199525,44689,TR,TR
104184,1699091520,1699129260,37740,110503,120867,MX,MX
102573,1700268960,1700273580,4620,117826,17890,GB,GB
92913,1699171620,1699183320,11700,70055,14562,US,US
46155,1700138700,1700163660,24960,34481,114417,RO,FR
98474,1700450220,1700480940,30720,40508,3788,TR,TR
27540,1699752840,1699769220,16380,120666,75801,CA,CA
50623,1700712900,1700742540,29640,70296,81176,TR,TR
92469,1698979860,1698984120,4260,51504,81183,AD,ES
7106,1700481120,1700489940,8820,153777,141200,IT,IT
188554,1699817100,1699827720,10620,27841,14649,IT,IT
72434,1699724880,1699741800,16920,40477,64804,US,US
118425,1700064420,1700073900,9480,39712,112427,PT,PT
2657,1699296180,1699325160,28980,100427,119758,TR,TR
66508,1700542080,1700576640,34560,161874,4265,TR,TR
139788,1700212860,1700216460,3600,34945,152465,GB,GB
160282,1700312940,1700325420,12480,5744,45880,PT,PT
188106,1699508520,1699521360,12840,117393,129140,RS,SI
6160,1699323960,1699327560,3600,40543,139234,GB,GB
144316,1700622780,1700635260,12480,175972,189059,US,US
131336,1699377360,1699401900,24540,80049,177715,AL,MK
17870,1699482120,1699488060,5940,193123,141578,NL,NL
192867,1700162160,1700197080,34920,175733,32236,TR,TR
54765,1699758120,1699772040,13920,172724,50129,ES,FR
126372,1699037280,1699072860,35580,173957,33261,MX,MX
175755,1699124820,1699138860,14040,48020,35848,IT,IT
134936,1699965540,1699998180,32640,164768,94595,TR,TR
167645,1700279160,1700295480,16320,172166,170089,US,US
56148,1698947820,1698977460,29640,173879,48315,TR,TR
73787,1700103420,1700115120,11700,145661,12409,US,CA
102245,1699400040,1699435080,35040,38172,129419,TR,TR
185204,1699801800,1699805400,3600,52018,167176,GB,GB
16442,1700644020,1700647620,3600,24154,42081,GB,GB
54886,1699296480,1699308120,11640,36176,126732,SK,SK
94990,1700641020,1700655420,14400,138122,1218,US,US
4414,1699556940,1699587900,30960,21099,38035,TR,TR
129533,1699907880,1699914600,6720,12231,185532,NL,NL
100625,1700481660,1700485260,3600,68221,161808,GB,GB
112161,1699585860,1699620900,35040,108865,38964,MX,MX
118867,1700550360,1700557200,6840,140914,128914,GB,GB
89893,1700463960,1700476620,12660,165393,32323,ES,ES
123564,1700271180,1700298540,27360,58905,36007,PL,DE
166948,1700635980,1700647740,11760,93543,22600,IT,IT
12151,1699497660,1699508520,10860,190664,176897,IT,IT
3154,1699009440,1699023360,13920,10631,82846,ES,DE
83480,1700701920,1700712060,10140,53002,95111,IT,IT
119496,1700804940,1700836500,31560,131768,85509,TR,TR
161687,1699222020,1699236780,14760,193776,10823,CA,CA
125721,1699432020,1699435620,3600,70102,162676,NL,NL
133958,1699966980,1699981500,14520,62891,178011,US,US
188142,1699677900,1699683420,5520,40837,114165,GB,GB
97102,1700183040,1700186640,3600,61964,8172,GB,GB
90337,1698892560,1698925320,32760,130192,14787,TR,TR
55438,1699905180,1699936020,30840,164995,33865,TR,TR
97919,1699875540,1699879140,3600,189595,129199,GB,GB
40789,1698877620,1698882000,4380,184309,53425,NL,NL
188877,1700341560,1700355660,14100,45086,113707,IT,FR
119753,1699266660,1699299540,32880,32982,9233,MX,MX
50452,1699984440,1699999440,15000,18111,137242,FR,FR
129636,1699554060,1699566120,12060,83645,176630,US,US
71412,1700247540,1700260020,12480,92096,136289,US,US
92427,1700467020,1700480460,13440,47579,198086,US,US
92601,1699651380,1699682700,31320,60676,190379,TR,TR
5705,1700294880,1700326620,31740,172901,2597,TR,TR
148199,1700635680,1700652960,17280,38124,119166,FR,FR
26350,1700582040,1700614380,32340,67743,51253,TR,TR
125013,1699555860,1699569060,13200,69154,108344,US,US
56811,1698957000,1698992400,35400,166862,181226,TR,TR
62554,1699003560,1699009500,5940,144073,78403,GB,GB
116278,1699427460,1699459380,31920,148105,157446,TR,TR
179873,1698836640,1698848700,12060,178727,29170,IT,IT
51845,1699356240,1699390080,33840,141148,172477,TR,TR
89830,1700012220,1700015820,3600,21630,81074,NL,NL
128201,1700409120,1700442600,33480,74331,179260,TR,TR
162509,1698972540,1699004220,31680,164404,141811,TR,TR
159490,1699122180,1699153140,30960,61518,142094,TR,TR
134877,1699515180,1699527540,12360,19968,85854,PT,PT
105475,1699174020,1699207500,33480,106609,163232,TR,TR
106784,1699905360,1699908960,3600,141072,40621,GB,GB
158508,1699230180,1699265700,35520,160572,38462,TR,TR
54479,1699530660,1699557420,26760,165515,16490,PL,PL
60757,1700783940,1700792700,8760,194327,2056,PT,PT
103861,1700791980,1700803500,11520,10158,90181,RS,DE
47263,1698901800,1698933660,31860,66012,82156,TR,TR
140901,1700364900,1700399700,34800,188684,171947,TR,TR
98346,1699902840,1699910760,7920,163359,88927,IT,IT
86163,1699627440,1699633680,6240,110921,171210,NL,NL
11395,1700765580,1700780400,14820,15848,139167,US,US
199939,1699970040,1699973640,3600,4020,136208,NL,NL
163443,1700132820,1700144460,11640,35177,41007,IT,IT
24533,1699326600,1699332540,5940,81556,49387,NL,BE
32389,1700576520,1700599620,23100,118303,49568,BR,BR
144446,1699544580,1699573680,29100,196305,71506,TR,TR
131961,1700494020,1700508480,14460,156197,196545,US,US
55015,1699062060,1699100400,38340,157975,148003,MX,MX
187477,1699597800,1699607880,10080,107686,117585,IT,IT
92114,1699312920,1699325640,12720,29803,26835,US,CA
118081,1700609580,1700619120,9540,199014,134217,IT,IT
100128,1700197260,1700232780,35520,46204,103520,TR,TR
168692,1699476780,1699509960,33180,53932,101160,TR,TR
33159,1700064060,1700067660,3600,169547,71839,NL,BE
117276,1700436720,1700467800,31080,34447,27616,TR,TR
11843,1698853440,1698866700,13260,170200,186979,US,US
75796,1700310780,1700314380,3600,112079,92070,GB,GB
73909,1699031040,1699034760,3720,7072,42371,NL,NL
98547,1698811920,1698827760,15840,32370,48583,US,US
137067,1699777980,1699792140,14160,147932,127359,HR,HR
117187,1699943520,1699977600,34080,122449,108024,TR,TR
185392,1699451940,1699460760,8820,159739,129473,IT,IT
139741,1699846740,1699879680,32940,21879,186483,TR,TR
91935,1700422560,1700426160,3600,39628,193546,NL,NL
40167,1700080440,1700115420,34980,195920,58349,TR,TR
65393,1700009700,1700040900,31200,170472,139603,TR,TR
41480,1700233680,1700268060,34380,101903,153153,TR,TR
184913,1699588680,1699602720,14040,54286,180512,US,US
169689,1699002240,1699017360,15120,90854,159417,AT,AT
113815,1700310360,1700339400,29040,40756,57785,MK,AL
171349,1698854760,1698858360,3600,30337,149616,GB,GB
122578,1699478640,1699492260,13620,74170,112316,IT,IT
9910,1699583340,1699595220,11880,56417,176498,IT,IT
9314,1700615520,1700637780,22260,173626,5511,BR,BR
114651,1700200380,1700228700,28320,155958,179481,DE,NL
9495,1699902720,1699931280,28560,24930,4881,PL,PL
161241,1699565700,1699594800,29100,99835,28431,TR,TR
24455,1700578500,1700610180,31680,40509,38279,TR,TR
35648,1699471140,1699504740,33600,95938,74946,TR,TR
34250,1699848840,1699861500,12660,47923,123344,US,US
171125,1700248860,1700274180,25320,192775,132177,NO,SE
143127,1700201760,1700205360,3600,13860,25101,NL,NL
95440,1699118460,1699123920,5460,196298,5707,GB,GB
119970,1700718900,1700752440,33540,106692,115685,TR,TR
81838,1700394180,1700399100,4920,10529,135388,NL,NL
75553,1700017080,1700026260,9180,5012,39480,IT,IT
92742,1698993600,1698997200,3600,102337,69284,GB,GB
166110,1700655480,1700712480,57000,173867,158005,BG,DE
171052,1700123280,1700155980,32700,155236,174663,TR,TR
62190,1700636640,1700647800,11160,145025,88056,US,US
20080,1699264080,1699267680,3600,130861,73093,GB,GB
104028,1700740080,1700772300,32220,192693,100337,TR,TR
129359,1698968760,1698992100,23340,23890,197022,BR,BR
121343,1699811280,1699843800,32520,76701,188353,TR,TR
19751,1700857320,1700868600,11280,15208,126078,AT,AT
68577,1700821500,1700846400,24900,56419,39491,PL,FR
89619,1698806340,1698813480,7140,69666,51195,GB,GB
47491,1700405520,1700437020,31500,43444,72681,TR,TR
104106,1700864760,1700871960,7200,154880,194079,IT,IT
197893,1699735320,1699766340,31020,22675,185264,TR,TR
145318,1698852180,1698876780,24600,18048,9529,DE,PL
86239,1699912920,1699948380,35460,139091,175589,MX,MX
37068,1700330640,1700347020,16380,117808,44391,US,US
148923,1700472960,1700504820,31860,123789,66086,TR,TR
70408,1699561440,1699584180,22740,1155,1992,PL,FR
129538,1700431380,1700441700,10320,114605,39454,IT,IT
152232,1700297580,1700328840,31260,138319,26823,BA,DE
75637,1700117520,1700126760,9240,83297,65975,SK,SK
186687,1699769700,1699801680,31980,110675,53923,TR,TR
53980,1699689840,1699722780,32940,83311,22996,TR,TR
105973,1700142420,1700157480,15060,52447,64580,RS,BA
196976,1700020200,1700054280,34080,59414,164876,TR,TR
79678,1698905940,1698936060,30120,140724,128039,TR,TR
100733,1699785300,1699790100,4800,89643,100308,GB,GB
196244,1698861480,1698868740,7260,72004,56637,IT,IT
153329,1700358300,1700387760,29460,154131,175549,TR,TR
197993,1700131140,1700166900,35760,114978,144080,TR,TR
170098,1700462460,1700520720,58260,185617,190213,UA,PL
22589,1700140140,1700151540,11400,189422,54434,IT,IT
134898,1699570560,1699587540,16980,4124,31612,US,US
175539,1700173800,1700205120,31320,177038,118011,TR,TR
148966,1700427720,1700441880,14160,59602,191279,IT,ES
15367,1698906420,1698922620,16200,123849,106192,FR,NL
64347,1699081440,1699115940,34500,168797,107196,TR,TR
14898,1698987840,1699004220,16380,1504,148718,CZ,CZ
62565,1699044060,1699061640,17580,143405,88104,US,US
154520,1700825820,1700829660,3840,97354,103388,GB,GB
92980,1699873860,1699887360,13500,125437,163893,SK,SK
145704,1699972440,1700006400,33960,71745,63400,TR,TR
102664,1700711460,1700718840,7380,140664,61070,HR,HR
97897,1700556060,1700562540,6480,24030,17219,GB,GB
158614,1699746900,1699752360,5460,59683,81211,NL,NL
83698,1700155620,1700164860,9240,74899,174739,IT,IT
173086,1699100280,1699131300,31020,106980,97503,TR,TR
93673,1698830040,1698834540,4500,179003,70346,NL,NL
162718,1699544940,1699577520,32580,105259,24509,TR,TR
132680,1700005500,1700018340,12840,93578,71420,IT,IT
94479,1700703720,1700721420,17700,147941,35802,CZ,CH
164946,1699044000,1699074600,30600,27595,13612,TR,TR
30820,1699312020,1699327800,15780,3662,20108,US,US
153930,1700092080,1700124900,32820,127794,101152,TR,TR
9932,1700717700,1700731200,13500,176699,148456,US,US
49857,1699101060,1699107120,6060,83985,159028,GB,GB
158779,1700258940,1700278860,19920,150118,69747,FR,FR
29188,1700476680,1700508960,32280,4365,192950,TR,TR
76622,1699914060,1699947000,32940,169466,157334,TR,TR
187044,1699484940,1699520580,35640,67532,48097,MX,MX
40772,1700604780,1700636280,31500,138818,194180,TR,TR
99693,1699916760,1699920720,3960,174935,180638,NL,NL
53464,1698912480,1698930240,17760,39619,113697,US,US
38788,1699770600,1699782240,11640,150242,8046,IT,IT
94393,1700626620,1700656680,30060,176917,114473,TR,TR
36508,1699995240,1700007000,11760,148,172635,US,US
33657,1700013480,1700017080,3600,5903,128882,NL,NL
60029,1699598220,1699601820,3600,28065,22904,NL,NL
174622,1700690640,1700694240,3600,78283,188248,NL,NL
186951,1699749900,1699782480,32580,89161,106785,TR,TR
143677,1700190600,1700201340,10740,88453,123844,HR,DE
46370,1699239600,1699270020,30420,91651,146239,TR,TR
130371,1699225920,1699255680,29760,133947,64271,TR,TR
104526,1699375980,1699384860,8880,44534,119114,IT,IT
39628,1700403840,1700416680,12840,33564,134556,US,US
31011,1700199600,1700218020,18420,97787,154871,LT,PL
116570,1700799000,1700810580,11580,67823,154709,US,US
180394,1699360680,1699396140,35460,4727,5390,TR,TR
199850,1699716060,1699750200,34140,101309,105314,TR,TR
79082,1699355400,1699390140,34740,122923,93233,TR,TR
155084,1699513800,1699529940,16140,95095,172839,AT,AT
48496,1700205720,1700236860,31140,183076,85524,TR,TR
46438,1699650120,1699653720,3600,15500,68453,NL,NL
52621,1699510920,1699524300,13380,67205,103546,IT,IT
193935,1700505240,1700529720,24480,127655,44140,DE,DE
68624,1700224260,1700259180,34920,163514,157600,TR,TR
147257,1699056120,1699090500,34380,158452,79522,TR,TR
149145,1700722680,1700752020,29340,126453,24507,TR,TR
130784,1699625280,1699655880,30600,48674,9980,TR,TR
30420,1699518720,1699526880,8160,135781,168411,IT,IT
133725,1699819560,1699846920,27360,168946,39243,PL,PL
159545,1699150440,1699165320,14880,199100,128690,CZ,CZ
62543,1700410800,1700424300,13500,134207,51259,PT,PT
16219,1699931160,1699964160,33000,166776,92578,TR,TR
99601,1700006400,1700035020,28620,129714,155260,RO,RO
78248,1699701420,1699731780,30360,104092,172762,TR,TR
48755,1699852200,1699887900,35700,133966,164329,TR,TR
114317,1700147100,1700184420,37320,100658,40873,MX,MX
68968,1699723320,1699736100,12780,187605,175775,HR,HR
179125,1700210580,1700233560,22980,65886,180735,CH,CZ
162306,1699079280,1699113480,34200,119978,153088,TR,TR
15725,1700385600,1700389200,3600,97696,129373,GB,GB
119069,1700731440,1700764980,33540,64247,152279,TR,TR
162361,1700458260,1700479080,20820,103852,131228,FR,FR
109733,1699050240,1699053840,3600,165011,111698,GB,GB
120943,1700223360,1700230020,6660,177003,85349,GB,GB
159378,1700381100,1700393820,12720,168813,194997,AT,AT
22734,1700653800,1700685960,32160,159473,87916,TR,TR
32271,1700735760,1700751360,15600,89941,165675,US,US
94613,1700127180,1700135160,7980,68906,162714,PT,PT
146962,1699817040,1699830540,13500,109732,195580,HR,HR
83177,1699134720,1699140840,6120,134806,190681,GB,GB
146161,1698856740,1698886680,29940,19488,106441,TR,TR
86128,1700447100,1700478540,31440,178003,159786,TR,TR
167484,1699121340,1699155060,33720,2787,150218,TR,TR
64880,1698813840,1698837000,23160,15356,155426,DE,BA
138411,1700014020,1700034480,20460,83567,96556,BE,NL
44859,1699305180,1699339440,34260,27359,158401,TR,TR
67352,1700166900,1700187120,20220,78982,159255,FR,FR
50203,1699809600,1699838100,28500,111358,161834,DE,DE
132356,1699864200,1699894380,30180,195538,83464,TR,TR
45794,1699627560,1699639200,11640,113592,49213,IT,MK
150704,1700306700,1700338980,32280,191001,103284,TR,TR
62604,1699921560,1699953720,32160,89173,86889,TR,TR
154407,1700488440,1700514300,25860,43238,134919,DE,DE
46479,1699296480,1699329060,32580,171334,38507,TR,TR
160484,1699345260,1699357680,12420,146539,16378,RS,NL
96715,1699911300,1699920840,9540,80871,193380,PT,PT
60437,1699897620,1699901220,3600,166278,107816,GB,GB
199265,1700768700,1700772660,3960,90796,157883,NL,NL
105719,1699125720,1699156680,30960,166725,109571,TR,TR
71228,1699744080,1699752420,8340,8184,115450,IT,IT
79986,1700321580,1700328300,6720,129137,195966,AD,ES
74089,1700608380,1700642040,33660,64861,42413,TR,TR
139409,1699917960,1699922640,4680,25541,23336,GB,GB
15788,1699037700,1699069980,32280,8178,39172,TR,TR
69138,1700823420,1700834820,11400,80738,80182,US,US
96354,1699865820,1699896660,30840,51227,80241,TR,TR
134623,1700125140,1700155320,30180,125211,42667,TR,TR
161526,1700431260,1700467080,35820,184979,87146,TR,TR
1864,1700518740,1700546280,27540,196671,53066,DE,HU
85295,1698858300,1698864900,6600,105689,193170,GB,GB
193351,1700098080,1700132280,34200,156248,129216,TR,TR
31709,1700265720,1700276640,10920,100595,125290,US,US
161494,1699499700,1699519500,19800,155901,170142,SE,SE
103840,1699058100,1699092840,34740,43458,95041,TR,TR
13732,1700301660,1700316180,14520,55049,191061,US,US
38090,1699649340,1699657080,7740,1466,19837,IT,IT
736,1700270100,1700287500,17400,27592,138433,US,US
35700,1699865880,1699883760,17880,126142,883,BE,NL
98355,1700451060,1700464680,13620,696,128211,IT,IT
81411,1700718240,1700733660,15420,173808,49197,US,US
20705,1699267080,1699278180,11100,161133,139219,US,US
164482,1699629660,1699663740,34080,86401,127188,TR,TR
187954,1700383860,1700395980,12120,96740,25645,CA,US
191149,1700692740,1700722920,30180,150854,107347,TR,TR
186417,1699513620,1699545540,31920,114503,106664,TR,TR
121475,1699665840,1699669560,3720,44524,122262,NL,NL
118552,1699155360,1699163940,8580,109148,81645,SK,SK
59728,1699080720,1699097040,16320,27249,21073,FR,FR
94423,1699359000,1699392840,33840,9355,92729,TR,TR
171124,1700178540,1700187000,8460,152005,121721,ES,ES
172533,1698896280,1698907860,11580,115290,73077,IT,HR
33945,1699496040,1699519380,23340,123108,168713,DE,DE
7592,1699949340,1699981500,32160,72023,145685,TR,TR
37090,1699664640,1699668240,3600,76711,179528,NL,NL
33676,1700699640,1700735220,35580,81347,133404,TR,TR
167823,1698852060,1698861480,9420,151841,15159,IT,IT
139717,1699952580,1699969440,16860,34064,103566,RS,RS
61190,1699351080,1699357200,6120,193958,163306,GB,GB
75602,1699688280,1699720020,31740,93858,115602,TR,TR
47260,1700346660,1700359380,12720,127908,127535,IT,IT
51379,1699402860,1699435680,32820,67731,174583,TR,TR
114388,1699922340,1699937880,15540,179723,6651,US,US
185285,1699863960,1699876080,12120,115235,141981,HR,RS
527,1700259000,1700268840,9840,77785,8930,IT,IT
173456,1699609260,1699645020,35760,83220,133758,TR,TR
129877,1700408580,1700414820,6240,145945,132371,GB,GB
128071,1699796340,1699835640,39300,23085,188031,MX,MX
31255,1700602920,1700632380,29460,6520,197018,TR,TR
192638,1699655220,1699681020,25800,158962,35588,BR,BR
5352,1700087940,1700095680,7740,152910,60070,HR,HR
95100,1699742100,1699754340,12240,81170,140501,CA,US
596,1699799280,1699831080,31800,96021,27983,TR,TR
43559,1700210340,1700221260,10920,21856,68823,US,US
199663,1699852560,1699861740,9180,67702,92419,IT,IT
191720,1699287720,1699320240,32520,83684,152597,TR,TR
169973,1699848960,1699871940,22980,154257,91950,DE,BG
98283,1699132740,1699167420,34680,126697,85510,MX,MX
195574,1699554180,1699586340,32160,192445,28820,TR,TR
77396,1700433180,1700436780,3600,27155,8513,NL,NL
68197,1700679120,1700709360,30240,44863,35596,TR,TR
58921,1699465560,1699494720,29160,112551,57688,TR,TR
42697,1699738020,1699769100,31080,46032,148146,TR,TR
67303,1699611780,1699643940,32160,175838,168188,TR,TR
52275,1699939320,1699975080,35760,11960,148948,TR,TR
41995,1699579440,1699583040,3600,57636,168462,GB,GB
31922,1699572000,1699606680,34680,123761,59746,TR,TR
108390,1700860080,1700883720,23640,111272,41340,DE,IT
27732,1699252860,1699288260,35400,36274,172763,TR,TR
64182,1700589060,1700612220,23160,13388,193135,DE,AT
119037,1699791120,1699804560,13440,151825,48893,HR,HR
16722,1700539800,1700550960,11160,55066,74472,US,US
127538,1698865320,1698903420,38100,68075,77749,MX,MX
49584,1699710060,1699715220,5160,191921,98650,GB,GB
44596,1699470600,1699505160,34560,8013,67,MX,MX
132788,1699493160,1699506840,13680,120949,127755,IT,IT
84966,1699919100,1699928880,9780,43152,160355,PT,PT
125036,1698826920,1698849060,22140,84306,28170,CH,BA
130596,1699544460,1699556220,11760,2103,38036,ES,AD
37836,1700630760,1700638560,7800,176208,197239,PT,PT
24066,1699539420,1699569600,30180,89028,194851,TR,TR
108224,1699441500,1699475880,34380,143408,9024,TR,TR
153552,1699100520,1699107000,6480,177404,86330,NL,NL
68778,1699078440,1699084200,5760,63300,37320,GB,GB
184244,1698929100,1698934620,5520,162569,38615,GB,GB
173877,1700543520,1700566440,22920,152732,41751,PL,NL
127611,1700077740,1700107920,30180,55833,190759,TR,TR
179686,1699587840,1699615620,27780,47812,2686,BA,HR
97107,1699206600,1699228860,22260,138119,152111,PL,PL
38476,1700125200,1700157540,32340,72029,390,TR,TR
15691,1699860900,1699876080,15180,14806,110569,US,US
50467,1698898080,1698920880,22800,120216,59145,BR,BR
129767,1700639160,1700669220,30060,29640,51862,TR,TR
71644,1699851120,1699869840,18720,145002,27577,FR,CZ
188922,1699130220,1699133820,3600,23726,150053,NL,NL
157227,1699046340,1699074300,27960,199434,55266,PL,PL
193987,1699724700,1699735320,10620,134389,49484,HR,HR
105607,1700136540,1700168580,32040,132202,172421,TR,TR
188977,1699140420,1699148520,8100,77336,91564,ES,ES
2921,1700109480,1700139060,29580,83861,10445,TR,TR
121917,1700644200,1700674500,30300,170261,62204,TR,TR
135149,1699341120,1699376520,35400,191959,4443,TR,TR
45750,1700652780,1700677620,24840,158736,118535,RO,MD
183622,1699344480,1699380300,35820,130247,16487,TR,TR
79044,1699686120,1699701120,15000,1476,3497,US,US
116994,1699044540,1699075320,30780,118353,8874,TR,TR
84708,1700293680,1700305560,11880,28904,45471,IT,IT
73678,1700619840,1700637360,17520,180805,86304,US,CA
125891,1699756980,1699790520,33540,186628,98881,TR,TR
40434,1700769960,1700805060,35100,62061,132691,TR,TR
187345,1699489080,1699497720,8640,193310,133767,IT,IT
190043,1700274960,1700299500,24540,59682,25308,ME,BA
111913,1699512960,1699544160,31200,151141,86485,TR,TR
99058,1699380960,1699407300,26340,118229,41378,DE,NL
62164,1700050920,1700085060,34140,75444,60403,MX,MX
143051,1699135860,1699166100,30240,123150,99193,TR,TR
119881,1699100400,1699129560,29160,70482,195485,TR,TR
72430,1699087020,1699116660,29640,162446,126235,TR,TR
106895,1698855900,1698859500,3600,129812,89858,GB,GB
141445,1699576860,1699607820,30960,179271,36657,TR,TR
76221,1699339440,1699372980,33540,8122,99270,TR,TR
121960,1700462940,1700493120,30180,77003,57917,TR,TR
162086,1699742400,1699747860,5460,42544,145126,GB,GB
167761,1700678760,1700708640,29880,157009,141382,TR,TR
44211,1699915800,1699920780,4980,196234,186838,NL,NL
16635,1699679700,1699695480,15780,160618,99258,US,US
71692,1699828920,1699862280,33360,53774,43891,TR,TR
199563,1699989540,1700007180,17640,89552,134048,CA,CA
40536,1700161800,1700176560,14760,43763,28166,US,US
806,1700774520,1700801700,27180,106895,164118,DE,DE
56219,1700447160,1700476260,29100,89376,103453,TR,TR
43469,1700319420,1700349300,29880,146155,61441,TR,TR
37041,1700469180,1700496660,27480,51745,12976,PL,HU
7794,1699149120,1699162860,13740,152390,56793,IT,IT
77543,1699929300,1699934580,5280,119517,77408,GB,GB
11565,1698973860,1699008660,34800,19443,134610,TR,TR
46841,1698999480,1699026900,27420,87160,33268,DE,CZ
7032,1699102140,1699105740,3600,188221,91929,GB,GB
67792,1700651580,1700682480,30900,17770,173834,TR,TR
97188,1699572480,1699578780,6300,125556,35362,NL,NL
183882,1699018140,1699053900,35760,35830,136695,TR,TR
4080,1700539620,1700551080,11460,19363,43615,US,US
73942,1699132020,1699149120,17100,158246,185889,US,US
157961,1700230140,1700259480,29340,179480,146079,TR,TR
169025,1699873020,1699881060,8040,57356,59908,IT,IT
173985,1699739100,1699748460,9360,184995,118176,ES,AD
149796,1700350560,1700379420,28860,195097,177000,TR,TR
13793,1700653680,1700691540,37860,92213,187350,MX,MX
134959,1700156400,1700191440,35040,121086,134696,TR,TR
142408,1699190820,1699194420,3600,5819,144614,NL,NL
156299,1699610280,1699637820,27540,162398,3610,PL,PL
170420,1699685220,1699710180,24960,8999,188776,HU,AT
61671,1699788480,1699818120,29640,74839,32597,TR,TR
195798,1700019780,1700028540,8760,159766,20332,IT,IT
53773,1700248080,1700259540,11460,129540,17716,HR,AT
182074,1700552280,1700566260,13980,29933,51889,IT,IT
15246,1700168040,1700179380,11340,139506,140205,ES,ES
185680,1698995700,1699024860,29160,191283,145359,TR,TR
124444,1699572540,1699594740,22200,94459,44763,PL,PL
20662,1700067900,1700088720,20820,198297,11483,FR,FR
90182,1700630880,1700663640,32760,63014,76854,TR,TR
98518,1700768280,1700798880,30600,150232,109361,TR,TR
109813,1700623500,1700674980,51480,180511,186734,BG,DE
107155,1698868680,1698880860,12180,169865,72860,US,US
193900,1699368600,1699381080,12480,39728,16335,ES,ES
42606,1699658400,1699686780,28380,106104,152617,RO,AT
142845,1698955740,1698966060,10320,184369,78366,IT,IT
84001,1700836020,1700871480,35460,76456,50624,TR,TR
184196,1700240580,1700244180,3600,154239,127418,GB,GB
29656,1699507620,1699524960,17340,50665,53302,US,US
167256,1699389840,1699393440,3600,58528,152522,GB,GB
81809,1700683260,1700688540,5280,148664,184004,NL,NL
101958,1699240800,1699254420,13620,10691,63529,US,US
126858,1698837480,1698847500,10020,155497,14454,IT,IT
191977,1699127940,1699131840,3900,3654,111028,CL,CL
17301,1699117560,1699129680,12120,101153,98595,AT,AT
52003,1699440600,1699463580,22980,29138,10084,RO,RO
17107,1700702520,1700711280,8760,36928,6337,IT,IT
142690,1699699860,1699718580,18720,195673,131954,FR,BE
175484,1699491000,1699525080,34080,35391,16540,TR,TR
71517,1699743840,1699747440,3600,97349,139014,NL,NL
175552,1699580280,1699611900,31620,153163,40185,TR,TR
169406,1699207080,1699219560,12480,15928,82640,PT,PT
12030,1699657380,1699672560,15180,172830,93998,RS,SI
96934,1699778460,1699809360,30900,44261,65164,TR,TR
87458,1700772780,1700784840,12060,150613,55564,AT,SK
48420,1699112040,1699141260,29220,99830,23718,TR,TR
63372,1700207640,1700240520,32880,99777,199466,TR,TR
35275,1700064660,1700069340,4680,96997,134847,NL,NL
113720,1700186040,1700211900,25860,111238,179111,HU,PL
120521,1700710020,1700736060,26040,35411,163312,DE,PL
52311,1700310660,1700343360,32700,36839,31776,TR,TR
171720,1699774800,1699778400,3600,121067,123743,GB,GB
148484,1700481120,1700510460,29340,51185,140267,TR,TR
189212,1699129620,1699134000,4380,57580,184338,GB,GB
130814,1700005080,1700034480,29400,103722,34355,TR,TR
28319,1700027940,1700034120,6180,156165,13592,GB,GB
141120,1699912020,1699944540,32520,46286,45418,TR,TR
12639,1700004060,1700029380,25320,153358,106206,PL,PL
47325,1700176920,1700207880,30960,166551,93046,TR,TR
61493,1700472900,1700507460,34560,72835,61904,TR,TR
79075,1699438320,1699450320,12000,110805,68871,IT,IT
198161,1699682520,1699696680,14160,168420,156633,IT,IT
186046,1700582400,1700586000,3600,107104,70045,GB,GB
43420,1699240320,1699253580,13260,74333,7931,ES,ES
85566,1699124640,1699158660,34020,80735,24681,TR,TR
165002,1698831600,1698857760,26160,198494,171105,BR,BR
156858,1699082700,1699096920,14220,103120,17788,IT,IT
186737,1699912260,1699944060,31800,169115,165633,TR,TR
60299,1699230120,1699262700,32580,19228,172233,TR,TR
52678,1700820900,1700838600,17700,44784,163362,US,US
79297,1700228160,1700260200,32040,75152,266,TR,TR
33532,1700150220,1700165820,15600,9772,180224,CZ,SK
194973,1700780880,1700795280,14400,152816,113476,US,CA
176772,1699961700,1699994940,33240,128928,175515,MX,MX
163324,1699520820,1699524420,3600,47782,173238,GB,GB
14394,1699779900,1699808760,28860,194958,11148,TR,TR
181010,1700362920,1700397240,34320,174951,116080,TR,TR
72458,1700307240,1700340240,33000,35859,174500,TR,TR
94257,1700527560,1700544720,17160,1575,142004,US,US
198764,1700365200,1700378640,13440,84807,90413,RS,RS
43839,1699688040,1699722000,33960,188507,67299,TR,TR
160287,1699800240,1699812960,12720,141880,6719,IT,IT
59458,1700570460,1700602980,32520,158118,191315,TR,TR
46188,1699390920,1699403400,12480,62,48243,US,US
56892,1700292840,1700323500,30660,198239,165223,TR,TR
140500,1699710420,1699765200,54780,66871,110204,BG,BG
84558,1700689740,1700722380,32640,174762,44469,TR,TR
99370,1699164660,1699181820,17160,97047,15427,US,US
182474,1700071680,1700088840,17160,187115,47319,US,US
54046,1699832220,1699849080,16860,130434,74685,SE,SE
66237,1700117100,1700146560,29460,109178,79778,TR,TR
117228,1699682700,1699718580,35880,40076,134108,TR,TR
15581,1700439360,1700470920,31560,147954,92041,TR,TR
185413,1700272500,1700306040,33540,167868,4673,TR,TR
29397,1700665260,1700676300,11040,62142,10755,ES,PT
79476,1700156280,1700188860,32580,26865,74754,TR,TR
154943,1699191600,1699200360,8760,95054,19971,HR,HR
175424,1698951660,1698975960,24300,76438,27548,DK,NO
5871,1699338720,1699354140,15420,109230,54095,US,US
64301,1699642740,1699678500,35760,61020,155738,TR,TR
114602,1700062140,1700091900,29760,98935,87934,TR,TR
110343,1699914120,1699945560,31440,164621,29023,TR,TR
121354,1699371840,1699385820,13980,123913,19796,IT,IT
142467,1700414460,1700442660,28200,160850,5204,DE,DE
129621,1699724820,1699729740,4920,34793,40795,GB,GB
194056,1699047300,1699066080,18780,61244,40944,BE,ES
44853,1700141940,1700151960,10020,196623,109236,IT,IT
169616,1700600940,1700604540,3600,119274,198998,GB,GB
164624,1700837640,1700841240,3600,22953,6824,GB,GB
151935,1700566560,1700592360,25800,93959,75061,BA,RS
72523,1698836280,1698842220,5940,137774,125192,GB,GB
13238,1699908540,1699919820,11280,22301,25615,IT,IT
138831,1699271940,1699304580,32640,169185,34353,TR,TR
66029,1698931020,1698943860,12840,120477,78051,IT,IT
182128,1700318580,1700352360,33780,145030,22886,TR,TR
170060,1699789080,1699813080,24000,144295,55504,DE,BG
99553,1698874440,1698907320,32880,140925,157012,TR,TR
118443,1699184040,1699210200,26160,195387,72235,PL,PL
73963,1700652000,1700656200,4200,102045,170640,GB,GB
12698,1699288140,1699317480,29340,96319,134134,TR,TR
60216,1700676600,1700708520,31920,131420,107761,TR,TR
99203,1699195560,1699202220,6660,79996,91646,NL,NL
199525,1699422420,1699452060,29640,74852,50203,TR,TR
94421,1698936000,1698945240,9240,119683,189077,IT,IT
80695,1699896720,1699924800,28080,44328,40194,PL,DE
107257,1699799580,1699835160,35580,165075,12722,TR,TR
75278,1700857860,1700869800,11940,109781,58901,AT,BG
50483,1699858380,1699873020,14640,118627,135112,BE,NL
110353,1699320240,1699337700,17460,26706,27667,US,US
152718,1700014320,1700034300,19980,119362,127315,FR,FR
146215,1699746060,1699779300,33240,56928,96573,TR,TR
1115,1699770600,1699800840,30240,95600,132850,TR,TR
176354,1698960900,1698996660,35760,190993,13215,TR,TR
154841,1699198920,1699207380,8460,33582,121129,IT,IT
109403,1700453640,1700465160,11520,29179,195646,US,US
188457,1700735340,1700746680,11340,81954,64074,IT,IT
174004,1699377000,1699394340,17340,91977,3480,US,US
55406,1700326080,1700361300,35220,170253,36738,TR,TR
124613,1699900740,1699917960,17220,111190,38269,US,US
89145,1699674540,1699689000,14460,173525,1999,BE,DE
175944,1699680720,1699692060,11340,48746,179554,US,CA
58184,1700828580,1700854740,26160,118855,89869,DE,DE
133402,1699449780,1699465800,16020,153330,187070,FR,FR
135089,1700287080,1700316540,29460,98483,153347,TR,TR
55291,1700596440,1700627400,30960,79574,155920,TR,TR
192387,1700135280,1700147880,12600,196389,39632,IT,IT
124347,1699876860,1699908840,31980,171933,123448,TR,TR
196924,1699387380,1699404060,16680,87100,63814,SE,SE
3908,1699851240,1699876500,25260,20382,156825,DE,HR
11204,1699077360,1699092120,14760,99754,196028,US,US
52331,1698831480,1698863220,31740,136504,127230,TR,TR
178193,1699782240,1699817340,35100,61036,175859,TR,TR
159836,1699155000,1699158600,3600,186624,140375,GB,GB
24732,1699919700,1699923780,4080,94799,172254,GB,GB
42261,1699103280,1699117740,14460,110297,52636,CA,CA
27039,1700710140,1700741160,31020,75816,129409,TR,TR
82716,1699323240,1699335060,11820,79854,9249,CZ,NL
189607,1699507980,1699511580,3600,184959,80859,NL,NL
73854,1698862740,1698868920,6180,133729,108646,NL,FR
85232,1698963600,1698980820,17220,125319,101161,FR,ES
168924,1699356480,1699364040,7560,37577,52246,HR,HR
25205,1699459380,1699476660,17280,114505,154484,US,US
75134,1699123200,1699155480,32280,159825,93584,TR,TR
59773,1699248660,1699255020,6360,124450,41863,NL,NL
159688,1700614080,1700629920,15840,146932,17763,US,US
109838,1700689380,1700720880,31500,112789,137963,TR,TR
55173,1699813260,1699832880,19620,113965,164176,FR,FR
116630,1699538520,1699555200,16680,159389,74671,FR,FR
18914,1699216860,1699248900,32040,168514,91329,TR,TR
86491,1699143240,1699150320,7080,149232,138717,NL,NL
68462,1699885680,1699891680,6000,101705,164117,GB,GB
78414,1700104320,1700140260,35940,11238,86811,TR,TR
27842,1700811120,1700825820,14700,145658,35598,FR,FR
8132,1700402280,1700436480,34200,81878,75320,TR,TR
89932,1698873960,1698900180,26220,129252,78409,HU,DE
134632,1698956700,1698969600,12900,76196,61823,US,US
193070,1699398540,1699404660,6120,148360,161476,GB,GB
149380,1699679160,1699690200,11040,69464,146120,US,US
126274,1699902960,1699907340,4380,148481,129426,GB,GB
44138,1700864940,1700868540,3600,111002,44991,GB,GB
31463,1700718120,1700732220,14100,32061,160758,IT,IT
112942,1698889020,1698902580,13560,20623,684,IT,IT
114629,1699642620,1699648080,5460,99594,22003,NL,NL
54980,1699695120,1699716120,21000,51554,44192,FR,FR
43701,1699686240,1699715820,29580,195805,13265,BA,HR
100186,1700161080,1700174280,13200,94337,112053,US,US
81688,1699428120,1699434780,6660,163529,167016,EE,EE
17734,1699830720,1699863780,33060,16617,99067,TR,TR
26874,1699854540,1699866780,12240,63826,135998,PT,PT
166882,1700301360,1700316420,15060,79060,113508,CZ,CZ
46288,1700506020,1700536140,30120,7454,133839,TR,TR
31657,1700510940,1700530500,19560,195441,139690,FR,NL
172284,1700171700,1700178000,6300,25143,6914,GB,GB
163400,1700622720,1700653440,30720,25932,56726,TR,TR
164255,1699175640,1699205160,29520,70946,82675,TR,TR
150399,1700302080,1700332860,30780,29699,78067,TR,TR
36671,1699808640,1699844040,35400,113948,135210,TR,TR
172362,1700607240,1700610840,3600,6710,30407,NL,NL
18537,1699094940,1699108560,13620,62725,180926,IT,IT
85524,1699056780,1699091340,34560,149290,193220,TR,TR
5533,1700596560,1700605860,9300,70537,197611,IT,IT
163967,1699552920,1699557840,4920,4790,72102,GB,GB
196126,1700245560,1700271480,25920,75370,162100,DE,HR
124566,1699355520,1699388460,32940,2165,44824,TR,TR
88068,1700266620,1700302140,35520,18756,120536,TR,TR
150344,1699554000,1699576860,22860,81547,66147,BR,BR
164151,1700859720,1700878560,18840,184128,35165,IN,IN
67857,1700759880,1700789580,29700,52767,138831,TR,TR
180336,1699703100,1699738800,35700,153596,109468,TR,TR
196468,1698865560,1698894420,28860,132608,87779,TR,TR
82743,1700567220,1700581260,14040,102852,150190,IT,IT
72813,1699407000,1699420800,13800,169678,199698,US,US
46999,1700862600,1700873340,10740,51444,147466,PT,PT
58694,1699387680,1699391280,3600,110057,21629,NL,NL
52867,1700344500,1700374980,30480,167396,75565,TR,TR
73795,1699392840,1699407180,14340,159009,166809,ES,ES
191357,1700631420,1700669460,38040,6891,33792,MX,MX
136038,1700492580,1700502240,9660,189563,113321,PT,PT
93750,1700030220,1700040060,9840,97180,69463,HR,HR
147676,1700594220,1700607240,13020,141754,104395,US,US
149348,1700624340,1700653140,28800,188655,146294,TR,TR
91807,1700807340,1700819040,11700,177019,173762,US,US
133801,1699104420,1699137180,32760,59519,156805,TR,TR
120734,1700301000,1700317620,16620,58852,78589,FR,FR
23304,1699725600,1699757700,32100,167834,82541,TR,TR
23186,1700375640,1700394180,18540,119513,51552,FR,FR
112572,1700534280,1700537880,3600,158388,78889,NL,NL
7953,1699240860,1699263660,22800,2802,191439,BR,BR
8456,1700582460,1700618160,35700,183544,60232,TR,TR
67963,1700215020,1700246160,31140,61096,188745,TR,TR
175328,1700013360,1700041920,28560,112657,30875,DE,DE
134829,1699761960,1699780020,18060,182073,37203,FR,FR
8280,1698895260,1698912060,16800,135653,23838,US,MX
100932,1700476920,1700485260,8340,16611,140564,PT,PT
67812,1700152860,1700164260,11400,103170,150257,IT,IT
73883,1699601520,1699626720,25200,135200,126113,PL,PL
58562,1700159100,1700186100,27000,15458,125981,DE,DE
142942,1699854720,1699858320,3600,92704,167020,GB,GB
137676,1700710140,1700744640,34500,148880,71679,TR,TR
167564,1700717400,1700721420,4020,39680,58175,NL,NL
3919,1699639920,1699651380,11460,122150,83771,US,US
197666,1699696440,1699730520,34080,51544,110876,TR,TR
16114,1699457460,1699463760,6300,31798,124535,GB,GB
97972,1699853880,1699869240,15360,68881,170214,FR,FR
168576,1699450380,1699480620,30240,130387,117386,TR,TR
2236,1700028120,1700054580,26460,125389,163601,DE,BA
103912,1700592480,1700609460,16980,129904,126981,FR,FR
192616,1700398500,1700410080,11580,87283,122336,US,US
102609,1700599680,1700626560,26880,40476,7251,DE,NL
114971,1699599600,1699615920,16320,148310,12492,AT,AT
80453,1698803160,1698814260,11100,187182,181675,ES,ES
150216,1699336080,1699355880,19800,67763,190337,FR,PL
179210,1699295640,1699306860,11220,29619,126973,IT,IT
97409,1700407680,1700419980,12300,135773,48515,HR,AT
158285,1700288400,1700322600,34200,112273,166711,TR,TR
12925,1700850420,1700881980,31560,61917,161826,TR,TR
137094,1699665480,1699694340,28860,76497,17684,TR,TR
155236,1700475180,1700510520,35340,1065,98940,TR,TR
21242,1699199640,1699204380,4740,172275,128822,NL,NL
168671,1698955620,1698986220,30600,11513,58958,TR,TR
86485,1700361840,1700391840,30000,167102,15518,TR,TR
11802,1700457240,1700491080,33840,81913,80391,TR,TR
106718,1700015220,1700047260,32040,45541,47230,TR,TR
182070,1700823180,1700856660,33480,93911,37687,TR,TR
61496,1699773300,1699808100,34800,64654,46301,TR,TR
26858,1700623920,1700628600,4680,96342,114407,GB,GB
166585,1700373540,1700391240,17700,100749,133894,FR,CH
135638,1699210200,1699233480,23280,193579,170759,BR,BR
133881,1699587840,1699601280,13440,108379,68338,US,US
130195,1699132380,1699163340,30960,84181,151138,TR,TR
27992,1700843040,1700869560,26520,180539,89501,BR,BR
47510,1698922020,1698937080,15060,79232,158849,US,US
62185,1698953040,1698986820,33780,41636,162491,TR,TR
150197,1699896120,1699903200,7080,59691,166155,GB,GB
198107,1699974420,1700035080,60660,49362,160779,UA,DE
194796,1699311300,1699322700,11400,58774,127369,US,US
24108,1699779360,1699814340,34980,84572,192847,TR,TR
164330,1699632420,1699645560,13140,160385,172461,AT,AT
144116,1698838980,1698860100,21120,90203,130833,FR,BE
25111,1700345280,1700377860,32580,38297,173274,TR,TR
190164,1699762500,1699785120,22620,41851,131268,DE,FR
78091,1699223160,1699245240,22080,95436,21875,PL,PL
150900,1700622960,1700656920,33960,49538,153849,MX,MX
11604,1700083200,1700090700,7500,120996,116961,HR,HR
47046,1699173300,1699180860,7560,94913,28129,IT,IT
71054,1700826000,1700839020,13020,126072,58978,US,US
128850,1700342820,1700353740,10920,87879,99724,PT,PT
127447,1699784580,1699816620,32040,20386,25728,TR,TR
191960,1700195580,1700199840,4260,64334,30210,GB,GB
95887,1700421180,1700424780,3600,143067,25019,GB,GB
67519,1700185020,1700201340,16320,63180,156670,US,US
22206,1699941420,1699951860,10440,158588,59758,PT,PT
108289,1700059740,1700094300,34560,100273,6311,TR,TR
43909,1699278360,1699284780,6420,96106,180018,NL,NL
13484,1700443680,1700457360,13680,83743,109687,IT,IT
59408,1699979160,1700014260,35100,158132,177736,TR,TR
185098,1700071260,1700101020,29760,166568,172767,TR,TR
12710,1700414400,1700430960,16560,5490,91462,US,US
138644,1699146900,1699175820,28920,174879,27412,TR,TR
143985,1699133220,1699165200,31980,127502,188716,TR,TR
197464,1700860140,1700871480,11340,99468,69504,US,US
184415,1699190580,1699195680,5100,101043,103550,GB,GB
17737,1699791840,1699808880,17040,137686,137453,CA,US
169328,1699829760,1699845240,15480,10895,161290,US,US
188161,1699942980,1699957680,14700,3288,102207,US,US
95959,1700254140,1700258100,3960,125253,128998,GB,GB
118132,1699767720,1699785240,17520,198429,176403,US,US
66513,1699888200,1699911420,23220,168729,149017,BR,BR
32731,1700715720,1700726940,11220,126088,88457,US,US
77335,1699504740,1699530720,25980,174201,69878,PL,PL
192684,1700451600,1700473140,21540,174729,131200,FR,RS
197753,1700708040,1700732460,24420,3732,196708,DK,DK
157731,1699680060,1699689360,9300,116432,15452,IT,IT
68190,1700436360,1700470800,34440,55241,120323,TR,TR
94814,1699331040,1699365960,34920,66894,84395,TR,TR
3006,1699059120,1699089540,30420,100587,113644,TR,TR
54555,1700743620,1700771640,28020,5503,42733,DE,DE
48804,1699822740,1699836300,13560,126141,196205,HR,HR
42477,1700141700,1700158080,16380,88337,29302,FR,PT
80766,1700740980,1700766480,25500,77373,47088,BR,BR
156051,1700533080,1700536740,3660,31324,11194,GB,GB
102794,1700422560,1700452380,29820,31284,11572,TR,TR
192700,1700426160,1700429760,3600,65824,172657,GB,GB
138349,1700119560,1700130780,11220,189503,44267,IT,IT
195746,1699824180,1699858680,34500,186680,147352,TR,TR
81340,1700118780,1700126640,7860,181307,191695,IT,IT
183312,1700494260,1700526180,31920,196148,166978,TR,TR
71366,1700784900,1700802540,17640,92189,189008,US,US
35968,1700548500,1700565600,17100,18799,41529,US,US
131431,1699069080,1699083360,14280,172416,79056,ES,AD
178950,1700027940,1700040540,12600,130603,84637,US,US
62695,1699523640,1699559340,35700,22283,178080,MX,MX
111208,1699883460,1699912860,29400,648,87060,TR,TR
142879,1699162620,1699195920,33300,146781,5045,TR,TR
28503,1700354040,1700359140,5100,77969,57076,GB,GB
49936,1699163520,1699198440,34920,165971,129960,TR,TR
181389,1700428140,1700446020,17880,179324,162349,FR,NL
176731,1700775180,1700810640,35460,125820,132681,TR,TR
14581,1700149680,1700157660,7980,168381,142906,IT,IT
184661,1698868920,1698874980,6060,74819,125849,GB,GB
146763,1699132800,1699186980,54180,155994,135265,BG,DE
108700,1699056780,1699073280,16500,89725,6377,AT,DE
56141,1700699580,1700703180,3600,87676,60146,GB,GB
15869,1700365980,1700380140,14160,44527,94038,IT,IT
32709,1699971780,1699983300,11520,139644,196109,IT,IT
157184,1699655160,1699659360,4200,21518,184565,GB,GB
54416,1699800180,1699829940,29760,120127,83891,TR,TR
178283,1700634540,1700647200,12660,69225,142781,IT,IT
128478,1700045640,1700049300,3660,177805,147459,NL,NL
11815,1700503380,1700533380,30000,40444,142159,TR,TR
110619,1698983520,1698987120,3600,92255,78040,NL,NL
85728,1699031220,1699045020,13800,174384,110897,US,US
102695,1699469040,1699504500,35460,143144,152665,TR,TR
34588,1698926880,1698948660,21780,23137,138466,BR,BR
6662,1700320680,1700355000,34320,24722,48820,TR,TR
159765,1700556540,1700591100,34560,112303,69429,TR,TR
26512,1699887000,1699899240,12240,85075,172545,AT,SK
185732,1698875220,1698907200,31980,88202,158900,TR,TR
49180,1700162340,1700201400,39060,24629,135208,MX,US
154089,1698945600,1698949200,3600,80664,136094,GB,GB
49939,1699836540,1699871460,34920,161489,191257,TR,TR
42168,1699610220,1699620360,10140,17083,6203,HR,BA
187560,1699816980,1699825980,9000,144549,58627,ES,AD
104604,1700031420,1700065140,33720,84267,158495,TR,TR
115783,1700462160,1700496600,34440,196357,150496,TR,TR
161491,1700093040,1700106180,13140,84115,182120,IT,IT
142235,1700695800,1700706900,11100,122770,34617,IT,IT
169047,1700835420,1700846640,11220,139594,188596,US,US
79285,1700438400,1700469000,30600,90389,34986,TR,TR
156307,1700213400,1700243580,30180,88946,119722,TR,TR
130270,1700090940,1700096940,6000,115723,187041,AD,ES
110686,1700238120,1700243520,5400,16970,117629,GB,GB
32439,1699279560,1699302780,23220,188346,174062,DK,DK
51351,1698911400,1698945240,33840,96450,49754,TR,TR
14703,1699854360,1699887660,33300,139803,102472,TR,TR
39753,1700293020,1700324580,31560,196651,8194,TR,TR
122770,1699054860,1699081260,26400,52216,144027,DE,HR
11300,1699766880,1699770480,3600,77291,134736,NL,NL
144807,1700568240,1700582340,14100,74918,37469,US,US
158462,1700377020,1700412240,35220,79120,199511,TR,TR
173857,1699073880,1699106040,32160,134527,9969,TR,TR
51501,1700367540,1700396640,29100,83200,43691,TR,TR
53537,1700410380,1700416320,5940,152168,181551,NL,NL
140210,1700095800,1700115840,20040,45873,38329,FR,FR
180597,1700579160,1700586600,7440,62558,32554,HR,DE
114707,1700219160,1700246640,27480,150550,136173,RO,RO
140539,1700846040,1700859840,13800,67137,133447,RS,ME
126419,1698936780,1698940380,3600,162992,43685,NL,NL
18142,1700840760,1700876460,35700,180725,109574,TR,TR
148317,1698878160,1698887100,8940,87316,31659,IT,IT
188466,1699465440,1699481700,16260,190442,102231,US,US
104766,1700864700,1700877240,12540,62272,32068,RS,NL
101661,1700629920,1700638440,8520,193920,89929,HR,HR
4353,1700784300,1700795040,10740,91809,12086,IT,IT
20818,1699804260,1699816440,12180,196329,189937,AT,AT
145987,1700731500,1700761380,29880,154531,30015,TR,TR
94500,1700579340,1700595240,15900,162377,175164,FR,FR
76614,1700033700,1700059080,25380,13357,45247,BR,BR
132076,1700762340,1700774340,12000,65264,165077,US,US
178407,1699112220,1699141500,29280,170495,83171,TR,TR
128842,1700551260,1700554860,3600,82035,178956,GB,GB
147199,1700530500,1700562540,32040,125190,5020,TR,TR
102182,1700142060,1700171520,29460,70090,68207,TR,TR
12360,1698835320,1698855420,20100,160691,13439,FR,DE
176588,1699588860,1699594500,5640,39476,98330,GB,GB
156606,1699072980,1699091400,18420,24034,63159,AL,BA
137730,1699989480,1700000760,11280,34450,49234,US,US
62195,1700864280,1700867940,3660,31612,69190,FI,EE
39280,1699500120,1699503720,3600,76994,163441,NL,NL
163868,1700325720,1700339760,14040,136791,69963,IT,IT
75268,1699288500,1699292520,4020,14,185340,CL,CL
153932,1700815440,1700825940,10500,119018,23481,PT,PT
180328,1700616000,1700644860,28860,146390,74702,TR,TR
161638,1698810600,1698823080,12480,20638,136625,ES,PT
87711,1699064220,1699095360,31140,163925,111464,TR,TR
192306,1700430660,1700454060,23400,123694,27613,PL,PL
34917,1700763480,1700792700,29220,187098,194741,TR,TR
11936,1700204280,1700215140,10860,195670,117029,ES,AD
175740,1700509560,1700544120,34560,173715,42987,TR,TR
126456,1699860780,1699890960,30180,97745,170041,TR,TR
131145,1700689260,1700694240,4980,150275,50597,GB,GB
38243,1699694880,1699699080,4200,43318,162979,GB,GB
26705,1699333500,1699356540,23040,85232,97853,DE,DE
140917,1700180520,1700184120,3600,96868,112247,GB,GB
106874,1700013480,1700035440,21960,179118,57428,HU,DE
28707,1698999960,1699034820,34860,3962,23281,TR,TR
121959,1700252220,1700289360,37140,38578,70150,MX,MX
161672,1698863580,1698881340,17760,134652,3499,AT,DE
102822,1699483680,1699519980,36300,64835,70279,MX,MX
48171,1699776240,1699808580,32340,124605,20679,TR,TR
160981,1699240440,1699264020,23580,4674,183557,DE,DE
37054,1699321680,1699325280,3600,131783,157834,GB,GB
57595,1699794180,1699819860,25680,66797,127496,HU,DE
110515,1700221200,1700227860,6660,47212,93436,NL,NL
92355,1699338840,1699363560,24720,63098,2690,DE,NL
104496,1699123440,1699135860,12420,105285,177846,IT,IT
73842,1698801360,1698833640,32280,129922,71210,TR,TR
84159,1700730960,1700747580,16620,197000,54894,US,US
161893,1699023000,1699049040,26040,181785,9510,BR,BR
166927,1698861240,1698894540,33300,54801,96425,TR,TR
93872,1699809000,1699842240,33240,52098,126021,TR,TR
98139,1699024320,1699039500,15180,188936,3927,FR,FR
84291,1700307600,1700319300,11700,118205,198273,SK,SK
184476,1699184640,1699192800,8160,1947,183702,HR,HR
101346,1700613540,1700627760,14220,90157,2261,RS,RS
26885,1700818140,1700850540,32400,90147,123672,TR,TR
9251,1699214100,1699223040,8940,83822,155339,IT,IT
30239,1700125200,1700157960,32760,72517,145462,MX,MX
34736,1698802740,1698815340,12600,128347,38164,RS,RS
60,1700129820,1700163900,34080,61638,195212,TR,TR
3445,1698870840,1698884520,13680,59580,177341,CZ,CZ
164211,1700150160,1700161680,11520,87247,63663,PT,PT
27272,1699555260,1699561080,5820,190034,65657,GB,GB
63179,1700279820,1700295660,15840,31209,41785,US,US
159187,1700534160,1700553600,19440,173886,77887,BE,NL
150975,1700120580,1700150820,30240,97534,151592,TR,TR
71285,1700025000,1700059260,34260,168972,41844,TR,TR
129173,1700440140,1700449800,9660,177012,142087,IT,IT
5713,1700538240,1700541840,3600,90793,24465,GB,GB
47758,1699285500,1699299780,14280,178888,160261,US,US
154849,1699344120,1699351260,7140,38173,18697,NL,NL
108687,1699870680,1699900920,30240,192292,32936,TR,TR
198349,1700186400,1700217360,30960,23621,87513,TR,TR
72450,1699655640,1699689840,34200,101882,94173,TR,TR
181212,1698838560,1698873840,35280,199068,39214,TR,TR
23327,1700522160,1700534460,12300,61519,56257,IT,IT
103596,1700290140,1700323500,33360,24090,192772,TR,TR
128974,1700014800,1700019360,4560,32609,58260,NL,NL
57277,1700363460,1700399340,35880,132553,14134,TR,TR
2413,1700169660,1700184720,15060,198739,134196,US,US
27794,1700246040,1700279580,33540,89614,28675,TR,TR
131810,1699109760,1699142280,32520,63652,36629,TR,TR
7550,1698796980,1698811200,14220,51149,32734,SK,CZ
98359,1699315020,1699319880,4860,180537,125471,GB,GB
61584,1700511360,1700543280,31920,46268,190560,TR,TR
167933,1699132560,1699143720,11160,10367,197731,AT,AT
73882,1699577820,1699602840,25020,26905,106760,DE,DE
29555,1700204040,1700215320,11280,164006,163280,US,US
134533,1700143500,1700150760,7260,196164,139306,HR,HR
64766,1700351280,1700358840,7560,148388,110858,IT,IT
18207,1699586040,1699597080,11040,121793,112262,ES,ES
134010,1700759940,1700790360,30420,138942,197110,TR,TR
109686,1700466120,1700491260,25140,6112,193071,PL,NL
112091,1700843700,1700878080,34380,22413,198562,TR,TR
17200,1700714040,1700718060,4020,20240,43670,GB,GB
32933,1700436540,1700472360,35820,182639,14582,TR,TR
41852,1698926040,1698933900,7860,97988,94537,IT,IT
93459,1699485900,1699519560,33660,9701,168896,TR,TR
88333,1699499760,1699532880,33120,191603,34830,TR,TR
85366,1699167060,1699194540,27480,160784,56417,DE,DE
146887,1700645700,1700678580,32880,197933,62920,TR,TR
92166,1700541720,1700553720,12000,80423,192754,IT,IT
95375,1698803400,1698837960,34560,109103,58771,TR,TR
127082,1698804600,1698839520,34920,110162,170217,TR,TR
29162,1698827220,1698852060,24840,17533,113687,DE,DE
90225,1698990360,1699015500,25140,35425,18232,PL,CZ
32027,1700782500,1700786100,3600,29389,32418,NL,NL
22865,1700240640,1700270400,29760,42142,133949,TR,TR
143715,1700442120,1700475840,33720,35299,157564,TR,TR
102616,1699164060,1699191960,27900,6996,181300,HU,CZ
146751,1700002620,1700006220,3600,12221,59196,NL,NL
75701,1699617120,1699620720,3600,148677,138413,NL,NL
34492,1698882540,1698886140,3600,20682,25007,GB,GB
165654,1700137080,1700147700,10620,11413,3765,IT,IT
188249,1700051040,1700065440,14400,52973,86409,US,US
114417,1700346900,1700350500,3600,20365,66054,NL,NL
170846,1698801540,1698836400,34860,115774,28696,TR,TR
30079,1700773980,1700828940,54960,147214,15397,BG,AT
195234,1700155020,1700162460,7440,113237,8632,IT,IT
100969,1699752600,1699756200,3600,89294,191928,GB,GB
123924,1698999240,1699026960,27720,73998,162533,DE,DE
104546,1699104780,1699129200,24420,59394,153919,AL,MK
32042,1699704060,1699735620,31560,89395,173379,TR,TR
17680,1698912300,1698944340,32040,172269,158315,TR,TR
117103,1700160720,1700175540,14820,32034,184329,US,US
176327,1699504260,1699520460,16200,68602,181604,US,US
47735,1700094960,1700102100,7140,57887,44425,GB,GB
104031,1700134980,1700170680,35700,122739,134118,TR,TR
94776,1700400780,1700431800,31020,171872,109065,TR,TR
195397,1698912720,1698943320,30600,52610,104330,TR,TR
72429,1700530680,1700561820,31140,18519,185674,TR,TR
100949,1699705320,1699732140,26820,89386,159874,BR,BR
25864,1699873320,1699905720,32400,112683,184527,TR,TR
113196,1699452600,1699464780,12180,43377,33935,AT,AT
188190,1698850860,1698855060,4200,75206,81766,NL,NL
7238,1700554020,1700580840,26820,129270,55917,PL,DE
84595,1699284960,1699318920,33960,145992,16247,MX,MX
124604,1698915900,1698932880,16980,129399,184927,US,US
84094,1699585920,1699608780,22860,184130,42880,DE,DE
49895,1699119480,1699133760,14280,101572,188736,RS,RS
177418,1700643480,1700647080,3600,7749,115204,NL,NL
12502,1700603220,1700616960,13740,671,98023,US,US
176806,1700145900,1700156700,10800,192431,11457,RS,SI
81599,1699871700,1699902000,30300,77419,7320,TR,TR
42239,1700102640,1700136060,33420,34981,79981,TR,TR
156294,1700762460,1700771100,8640,140471,126975,HR,HR
193461,1699136280,1699168860,32580,69563,87694,TR,TR
27266,1700763120,1700798040,34920,182248,15633,TR,TR
182411,1700374740,1700409120,34380,193074,59289,TR,TR
91236,1699092660,1699127640,34980,139566,43097,TR,TR
160726,1700216160,1700250840,34680,98056,62948,MX,MX
107919,1700326800,1700361060,34260,122136,87922,TR,TR
164901,1699371360,1699405500,34140,23315,41848,TR,TR
11434,1700775960,1700801460,25500,154816,18032,DE,BA
77390,1700595660,1700605800,10140,152339,85628,IT,IT
40566,1699340160,1699371360,31200,118592,171271,TR,TR
156331,1700685420,1700705820,20400,6973,54972,BE,FR
37851,1700484420,1700500920,16500,111110,168480,US,US
10545,1700344680,1700350740,6060,105239,68519,GB,GB
105307,1698876720,1698892620,15900,41978,55035,FR,FR
127351,1700192100,1700196840,4740,62419,24238,GB,GB
11095,1699202820,1699237260,34440,185652,130482,TR,TR
130319,1700384400,1700414100,29700,47724,68663,TR,TR
88179,1700553900,1700557500,3600,161993,122381,GB,GB
99914,1700600940,1700622420,21480,193777,148031,MD,RO
27921,1699675020,1699678620,3600,160172,120638,NL,GB
73438,1699925280,1699951800,26520,96300,121837,DE,FR
85076,1699412220,1699424940,12720,5936,149873,IT,IT
143257,1700371860,1700386560,14700,162258,188726,US,US
120808,1699633440,1699665900,32460,111340,179105,TR,TR
118144,1699252920,1699284780,31860,24316,161998,TR,TR
86134,1700017560,1700030460,12900,154823,174707,HR,HR
140903,1699406700,1699429740,23040,56165,29580,DE,NL
100239,1700631960,1700662920,30960,30542,38898,TR,TR
19270,1699155660,1699169160,13500,183912,156413,US,US
53940,1699578300,1699595640,17340,60350,153496,US,US
109229,1700761260,1700778840,17580,35881,104629,SE,SE
75047,1699086900,1699119000,32100,173774,93832,TR,TR
134345,1700676060,1700700600,24540,5776,160400,DE,DE
3493,1699148460,1699157940,9480,95202,166665,IT,IT
142448,1699036440,1699071900,35460,44925,13008,TR,TR
27838,1700167200,1700199240,32040,50294,187846,TR,TR
188044,1699115760,1699119360,3600,167034,50138,GB,GB
44530,1700195760,1700202060,6300,63332,128823,GB,GB
165494,1699616880,1699622760,5880,61067,63916,NL,NL
107447,1699316220,1699352160,35940,147988,21678,TR,TR
166088,1700639460,1700665560,26100,127945,7219,DE,BA
46348,1699154400,1699186140,31740,123145,106120,TR,TR
101303,1699383120,1699413660,30540,39798,85182,TR,TR
190577,1699822500,1699839120,16620,86387,104047,US,US
49794,1700334000,1700345460,11460,43441,63829,US,US
116174,1700443560,1700447160,3600,51900,113376,GB,GB
166753,1699318680,1699334460,15780,128997,173164,US,US
36316,1700124900,1700139540,14640,132958,86045,RS,RS
28650,1698975300,1699010640,35340,82295,180649,TR,TR
39995,1700038080,1700051040,12960,107408,141049,PT,PT
70312,1699579560,1699592280,12720,165065,187318,IT,IT
70565,1698820560,1698830340,9780,153034,25910,IT,IT
51706,1700576220,1700581380,5160,117822,104161,GB,GB
124814,1700866320,1700874240,7920,109893,118737,ES,ES
145613,1699685400,1699689000,3600,88160,138116,GB,GB
106969,1699467720,1699477800,10080,14077,36235,HR,HR
133435,1699575240,1699592760,17520,163020,164991,FR,FR
82845,1699204800,1699208400,3600,162439,88047,GB,GB
182151,1700447340,1700456940,9600,180459,16881,HR,HR
137155,1700592600,1700603640,11040,24823,153506,PT,PT
59434,1700321940,1700330820,8880,14016,148416,HR,HR
93425,1699910400,1699927140,16740,78832,14942,FR,FR
161778,1699905420,1699915380,9960,106126,2988,IT,IT
177822,1699376460,1699406820,30360,180975,36656,TR,TR
36634,1700367360,1700391000,23640,142730,39591,NO,DE
53943,1700551140,1700578440,27300,54882,75153,PL,DE
115749,1699199340,1699216080,16740,193,161300,US,US
199803,1700585520,1700620200,34680,12311,165253,TR,TR
185229,1699547040,1699578660,31620,194037,23757,TR,TR
155073,1698832980,1698860700,27720,167064,66453,DE,DE
116640,1699302240,1699335240,33000,194584,39477,TR,TR
112722,1699634100,1699665780,31680,197593,29270,BA,AL
153908,1698865500,1698896340,30840,194544,187875,TR,TR
195107,1700280120,1700288640,8520,115132,96762,HR,HR
175364,1700468580,1700499240,30660,95597,126213,TR,TR
104246,1700412480,1700423820,11340,138045,152748,IT,IT
65436,1699043940,1699076340,32400,17425,60222,TR,TR
40317,1699015140,1699047000,31860,68157,160394,TR,TR
147266,1699867740,1699875540,7800,67490,18484,IT,IT
158005,1700112960,1700124300,11340,199204,64609,US,US
133594,1699624320,1699659060,34740,94382,48636,MX,MX
134490,1700562360,1700595300,32940,199557,180511,TR,TR
169039,1699721820,1699756800,34980,185962,49851,TR,TR
137533,1699634220,1699645560,11340,170610,60426,IT,IT
56619,1699478520,1699508220,29700,153943,149547,TR,TR
73616,1699611240,1699624560,13320,81356,160071,IT,IT
155662,1699034340,1699067340,33000,55363,36016,TR,TR
33111,1699119840,1699130880,11040,108108,139382,US,US
162584,1699087560,1699119120,31560,111139,133939,TR,TR
146919,1699609380,1699615560,6180,69110,17718,FI,EE
88497,1700056620,1700090760,34140,131215,93728,TR,TR
136388,1700061180,1700077020,15840,49065,154195,US,US
74941,1699684020,1699718400,34380,28037,142506,TR,TR
17706,1700839320,1700875800,36480,121748,104622,MX,MX
75779,1699387920,1699405500,17580,121614,23498,CZ,DE
119451,1699719000,1699754280,35280,168603,78330,TR,TR
164686,1698931140,1698965940,34800,111060,173617,TR,TR
163764,1699986060,1699989660,3600,106046,171596,NL,NL
159753,1699836600,1699848060,11460,68468,127995,SK,IT
193953,1699777140,1699791000,13860,88899,77163,IT,IT
75160,1700530860,1700542620,11760,103657,125573,IT,IT
153022,1698805740,1698815340,9600,127751,149340,IT,IT
115077,1700119200,1700151300,32100,16285,187742,TR,TR
25176,1700821200,1700859060,37860,117925,24584,MX,MX
131414,1700283960,1700298120,14160,131278,160435,US,US
49666,1699862820,1699867260,4440,191776,117066,NL,NL
148936,1700832480,1700861640,29160,20688,78065,TR,TR
132395,1698984120,1698987960,3840,105538,158905,GB,GB
131766,1700175060,1700200200,25140,163296,86891,BR,BR
39151,1699020540,1699056360,35820,44949,155841,TR,TR
48070,1699452180,1699486980,34800,3790,116719,TR,TR
190337,1699565460,1699598460,33000,59700,138572,TR,TR
184260,1699617300,1699648740,31440,178357,67569,TR,TR
148630,1699763700,1699792620,28920,47698,48415,TR,TR
152049,1700423220,1700434980,11760,161094,76484,US,US
131503,1700412420,1700447460,35040,106301,96496,TR,TR
186533,1699998000,1700022060,24060,18198,76561,PL,AT
27450,1700857560,1700872440,14880,13585,28214,US,US
68633,1699783620,1699814520,30900,62669,93731,TR,TR
108500,1699313400,1699343340,29940,66523,81916,TR,TR
185636,1700136600,1700149920,13320,183786,163665,US,US
102578,1699365840,1699397340,31500,25071,44625,TR,TR
149501,1700374860,1700406600,31740,117150,31023,TR,TR
51401,1699207080,1699238760,31680,20740,176103,TR,TR
134951,1700205480,1700235240,29760,19309,150624,TR,TR
134091,1699088580,1699092180,3600,36442,195038,GB,GB
150641,1698824820,1698859260,34440,83620,88261,TR,TR
156844,1699035480,1699051740,16260,74388,116590,US,US
82581,1699905660,1699911540,5880,158932,157976,NL,NL
184612,1699960440,1699987800,27360,123819,182893,DE,DE
176368,1699801560,1699807980,6420,157498,181734,NL,NL
37311,1700695260,1700724360,29100,166436,140549,TR,TR
132454,1700782920,1700791800,8880,121231,91905,ES,ES
167874,1698997260,1699028160,30900,66526,87202,TR,TR
110836,1700095620,1700108880,13260,183174,134017,PT,PT
68830,1700790600,1700825580,34980,113941,117133,MX,MX
95542,1699357680,1699387140,29460,163060,15230,TR,TR
22251,1700580180,1700602620,22440,97433,107217,DE,AT
98347,1699410360,1699423080,12720,179459,74481,US,US
155467,1700586900,1700600100,13200,93831,128871,US,CA
63715,1699497660,1699528260,30600,147795,91126,TR,TR
190490,1698846300,1698881040,34740,154054,180783,TR,TR
133684,1699411020,1699423920,12900,2208,87766,IT,IT
148747,1700064600,1700079180,14580,44487,131945,FR,NL
84600,1700219520,1700249580,30060,30589,47729,TR,TR
60637,1700336940,1700349720,12780,120841,193180,HR,HR
89820,1699571400,1699575000,3600,177497,7917,NL,BE
133200,1698861120,1698875520,14400,122038,123922,RS,RS
174505,1699462320,1699479060,16740,8117,72548,US,US
110438,1700552880,1700584620,31740,173228,94683,MK,RS
102848,1699675320,1699699080,23760,184836,89714,BR,BR
171204,1700072820,1700076660,3840,20284,91371,NL,NL
90377,1699796640,1699824240,27600,67859,59187,DE,BA
185597,1698853920,1698889500,35580,6594,116153,TR,TR
56406,1700332260,1700344200,11940,66003,9595,ES,ES
20365,1699874820,1699892520,17700,15139,181829,AT,AT
69069,1700837220,1700872740,35520,44961,158192,TR,TR
135096,1699462020,1699477500,15480,170598,47034,FR,NL
59005,1700067600,1700080380,12780,44537,147536,IT,IT
109874,1700087280,1700118780,31500,173033,26376,TR,TR
169489,1699637880,1699665960,28080,93206,86314,DE,DE
193491,1700478780,1700538600,59820,88731,95759,UA,DE
183667,1700192100,1700208840,16740,146185,94299,US,MX
54815,1700531340,1700535540,4200,96353,184731,GB,GB
176294,1700220060,1700253420,33360,133076,50378,TR,TR
60616,1699216680,1699245600,28920,89902,177214,TR,TR
88845,1698793320,1698825720,32400,164013,81628,TR,TR
135348,1700087640,1700101980,14340,125952,31898,US,US
163012,1700166060,1700178900,12840,835,128972,IT,IT
149473,1699437600,1699451580,13980,145257,60213,HR,HR
32154,1700497740,1700533560,35820,168764,7291,TR,TR
179354,1700227380,1700260200,32820,4757,168051,TR,TR
166558,1698920940,1698956580,35640,134093,110519,TR,TR
71738,1700022180,1700039640,17460,71980,21857,US,US
56524,1700834640,1700847360,12720,30806,104415,ES,PT
103852,1700444580,1700480460,35880,51708,125540,TR,TR
12205,1699039920,1699043520,3600,155256,65684,GB,GB
59764,1699770480,1699796280,25800,164313,48591,PL,DE
114919,1699661880,1699683000,21120,155919,180685,FR,NL
146287,1699767960,1699776780,8820,69689,66681,AD,FR
153020,1700009280,1700013120,3840,142538,194585,GB,GB
168570,1699875360,1699878960,3600,173772,184050,GB,GB
106813,1700856420,1700860020,3600,112544,175813,GB,GB
158511,1699963140,1699974660,11520,37454,6339,RS,RS
88286,1698839760,1698852480,12720,121191,158910,IT,IT
82056,1699365600,1699372020,6420,44857,192107,GB,GB
197814,1700544300,1700569800,25500,69446,3613,RO,RO
192209,1699568580,1699594260,25680,135992,92422,RO,RO
172266,1699185960,1699216320,30360,88817,46477,TR,TR
22714,1700361360,1700384880,23520,193270,161915,DE,AT
16035,1700736420,1700769360,32940,137625,142845,TR,TR
63814,1700301900,1700322300,20400,60704,128673,SE,DE
16183,1700572020,1700607540,35520,9382,182946,TR,TR
52112,1698826860,1698840660,13800,15320,35423,US,US
70555,1698863820,1698880260,16440,147028,161237,FR,FR
27708,1698963960,1698997920,33960,198713,101511,TR,TR
22241,1698849240,1698884220,34980,103637,171184,MX,US
82930,1700779380,1700792100,12720,25816,124509,US,US
198510,1700102220,1700113440,11220,188167,13848,US,US
84202,1700635380,1700666940,31560,144015,33154,TR,TR
160311,1699294080,1699328940,34860,176288,48267,TR,TR
132226,1700796660,1700801580,4920,54933,138924,GB,GB
34447,1700753040,1700762940,9900,102694,20516,IT,IT
19422,1699791840,1699807560,15720,52730,106227,US,US
160331,1699233660,1699245480,11820,24675,60872,PT,PT
1374,1700414220,1700417820,3600,142138,78523,GB,GB
188351,1699904940,1699936800,31860,69495,74449,TR,TR
68105,1700678940,1700682780,3840,430,38803,GB,GB
3033,1700473260,1700490660,17400,73351,194751,US,MX
87557,1700029440,1700061960,32520,33715,171094,TR,TR
24347,1700164980,1700173020,8040,33954,95856,HR,HR
123493,1700625900,1700639460,13560,146856,50164,US,US
43358,1699465260,1699479960,14700,159270,85928,US,US
98248,1700479920,1700508780,28860,146135,42080,TR,TR
155850,1699147620,1699159440,11820,98558,132811,CZ,AT
55679,1700764560,1700769420,4860,51391,67964,GB,GB
28320,1699301700,1699331340,29640,29303,44384,TR,TR
169393,1699924200,1699959420,35220,55445,169856,TR,TR
122367,1700572920,1700605860,32940,32405,156874,TR,TR
96234,1700069880,1700093340,23460,47524,169969,DE,DE
59945,1700401380,1700434140,32760,106072,14885,TR,TR
125213,1700313780,1700346660,32880,199443,198010,TR,TR
314,1699470900,1699474500,3600,20663,160211,GB,GB
169864,1700380980,1700394720,13740,32308,112969,US,CA
156795,1700660700,1700686560,25860,71586,108807,BR,BR
134896,1700148000,1700164800,16800,90433,26689,US,US
68415,1698802200,1698834180,31980,6840,176459,TR,TR
173833,1700215680,1700244420,28740,27825,123331,PL,HU
126632,1700011980,1700042460,30480,191179,93756,TR,TR
105790,1700468280,1700499420,31140,129107,16305,TR,TR
167527,1698795420,1698834300,38880,185665,196738,MX,MX
133373,1698988440,1699000200,11760,189297,152239,PT,PT
137235,1699445520,1699449120,3600,183393,23025,NL,NL
187826,1699030680,1699036320,5640,67599,175088,GB,GB
87177,1700598000,1700603820,5820,115886,123722,GB,GB
183806,1699186860,1699196640,9780,157032,37840,AD,ES
108385,1699114380,1699123440,9060,161034,40327,IT,IT
193372,1699372860,1699403040,30180,141648,195092,TR,TR
61463,1699110540,1699117260,6720,188811,33521,GB,GB
111489,1700329140,1700340900,11760,128486,124353,US,US
168468,1699549140,1699562160,13020,37335,4945,IT,IT
122830,1699396920,1699416420,19500,160923,111750,FR,IT
73582,1700196540,1700230500,33960,68591,147129,TR,TR
159488,1700748660,1700761860,13200,56237,36450,ES,ES
76223,1700311380,1700343420,32040,62382,129661,TR,TR
87377,1699002540,1699014720,12180,177517,50436,ES,ES
146062,1700727300,1700742300,15000,96506,186946,US,US
28668,1699856400,1699889400,33000,83436,18854,TR,TR
85138,1700178900,1700196420,17520,85251,112181,RS,SI
100232,1700542620,1700572380,29760,199105,135212,TR,TR
172614,1700069820,1700082660,12840,34479,8917,IT,IT
126846,1700490420,1700510520,20100,12019,117077,LT,PL
83127,1699887660,1699921500,33840,23997,152282,TR,TR
168424,1699394520,1699419660,25140,16550,97900,DE,DE
37977,1700291760,1700321940,30180,190770,44974,TR,TR
137082,1699266180,1699286820,20640,130285,75485,DK,DE
177919,1699942380,1699977840,35460,195689,156963,TR,TR
190352,1700743080,1700778660,35580,17970,178544,TR,TR
30718,1700032920,1700065140,32220,163299,96374,TR,TR
60421,1699153020,1699166400,13380,13154,33396,IT,IT
162855,1700628120,1700641800,13680,21520,53338,US,US
187241,1698884700,1698902340,17640,195917,20102,CZ,AT
185660,1700137740,1700168460,30720,139008,182308,TR,TR
9070,1699922820,1699948320,25500,12328,107930,BR,BR
7226,1700307480,1700318940,11460,133754,187113,RS,DE
195250,1699401120,1699413420,12300,20212,160133,US,US
14985,1698987420,1699020540,33120,31658,46550,TR,TR
103261,1700375820,1700379420,3600,52480,75214,GB,GB
53124,1700623560,1700642400,18840,52666,68037,FR,FR
58307,1699300320,1699310760,10440,146235,3061,IT,IT
129671,1700569080,1700580660,11580,53257,37307,US,US
138984,1699915440,1699937040,21600,82285,101622,DE,PL
68216,1699940220,1699955100,14880,170412,96180,US,US
15106,1700040120,1700056020,15900,190417,53569,US,US
19596,1699204740,1699208520,3780,19957,146262,GB,GB
114751,1700075880,1700111100,35220,160212,156174,TR,TR
52582,1698826800,1698855960,29160,146383,155674,TR,TR
77624,1700732040,1700747580,15540,153259,169309,US,US
159926,1700844240,1700847840,3600,177335,60181,GB,GB
170445,1699305660,1699322520,16860,159238,42509,US,US
6271,1700500560,1700512200,11640,195906,2026,US,US
125702,1699452060,1699481580,29520,156206,125019,TR,TR
159550,1699132500,1699161780,29280,80639,104513,TR,TR
73272,1699777860,1699786980,9120,172044,59193,IT,IT
158438,1700841660,1700862120,20460,183222,136517,SE,SE
89565,1699120320,1699154700,34380,22778,154290,TR,TR
18816,1700383320,1700417520,34200,53928,167097,MX,MX
171727,1700363820,1700390220,26400,172801,504,DE,CH
34306,1700372340,1700381520,9180,112601,81788,IT,IT
4766,1699098300,1699102620,4320,123261,172172,GB,GB
132886,1699826220,1699844160,17940,74805,111838,CZ,PL
66286,1700583240,1700586840,3600,1966,15731,GB,GB
172448,1700845200,1700848800,3600,119983,136721,NL,GB
134571,1700602740,1700607480,4740,40404,59658,GB,GB
26192,1699734420,1699751040,16620,115296,65397,US,US
59218,1699385940,1699389540,3600,16692,63642,GB,GB
175558,1700609400,1700644620,35220,179979,174911,TR,TR
149725,1700751000,1700754600,3600,110031,128524,NL,NL
149327,1699284720,1699307580,22860,2047,18926,ME,RS
174900,1699034940,1699063260,28320,87432,59512,PL,FR
63744,1699241700,1699250700,9000,132143,7146,HR,HR
140192,1699310940,1699335900,24960,86124,171505,RO,RO
86618,1699599000,1699610040,11040,157634,59944,ES,ES
36774,1700706360,1700717340,10980,65429,109155,IT,IT
138837,1700779380,1700794740,15360,143876,40493,US,US
34425,1699726500,1699758300,31800,67165,74695,TR,TR
98721,1699035780,1699065300,29520,99407,56299,TR,TR
89776,1700291700,1700308740,17040,64710,106825,US,US
38490,1699060860,1699065900,5040,21331,100929,GB,GB
167503,1699677240,1699681920,4680,102999,142962,NL,NL
12238,1699867140,1699871340,4200,2786,187216,GB,GB
668,1699467900,1699478460,10560,77264,72877,HR,DE
165367,1700736660,1700747040,10380,66186,108474,HR,HR
158714,1699803660,1699813800,10140,149970,76169,IT,IT
36517,1699731420,1699735020,3600,137038,108050,NL,NL
77028,1699246680,1699280640,33960,189861,27653,TR,TR
49374,1699634940,1699648560,13620,170144,17795,US,US
105365,1699768620,1699772220,3600,128976,66112,GB,GB
13286,1699305900,1699314660,8760,199431,114397,IT,IT
168745,1700145360,1700171700,26340,10905,112162,BR,BR
167370,1699844400,1699878720,34320,128623,173404,TR,TR
14571,1700503500,1700535900,32400,132864,68027,TR,TR
142958,1700387580,1700422080,34500,11220,164286,TR,TR
13646,1699795680,1699808700,13020,187521,103819,US,US
102278,1699165380,1699178520,13140,35041,58299,AT,BG
180972,1699383480,1699417980,34500,86298,28636,TR,TR
37905,1699934220,1699942560,8340,68101,134947,IT,IT
135731,1699232760,1699256820,24060,152329,33281,HU,UA
154299,1699737720,1699764000,26280,143343,168254,DE,DE
170168,1700586000,1700621460,35460,75943,112880,TR,TR
58884,1700550960,1700559300,8340,11249,193644,IT,IT
164469,1700160300,1700169300,9000,79660,39138,PT,PT
91718,1699874220,1699908000,33780,144781,146104,TR,TR
182639,1700077260,1700092860,15600,22711,1052,US,US
195309,1699825860,1699837920,12060,19662,175224,US,US
38611,1699498380,1699529400,31020,15002,164033,TR,TR
189885,1700011140,1700040180,29040,5626,2331,TR,TR
128980,1699552620,1699581960,29340,74532,164399,TR,TR
85196,1698807120,1698837720,30600,12296,72486,TR,TR
110949,1700149200,1700154540,5340,29378,55850,NL,NL
198827,1700454840,1700478060,23220,80057,96153,DE,DE
68226,1700142660,1700153040,10380,199841,103371,PT,PT
132604,1699717860,1699729380,11520,42716,77867,IT,IT
61910,1700544660,1700552460,7800,125534,28818,IT,IT
29409,1700835480,1700851560,16080,34225,87611,US,US
70832,1699152480,1699183020,30540,50884,128855,TR,TR
134193,1699667340,1699670940,3600,101375,35517,GB,GB
147574,1699835940,1699841880,5940,170174,194782,NL,NL
10672,1699759260,1699795200,35940,77657,3985,TR,TR
186260,1699319220,1699326540,7320,146645,77546,EE,PL
54089,1698826980,1698832560,5580,170234,41082,GB,GB
162234,1700350020,1700380140,30120,9492,68169,TR,TR
105473,1699597860,1699619640,21780,87618,145464,BR,BR
128224,1698941880,1698972180,30300,153028,40511,TR,TR
185079,1700795340,1700798940,3600,22437,199185,GB,GB
35152,1698855300,1698866940,11640,23841,189843,IT,IT
90530,1699266780,1699279320,12540,177653,65125,IT,IT
49403,1699622700,1699658400,35700,3840,47965,TR,TR
45041,1699899420,1699914960,15540,92706,70483,US,US
87463,1700778720,1700809200,30480,38615,54142,TR,TR
114535,1700731320,1700741640,10320,13146,3163,IT,IT
33772,1699280820,1699289940,9120,59598,131577,IT,IT
56211,1699748880,1699778580,29700,77603,133018,TR,TR
20507,1699948740,1699960920,12180,42292,53968,SK,AT
83788,1699808520,1699824720,16200,589,82615,FR,DE
142098,1700381880,1700394360,12480,57823,21956,US,US
162506,1699054200,1699088280,34080,59244,91503,TR,TR
80085,1698797400,1698801000,3600,125058,104624,GB,GB
62135,1700731080,1700742840,11760,130610,128865,AT,AT
194712,1700544480,1700569500,25020,125160,149231,DK,DK
179488,1699374360,1699385280,10920,182292,71116,AT,AT
36899,1699016640,1699033440,16800,46760,139012,US,US
32531,1698942960,1698962100,19140,60129,106317,SI,RS
155452,1699665300,1699668900,3600,136546,134522,GB,GB
196474,1700414100,1700424840,10740,172441,14815,PT,PT
117380,1700830680,1700862480,31800,108659,29342,TR,TR
25541,1700029320,1700042460,13140,100605,27725,US,US
21120,1700088420,1700119980,31560,102560,68010,TR,TR
132283,1699288440,1699304040,15600,87598,112071,FR,IT
127835,1700397360,1700404560,7200,137892,89427,HR,HR
178310,1699316580,1699350180,33600,77220,153796,TR,TR
3350,1699927560,1699931400,3840,109648,184754,GB,GB
124445,1699091280,1699122120,30840,184668,92655,TR,TR
164981,1700644800,1700676720,31920,167293,36729,TR,TR
199100,1700472060,1700475660,3600,93034,156807,GB,GB
154096,1699509120,1699516320,7200,173783,87193,IT,IT
135353,1700595000,1700610720,15720,172673,110113,US,US
112457,1700119920,1700127600,7680,133359,85050,IT,IT
74125,1700748900,1700757060,8160,49166,169198,HR,DE
93628,1700807340,1700827080,19740,70856,31719,SE,NO
134376,1700348160,1700353740,5580,98528,3170,GB,GB
114864,1698988440,1698992040,3600,66107,110796,NL,NL
121929,1700823540,1700855400,31860,14825,194354,TR,TR
29905,1699879560,1699883160,3600,108610,107425,GB,GB
111353,1699999260,1700029200,29940,199703,135645,TR,TR
170288,1700722020,1700737080,15060,150054,35354,US,US
92428,1699207320,1699237860,30540,88274,63740,TR,TR
86632,1700645040,1700652600,7560,6573,150129,HR,HR
15257,1700772360,1700787900,15540,149054,78243,RS,RS
126531,1699754580,1699783560,28980,97587,85210,TR,TR
194140,1700547720,1700562840,15120,164883,63690,US,US
112734,1699840080,1699869120,29040,103857,33605,BA,BA
144470,1699223940,1699238400,14460,76806,190299,US,US
187402,1700840880,1700852220,11340,32102,163217,IT,IT
38377,1699205400,1699229340,23940,9807,36057,BR,BR
197761,1699053240,1699089780,36540,6113,33295,MX,US
43259,1699367760,1699385400,17640,46848,131040,US,US
3838,1699074900,1699109520,34620,110374,83676,MX,MX
107851,1700286000,1700299140,13140,145058,187102,US,US
101899,1699011600,1699021020,9420,32847,59526,PT,PT
158332,1699367400,1699376760,9360,166340,165137,IT,IT
66889,1700337480,1700369700,32220,98978,159018,TR,TR
64262,1699651980,1699664100,12120,153544,63331,AT,HR
180018,1700167920,1700197620,29700,5528,45084,TR,TR
156943,1700111280,1700146020,34740,144751,157965,TR,TR
8827,1700353260,1700366100,12840,174722,175820,US,US
36018,1700105760,1700112960,7200,58822,194448,ES,ES
158672,1700059680,1700097360,37680,147955,86626,MX,MX
122287,1700666100,1700698860,32760,116179,87270,TR,TR
5161,1700715300,1700744520,29220,102704,114297,TR,TR
38389,1699452180,1699487100,34920,177945,98626,TR,TR
188224,1699644960,1699648560,3600,191112,35137,GB,GB
10174,1699704420,1699728960,24540,175379,102059,DE,HR
172889,1699292640,1699306260,13620,186999,44237,IT,IT
159689,1700044080,1700076480,32400,8457,145959,TR,TR
102859,1700445180,1700478840,33660,153707,196920,TR,TR
67085,1699849440,1699881600,32160,121424,134924,TR,TR
159772,1699092240,1699126860,34620,9381,53336,TR,TR
94732,1700585100,1700589780,4680,151820,86652,GB,GB
147033,1699075800,1699081140,5340,65685,154520,NL,BE
102294,1698967980,1699000620,32640,59233,199803,TR,TR
13051,1700051700,1700078400,26700,140500,84655,DE,DE
116400,1700300460,1700306880,6420,9837,179595,NL,NL
137489,1699997820,1700015820,18000,195174,68206,FR,NL
155946,1700034180,1700046900,12720,8686,31180,US,US
61131,1699589520,1699602840,13320,176545,144835,US,US
180682,1699781340,1699794720,13380,140613,784,US,US
85657,1700128680,1700139780,11100,5320,109906,US,US
77057,1700360220,1700372400,12180,194270,191693,HR,HR
35033,1699368660,1699404000,35340,192268,1579,TR,TR
54999,1700052360,1700087700,35340,87125,121137,MX,MX
84968,1700618580,1700629860,11280,128145,106170,US,US
124430,1699467840,1699476780,8940,99722,99908,HR,AT
181874,1700717340,1700728020,10680,167273,4638,ES,ES
99298,1699249140,1699281780,32640,101416,93991,TR,TR
170304,1699597020,1699626540,29520,30871,189338,TR,TR
51554,1700709120,1700744280,35160,148277,95893,TR,TR
189317,1700725260,1700742300,17040,97025,135916,US,US
49131,1700486040,1700520000,33960,183326,29621,TR,TR
30485,1700002440,1700032500,30060,176625,64691,TR,TR
184719,1698970380,1698974460,4080,9330,92717,NL,NL
79021,1700036760,1700067000,30240,171547,114372,TR,TR
59248,1698859140,1698862740,3600,116580,47513,GB,GB
179054,1699349880,1699385040,35160,71735,25280,TR,TR
53966,1699662600,1699685460,22860,138227,12542,CH,IT
151458,1699070160,1699084800,14640,43333,91137,US,US
136683,1699025400,1699037700,12300,17286,151248,HR,HR
88663,1699634580,1699638180,3600,146393,102134,GB,GB
25309,1700183460,1700188560,5100,86086,1387,GB,GB
24053,1700060400,1700094600,34200,82329,77271,TR,TR
187548,1700706900,1700742780,35880,198641,17874,TR,TR
77990,1699763400,1699787100,23700,75721,2651,PL,DE
73045,1700524080,1700528640,4560,98359,78687,GB,GB
188186,1700813220,1700822340,9120,58042,199846,IT,IT
99934,1699671480,1699683180,11700,114780,91651,PT,PT
93853,1698970500,1699001940,31440,112730,86530,TR,TR
184949,1699190940,1699204260,13320,50811,73005,PT,PT
193889,1699981680,1699994460,12780,185047,126866,US,US
114435,1699132980,1699167360,34380,23523,19708,TR,TR
146348,1700768760,1700784960,16200,121541,58673,US,CA
158790,1700554740,1700589420,34680,59567,99942,TR,TR
59002,1700450220,1700453820,3600,26529,188176,GB,GB
16702,1699619640,1699654260,34620,9659,114593,MX,MX
148442,1699240320,1699269840,29520,169475,85383,TR,TR
26792,1700335320,1700348100,12780,54270,70976,US,US
64836,1700055960,1700062800,6840,41121,141590,GB,GB
183253,1700140260,1700164500,24240,131931,12626,PL,PL
71882,1700344440,1700359800,15360,170919,134951,US,US
21545,1699615560,1699631700,16140,142405,133382,AT,AT
41567,1699037280,1699042440,5160,37302,118688,GB,GB
194323,1699556460,1699570560,14100,5150,78239,AT,PL
22208,1699779960,1699790880,10920,63023,140165,IT,IT
132598,1700230320,1700238900,8580,62491,82042,IT,IT
85779,1700082240,1700114820,32580,119025,74108,TR,TR
105101,1700630520,1700634120,3600,141431,34111,GB,GB
117002,1698843360,1698851460,8100,147901,142800,HR,HR
111377,1699456860,1699470600,13740,168121,46386,RS,DE
126941,1699416000,1699453380,37380,43242,143053,MX,MX
7868,1698873840,1698877440,3600,154620,134190,GB,GB
6747,1700018400,1700022480,4080,45252,38029,GB,GB
1973,1698904680,1698909360,4680,16366,137051,NL,NL
73651,1699520520,1699552500,31980,44177,9730,TR,TR
157563,1700674680,1700683140,8460,131474,192800,IT,HR
5994,1700598240,1700631600,33360,96537,19027,TR,TR
4295,1700482380,1700486640,4260,8647,118113,GB,GB
107971,1699839660,1699843260,3600,184300,17483,GB,GB
121376,1699551660,1699585560,33900,86667,95379,TR,TR
50596,1700766240,1700793060,26820,34086,47847,DE,DE
45983,1699165140,1699181700,16560,45183,136640,US,US
106404,1699911600,1699925400,13800,63408,57537,PT,PT
181095,1699886160,1699901220,15060,19222,12057,US,US
191638,1698848640,1698881220,32580,163639,87054,TR,TR
125929,1699996500,1700031180,34680,161003,41850,TR,TR
183632,1700703240,1700733360,30120,80040,136947,TR,TR
4069,1699741500,1699745640,4140,18877,9604,NL,FR
53873,1699179480,1699183440,3960,54854,10253,GB,GB
12267,1699987980,1700014440,26460,183897,153024,RO,MD
183597,1698820560,1698851280,30720,156613,153861,TR,TR
37769,1700815860,1700819460,3600,69513,189083,NL,NL
46526,1699980180,1700004540,24360,13927,84861,PL,DE
25876,1698833640,1698862500,28860,56916,81067,TR,TR
41654,1700357040,1700370540,13500,174754,175791,US,US
119912,1699653300,1699685580,32280,134847,171669,TR,TR
17780,1700180280,1700213040,32760,191102,91548,TR,TR
125504,1700422140,1700444400,22260,176258,181760,DE,RS
71867,1699140720,1699146360,5640,199838,5743,NL,NL
67149,1699049940,1699066320,16380,181178,177389,US,US
65051,1699874100,1699879020,4920,128765,54828,GB,GB
85747,1699028700,1699040640,11940,146951,5289,US,US
50903,1699280280,1699287480,7200,105016,29192,IT,IT
56710,1699430160,1699447680,17520,145468,185837,US,US
91033,1699263420,1699274580,11160,143947,92258,US,US
158190,1698823380,1698856080,32700,198539,160062,TR,TR
89105,1700042700,1700047080,4380,170500,21356,GB,GB
114936,1698877440,1698908880,31440,61576,74085,TR,TR
150733,1700640480,1700671920,31440,93128,91496,TR,TR
8074,1699674840,1699697100,22260,192954,155217,DE,DE
45534,1699654800,1699684980,30180,157132,149157,TR,TR
88640,1700699400,1700733060,33660,74563,76276,TR,TR
128662,1700396100,1700407080,10980,98576,92806,IT,IT
96006,1699320120,1699352100,31980,8316,29101,TR,TR
169828,1699397040,1699428780,31740,175899,161842,TR,TR
184408,1700451960,1700485920,33960,107267,6518,TR,TR
189044,1698986940,1699017840,30900,26974,78779,TR,TR
165813,1698812880,1698819480,6600,35307,71484,NL,NL
7726,1699086600,1699091700,5100,29128,148764,GB,GB
144161,1700816520,1700821260,4740,48929,9318,GB,GB
30899,1699762260,1699771980,9720,20562,132429,ES,ES
127479,1699303440,1699319460,16020,136887,29672,US,US
93176,1699399500,1699403520,4020,55011,111258,GB,GB
106908,1700010780,1700028060,17280,93228,69646,US,US
186409,1700188560,1700198220,9660,35766,116735,IT,IT
190074,1698949260,1698959460,10200,91647,5055,IT,IT
110475,1700380620,1700405160,24540,12541,108784,DE,BA
57371,1700732400,1700748720,16320,15940,78983,US,US
47025,1699681140,1699714320,33180,136063,152493,TR,TR
157075,1700573580,1700583780,10200,94854,24726,SK,AT
113981,1699984800,1700018940,34140,150905,17873,TR,TR
185959,1699708380,1699716840,8460,106777,82075,IT,IT
55870,1700810220,1700845860,35640,100114,51168,TR,TR
124150,1700070240,1700087220,16980,164127,196675,US,US
150068,1700104500,1700121840,17340,61730,46815,US,US
180372,1699554780,1699558680,3900,105354,150340,GB,GB
19398,1699737540,1699766400,28860,145102,129280,TR,TR
22197,1700668560,1700672160,3600,58541,153699,GB,GB
54297,1700234820,1700269080,34260,155517,38194,TR,TR
189705,1699146300,1699176660,30360,32326,90514,TR,TR
176867,1699452540,1699481880,29340,57404,128293,TR,TR
69710,1699738380,1699743660,5280,47223,181919,GB,GB
88930,1699423080,1699453260,30180,165708,157413,TR,TR
196462,1700649060,1700683200,34140,25976,126772,TR,TR
145138,1699299900,1699308240,8340,114826,163683,IT,IT
15620,1700320320,1700343240,22920,112509,119158,DE,HR
86726,1700009640,1700032080,22440,109179,165065,RO,RO
134487,1699395120,1699421580,26460,180772,196519,BA,HR
108505,1700432400,1700447760,15360,88285,182794,US,US
16290,1699822440,1699856100,33660,59359,137771,TR,TR
24303,1699390080,1699409580,19500,143091,188901,DK,DK
192572,1700571600,1700601840,30240,45309,116642,TR,TR
153214,1699248780,1699269900,21120,20323,19842,MD,RO
1952,1700235240,1700265060,29820,46927,49870,TR,BG
85917,1699564320,1699573860,9540,24999,173783,IT,IT
71428,1698842700,1698846300,3600,65462,143426,GB,GB
36467,1699738260,1699755720,17460,68109,62773,US,US
116483,1699275000,1699293780,18780,100956,138783,DK,CZ
94347,1699558740,1699589700,30960,91310,41478,TR,TR
27326,1698947280,1698950880,3600,136805,174688,GB,GB
58582,1699404720,1699422180,17460,126713,179894,CZ,CZ
141987,1700538300,1700572500,34200,122537,116439,TR,TR
128208,1699251120,1699283400,32280,122833,154165,TR,TR
3955,1699283400,1699295280,11880,183721,98072,US,US
179680,1699338900,1699354260,15360,119806,77178,US,US
30679,1699584780,1699619640,34860,168039,13275,TR,TR
137897,1699084680,1699091820,7140,126552,132062,NL,NL
184717,1699468920,1699480500,11580,121811,7028,SK,SK
100724,1700588340,1700599740,11400,190429,102444,PT,PT
14628,1700787240,1700818860,31620,49955,32286,TR,TR
142934,1699748520,1699774800,26280,82898,93496,PL,PL
17370,1699700280,1699712700,12420,2584,142401,PT,PT
8695,1698852540,1698864660,12120,110808,35839,IT,IT
82945,1700414820,1700449740,34920,162476,23581,TR,TR
128755,1699068780,1699072380,3600,178731,64777,GB,GB
103884,1698941700,1698956040,14340,67673,35952,US,US
53846,1700294100,1700326500,32400,146750,87179,TR,TR
153534,1700250000,1700282700,32700,96504,135595,TR,TR
107975,1700770320,1700780220,9900,10125,7497,PT,PT
111456,1699633140,1699643640,10500,132410,80484,IT,IT
75442,1699582500,1699604580,22080,20649,157700,RO,RO
126724,1700193180,1700201640,8460,195004,82498,PT,PT
125849,1700468760,1700503080,34320,75153,26947,TR,TR
46412,1699001160,1699036440,35280,38995,30996,MX,MX
174191,1700556720,1700587620,30900,188441,33009,TR,TR
148290,1700561400,1700575140,13740,74987,43212,US,US
193047,1700684520,1700688120,3600,163430,124379,GB,GB
105670,1698903720,1698937020,33300,7216,96126,TR,TR
86393,1700485260,1700512440,27180,199213,52843,DE,DE
194075,1700019600,1700050680,31080,121732,86007,TR,TR
151440,1699627800,1699635420,7620,159960,96000,EE,EE
164935,1699714440,1699744620,30180,15146,66264,TR,TR
15440,1699446960,1699480680,33720,94925,144570,TR,TR
125701,1698918420,1698948240,29820,65504,131555,TR,TR
18586,1698949080,1698979680,30600,67081,76014,TR,TR
53826,1699074720,1699104900,30180,194971,79107,TR,TR
137585,1700362680,1700369280,6600,12080,90559,GB,GB
144046,1700113200,1700125740,12540,128751,3090,US,US
12888,1700769540,1700788140,18600,141449,30538,FR,ES
62896,1700395800,1700406600,10800,152111,39006,CZ,AT
184787,1700837880,1700842320,4440,126679,39925,GB,FR
107303,1700597100,1700630280,33180,113422,103037,TR,TR
107123,1699449120,1699483080,33960,184509,121846,TR,TR
62525,1698969360,1698986700,17340,174396,175111,FR,IT
83457,1698944820,1698958140,13320,100962,36505,US,US
16657,1700188980,1700213160,24180,153927,174969,DE,BG
154766,1699712460,1699745460,33000,117466,23781,TR,TR
4220,1699808580,1699842660,34080,35803,159841,TR,TR
79327,1700840460,1700869800,29340,131374,101284,TR,TR
196099,1699494180,1699502640,8460,66083,93330,ES,PT
97383,1700170140,1700182200,12060,128018,7539,US,US
88085,1698906900,1698917760,10860,166162,174424,US,US
13274,1700845560,1700867460,21900,186604,145913,DE,DE
145699,1699885980,1699889940,3960,120141,41427,GB,GB
134582,1698996300,1699029780,33480,127854,42911,TR,TR
166660,1699790040,1699793880,3840,153348,193755,FI,EE
104983,1699619820,1699631940,12120,62460,141060,ES,ES
95293,1700326800,1700361000,34200,13986,137340,TR,TR
172019,1700283240,1700289120,5880,157057,199446,GB,GB
37237,1699535700,1699559820,24120,46676,156516,DE,PL
72854,1699655160,1699684020,28860,113623,141065,TR,TR
72529,1699695900,1699699500,3600,71271,192496,NL,NL
196557,1699042020,1699076220,34200,128563,141580,TR,TR
172163,1700103840,1700140380,36540,173625,157350,MX,MX
134885,1700048940,1700080020,31080,113902,166211,TR,TR
130272,1700554740,1700587320,32580,111728,8562,TR,TR
66000,1700012700,1700045940,33240,94276,71106,TR,TR
159091,1700247960,1700283120,35160,106772,8089,TR,TR
133047,1700535240,1700569200,33960,147876,190992,TR,TR
119147,1700722980,1700732040,9060,49507,64472,IT,IT
42839,1699323420,1699352580,29160,62541,99754,TR,TR
184395,1699023060,1699026660,3600,121266,98436,GB,GB
28567,1700462220,1700497020,34800,147544,115383,TR,TR
4778,1699156980,1699171560,14580,46854,112255,US,US
92277,1700475180,1700488680,13500,87464,47475,IT,IT
78014,1699809720,1699839660,29940,117793,148223,TR,TR
129458,1700434200,1700437800,3600,29820,103635,GB,GB
76401,1698882900,1698918720,35820,80070,182539,TR,TR
10878,1700294040,1700329740,35700,10368,23339,TR,TR
82071,1699738740,1699750380,11640,48628,52073,US,US
132805,1700662980,1700666580,3600,127878,196810,GB,GB
117308,1699287300,1699321200,33900,56557,142905,TR,TR
103460,1700122320,1700154360,32040,33494,195426,TR,TR
60022,1698891540,1698904920,13380,193685,82101,IT,IT
81861,1700271540,1700288160,16620,105797,105609,US,US
154952,1700385780,1700407380,21600,131862,195429,RO,DE
98812,1699655640,1699691340,35700,84810,143950,TR,TR
32418,1700597340,1700629440,32100,105956,119223,TR,TR
81183,1699870620,1699903920,33300,109311,148744,TR,TR
43943,1700820660,1700849640,28980,98099,129134,TR,TR
169872,1700384340,1700396160,11820,145977,74608,US,US
159449,1699514160,1699544040,29880,112013,2433,TR,TR
188400,1700437620,1700468700,31080,149489,70612,TR,TR
138917,1700447940,1700451540,3600,2678,50490,GB,GB
80568,1700796720,1700811300,14580,119635,139809,AT,NL
133272,1699016880,1699029960,13080,22809,181914,US,US
128646,1700277660,1700289720,12060,104401,141481,US,US
98101,1699578420,1699596240,17820,142543,74476,US,US
192069,1699678680,1699708620,29940,40643,110420,TR,TR
191223,1700484300,1700492760,8460,174793,115125,PT,PT
149360,1699314900,1699330500,15600,192272,109431,FR,ES
10293,1699968480,1699993140,24660,9137,126360,RO,RO
140338,1700040420,1700044020,3600,25524,165528,NL,BE
189365,1700716800,1700723880,7080,56236,140230,NL,NL
190792,1699209000,1699238820,29820,120386,52449,TR,TR
101681,1698815400,1698829800,14400,15029,124622,FR,NL
67129,1699953120,1699987560,34440,156559,170486,TR,TR
37842,1700341260,1700344860,3600,170593,59012,NL,NL
86938,1700786220,1700797260,11040,92185,126890,PT,PT
99826,1699157820,1699190400,32580,91858,105978,TR,TR
187564,1699335120,1699366620,31500,107681,22244,TR,TR
2961,1699615800,1699629300,13500,38961,72951,US,US
181064,1699149540,1699161600,12060,1980,54070,US,US
6587,1698880440,1698892380,11940,35020,54772,IT,IT
68965,1700025660,1700041860,16200,97905,151270,US,US
158893,1700416620,1700421960,5340,159609,41096,GB,GB
196118,1698860940,1698893880,32940,151627,18171,TR,TR
93820,1699762020,1699797000,34980,89663,196443,TR,TR
52475,1700555700,1700588700,33000,106316,140039,TR,TR
135746,1700329560,1700360880,31320,130019,41639,TR,TR
127567,1699116480,1699132920,16440,105840,162710,US,US
41160,1700380320,1700409120,28800,19747,55551,TR,TR
189378,1699267320,1699303920,36600,105189,150459,MX,MX
172594,1700548260,1700581740,33480,109902,4675,TR,TR
77977,1699760700,1699793760,33060,157143,172884,TR,TR
101172,1700609400,1700625660,16260,7360,23538,BE,NL
93111,1700368620,1700376840,8220,70875,47632,IT,IT
47170,1699991760,1700003040,11280,68863,156489,US,US
118308,1698920340,1698949500,29160,104557,18215,TR,TR
171473,1700265240,1700269080,3840,184885,86134,GB,GB
12225,1699630440,1699642680,12240,117122,134623,AT,AT
64537,1698922920,1698955980,33060,14897,198875,TR,TR
25558,1700001660,1700014740,13080,194075,75513,US,MX
37948,1699910700,1699922640,11940,141044,30338,ES,FR
77278,1699474740,1699479840,5100,84562,126662,NL,NL
116615,1698861120,1698894840,33720,16161,78288,TR,TR
132213,1700285280,1700288880,3600,16421,140111,NL,NL
11902,1700212200,1700224320,12120,39823,153969,IT,IT
194068,1700845020,1700874240,29220,145633,152057,TR,TR
80525,1700224320,1700235600,11280,66155,2119,US,US
156334,1698801000,1698804600,3600,176254,182003,NL,PL
195939,1699782900,1699815120,32220,151981,122989,TR,TR
9322,1700022360,1700035140,12780,198125,164679,US,US
28062,1700072220,1700089620,17400,58181,140654,CZ,CZ
18375,1699153980,1699187220,33240,60615,51029,TR,TR
194308,1699164480,1699187580,23100,110683,31376,HU,AT
137715,1700364180,1700393940,29760,44544,94202,TR,TR
63221,1699580100,1699613400,33300,91065,149409,TR,TR
38640,1699553220,1699589100,35880,160362,157655,TR,TR
99730,1699787160,1699822260,35100,40351,85176,TR,TR
198408,1698945660,1698957840,12180,39,108132,HR,HR
137776,1699133940,1699146360,12420,20860,50896,IT,IT
183118,1699205400,1699240440,35040,71106,95222,TR,TR
196025,1700550360,1700570460,20100,33109,162283,SE,SE
2944,1698935940,1698970200,34260,68004,87735,TR,TR
161303,1699943580,1699959600,16020,30439,139502,RS,RS
78917,1700779380,1700811120,31740,113545,46278,TR,TR
129712,1698895920,1698903180,7260,163179,46909,PT,PT
149744,1699429500,1699460520,31020,16103,9632,TR,TR
21445,1700310600,1700328660,18060,67182,6941,FR,FR
190887,1700146680,1700180280,33600,50614,195219,TR,TR
54839,1699606620,1699635900,29280,71390,88376,TR,TR
46084,1699441620,1699471740,30120,193134,49847,TR,TR
183689,1699731360,1699734960,3600,188409,13768,GB,GB
63610,1700786820,1700822520,35700,51460,1655,TR,TR
151114,1699643040,1699657140,14100,101399,85019,SK,AT
143847,1699361340,1699380060,18720,30474,82843,FR,FR
79034,1700487540,1700517180,29640,91303,151348,TR,TR
92034,1700662140,1700696340,34200,35406,126275,TR,TR
54237,1700292120,1700321160,29040,171964,49374,TR,TR
172328,1700199180,1700205720,6540,163881,167705,GB,GB
27032,1700211000,1700245800,34800,182902,1107,TR,TR
59453,1700521380,1700527680,6300,15616,116170,GB,GB
175287,1699772640,1699778760,6120,151200,128615,GB,GB
166543,1700561520,1700573280,11760,37282,37072,ES,ES
163485,1699743660,1699754220,10560,44729,196102,IT,IT
180754,1700469780,1700479020,9240,32307,102132,AD,ES
54369,1699742760,1699764480,21720,37363,77542,DE,DE
64483,1698926040,1698938820,12780,35791,41391,IT,IT
86011,1698973020,1698999420,26400,130049,45794,DE,DE
141235,1699877400,1699908060,30660,96384,178202,TR,TR
135827,1700698200,1700733600,35400,8450,107611,TR,TR
113767,1699178580,1699192440,13860,59074,80553,US,US
189983,1700792160,1700797500,5340,38843,41824,NL,NL
7012,1700272980,1700291520,18540,73396,193397,DK,DK
109618,1698868680,1698901260,32580,8539,53780,TR,TR
24864,1700298600,1700315160,16560,66578,61188,AT,HU
108861,1700464140,1700480340,16200,137158,171663,AT,AT
74628,1700773320,1700780160,6840,128767,186972,GB,GB
80914,1699949640,1699980000,30360,16072,55625,TR,TR
172243,1699443600,1699477740,34140,91381,107874,TR,TR
171639,1698877080,1698903180,26100,130272,153602,DE,FR
16336,1699477620,1699481220,3600,161124,122923,GB,GB
85720,1699705620,1699710420,4800,88835,179523,NL,NL
126887,1698855960,1698884880,28920,75502,103543,TR,TR
107272,1700778900,1700810460,31560,156603,141961,TR,TR
154701,1700272080,1700286960,14880,149797,195310,US,US
82234,1699808100,1699835520,27420,138741,65980,DE,RS
22849,1699344600,1699379580,34980,199876,73435,TR,TR
198354,1700721660,1700757720,36060,126447,13011,MX,US
157665,1699930320,1699965240,34920,150657,62496,TR,TR
169308,1699771380,1699779060,7680,10608,79140,ES,ES
118809,1700353260,1700366580,13320,64260,18675,US,US
53468,1699735140,1699745040,9900,18649,96298,HR,HR
77548,1700807880,1700825640,17760,91743,182460,CA,US
152312,1698959580,1698970140,10560,25570,66935,PT,PT
92889,1699764240,1699778100,13860,36262,90969,CZ,CZ
91519,1699233420,1699266540,33120,146322,72314,TR,TR
77743,1698911940,1698915540,3600,142531,168839,GB,GB
86001,1700579460,1700608740,29280,8368,42233,TR,TR
156333,1700352060,1700357100,5040,28410,79460,GB,GB
52775,1699278540,1699311240,32700,43372,162832,MK,DE
74699,1699494420,1699529220,34800,59310,33931,TR,TR
198864,1699719060,1699723020,3960,9625,148073,GB,GB
133880,1700630040,1700665680,35640,123396,78862,TR,TR
45503,1700672880,1700689980,17100,83574,102256,FR,FR
96730,1699980960,1699995540,14580,76347,170662,US,US
180369,1699415760,1699427940,12180,102890,1483,US,US
65267,1700061120,1700078880,17760,31118,13899,US,US
120128,1700632500,1700667900,35400,115282,67562,MX,MX
194094,1699928640,1699934700,6060,94748,169311,NL,DE
7752,1699441980,1699467900,25920,111015,106445,DE,DE
28095,1700194620,1700208600,13980,170926,27255,PT,PT
158075,1700706600,1700742060,35460,138597,64226,TR,TR
145249,1698835560,1698868500,32940,172666,16237,MX,MX
126775,1698872940,1698903960,31020,96165,50673,TR,TR
153981,1700073540,1700089320,15780,166364,128400,US,US
70940,1700664360,1700675520,11160,11593,104215,CZ,CZ
196285,1699943400,1699979040,35640,123014,107929,TR,TR
143935,1700731980,1700735640,3660,64161,77742,GB,GB
148479,1700720100,1700759460,39360,144036,113681,MX,MX
35298,1700586480,1700593500,7020,142242,42586,GB,GB
11197,1700134740,1700148600,13860,93878,36698,PT,PT
632,1699898100,1699931880,33780,137618,78496,TR,TR
135407,1700258940,1700267460,8520,6268,32437,IT,IT
173361,1699353480,1699387320,33840,137304,148095,TR,TR
76335,1700417700,1700449440,31740,5702,114103,TR,TR
195271,1698971760,1699007220,35460,20735,27652,TR,TR
101546,1700093100,1700120760,27660,13837,158266,HU,IT
11720,1699838160,1699847700,9540,131593,166496,SK,SK
100488,1700866680,1700886060,19380,46952,90037,MD,RO
182528,1699748820,1699782240,33420,174196,198212,TR,TR
32480,1699761900,1699767900,6000,58084,164513,NL,NL
38192,1700385360,1700388960,3600,3831,137391,GB,GB
95713,1700596560,1700609580,13020,78114,131497,US,US
150577,1700103420,1700138400,34980,83881,191724,TR,TR
163249,1700410260,1700422380,12120,145258,126251,RS,BG
18100,1700296500,1700330520,34020,95042,155810,TR,TR
46368,1700512020,1700541240,29220,24020,46838,TR,TR
86188,1699202520,1699212840,10320,106824,135398,IT,IT
9463,1699749840,1699781820,31980,2792,133084,TR,TR
106300,1699743840,1699753860,10020,46288,57497,CL,CL
164110,1699668180,1699671780,3600,189973,95180,NL,NL
165737,1698880680,1698897420,16740,114415,44888,US,US
166891,1699305960,1699341240,35280,196387,177197,TR,TR
95270,1699939380,1699971480,32100,51114,141494,TR,TR
150027,1700315940,1700329260,13320,46355,63817,IT,IT
22199,1699899000,1699923840,24840,121726,93317,DE,BG
24022,1699030440,1699062840,32400,102436,185265,TR,TR
11867,1700550480,1700584380,33900,44139,70627,TR,TR
36256,1699226940,1699230540,3600,108233,8571,NL,BE
16521,1698925500,1698941280,15780,127291,120007,US,US
6493,1700004000,1700035860,31860,124175,44825,TR,TR
43896,1700067780,1700099220,31440,124105,146601,BA,AT
164656,1700361120,1700393580,32460,37165,98698,TR,TR
130008,1699216260,1699242840,26580,46326,82011,DE,FR
195235,1700789760,1700815380,25620,154611,59094,PL,PL
157180,1699262040,1699294140,32100,56765,72871,TR,TR
177688,1700314620,1700345820,31200,130774,171389,TR,TR
143222,1700512980,1700524740,11760,4622,78826,ES,ES
111903,1700654640,1700666460,11820,60053,46328,US,US
18239,1699256040,1699259640,3600,124624,63937,GB,GB
64117,1700170260,1700201820,31560,102579,6211,BA,ME
151516,1699682220,1699690020,7800,33413,32514,PT,PT
18628,1699010100,1699018980,8880,142077,54709,HR,HR
76603,1699179180,1699186080,6900,109539,29325,NL,NL
56038,1698883740,1698902880,19140,126659,64137,FR,FR
53895,1700421420,1700446320,24900,14547,177097,PL,PL
29701,1700283060,1700314080,31020,72558,174989,TR,TR
147469,1700620440,1700637180,16740,150709,59176,FR,IT
91445,1699183800,1699187640,3840,87504,120954,GB,GB
195082,1700559240,1700588160,28920,98438,171755,TR,TR
57472,1700645400,1700662020,16620,76807,18476,US,US
152665,1700305500,1700334660,29160,107703,155570,TR,TR
60730,1700662920,1700689620,26700,98993,192833,RO,MD
88099,1699270980,1699283580,12600,68934,27171,US,US
125719,1699453560,1699490220,36660,50157,165662,MX,MX
151072,1700358600,1700372160,13560,52514,113836,IT,IT
5341,1700137140,1700172960,35820,100909,79426,TR,TR
125001,1699095900,1699130040,34140,154236,49841,MX,MX
126928,1699821300,1699824900,3600,66109,55523,GB,GB
137671,1699923180,1699926780,3600,157667,119152,GB,GB
153571,1700584440,1700609460,25020,113596,166022,BR,BR
949,1700811360,1700814960,3600,5732,168999,NL,NL
104960,1699349040,1699381080,32040,187719,188794,TR,TR
43043,1698895200,1698901380,6180,183213,34259,GB,GB
21485,1700863320,1700869860,6540,138100,137046,NL,NL
25503,1700089620,1700102460,12840,126821,39538,AT,AT
171238,1699547220,1699550820,3600,176067,39344,GB,GB
57258,1700153520,1700166960,13440,169137,17254,RS,RS
88960,1699342680,1699358760,16080,182002,27175,AT,AT
135082,1698957000,1698967980,10980,107513,32619,IT,IT
13204,1699735860,1699739460,3600,36558,173912,GB,GB
75057,1698962280,1698981780,19500,151398,18816,BE,DE
150293,1700083440,1700109000,25560,5738,12827,BA,ME
5996,1700620200,1700623800,3600,147538,118555,NL,NL
175993,1700726760,1700737560,10800,47,149317,US,MX
96456,1699260420,1699293180,32760,45757,174413,TR,TR
81015,1700620380,1700634540,14160,177674,126716,CZ,CZ
14826,1700123040,1700152560,29520,136511,17610,TR,TR
116729,1700740200,1700773560,33360,54379,134880,MX,MX
126451,1700495160,1700509320,14160,174566,108238,US,US
22272,1699224600,1699229400,4800,4614,37487,GB,GB
11851,1699828500,1699839660,11160,176025,73631,US,US
79270,1700358720,1700371800,13080,97933,191680,IT,IT
160110,1699706040,1699735260,29220,98035,165935,TR,TR
25612,1699314660,1699341420,26760,186709,39374,BR,BR
18544,1700351280,1700380800,29520,114216,117587,TR,TR
154395,1700511660,1700528220,16560,196844,193080,US,US
142373,1699735140,1699743120,7980,131134,171322,HR,HR
175231,1699242900,1699272360,29460,146687,116643,TR,TR
81456,1700702400,1700714100,11700,61959,58758,AT,DE
13735,1699524120,1699532040,7920,133748,85841,IT,IT
169833,1699981080,1699990080,9000,190394,34032,IT,IT
102880,1700500200,1700514180,13980,76628,60577,US,US
32157,1699315080,1699349820,34740,133322,68258,TR,TR
120800,1698906720,1698924420,17700,23294,21143,US,US
128123,1700564460,1700595960,31500,164117,147201,TR,TR
7798,1700271960,1700300760,28800,115542,109799,TR,TR
30896,1699378140,1699408200,30060,118749,35513,TR,TR
33480,1699382340,1699407900,25560,10494,128570,DE,BA
149642,1699479420,1699503420,24000,116490,141761,BR,BR
179235,1699415160,1699449000,33840,74499,147797,TR,TR
133219,1700366820,1700402100,35280,127781,53697,TR,TR
92760,1700414760,1700440680,25920,146634,111923,DE,DE
143834,1700857860,1700865300,7440,122064,192526,HR,HR
133647,1700237880,1700254980,17100,2204,13939,RS,RS
20827,1700429760,1700446680,16920,166444,74288,US,US
63242,1699805280,1699839300,34020,26841,74862,TR,TR
133916,1699342680,1699358100,15420,161168,148662,US,US
39084,1699780380,1699805220,24840,116957,183329,DE,DE
157776,1699377780,1699391520,13740,125447,145896,IT,IT
6181,1699398420,1699429680,31260,6854,57430,TR,TR
2234,1700376120,1700379720,3600,151934,139999,GB,GB
31780,1700807880,1700812140,4260,11282,152604,GB,GB
126378,1699665840,1699678860,13020,24729,43693,US,US
66240,1700773320,1700780880,7560,67778,174047,IT,IT
141240,1700364480,1700368080,3600,182277,109282,GB,GB
47641,1699008600,1699024860,16260,60416,109008,US,US
22674,1699342200,1699376640,34440,143342,12268,TR,TR
34177,1699587240,1699619520,32280,102914,4570,TR,TR
193266,1699588140,1699596360,8220,25462,164727,HR,HR
72947,1699137720,1699171800,34080,148865,142170,TR,TR
66143,1698848400,1698883440,35040,15166,48445,TR,TR
165062,1699069260,1699072860,3600,168817,189412,GB,GB
20747,1699635900,1699668900,33000,117136,196428,MX,MX
44317,1699019880,1699038600,18720,84019,47314,FR,FR
125683,1699198860,1699232340,33480,157576,132869,TR,TR
188349,1698863520,1698898140,34620,18129,144193,TR,TR
33674,1699249140,1699274340,25200,136176,151731,CH,CZ
119740,1699852320,1699884420,32100,181604,26593,TR,TR
136743,1700641620,1700671020,29400,38143,12182,TR,TR
18815,1699382880,1699413900,31020,152728,21227,TR,TR
19370,1700742720,1700777580,34860,107557,102154,MX,MX
176523,1699879800,1699913640,33840,185172,185360,TR,TR
134532,1699134120,1699164300,30180,74557,182427,TR,TR
163263,1699812360,1699818960,6600,196039,48747,GB,GB
22715,1700661600,1700668740,7140,91243,142621,GB,GB
188588,1699035600,1699039920,4320,127432,33930,NL,NL
7992,1699167840,1699199760,31920,161455,168337,TR,TR
127514,1699275540,1699312920,37380,138710,173089,MX,MX
65761,1699963860,1699980240,16380,157575,141234,RS,RS
65972,1699572540,1699602720,30180,169707,174993,TR,TR
86558,1700295120,1700308500,13380,145533,40942,HR,HR
129984,1698870480,1698885300,14820,164561,110720,FR,NL
87552,1699413960,1699445520,31560,131275,84469,TR,TR
137364,1700285820,1700297520,11700,195958,155987,CZ,CZ
83790,1699905060,1699919340,14280,198794,158973,US,US
15828,1700035560,1700053140,17580,168335,170137,CA,CA
152848,1698960960,1698988980,28020,191793,40513,DE,GB
189605,1700346120,1700358300,12180,30814,38554,IT,IT
33344,1699321740,1699356000,34260,67543,197026,TR,TR
51043,1700162820,1700173380,10560,87039,103277,IT,IT
53840,1700715900,1700746200,30300,172096,126892,TR,TR
119105,1700637120,1700659320,22200,133552,155487,RO,TR
94658,1699426560,1699440780,14220,151201,97866,CZ,NL
66761,1700569380,1700580060,10680,7434,111242,IT,IT
30018,1698849720,1698865980,16260,97008,43168,US,US
79223,1698905340,1698934620,29280,190797,76328,TR,TR
105522,1700049600,1700085060,35460,87993,7206,TR,TR
77971,1700256120,1700269560,13440,44591,180554,IT,IT
153663,1700770860,1700774460,3600,42425,171430,GB,GB
152265,1699257660,1699272300,14640,167602,75832,RS,RS
38773,1700702220,1700714160,11940,118572,90055,IT,IT
22493,1699665240,1699678800,13560,181879,145698,HR,HR
113577,1699432920,1699448040,15120,127925,76570,RS,BA
173374,1699646820,1699669380,22560,29052,12094,RO,RO
7491,1700845020,1700877420,32400,119133,191793,TR,TR
189475,1699283520,1699306440,22920,113920,110548,RO,RO
33537,1700561280,1700572440,11160,64760,124082,HR,NL
41052,1699974180,1700007000,32820,138493,85996,TR,TR
199607,1700246100,1700256420,10320,182918,142405,IT,IT
118975,1699587000,1699616940,29940,29438,34845,TR,TR
175249,1699139400,1699143000,3600,181075,198489,NL,NL
170918,1700262480,1700279460,16980,140311,129097,AT,AT
10487,1700266080,1700295960,29880,198686,58453,TR,TR
147030,1699509420,1699545180,35760,26797,56795,TR,TR
54090,1700470800,1700488860,18060,76163,141150,SE,NO
93975,1700287320,1700322960,35640,51794,103448,TR,TR
169868,1700563980,1700595420,31440,78684,137434,TR,TR
92348,1699623360,1699657200,33840,17942,42516,TR,TR
23956,1699144800,1699172520,27720,146086,117012,BR,BR
162746,1700489760,1700516520,26760,41690,29979,DE,FR
157323,1700410080,1700421360,11280,33535,173194,US,US
86229,1700310000,1700313600,3600,134757,144776,GB,GB
38956,1700512620,1700547240,34620,103373,77566,TR,TR
89675,1700863500,1700885280,21780,184001,59071,BR,BR
15520,1699445760,1699480920,35160,25121,112540,TR,TR
67105,1700070720,1700104200,33480,153623,25701,TR,TR
19088,1700807400,1700838660,31260,94205,120802,TR,TR
190507,1699502160,1699531320,29160,27450,166200,TR,TR
82225,1700093820,1700118900,25080,48035,115152,PL,PL
162444,1698898020,1698931260,33240,72515,118094,TR,TR
41651,1699449780,1699478760,28980,89624,170592,TR,TR
47279,1699676880,1699712340,35460,103727,196952,TR,TR
8612,1699583220,1699615200,31980,60716,173078,TR,TR
190875,1700389680,1700417160,27480,134449,32452,PL,PL
107115,1699317000,1699330740,13740,120153,191570,US,US
96563,1699079880,1699084020,4140,93525,52493,GB,GB
77747,1700675760,1700708580,32820,21083,119713,TR,TR
17891,1700158560,1700188020,29460,13693,156354,TR,TR
186983,1699316100,1699319700,3600,46739,188981,GB,GB
105073,1699259280,1699262880,3600,9930,99778,GB,GB
147907,1698905340,1698931500,26160,84443,165623,DE,IT
52601,1700153940,1700189460,35520,5870,95411,TR,TR
181612,1699080120,1699094100,13980,144399,141056,ES,ES
14764,1700274900,1700307900,33000,143610,188996,TR,TR
133113,1700082900,1700111700,28800,133865,163165,TR,TR
859,1699974480,1700003280,28800,24232,198089,TR,TR
57748,1700640300,1700647200,6900,97615,109953,EE,EE
197970,1699667220,1699680660,13440,159413,181621,US,US
3365,1699104540,1699108140,3600,134697,52403,NL,NL
65380,1699296060,1699323240,27180,38978,29217,RO,RO
186584,1699357380,1699391160,33780,189560,196650,TR,TR
151911,1699996920,1700013360,16440,29227,83356,US,US
28866,1700221740,1700254740,33000,92475,146003,TR,TR
85258,1700028840,1700043060,14220,64984,149916,US,US
82849,1699537500,1699571520,34020,92533,187985,MX,MX
85736,1700151420,1700162520,11100,32909,180743,US,US
114428,1700609580,1700644320,34740,180147,4071,MX,MX
71563,1700859300,1700867280,7980,174952,68100,IT,IT
95526,1700843100,1700878440,35340,50605,182472,TR,TR
84759,1700019720,1700050200,30480,106249,197860,TR,TR
49512,1699481280,1699511640,30360,21272,122390,TR,TR
108966,1700262000,1700296620,34620,180336,62150,TR,TR
46535,1698939600,1698954960,15360,7660,96614,US,US
30515,1700345460,1700377140,31680,32837,183209,TR,TR
119356,1698922500,1698947220,24720,171080,86519,DE,DE
48525,1698963240,1698966840,3600,27181,29628,GB,GB
72685,1700282700,1700313360,30660,92512,155328,TR,TR
19550,1699911120,1699914720,3600,86267,127947,NL,NL
173149,1699371180,1699374780,3600,16165,97949,GB,GB
181507,1699968480,1699980300,11820,97649,116941,SK,AT
92762,1699020000,1699049880,29880,116508,190352,TR,TR
100720,1699079580,1699104960,25380,156469,175892,BR,BR
129547,1699968120,1699990620,22500,123671,67159,DE,DE
140772,1700267460,1700294280,26820,144046,151971,ME,HR
1761,1699419480,1699452060,32580,188379,111725,TR,TR
8114,1700140140,1700154480,14340,12054,44486,SK,SK
196847,1700492940,1700502000,9060,111834,114134,PT,PT
14603,1700027640,1700033340,5700,3434,146115,EE,FI
114624,1700188020,1700227140,39120,172189,19349,MX,MX
58334,1699934580,1699951740,17160,55301,129149,US,US
42986,1700165760,1700203860,38100,181423,189769,MX,MX
38075,1700578860,1700582460,3600,89058,81204,GB,GB
127399,1699762440,1699775100,12660,113473,3144,US,US
63889,1700113440,1700118420,4980,55938,184155,GB,GB
177239,1700135100,1700148360,13260,35751,30208,US,US
935,1699314000,1699345020,31020,64166,5968,TR,TR
112267,1699938720,1699952880,14160,95107,122017,US,US
100217,1699513920,1699548120,34200,167072,73544,TR,TR
120125,1699748340,1699759500,11160,110020,118273,US,US
25219,1700147100,1700181720,34620,2824,193685,TR,TR
166567,1699830720,1699843020,12300,177545,55174,HR,HR
18754,1700796000,1700812560,16560,151075,128675,US,US
75177,1700663760,1700692920,29160,167510,107172,TR,TR
120574,1699239900,1699296480,56580,14574,78745,UA,PL
153023,1700377140,1700380740,3600,54785,126246,GB,GB
129786,1699281180,1699309500,28320,102339,53826,CH,IT
129025,1699048440,1699054440,6000,168135,1162,EE,FI
112170,1699979520,1700012100,32580,98841,12452,TR,TR
87561,1700699340,1700730900,31560,134201,132099,TR,TR
72835,1699976880,1699991040,14160,93223,79508,PT,PT
67975,1699629660,1699633260,3600,184580,185178,NL,DE
117615,1700286480,1700298480,12000,86135,19008,US,US
114070,1700570280,1700581140,10860,197058,15642,US,US
131158,1700767680,1700794740,27060,37166,65163,PL,CZ
15452,1698845340,1698856200,10860,57460,156161,US,US
128126,1699438980,1699450380,11400,181127,45792,US,US
150219,1698937020,1698948900,11880,68596,189296,IT,IT
168007,1700696820,1700700420,3600,50957,53100,NL,NL
88915,1699040760,1699073880,33120,123502,98968,TR,TR
22286,1699277220,1699311240,34020,149639,24070,TR,TR
30289,1699553460,1699568340,14880,3674,39288,FR,FR
30235,1700236440,1700255400,18960,153895,8063,FR,BE
177038,1700073480,1700107620,34140,166586,190019,MX,MX
127492,1699841520,1699877340,35820,88450,39590,TR,TR
197249,1699489860,1699522560,32700,51371,109871,TR,TR
137139,1699816020,1699821360,5340,146600,12746,EE,EE
13747,1698870480,1698903420,32940,63261,44807,TR,TR
67534,1699734780,1699750140,15360,128743,132271,US,US
50160,1699230720,1699260540,29820,59661,52594,TR,TR
181965,1699670160,1699704960,34800,131963,188493,TR,TR
168153,1699613220,1699638300,25080,34058,113565,PL,AT
39787,1698940620,1698947820,7200,20527,54802,SK,CZ
141523,1699843500,1699874220,30720,110626,83398,TR,TR
184388,1699753620,1699757220,3600,137413,138865,NL,NL
147144,1699219800,1699224480,4680,20817,140912,NL,NL
7899,1699236420,1699241640,5220,153167,44281,GB,GB
79062,1699091100,1699124100,33000,71644,36706,TR,TR
141041,1700026500,1700057220,30720,13206,48080,TR,TR
727,1699295640,1699317300,21660,73948,149113,DE,DE
191818,1700551620,1700584020,32400,171468,84094,TR,TR
141742,1700380620,1700404620,24000,20640,131872,DE,DE
79284,1700078220,1700091300,13080,70683,82303,US,US
34016,1699955280,1699989240,33960,183216,84241,TR,TR
16640,1700381040,1700390340,9300,194154,8961,ES,AD
29195,1699882080,1699896180,14100,162080,32388,HR,HR
21565,1699643400,1699676100,32700,122760,12101,TR,TR
10235,1699159320,1699165560,6240,94249,126199,GB,GB
40703,1699893480,1699927680,34200,4467,73106,TR,TR
44457,1699012200,1699024500,12300,3940,179690,AT,AT
183290,1698797580,1698803760,6180,81840,79948,GB,GB
38262,1700380800,1700384400,3600,66295,43609,NL,NL
30827,1700268780,1700282340,13560,35356,178887,US,US
63948,1699456440,1699460040,3600,160280,185456,GB,GB
57670,1699235940,1699274280,38340,53872,145648,MX,MX
131401,1699708680,1699723080,14400,19677,136247,US,US
89846,1700424180,1700440320,16140,6562,44169,FR,FR
170282,1699570680,1699604280,33600,4495,75848,MX,MX
23161,1700694840,1700701500,6660,52019,27845,GB,GB
130573,1699851000,1699866360,15360,40108,98802,FR,FR
197504,1700332200,1700362920,30720,88964,72696,TR,TR
163279,1700277060,1700312340,35280,167357,5605,TR,TR
158971,1699560660,1699596480,35820,149123,152373,TR,TR
122033,1700439660,1700445900,6240,158131,192510,NL,NL
15666,1699559700,1699572120,12420,35050,145566,PT,PT
39788,1700350740,1700356740,6000,47604,29032,GB,NL
197697,1699844160,1699847760,3600,29963,110451,GB,GB
189903,1698932580,1698963360,30780,121722,190289,TR,TR
49442,1699180260,1699207620,27360,8813,184596,BR,BR
144305,1698884760,1698892740,7980,193695,39307,IT,IT
193233,1700073960,1700085900,11940,110572,73514,IT,IT
199979,1699212540,1699224660,12120,23824,130379,AT,BG
68857,1700127360,1700160480,33120,24391,165089,TR,TR
171404,1700502900,1700520240,17340,88676,26334,AT,HU
79295,1700463720,1700498580,34860,52512,119942,TR,TR
14223,1699953240,1699958520,5280,3855,172243,NL,NL
129093,1700792160,1700798820,6660,190654,161125,NL,NL
106327,1700508720,1700544420,35700,30743,3134,TR,TR
104214,1699201020,1699227720,26700,37386,40260,DE,CZ
140738,1700674740,1700705640,30900,104663,150418,TR,TR
8398,1699458540,1699462140,3600,14715,145445,NL,BE
58170,1699706400,1699736760,30360,94190,70281,TR,TR
80244,1699315020,1699332360,17340,189538,31327,AT,AT
90989,1700240940,1700257260,16320,44301,138559,US,US
148703,1699936020,1699939620,3600,174448,127045,GB,GB
71105,1700647080,1700658360,11280,121802,141092,IT,IT
173646,1699642620,1699648440,5820,20451,183516,GB,GB
134948,1699711020,1699739940,28920,78623,172535,TR,TR
104623,1700354940,1700388360,33420,5798,59491,TR,TR
187420,1698969780,1699005240,35460,61503,101758,TR,TR
3971,1699355880,1699385100,29220,89731,19741,TR,TR
190799,1699144380,1699173300,28920,167122,79679,TR,TR
21710,1699407240,1699419720,12480,182273,122091,US,US
89288,1699663980,1699698480,34500,95808,18119,TR,TR
87577,1699302720,1699328220,25500,19100,195534,RO,IT
40005,1700737980,1700752080,14100,21610,19136,PT,PT
88307,1700364600,1700380740,16140,41140,126538,RS,RS
56807,1700800500,1700816460,15960,169034,123040,US,US
150966,1699911540,1699926720,15180,177328,179509,US,US
40350,1699613220,1699648260,35040,180880,127848,TR,TR
37704,1699975500,1700006820,31320,16270,56963,TR,TR
109759,1699110300,1699140540,30240,12277,148684,TR,TR
94048,1700468940,1700480760,11820,147864,62489,US,US
65394,1699029840,1699033440,3600,14199,192570,NL,NL
147113,1699616220,1699625280,9060,149846,85403,ES,ES
151753,1699272300,1699305900,33600,184012,14637,MX,MX
48500,1700856720,1700862300,5580,147009,186623,GB,GB
49827,1699174260,1699203480,29220,187966,104875,TR,TR
30397,1699394400,1699408740,14340,189719,44736,CZ,CZ
7348,1700821800,1700827440,5640,131373,35260,NL,NL
81930,1698811260,1698817560,6300,127145,17953,NL,NL
187601,1699945920,1699980120,34200,135892,121480,TR,TR
165803,1699310820,1699327860,17040,96945,1346,US,US
101795,1700668740,1700684460,15720,22352,38644,FR,FR
61483,1700114220,1700125800,11580,156428,152106,IT,IT
22830,1700163300,1700168880,5580,186957,58988,GB,GB
711,1700059980,1700075760,15780,189952,23377,AT,AT
139226,1699452600,1699463820,11220,134349,9359,IT,IT
44687,1699983180,1700018640,35460,112095,105078,TR,TR
16888,1699361820,1699382040,20220,194835,124403,BE,DE
103740,1698834300,1698867120,32820,149837,115149,TR,TR
85337,1700398200,1700433660,35460,24822,172828,TR,TR
39259,1700606520,1700622600,16080,146470,63855,US,US
171757,1700179920,1700197980,18060,93007,152987,BE,NL
76388,1699293960,1699306380,12420,43270,18420,US,US
33209,1698932820,1698964680,31860,49888,4058,TR,TR
64540,1699622640,1699654860,32220,113433,56381,TR,TR
198797,1700674500,1700688120,13620,64664,50341,US,US
100009,1700408520,1700443500,34980,24003,188458,TR,TR
174436,1698858780,1698880200,21420,160766,39132,FR,BE
59310,1699839660,1699873380,33720,83931,1537,MX,US
108633,1700235120,1700269140,34020,248,96898,TR,TR
72761,1700739900,1700747760,7860,75288,143897,IT,IT
78935,1699218480,1699241100,22620,166930,104464,BR,BR
159684,1700696220,1700731920,35700,172933,83552,TR,TR
107351,1699958880,1699994760,35880,138259,118160,TR,TR
62289,1699148040,1699151640,3600,140638,142330,NL,NL
134062,1699302120,1699313400,11280,6006,157196,US,US
125518,1698857100,1698870000,12900,156132,130930,ES,AD
31103,1699846260,1699879980,33720,49696,47910,TR,TR
2363,1700184780,1700216880,32100,129153,156029,TR,TR
134652,1699106400,1699137660,31260,69815,74618,TR,TR
32693,1700487480,1700519340,31860,92362,160944,TR,TR
43177,1700181060,1700194920,13860,91703,175325,US,US
180112,1699979700,1700011320,31620,52053,104619,TR,TR
142418,1700347140,1700350740,3600,105502,151750,NL,NL
177563,1699978320,1700011080,32760,166935,14571,TR,TR
74217,1699157220,1699181820,24600,54050,28740,DE,HR
62789,1700011020,1700017080,6060,6315,13219,GB,GB
39632,1700161320,1700164920,3600,157811,115492,NL,NL
55653,1699606380,1699638360,31980,10703,129547,TR,TR
40609,1698952020,1698977280,25260,72734,28593,RO,MD
143523,1700746560,1700751360,4800,127877,65371,GB,GB
154869,1700653380,1700687100,33720,7323,101323,TR,TR
156665,1699279680,1699293720,14040,168260,27575,US,US
25689,1700065440,1700104380,38940,158493,62243,MX,US
131441,1698798660,1698804240,5580,36870,119163,GB,GB
149300,1699839420,1699853220,13800,157382,112734,IT,HR
64273,1698862440,1698875400,12960,16259,120578,US,US
166621,1699131900,1699162980,31080,166695,167572,TR,TR
162774,1699995540,1700024460,28920,101676,116307,TR,TR
98198,1699008600,1699038780,30180,128415,15901,TR,TR
13945,1699564920,1699593840,28920,22085,98351,TR,TR
49215,1699482720,1699502340,19620,100721,86584,FR,IT
147293,1700023080,1700058900,35820,158405,241,TR,TR
148295,1699700880,1699710840,9960,88259,121306,PT,PT
86344,1700319660,1700346840,27180,4193,123960,DE,RS
180170,1699930620,1699946040,15420,119783,151823,US,US
148405,1700402160,1700412180,10020,127802,5669,HR,HU
102254,1699903680,1699907280,3600,37539,134637,GB,GB
39997,1700616600,1700621760,5160,33821,5781,GB,GB
30415,1699050000,1699079160,29160,96878,166353,TR,TR
112322,1698905460,1698918420,12960,97921,184056,AT,AT
72907,1699243320,1699257240,13920,114944,99921,RS,RS
95280,1698952560,1698988320,35760,11638,173076,TR,TR
17174,1699182540,1699212060,29520,113126,34337,TR,TR
50172,1699837200,1699867560,30360,184321,31916,TR,TR
6094,1699850100,1699871700,21600,191457,180683,BR,BR
145093,1700057280,1700060880,3600,124039,25900,GB,GB
43799,1700822820,1700826420,3600,93974,117068,NL,NL
156126,1700022480,1700044080,21600,192202,58748,RO,RO
196365,1698882780,1698897000,14220,103023,28225,ES,AD
22776,1698851160,1698861960,10800,56159,78941,IT,HR
82607,1699911300,1699928880,17580,140059,164854,CZ,CZ
79882,1699786200,1699789800,3600,178734,80421,NL,NL
65982,1700097900,1700122320,24420,112201,144959,DE,IT
183388,1700601420,1700613120,11700,161741,80811,IT,IT
114609,1700263560,1700287140,23580,189348,49524,PL,PL
131320,1700497080,1700509920,12840,177474,95729,US,US
157491,1700039220,1700064240,25020,36977,28631,DE,PL
23919,1699993260,1699998960,5700,64860,142267,NL,NL
2500,1698814500,1698849660,35160,178887,116336,TR,TR
167449,1700569560,1700573340,3780,171604,134643,NL,NL
71513,1700054340,1700080740,26400,123124,11934,DE,DE
176373,1700611260,1700619540,8280,152560,91035,IT,IT
66896,1699014480,1699045740,31260,79638,182684,TR,TR
40048,1699436580,1699440180,3600,105708,140433,GB,GB
66764,1699633920,1699647960,14040,194745,159790,IT,IT
77226,1700460060,1700489460,29400,68897,33677,TR,TR
58322,1699636200,1699691880,55680,175396,97514,UA,DE
171352,1700241000,1700254560,13560,3268,157159,PT,PT
65156,1699602180,1699615440,13260,90727,83260,SK,SK
155417,1699842840,1699870080,27240,33087,76227,BA,AT
42175,1699368000,1699380660,12660,122939,191958,US,US
77130,1699519200,1699531020,11820,178722,157111,IT,IT
14847,1700803620,1700830380,26760,113595,167188,DE,PL
165880,1700472660,1700476260,3600,46741,158436,GB,GB
47866,1700182800,1700188620,5820,100671,41152,NL,NL
195677,1699943400,1699953600,10200,97706,19758,EE,EE
197880,1699150800,1699186620,35820,121376,187352,TR,TR
123235,1699175400,1699210620,35220,59410,146453,TR,TR
52689,1700256840,1700287140,30300,41781,56401,TR,TR
179430,1699834080,1699850460,16380,49066,71920,US,US
9570,1700368800,1700383500,14700,92133,12044,AT,AT
107700,1699264320,1699298520,34200,150087,110289,TR,TR
96522,1700554140,1700584080,29940,167400,67755,TR,TR
26267,1700268540,1700279640,11100,132275,156270,ES,AD
127672,1698847680,1698865320,17640,162150,104299,US,US
174965,1699531800,1699542660,10860,34525,52155,IT,IT
188442,1699904340,1699913460,9120,129173,177179,FI,EE
183656,1699035420,1699044600,9180,153350,91541,IT,IT
40296,1699270020,1699299300,29280,8915,72473,TR,TR
36778,1699670940,1699690380,19440,165463,148047,FR,SE
36318,1700420400,1700452500,32100,107351,133314,TR,TR
29629,1698871500,1698882420,10920,111868,95543,CZ,CZ
154261,1700256660,1700291820,35160,97319,147662,TR,TR
114923,1698992280,1698995880,3600,120144,52746,GB,GB
30839,1698877560,1698883200,5640,37707,60715,GB,GB
192812,1699559340,1699588440,29100,101358,99758,TR,TR
86285,1700068140,1700099160,31020,113634,152240,TR,TR
101498,1698825780,1698855180,29400,126928,197581,TR,TR
33226,1700169720,1700182800,13080,58360,169235,US,US
39306,1699233960,1699249800,15840,105365,118573,FR,FR
190907,1699142040,1699166940,24900,141358,24058,SI,RS
4859,1700651100,1700665440,14340,94600,93522,IT,IT
17782,1700042820,1700049720,6900,107677,175824,NL,DE
146097,1699809480,1699843920,34440,11948,50696,MX,MX
190827,1699488600,1699520820,32220,105763,168820,TR,TR
1621,1699551000,1699568220,17220,168322,88483,US,US
108246,1699100760,1699132140,31380,75464,185632,TR,TR
39262,1700582220,1700611140,28920,31590,194798,TR,TR
103498,1699346340,1699376820,30480,81864,3518,TR,TR
61902,1700423100,1700439300,16200,131636,62221,FR,FR
68657,1700578500,1700609160,30660,28432,87908,TR,TR
37696,1699556520,1699572120,15600,148799,69332,US,US
180939,1699105920,1699120740,14820,39538,197952,US,MX
183665,1700859420,1700890620,31200,16895,21467,TR,TR
136018,1699206780,1699236780,30000,114959,164797,TR,TR
283,1699812900,1699820700,7800,162926,164360,EE,FI
74669,1699071300,1699101120,29820,77285,151724,TR,TR
79693,1698886920,1698890760,3840,86212,57457,GB,GB
12915,1699071540,1699105500,33960,106280,13876,TR,TR
84125,1700851800,1700864820,13020,186246,72014,US,US
187035,1699114800,1699127940,13140,155039,1070,AT,AT
17546,1699060020,1699068900,8880,122439,170992,IT,IT
54158,1699160520,1699192860,32340,100473,101232,TR,TR
175000,1700227140,1700230740,3600,196936,132153,NL,NL
180878,1700360100,1700374380,14280,189826,198933,PT,PT
182602,1699654380,1699657980,3600,157781,11371,GB,GB
43621,1699448640,1699479780,31140,49596,107071,TR,TR
27642,1699916160,1699919760,3600,76836,143268,GB,GB
94662,1699880340,1699891020,10680,14792,82874,AD,ES
132681,1699141800,1699158540,16740,47906,39326,CZ,CZ
50644,1699880580,1699910520,29940,90254,146186,TR,TR
166758,1699222680,1699232820,10140,189235,176627,IT,IT
186458,1699296840,1699300440,3600,26397,127675,GB,GB
67888,1699243980,1699247580,3600,180088,17559,NL,NL
162391,1699721460,1699727580,6120,141772,95294,GB,GB
167201,1700604720,1700609040,4320,177719,112946,GB,GB
126175,1700296920,1700304780,7860,171455,155055,IT,IT
30103,1700176500,1700189760,13260,159833,41624,AT,AT
150684,1699145040,1699158660,13620,116520,91,CZ,BE
192786,1700726760,1700741100,14340,6845,90106,IT,IT
19332,1699682520,1699692420,9900,56457,80638,ES,ES
82132,1700598720,1700612760,14040,38569,185392,HR,HR
47680,1700583900,1700587500,3600,100922,67724,GB,GB
92209,1699565100,1699579680,14580,80307,30282,AT,DE
53538,1699958580,1699993500,34920,25783,100085,TR,TR
113328,1700865420,1700895300,29880,158921,21052,TR,TR
146465,1699259880,1699284900,25020,139886,77699,PL,NL
124661,1700141100,1700151540,10440,185770,42154,PT,PT
130995,1699735500,1699770840,35340,185566,82947,TR,TR
192925,1700816940,1700831700,14760,124293,87323,BE,NL
27845,1699524420,1699542900,18480,180400,112398,FR,FR
194154,1700408820,1700412420,3600,77847,192345,NL,NL
138128,1700011680,1700025180,13500,102741,143306,IT,IT
128088,1700739600,1700743200,3600,34480,132190,NL,NL
157308,1700051040,1700077500,26460,5078,180524,BA,AT
114574,1699822500,1699853400,30900,196744,163422,TR,TR
169688,1699130100,1699142640,12540,151244,142172,ES,FR
113492,1699512420,1699546200,33780,189335,99389,TR,TR
23681,1700160660,1700192700,32040,153408,143758,TR,TR
121580,1700841540,1700854860,13320,91998,117189,US,US
17621,1700544480,1700548080,3600,4420,159421,GB,GB
128284,1699219320,1699227600,8280,61144,85285,PT,PT
73635,1699841160,1699847160,6000,118394,135749,FI,EE
169633,1700513700,1700518800,5100,101550,161616,GB,GB
39530,1700286300,1700290380,4080,47170,106765,GB,GB
42893,1700277300,1700307300,30000,100078,67474,TR,TR
40416,1699578420,1699591380,12960,85961,143530,IT,IT
150072,1700043060,1700057100,14040,25322,159264,ES,ES
120242,1699389120,1699425000,35880,110687,99414,TR,TR
112655,1700375040,1700405460,30420,168330,16937,TR,TR
171213,1699773720,1699806360,32640,146207,50655,TR,TR
29985,1698814260,1698837300,23040,69130,66183,PL,DE
147170,1700359620,1700370840,11220,18857,63673,CZ,CZ
81425,1700757000,1700785860,28860,164558,38123,TR,TR
121057,1698979920,1698988500,8580,144183,31100,IT,IT
28162,1700630460,1700659920,29460,23025,84291,TR,TR
136592,1699727520,1699743360,15840,194788,59022,FR,FR
38657,1699043280,1699056240,12960,38314,67462,HR,HR
4068,1700278260,1700310840,32580,131747,2190,TR,TR
135843,1700550180,1700566800,16620,111014,162256,US,US
196418,1700803680,1700837700,34020,1496,153901,TR,TR
199079,1699138500,1699156260,17760,89841,181324,US,US
132442,1698796620,1698827100,30480,146888,192078,TR,TR
20403,1699694100,1699703640,9540,162702,152319,IT,IT
121074,1699397640,1699427580,29940,50806,124170,TR,TR
15237,1699704000,1699733580,29580,13052,17355,TR,TR
48106,1699846560,1699876860,30300,37002,35994,TR,TR
114123,1699957080,1699973160,16080,48053,159489,US,US
82805,1700647140,1700673720,26580,196697,144574,BR,BR
132743,1699656060,1699664400,8340,21969,34687,IT,IT
49236,1700377800,1700413560,35760,35562,113666,TR,TR
161980,1699234020,1699265160,31140,86223,77155,TR,TR
121734,1700858040,1700875380,17340,132099,185842,US,US
29153,1700498460,1700528460,30000,150123,185474,TR,TR
100991,1700672580,1700701200,28620,54495,67117,PL,PL
112624,1699483080,1699512000,28920,190283,43005,TR,TR
144822,1700071860,1700075460,3600,21652,94370,NL,NL
115546,1700035560,1700046360,10800,57392,190048,HR,HR
127206,1699955760,1699959360,3600,78251,93443,NL,NL
15024,1699093260,1699107900,14640,141397,123997,US,US
96666,1700471460,1700501820,30360,77716,173573,TR,TR
10063,1699241880,1699246680,4800,120175,34806,GB,GB
22561,1699253640,1699288080,34440,167867,42917,TR,TR
138535,1699017300,1699027680,10380,161688,155456,IT,IT
185358,1700422260,1700448000,25740,95956,82918,BR,BR
112708,1699766700,1699797300,30600,90557,77966,TR,TR
4259,1699885980,1699921260,35280,11251,145015,TR,TR
65912,1700582220,1700599020,16800,107173,31293,US,US
2411,1700183580,1700203140,19560,106293,96924,SE,SE
13439,1700453100,1700464740,11640,17848,40489,US,US
145725,1700099040,1700110020,10980,199450,171795,ES,ES
73952,1698851880,1698881220,29340,167960,108252,TR,TR
110512,1700022660,1700055000,32340,96108,181,TR,TR
152748,1699037880,1699075920,38040,187174,162090,MX,MX
134416,1700641020,1700649600,8580,31011,154519,HR,FR
148742,1699207620,1699242900,35280,54710,16267,TR,TR
97058,1700386260,1700418660,32400,26555,169562,TR,TR
85670,1700014320,1700027880,13560,162862,77110,HR,DE
89251,1700859300,1700865900,6600,2645,93423,GB,GB
36654,1700389260,1700424360,35100,52034,30217,MX,US
8610,1699183740,1699198980,15240,135550,199113,US,US
165320,1700225100,1700256240,31140,11959,80724,TR,TR
106794,1700507940,1700522880,14940,103555,171756,US,US
93044,1700737380,1700758260,20880,43148,126584,FR,BE
56894,1699073700,1699077300,3600,38711,96012,NL,PL
147478,1699886340,1699920900,34560,81068,126880,TR,TR
50915,1698923760,1698927360,3600,74060,64413,NL,NL
54453,1699563360,1699573560,10200,15462,162986,HR,HR
149381,1699312020,1699328940,16920,71401,186026,CA,CA
169749,1700016840,1700031120,14280,84622,74587,IT,IT
24118,1698899640,1698930540,30900,67031,71582,TR,TR
162079,1699233300,1699249860,16560,173343,39745,US,US
187393,1699891860,1699896540,4680,101872,40967,NL,NL
158522,1698819660,1698833280,13620,65932,64683,US,US
104175,1700736600,1700740200,3600,167878,17641,NL,NL
12145,1700069880,1700102160,32280,119662,75593,TR,TR
102167,1698933120,1698968280,35160,188724,16188,TR,TR
70241,1700260860,1700272620,11760,175853,28002,CZ,CZ
34216,1699355700,1699390860,35160,13172,45095,TR,TR
54711,1700701620,1700705220,3600,1205,55641,NL,NL
130060,1699683300,1699689120,5820,104895,69518,NL,NL
39477,1699212360,1699241400,29040,78436,89494,TR,TR
26884,1700122560,1700126340,3780,97526,21547,GB,GB
192037,1699447020,1699452060,5040,31145,163046,NL,NL
91369,1698843000,1698859380,16380,56904,190945,FR,ES
122940,1699296000,1699319040,23040,309,27686,DE,HU
120547,1700230560,1700265960,35400,112521,154806,TR,TR
59025,1700266380,1700276400,10020,155540,156923,IT,DE
174828,1699588320,1699619580,31260,18467,49467,TR,TR
94296,1699129320,1699138860,9540,58908,109706,IT,IT
81239,1698862140,1698897240,35100,22900,13733,TR,TR
149611,1699312800,1699329360,16560,114969,188945,US,US
199076,1700054820,1700071740,16920,124025,192606,RS,DE
176101,1700092680,1700096280,3600,187727,77222,GB,GB
158353,1699055700,1699073040,17340,6500,4080,US,US
167504,1700290260,1700302260,12000,30604,41899,US,US
77476,1699470060,1699483200,13140,3638,55249,IT,IT
95103,1699269780,1699274340,4560,29290,45874,NL,NL
5654,1700582460,1700588340,5880,32571,9512,GB,GB
63386,1700629740,1700661000,31260,158725,124227,TR,TR
100773,1700348520,1700381460,32940,71065,159955,MX,MX
154343,1699684440,1699697880,13440,178517,97434,US,US
49523,1700538300,1700550060,11760,195411,75238,RS,RS
196775,1699551840,1699578360,26520,5821,173272,PL,PL
53172,1700398800,1700413500,14700,63256,91429,US,US
93704,1700402340,1700434080,31740,75059,112915,TR,TR
167991,1698922260,1698954060,31800,114428,47552,TR,TR
81591,1700606760,1700641020,34260,42578,4118,TR,TR
50893,1700646240,1700657940,11700,116417,164137,US,US
198274,1699655100,1699658700,3600,165247,29663,NL,NL
116987,1700626980,1700658300,31320,92576,117193,TR,TR
96933,1699615200,1699651140,35940,151503,163365,MX,MX
60350,1699218660,1699227840,9180,53546,151175,ES,AD
96278,1699427700,1699460640,32940,173560,177078,TR,TR
60986,1700030940,1700065140,34200,161217,183950,TR,TR
129237,1700317260,1700338740,21480,108784,146139,FR,FR
147990,1698977220,1699012200,34980,105940,135062,TR,TR
118733,1700274720,1700281740,7020,60255,188553,GB,GB
130362,1700316180,1700325540,9360,107162,151939,ES,ES
127714,1700174280,1700208600,34320,28803,165990,TR,TR
98098,1698811200,1698842340,31140,66007,127842,TR,TR
53972,1700474220,1700489580,15360,6320,81758,US,US
14291,1699458180,1699469040,10860,22724,196805,IT,IT
15922,1698841140,1698862320,21180,37880,77220,FR,CZ
25132,1700613600,1700641200,27600,71364,156611,DE,IT
5203,1699200540,1699204140,3600,48319,32848,GB,GB
123165,1698795720,1698824940,29220,181330,194995,TR,TR
24494,1699771920,1699775520,3600,14912,123211,NL,NL
56459,1700190240,1700199420,9180,184222,13887,HR,HR
193484,1700106480,1700117160,10680,96198,45714,ES,ES
181434,1699468800,1699480140,11340,137617,164462,AT,AT
174840,1699162560,1699166160,3600,178448,100223,GB,GB
3409,1699313700,1699320720,7020,64183,102088,GB,GB
128347,1700032320,1700040120,7800,1870,38935,HR,AL
73473,1700359860,1700363460,3600,187543,43020,NL,NL
41460,1700682000,1700686560,4560,16897,18263,GB,GB
182539,1700350140,1700381220,31080,52699,17758,TR,TR
77034,1699879080,1699894680,15600,124063,65112,US,US
169003,1700474940,1700480580,5640,49015,106428,GB,GB
94372,1700477280,1700513760,36480,2931,86772,MX,MX
110581,1699918800,1699948560,29760,122490,39868,TR,TR
191404,1700005920,1700017680,11760,98305,75205,IT,IT
105484,1699763280,1699792080,28800,127517,185872,TR,TR
154184,1699743540,1699769880,26340,187020,77162,DE,HR
199354,1700821800,1700830860,9060,26752,48143,IT,IT
16608,1699691520,1699726200,34680,105645,154580,TR,TR
87505,1698928620,1698939540,10920,194664,39795,ES,AD
177148,1700200620,1700207100,6480,98027,56008,NL,NL
58202,1699669620,1699705020,35400,193810,55451,MX,MX
160336,1700253000,1700267100,14100,22962,24216,HR,AT
137115,1698984540,1699000020,15480,85216,17070,AT,NL
160270,1700225280,1700236380,11100,56812,40016,ES,PT
77449,1700692620,1700728020,35400,60798,178381,TR,TR
159010,1699688880,1699693320,4440,177862,180417,GB,GB
167779,1699851660,1699886760,35100,188364,106845,TR,TR
37760,1700449620,1700463120,13500,566,74585,IT,IT
148540,1700395440,1700406540,11100,123070,103270,IT,IT
15469,1700299380,1700314200,14820,184065,110090,US,US
42950,1700036220,1700069100,32880,191059,189878,TR,TR
2512,1698828960,1698859320,30360,77390,191454,TR,TR
143880,1699706460,1699740480,34020,129845,118009,TR,TR
96975,1700698080,1700701680,3600,181835,33611,GB,GB
99251,1699020540,1699053300,32760,169806,74330,TR,TR
155061,1699738800,1699745880,7080,142496,85745,GB,GB
145203,1699817400,1699821000,3600,164795,69506,GB,GB
16847,1699471320,1699506480,35160,19864,7188,TR,TR
49082,1699060680,1699064280,3600,130664,19682,GB,GB
94899,1700582460,1700599920,17460,69742,78317,US,US
25330,1699075440,1699087380,11940,125023,86341,IT,IT
9727,1700607480,1700643120,35640,183466,71021,TR,TR
10701,1700667300,1700672040,4740,177707,7962,CL,CL
22448,1700283120,1700286720,3600,126033,135113,GB,GB
109416,1700481840,1700485440,3600,54210,131548,GB,GB
11671,1699522620,1699529460,6840,170014,108722,NL,NL
119534,1700717160,1700720760,3600,132575,61007,GB,GB
63108,1699354920,1699369500,14580,121904,191299,US,US
17855,1699658460,1699668000,9540,130601,155900,IT,IT
178251,1700571900,1700585640,13740,148077,138695,RS,RS
105656,1700668680,1700701500,32820,36769,148587,MX,US
89632,1699736280,1699769820,33540,125276,87220,TR,TR
122337,1700151660,1700186340,34680,20597,166927,TR,TR
105993,1699288440,1699302420,13980,160048,18634,US,US
141019,1699397100,1699432080,34980,37417,144466,TR,TR
56866,1699136580,1699153320,16740,134119,154552,US,US
112054,1699817100,1699829400,12300,38525,119394,IT,IT
179878,1699980960,1699993080,12120,70845,6415,CA,CA
104984,1698997620,1699032480,34860,80723,174533,TR,TR
156301,1699121160,1699133100,11940,139786,115240,US,US
10996,1699903260,1699917240,13980,16689,181827,US,US
39160,1700050080,1700071680,21600,70626,24391,CH,FR
109233,1699128840,1699132440,3600,9642,19126,GB,GB
156231,1700060700,1700069760,9060,68736,175144,EE,EE
10106,1700591880,1700597160,5280,159330,117754,GB,GB
78430,1700635680,1700665200,29520,129406,18351,TR,TR
86286,1700680680,1700696100,15420,171150,7301,US,US
135681,1699672200,1699680300,8100,188228,171202,ES,ES
3080,1700218740,1700274000,55260,26402,34842,BG,AT
34884,1700769900,1700787600,17700,154048,15268,US,US
113557,1700269920,1700299020,29100,152281,132586,TR,TR
128149,1698911220,1698916380,5160,132150,81276,NL,NL
43821,1699889280,1699921800,32520,32550,12181,MX,MX
163564,1700120220,1700134920,14700,71939,109100,FR,FR
148958,1698881520,1698896040,14520,93139,12957,US,US
119159,1700040900,1700044500,3600,78773,190812,GB,GB
180250,1699325760,1699360080,34320,192303,68085,TR,TR
163979,1699500300,1699503900,3600,170626,179602,NL,NL
40463,1699663020,1699698240,35220,160910,36090,TR,TR
88207,1700082300,1700089080,6780,19644,188896,GB,GB
8224,1699862160,1699890660,28500,93982,154148,BA,BA
153650,1700683140,1700690820,7680,184636,186620,SK,SK
30627,1699628700,1699661280,32580,10215,70920,TR,TR
6577,1700866620,1700880540,13920,34210,40273,PT,PT
151157,1700338980,1700347560,8580,63450,178374,HR,PL
158360,1700532480,1700589840,57360,112158,80631,UA,MD
149638,1700228160,1700285220,57060,114367,52063,UA,PL
115220,1699161120,1699218600,57480,184826,50062,BG,DE
88912,1700708400,1700712000,3600,106647,123785,GB,GB
126618,1699115220,1699150260,35040,61784,72892,TR,TR
132148,1699043580,1699072680,29100,197561,136135,TR,TR
57563,1699028100,1699032120,4020,8075,198261,NL,NL
58069,1699781460,1699816200,34740,76007,93015,TR,TR
93184,1699422840,1699435320,12480,113907,40555,HR,HR
143532,1700272380,1700278440,6060,6300,46777,GB,GB
592,1699996680,1700006940,10260,141361,169657,PT,PT
87726,1699242120,1699257660,15540,96331,113811,US,US
121694,1699758060,1699774800,16740,2917,56711,US,US
114521,1698949260,1698963480,14220,126614,181181,ES,AD
4053,1699471620,1699496520,24900,129327,176881,DE,FR
26324,1698796080,1698803700,7620,51974,152481,PT,FR
159170,1700733780,1700737380,3600,196019,153851,GB,GB
173948,1699070820,1699084680,13860,4289,118501,PT,PT
34010,1699383960,1699392360,8400,105769,140805,SK,SK
54871,1699682580,1699698960,16380,41934,59451,US,US
181616,1699426260,1699439340,13080,137072,24832,US,US
41149,1700408400,1700412000,3600,159889,142379,GB,GB
39194,1700471820,1700502900,31080,143443,126400,TR,TR
115848,1700686320,1700700000,13680,125431,80285,US,US
68028,1699293240,1699302840,9600,69810,116494,IT,IT
131184,1700296500,1700326500,30000,56011,53789,TR,TR
32548,1700184780,1700217900,33120,28072,81796,TR,TR
136333,1698834420,1698838020,3600,53586,140133,GB,GB
98820,1700718000,1700731020,13020,104498,40926,US,US
176078,1700713980,1700726340,12360,130350,43028,IT,IT
144910,1699111800,1699125900,14100,8804,123296,HR,HR
30686,1699043100,1699077180,34080,114228,8709,TR,TR
26395,1699642500,1699660260,17760,16987,27116,US,US
124122,1699011780,1699015380,3600,81458,186777,NL,NL
83874,1698794700,1698824340,29640,125426,151104,TR,TR
116073,1699106640,1699114500,7860,181564,85105,HR,HR
101017,1700854200,1700860860,6660,11099,137481,EE,EE
46655,1698795360,1698825660,30300,198213,137123,TR,TR
74177,1700095920,1700130900,34980,16580,179809,TR,TR
54022,1700520660,1700555820,35160,74602,16874,MX,MX
13798,1700411700,1700418240,6540,195064,46986,GB,GB
39841,1700350800,1700368740,17940,123976,191178,US,US
52909,1699353960,1699370100,16140,177645,153291,US,US
179428,1699632720,1699642560,9840,88912,193902,IT,IT
34509,1700815440,1700819760,4320,113465,145020,GB,GB
150833,1699981740,1700013240,31500,97776,187055,TR,TR
12386,1700852940,1700866860,13920,77519,135169,IT,IT
43904,1700467380,1700470980,3600,61456,171878,GB,GB
47053,1699162980,1699196280,33300,151746,95144,TR,TR
198593,1700730600,1700743980,13380,137788,171204,US,US
113651,1699915320,1699947000,31680,189632,43716,TR,TR
146890,1700335140,1700370900,35760,164815,52950,TR,TR
94786,1700182500,1700194560,12060,97606,184526,US,US
108822,1700403180,1700419560,16380,30947,96894,US,US
166287,1699787640,1699815060,27420,173347,159074,BR,BR
175072,1700214060,1700244840,30780,48881,189438,TR,TR
181338,1700649540,1700653140,3600,159371,132599,NL,FR
136441,1699715400,1699748580,33180,143872,35582,MX,MX
40926,1700688180,1700696160,7980,70504,85376,HR,HR
199687,1699732440,1699736040,3600,23180,180469,NL,NL
174843,1698906960,1698927540,20580,77924,88230,FR,FR
182939,1700272860,1700290440,17580,76411,113934,AT,BG
134618,1699112580,1699117320,4740,28727,70944,NL,NL
38062,1700456220,1700485320,29100,5771,159068,TR,TR
75517,1700759400,1700768880,9480,52393,13818,SK,SK
168100,1700440740,1700475780,35040,66207,177107,TR,TR
56925,1699240080,1699252500,12420,147058,59354,US,US
110546,1700335320,1700364120,28800,112428,1024,BA,BA
137097,1700661360,1700673060,11700,75674,166443,US,US
75404,1699625160,1699637280,12120,70393,101889,US,US
36063,1699736160,1699739760,3600,130642,117796,GB,GB
41335,1700125620,1700146860,21240,119844,73234,FR,BE
70394,1700452800,1700483880,31080,13222,95152,TR,TR
55559,1699784880,1699788480,3600,59469,124583,GB,GB
142458,1700324940,1700355720,30780,150116,149055,TR,TR
164976,1699736940,1699756860,19920,150697,130165,FR,DE
96482,1699902960,1699916340,13380,138289,184646,CZ,PL
139170,1700284200,1700318940,34740,164720,62575,TR,TR
6775,1699190220,1699224600,34380,76779,162783,TR,TR
3151,1699975740,1700006280,30540,86803,58242,TR,TR
132360,1699383780,1699395120,11340,11187,175038,IT,IT
79004,1699995600,1700029860,34260,77055,99104,TR,TR
129470,1700137260,1700140860,3600,132438,143726,GB,GB
10724,1698892500,1698925740,33240,103668,93276,TR,TR
169694,1698861720,1698888240,26520,82332,145161,PL,NL
187620,1700518800,1700547480,28680,85752,160526,DE,NL
176305,1700367840,1700393520,25680,40572,144730,PL,SK
147671,1699558080,1699591560,33480,33908,90050,TR,TR
86251,1700022600,1700055420,32820,60532,30461,TR,TR
137821,1699244820,1699252320,7500,141605,72136,IT,IT
77150,1699176180,1699211400,35220,82749,108515,TR,TR
192763,1699160700,1699194840,34140,198468,85088,TR,TR
1782,1699681140,1699684740,3600,30154,124039,GB,GB
154586,1700721240,1700753640,32400,106167,85330,MX,MX
152900,1699415520,1699450740,35220,65546,164974,TR,TR
61050,1699657740,1699674600,16860,46398,153265,CZ,DE
1079,1699798620,1699827840,29220,104806,122466,TR,TR
89021,1700712660,1700716260,3600,64074,98244,NL,NL
43354,1700722800,1700737320,14520,88911,172455,CZ,FR
163693,1700373780,1700380620,6840,20259,134631,NL,NL
92190,1700806140,1700836260,30120,33142,80863,TR,TR
64522,1700769780,1700799720,29940,29326,21508,TR,TR
138843,1699450320,1699464240,13920,35940,196453,PT,PT
65050,1700095380,1700098980,3600,70083,87140,GB,GB
199103,1699086960,1699098120,11160,154424,95008,IT,IT
191989,1699901220,1699933500,32280,123466,184150,TR,TR
90396,1699194660,1699227780,33120,129029,9313,MX,MX
196550,1700430000,1700456640,26640,164196,147675,DE,SE
22598,1699885020,1699888620,3600,74520,195364,GB,GB
95823,1699915800,1699943760,27960,101021,14574,BR,BR
117815,1699429080,1699439400,10320,4254,17514,IT,IT
38565,1700400960,1700431680,30720,160530,175163,TR,TR
134175,1700580480,1700615580,35100,130344,67530,TR,TR
22263,1699516380,1699522260,5880,96636,186013,GB,GB
88471,1700185860,1700205420,19560,175313,63498,BE,FR
155549,1700155680,1700186400,30720,92414,95671,TR,TR
161192,1700127480,1700163420,35940,12537,10306,TR,TR
187806,1700751600,1700772900,21300,68739,105478,FR,FR
177317,1700719140,1700730600,11460,15792,143429,US,US
183463,1700108700,1700140440,31740,66629,128089,TR,TR
163565,1700685660,1700697000,11340,131058,174007,RS,RS
106909,1699927080,1699960680,33600,74398,13750,TR,TR
171849,1700007180,1700010780,3600,187883,188661,GB,GB
130398,1699368840,1699424700,55860,107734,117148,BG,DE
151977,1698927420,1698960000,32580,159030,181271,TR,TR
113581,1699405980,1699409760,3780,8436,129427,NL,NL
21631,1699235820,1699267140,31320,2089,86348,TR,TR
183787,1699177380,1699193400,16020,124752,12045,US,US
185243,1700085900,1700142300,56400,8668,92876,BG,AT
45102,1700239260,1700251800,12540,27712,44965,HR,HR
128645,1700861940,1700896980,35040,39867,179128,TR,TR
158622,1699863600,1699897500,33900,181928,32230,TR,TR
151912,1699160880,1699191780,30900,123862,93795,TR,TR
116791,1700701740,1700716500,14760,106813,110554,AT,AT
38155,1699187820,1699196940,9120,3425,34082,IT,IT
87378,1700077980,1700095740,17760,2394,70127,US,US
47814,1698909000,1698942240,33240,168882,83551,TR,TR
167788,1699735080,1699745520,10440,94105,16677,SK,AT
67036,1700602020,1700614260,12240,35840,94020,IT,IT
145123,1699659060,1699669920,10860,179202,189284,AT,DE
27788,1699839600,1699854360,14760,38275,75655,CA,US
67452,1699487820,1699518840,31020,11462,176487,TR,TR
104622,1699124160,1699138740,14580,64437,164819,US,US
27605,1699005960,1699036680,30720,42700,110262,TR,TR
80773,1699311240,1699341720,30480,150521,188959,TR,TR
54051,1699159860,1699173840,13980,189778,151024,CA,CA
182427,1698980400,1698987780,7380,178969,162877,PT,PT
68595,1699371600,1699378980,7380,90385,121849,PT,PT
23669,1700017620,1700024400,6780,195398,6257,NL,NL
32438,1700458260,1700487360,29100,70602,65794,TR,TR
94597,1699431900,1699435500,3600,96777,1265,GB,GB
155428,1700297520,1700328600,31080,45575,123866,TR,RO
130904,1700069040,1700103660,34620,35585,84095,TR,TR
153500,1699078860,1699082460,3600,124186,190661,GB,GB
22785,1698846120,1698877560,31440,162301,162419,TR,TR
95045,1700002620,1700008740,6120,14881,58899,NL,NL
184215,1700429940,1700458800,28860,19673,54994,TR,TR
54156,1700233860,1700238180,4320,175331,189557,NL,NL
186143,1698875460,1698882600,7140,148210,179802,GB,GB
53605,1699469040,1699478760,9720,195901,71645,IT,IT
59543,1700317800,1700346660,28860,24063,105496,TR,TR
12751,1699496280,1699531020,34740,92671,189407,TR,TR
21313,1699852020,1699887300,35280,189017,110598,TR,TR
169142,1700583120,1700586720,3600,41174,106676,GB,GB
16318,1700459460,1700494140,34680,151011,183307,TR,TR
98978,1700726700,1700733840,7140,166814,192031,GB,GB
192083,1699863060,1699876440,13380,148703,49288,US,US
2940,1699082040,1699113600,31560,36441,53317,TR,TR
55944,1699421580,1699435020,13440,60443,182008,US,US
116540,1700377620,1700400240,22620,58714,132118,DE,CH
78674,1700405700,1700436540,30840,69319,80733,TR,TR
144324,1700006280,1700060760,54480,158282,85601,BG,AT
101934,1700564040,1700595960,31920,98048,90365,TR,TR
63063,1699269900,1699273680,3780,185129,101707,GB,GB
171278,1700256540,1700291640,35100,22814,99281,TR,TR
164229,1699513260,1699516860,3600,70101,6395,GB,GB
61336,1700119560,1700126460,6900,36941,112210,NL,NL
170090,1699239300,1699274160,34860,35871,176173,TR,TR
190327,1700462160,1700472180,10020,191951,105770,HR,RS
91694,1699288560,1699302300,13740,162588,136390,CZ,CZ
47372,1699933740,1699956060,22320,32396,177195,DE,FR
193599,1699187100,1699222500,35400,117174,143297,TR,TR
192170,1699659240,1699685820,26580,168117,172660,RO,RO
115413,1700274660,1700287800,13140,100062,54557,IT,IT
99205,1699581180,1699611060,29880,190449,22726,TR,TR
97332,1698862860,1698897240,34380,9847,99305,MX,MX
132838,1699234440,1699244100,9660,80265,148340,IT,FR
43032,1700209260,1700212860,3600,72003,89099,GB,GB
112010,1699624020,1699654260,30240,67904,56483,TR,TR
164296,1699414500,1699439700,25200,150009,190354,ME,HR
93498,1700834460,1700870400,35940,129465,116076,TR,TR
17996,1699564860,1699577760,12900,28572,55001,US,US
133158,1700509320,1700541480,32160,199137,185469,TR,TR
66590,1699055040,1699084380,29340,91890,129452,TR,TR
161446,1699048620,1699081620,33000,142990,130151,TR,TR
145651,1698902940,1698935580,32640,13638,171657,TR,TR
57122,1699112580,1699145760,33180,102627,129623,TR,TR
9135,1699358520,1699370880,12360,93687,184420,US,US
46878,1700279460,1700301840,22380,59671,88384,PL,HR
124410,1700464260,1700488440,24180,79772,82626,PL,PL
67729,1699317900,1699321620,3720,3865,126580,NL,NL
53952,1698892680,1698925620,32940,90217,98434,MX,MX
194027,1700592000,1700596020,4020,188695,141587,GB,GB
189036,1699857360,1699888080,30720,91064,56924,TR,TR
44718,1699388220,1699418880,30660,84610,184906,TR,TR
14753,1700036340,1700062800,26460,73736,127268,DE,PL
7476,1698902640,1698918180,15540,141664,97643,US,US
60572,1699703580,1699707180,3600,109785,115790,GB,GB
87182,1700109180,1700112780,3600,197603,64469,NL,DE
42499,1700159940,1700171700,11760,108862,52290,IT,IT
150776,1699809300,1699839000,29700,149151,147276,TR,TR
54865,1699457160,1699510320,53160,118857,90015,BG,DE
131867,1700288460,1700320800,32340,134900,82945,TR,TR
111364,1700439540,1700471040,31500,108477,195120,TR,TR
142899,1699649880,1699663260,13380,118829,149966,US,US
115351,1699932780,1699972140,39360,54484,56947,MX,MX
108795,1700630400,1700646120,15720,80278,4466,US,US
119737,1700385660,1700413320,27660,97801,199990,PL,PL
129052,1699325280,1699354980,29700,163145,137507,TR,TR
57658,1700301900,1700313960,12060,70111,105906,US,US
129212,1698968580,1698972180,3600,8624,110918,GB,GB
102108,1700496900,1700500500,3600,64966,20281,GB,GB
92202,1700061120,1700073300,12180,138351,131680,IT,IT
15606,1700620560,1700639160,18600,41741,117692,BE,FR
115806,1698921300,1698936240,14940,49340,47022,US,US
105272,1699698720,1699731720,33000,67728,173400,TR,TR
69189,1699103700,1699119420,15720,112858,148917,US,US
72288,1700752080,1700765880,13800,177957,98977,ES,PT
152332,1699640400,1699675380,34980,197491,119623,MX,MX
8613,1700465640,1700473800,8160,175944,55420,PT,PT
85359,1699557360,1699572000,14640,195740,117897,CA,CA
11805,1699076820,1699083900,7080,16045,169411,NL,NL
181362,1700314680,1700321160,6480,192742,16797,GB,GB
138193,1699942380,1699954080,11700,189055,89718,US,US
198570,1698795960,1698825600,29640,129981,8348,TR,TR
141112,1700263200,1700276580,13380,196852,75468,AT,AT
155342,1699149720,1699181880,32160,22646,156625,TR,TR
31277,1700150820,1700180160,29340,154660,12163,TR,TR
116320,1699613880,1699617480,3600,132580,150746,NL,NL
39347,1699692780,1699727400,34620,13076,158125,TR,TR
170998,1700386140,1700392380,6240,113570,93118,GB,GB
139540,1699312260,1699340940,28680,153947,39549,RO,MD
148689,1700600100,1700628900,28800,154992,117409,TR,TR
135235,1700523120,1700536500,13380,155104,36451,PT,PT
164553,1699933020,1699947240,14220,85099,12090,US,US
199611,1698882480,1698895380,12900,49393,176463,US,US
26387,1700764500,1700800260,35760,181707,155020,TR,TR
117471,1699411860,1699422540,10680,113647,43785,IT,IT
165871,1700304540,1700308140,3600,30085,45274,GB,GB
138751,1699430760,1699465980,35220,180567,127890,TR,TR
112262,1698915420,1698926520,11100,187808,85418,HR,HR
197987,1699094040,1699110000,15960,17473,107490,AT,AT
29323,1698863940,1698880980,17040,56396,126397,US,US
106012,1700489100,1700501280,12180,80343,129500,ES,AD
67473,1699807200,1699830120,22920,69937,120595,PL,PL
77357,1699981560,1699985160,3600,167463,141703,GB,GB
4584,1698795300,1698822960,27660,199874,175587,DE,PL
172948,1698942000,1698954360,12360,58649,49791,US,US
124395,1700085660,1700102280,16620,37709,145811,US,US
194322,1700633580,1700650800,17220,11611,78383,BE,FR
84822,1700527860,1700557500,29640,181995,126097,TR,TR
39202,1700226780,1700230380,3600,124476,86344,GB,GB
65639,1700745960,1700758080,12120,95248,98547,CZ,SK
107264,1700745480,1700777040,31560,160279,176193,TR,TR
87539,1700102760,1700119020,16260,34259,49646,FR,FR
116624,1699754580,1699788600,34020,65859,176737,TR,TR
45061,1699146900,1699159260,12360,119971,31340,IT,IT
147372,1699849620,1699863000,13380,51025,43226,IT,IT
73985,1700548140,1700583000,34860,31070,88614,TR,TR
99677,1699253280,1699282980,29700,114700,124444,TR,TR
44151,1700564040,1700596860,32820,177516,101716,TR,TR
15364,1699758660,1699793880,35220,146372,192075,TR,TR
169301,1699440960,1699471200,30240,27094,177180,TR,TR
50056,1700392440,1700405160,12720,52709,104116,US,US
69513,1699608060,1699612980,4920,53728,142900,NL,IT
20872,1698994140,1699007640,13500,82662,177344,US,US
26989,1699336920,1699348440,11520,158599,131552,ES,ES
35548,1700643780,1700656800,13020,36146,175464,IT,IT
54732,1699712340,1699741680,29340,84830,95527,TR,TR
39423,1699835640,1699850640,15000,41167,63341,US,US
3784,1699170000,1699178040,8040,179652,113906,PT,PT
87122,1700242800,1700276880,34080,93366,16814,MX,MX
113592,1699382100,1699397640,15540,70525,130533,US,US
5955,1699808940,1699824780,15840,62041,29370,US,US
168147,1700016420,1700025600,9180,113924,73132,PT,PT
126740,1700726280,1700729880,3600,163151,140261,GB,GB
118082,1700230860,1700236080,5220,182741,169087,GB,GB
46740,1700357940,1700387280,29340,191282,132992,TR,TR
50682,1700318340,1700351940,33600,198137,140134,TR,TR
149030,1700287440,1700320920,33480,133844,26498,TR,TR
54025,1700712540,1700738280,25740,92064,84341,RO,RO
142587,1700614800,1700622420,7620,10833,55652,IT,IT
82086,1700382960,1700397300,14340,81095,193629,US,US
65316,1699763820,1699798320,34500,7293,18298,TR,TR
199010,1699642500,1699646100,3600,198159,107935,GB,GB
142080,1700511360,1700533440,22080,132474,17545,DE,RS
172561,1700613120,1700639040,25920,198328,127917,DE,FR
193863,1699409340,1699434180,24840,68103,175295,PL,DE
45318,1700580120,1700592420,12300,87552,22467,SK,SK
151950,1698948480,1698962520,14040,39329,153619,ES,BE
188276,1698939120,1698972600,33480,134651,60916,TR,TR
133480,1699227180,1699257480,30300,105628,61284,TR,TR
127143,1700409660,1700427360,17700,92295,92371,US,US
161742,1698946740,1698959820,13080,187664,196424,IT,IT
72135,1699979820,1699997340,17520,136606,48506,US,US
122000,1698810540,1698833700,23160,161319,192587,PL,PL
121967,1700860380,1700874960,14580,9923,137085,US,US
27995,1699477320,1699494720,17400,157194,90455,RS,RS
35640,1700428560,1700440140,11580,74350,159287,IT,IT
194640,1700703720,1700711760,8040,134572,7431,PT,PT
129812,1700805480,1700838600,33120,101282,130872,TR,TR
149015,1699832100,1699870740,38640,26730,9520,MX,MX
57781,1699507080,1699511280,4200,6509,121487,GB,GB
98881,1700802900,1700818500,15600,124193,4277,BE,DE
62234,1698879420,1698890280,10860,158381,37099,US,US
49874,1700273520,1700308800,35280,164096,119451,TR,TR
121810,1700539380,1700544060,4680,49475,147521,NL,NL
33071,1700715540,1700720460,4920,118984,33630,GB,GB
84645,1700042160,1700069820,27660,109229,184997,RO,RO
17783,1699076580,1699087980,11400,145553,132947,PT,PT
87394,1699487100,1699517760,30660,41184,11724,TR,TR
132124,1699675860,1699710600,34740,29566,80276,TR,TR
143778,1699620300,1699651620,31320,99862,46384,TR,TR
90012,1700529960,1700542740,12780,183974,190956,US,US
53963,1700573700,1700581140,7440,125398,149729,IT,ES
139502,1700499780,1700515500,15720,78208,91974,US,US
197888,1699227540,1699240920,13380,197703,43392,IT,IT
102910,1699243560,1699247160,3600,52340,8313,GB,GB
87591,1700227320,1700239800,12480,149388,105754,HR,HR
84697,1698962700,1698996780,34080,100842,192880,TR,TR
92523,1699935300,1699942560,7260,87114,128885,HR,HR
17028,1700750700,1700765640,14940,60092,25211,US,US
180437,1700125020,1700160600,35580,182752,198987,TR,TR
38763,1700858280,1700862420,4140,53179,31556,NL,BE
117717,1700112300,1700115900,3600,112219,146040,GB,GB
58822,1699281240,1699310700,29460,59060,177689,TR,TR
5614,1699663680,1699677000,13320,72123,93962,IT,IT
164627,1699634760,1699650780,16020,76189,128477,FR,FR
151176,1699701000,1699728300,27300,98689,50074,BR,BR
13781,1700775540,1700804340,28800,180505,20028,TR,TR
109514,1699227060,1699235160,8100,184212,71966,HR,DE
54570,1699504440,1699514400,9960,194003,48443,AD,ES
124157,1700432100,1700467080,34980,133089,25087,TR,TR
16728,1700603820,1700614440,10620,87351,18741,IT,IT
72957,1700734620,1700768460,33840,169234,7781,TR,TR
103116,1699591680,1699626300,34620,97459,131790,TR,TR
184823,1699519080,1699522920,3840,97474,153177,NL,NL
86718,1700454480,1700475540,21060,128146,179454,FR,HU
7330,1699567680,1699580460,12780,190390,86723,AT,AT
105695,1700628240,1700636820,8580,161786,49607,SK,SK
163020,1698803700,1698809100,5400,135690,41679,NL,NL
157389,1700360220,1700391600,31380,56014,124711,TR,TR
110418,1699670640,1699688340,17700,102525,160978,FR,FR
79405,1700071320,1700096940,25620,53156,95903,PL,UA
73172,1700182200,1700215560,33360,825,39270,TR,TR
95552,1698819840,1698855420,35580,190491,111128,TR,TR
71940,1700202720,1700234460,31740,179601,89840,TR,TR
23029,1698961080,1698995220,34140,156682,4586,TR,TR
63433,1698977760,1698989820,12060,70455,118598,AT,BG
195989,1700087640,1700116740,29100,40772,163484,TR,TR
15313,1699153560,1699186320,32760,186410,46505,TR,TR
123499,1698845880,1698876840,30960,68105,47341,TR,TR
40938,1699592160,1699595940,3780,108395,179734,GB,GB
192624,1700061120,1700064720,3600,143755,193107,GB,GB
175925,1699106460,1699139400,32940,48747,82158,TR,TR
139048,1699236120,1699269960,33840,75809,64532,TR,TR
185622,1700206920,1700212680,5760,27067,166349,NL,NL
129125,1700226960,1700252880,25920,118735,126911,RO,RO
116344,1700703600,1700707380,3780,35893,118614,NL,NL
141425,1700315580,1700326260,10680,55768,56671,EE,EE
137708,1700444220,1700477820,33600,192836,182,TR,TR
45513,1699611300,1699622040,10740,182889,68318,HR,HR
45512,1700734680,1700741760,7080,85943,47661,GB,GB
72035,1699223700,1699252920,29220,125388,98851,TR,TR
170957,1699049640,1699061220,11580,165380,9586,IT,IT
27614,1699609740,1699613340,3600,125741,150838,NL,NL
93287,1700007600,1700021700,14100,37009,144368,HR,HR
115495,1699459020,1699492020,33000,57354,122304,TR,TR
46290,1698811620,1698842280,30660,127220,135669,TR,TR
162850,1699867860,1699899720,31860,114522,157832,TR,TR
61214,1699795500,1699826280,30780,12400,161837,TR,TR
4275,1700582040,1700596020,13980,113735,20094,US,US
119837,1700104620,1700120880,16260,151269,43432,US,US
36442,1700079600,1700083620,4020,162799,70249,GB,GB
74442,1700653560,1700668260,14700,87383,44969,FR,DE
43210,1699572720,1699602000,29280,169281,144205,TR,TR
108048,1699402620,1699417740,15120,71306,134903,US,US
178171,1700798040,1700828700,30660,139329,93339,TR,TR
72409,1700027160,1700044680,17520,162857,158580,BE,HR
106878,1698861900,1698865500,3600,158563,68600,GB,GB
140250,1700658600,1700684700,26100,28558,24071,DE,BE
181040,1699762320,1699793280,30960,31470,6833,TR,TR
115513,1698995760,1699007220,11460,75479,148458,HR,HR
70087,1700300880,1700332080,31200,51789,44682,TR,TR
138288,1699507980,1699522860,14880,95753,194325,FR,FR
105302,1699670820,1699681800,10980,126228,98988,PT,PT
16633,1699683660,1699718760,35100,103104,155370,TR,TR
43308,1698858540,1698911340,52800,149652,71734,BG,AT
159878,1700409360,1700423520,14160,65635,189836,US,US
45802,1699853160,1699856760,3600,148081,177026,GB,GB
172957,1698802740,1698853560,50820,161383,18387,BG,DE
191987,1698850440,1698861120,10680,10712,198291,IT,IT
143368,1700046840,1700051340,4500,138229,43043,GB,GB
148418,1699200420,1699218180,17760,155297,121015,AT,AT
57520,1699824360,1699857360,33000,10178,23736,TR,TR
36679,1699062840,1699079040,16200,148522,133743,RS,HR
165746,1698829200,1698858720,29520,175873,122457,TR,TR
97892,1699769520,1699785720,16200,191289,6543,CZ,CZ
126090,1699849080,1699857540,8460,177364,119913,IT,IT
193063,1700489820,1700520780,30960,145251,77217,TR,TR
110965,1700455020,1700466480,11460,181110,127690,PT,FR
84582,1699747500,1699777080,29580,176674,123403,TR,TR
52685,1699608540,1699637580,29040,39431,75785,TR,TR
118676,1700186220,1700191380,5160,110870,29830,NL,FR
76460,1699805400,1699836000,30600,98207,152934,TR,TR
61829,1699253160,1699262820,9660,134254,152280,IT,IT
169988,1700065200,1700079180,13980,72312,81470,US,US
30156,1699175460,1699208580,33120,144617,160311,TR,TR
34280,1700713380,1700747280,33900,35997,194207,TR,TR
6107,1699424220,1699436100,11880,14612,173418,HR,HR
39688,1700040300,1700077140,36840,176476,77761,MX,US
121455,1700858940,1700866140,7200,111667,152180,IT,IT
82462,1700303100,1700310660,7560,66389,67908,PT,PT
41208,1698813720,1698825000,11280,65983,175911,PT,PT
24312,1699043580,1699078260,34680,93942,55684,TR,TR
19149,1699249860,1699281420,31560,31283,159300,TR,TR
75617,1699249140,1699252740,3600,96581,35820,GB,GB
111263,1699722840,1699728780,5940,165100,6876,NL,NL
14771,1700616060,1700649120,33060,73894,69165,TR,TR
182955,1699338540,1699371720,33180,187172,96903,TR,TR
110712,1699060620,1699070100,9480,106236,118222,IT,IT
50447,1700615160,1700649300,34140,199666,12034,TR,TR
26469,1700546040,1700563740,17700,8125,75300,US,US
152106,1699602180,1699633800,31620,161268,192533,TR,TR
9196,1698856260,1698889440,33180,14586,195402,TR,TR
21451,1699706160,1699737300,31140,139955,89405,TR,TR
115824,1699244220,1699247820,3600,96429,118648,GB,GB
54807,1699288620,1699320840,32220,162443,57279,TR,TR
10965,1698841440,1698870660,29220,16525,113423,TR,TR
67201,1699727760,1699761060,33300,137867,173880,TR,TR
178897,1699260120,1699288200,28080,172377,102692,DE,CZ
11329,1700775480,1700809620,34140,19425,42086,TR,TR
99997,1700646960,1700676540,29580,56332,128906,TR,TR
114339,1700102220,1700136420,34200,96299,35224,TR,TR
181595,1699842960,1699846560,3600,93058,198684,GB,GB
159290,1700383080,1700386680,3600,166365,50368,NL,NL
4412,1699320780,1699324380,3600,125482,84639,GB,GB
138795,1700828160,1700842020,13860,32743,180026,US,US
24781,1698799740,1698805380,5640,183278,33074,GB,GB
38124,1698814380,1698852240,37860,180384,176796,MX,US
93675,1699609320,1699613340,4020,64275,69986,GB,GB
164186,1699236300,1699247640,11340,140042,75789,IT,IT
81879,1698949740,1698978600,28860,153141,115157,TR,TR
46592,1699049640,1699062720,13080,121707,182620,US,US
151068,1699522740,1699526340,3600,153405,79143,GB,GB
186418,1699450200,1699483920,33720,151073,72790,TR,TR
129633,1700409480,1700413080,3600,165280,84408,GB,GB
99641,1700612400,1700666100,53700,58133,41756,BG,TR
43422,1700849460,1700880180,30720,195651,32143,TR,TR
116661,1700248080,1700280360,32280,147122,76448,TR,TR
163084,1699528860,1699564140,35280,15314,24625,TR,TR
199404,1699566720,1699570320,3600,175666,152098,GB,GB
34411,1699977060,1700007900,30840,139212,154040,TR,TR
154046,1699215960,1699232760,16800,152386,26889,US,US
67939,1699915500,1699945200,29700,8735,30530,TR,TR
150575,1700342820,1700355420,12600,101203,43816,IT,IT
62261,1700821680,1700830260,8580,24415,197908,IT,FR
67660,1699908240,1699912680,4440,33099,98879,NL,NL
174638,1699429440,1699452900,23460,169835,164411,PL,UA
97139,1699781580,1699785840,4260,5637,84381,NL,NL
121704,1699697220,1699703340,6120,24347,171179,GB,GB
195394,1699791540,1699805880,14340,75229,13056,IT,IT
148719,1699378680,1699382280,3600,136065,60656,EE,EE
160246,1700479980,1700494980,15000,194071,199257,US,US
150943,1700010540,1700040300,29760,102783,126233,TR,TR
149103,1699052400,1699074300,21900,86643,81357,DE,DE
42238,1699006800,1699042500,35700,61177,2879,TR,TR
111887,1699639740,1699675500,35760,155614,45974,TR,TR
185077,1699148100,1699177020,28920,62360,108476,TR,TR
158207,1699644540,1699676100,31560,101544,101045,TR,TR
11289,1699928400,1699934160,5760,182801,97419,GB,GB
19186,1700683620,1700715420,31800,61019,31668,TR,TR
12630,1699647600,1699655040,7440,85519,47042,HR,HR
73812,1700335620,1700348160,12540,83940,184260,IT,IT
41594,1699701360,1699704960,3600,175061,52840,GB,GB
141919,1699028220,1699042380,14160,51832,144359,US,US
34318,1699977660,1699982400,4740,157230,61824,NL,HR
78986,1700785140,1700797260,12120,34589,181629,SK,SK
17862,1698813540,1698829080,15540,172650,183676,US,US
55774,1699162860,1699176660,13800,50052,28116,PT,PT
65846,1699910100,1699926120,16020,134061,99953,FR,FR
96027,1700082420,1700086440,4020,125007,117406,GB,GB
138543,1699146420,1699181820,35400,25059,186716,MX,MX
31886,1699516860,1699529940,13080,20423,137910,IT,FR
126095,1699219920,1699231200,11280,180054,115658,IT,IT
179176,1698876180,1698911100,34920,186599,124274,TR,TR
84998,1699574880,1699587780,12900,143340,199739,RS,RS
113237,1699249440,1699253040,3600,192767,50055,NL,DE
43393,1699318800,1699351200,32400,49290,77910,TR,TR
148898,1699524060,1699553040,28980,76822,11517,TR,TR
133448,1700848800,1700880000,31200,152607,75103,TR,TR
94003,1699425300,1699429020,3720,42503,96920,NL,NL
186006,1700701260,1700735640,34380,28483,77501,TR,TR
152186,1699432320,1699437300,4980,197725,121632,NL,NL
16388,1700341500,1700373180,31680,62100,49833,TR,TR
163338,1699869660,1699886880,17220,19339,78813,US,US
188544,1699438380,1699445100,6720,41137,67461,NL,NL
990,1700467440,1700485740,18300,175758,97197,FR,FR
38498,1699170960,1699185780,14820,110302,14205,US,US
68625,1699432860,1699467600,34740,194782,7018,TR,TR
190584,1699369620,1699402980,33360,105877,47918,TR,TR
134980,1700704680,1700741880,37200,77994,124699,MX,MX
118916,1699723560,1699735200,11640,64174,113021,IT,IT
8441,1699213740,1699228500,14760,190268,75442,AT,AT
118804,1699060740,1699091100,30360,106593,87669,TR,TR
15266,1699714860,1699723800,8940,170686,98727,HR,HR
159989,1700247420,1700260140,12720,178788,185747,US,US
116378,1700762580,1700797320,34740,62806,61578,TR,TR
100281,1699153080,1699182360,29280,149782,78720,TR,TR
91089,1699020300,1699025160,4860,145631,132248,CL,CL
142526,1699325340,1699348860,23520,35082,49592,DE,DE
149809,1699573560,1699603140,29580,6151,186947,TR,TR
79244,1699042620,1699074000,31380,39799,152611,TR,TR
198480,1698852600,1698883200,30600,141979,91733,TR,TR
190049,1698912780,1698916380,3600,138492,169734,GB,GB
77770,1699920960,1699952460,31500,190659,81127,TR,TR
197745,1699584180,1699597980,13800,142624,174281,ES,ES
3558,1699167960,1699201080,33120,46995,3807,TR,TR
129039,1699560960,1699574580,13620,3050,130818,IT,IT
89668,1700295480,1700308020,12540,7769,163148,US,US
67775,1699425420,1699429020,3600,53009,22844,GB,GB
31653,1700095440,1700125380,29940,68328,50523,TR,TR
81470,1700678400,1700690400,12000,4083,116846,IT,IT
154193,1700863740,1700867340,3600,75098,26314,GB,GB
50951,1699103220,1699107120,3900,174923,21117,GB,GB
55159,1699941240,1699964040,22800,133273,110316,DE,BG
44519,1699250940,1699267380,16440,62080,44411,US,US
46804,1698913320,1698922920,9600,182274,176156,SK,SK
78282,1700532720,1700565900,33180,129836,47749,TR,TR
164985,1700623380,1700645220,21840,118035,144868,PL,PL
180141,1699315440,1699327560,12120,50242,2105,ES,ES
28619,1699201980,1699205580,3600,166051,67406,NL,NL
143705,1699789920,1699794480,4560,92637,102715,GB,GB
156549,1698794280,1698805080,10800,123268,65033,RS,RS
135464,1698974400,1698992040,17640,8727,143009,RS,RS
61616,1700421960,1700451600,29640,67749,178792,TR,TR
87684,1700854980,1700887740,32760,76361,132136,TR,TR
62056,1700281680,1700293380,11700,49332,53205,US,US
115509,1699360320,1699377960,17640,168533,114646,US,US
30061,1699342680,1699346280,3600,140141,176162,GB,GB
12941,1699733940,1699758840,24900,139066,173756,DE,BG
16331,1699847640,1699864140,16500,99449,5008,US,US
132196,1700799180,1700802780,3600,146259,753,GB,GB
138625,1699624560,1699637520,12960,44293,88661,CZ,CZ
87780,1700779500,1700810640,31140,194078,42812,TR,TR
108683,1698823320,1698833880,10560,186667,27768,GR,BG
77869,1699773360,1699789080,15720,195582,149192,US,US
64201,1699614180,1699644120,29940,165212,117618,TR,TR
103493,1700071920,1700107020,35100,150188,103411,TR,TR
85949,1699491000,1699504200,13200,79118,98694,IT,CH
77649,1699115700,1699119300,3600,196226,10503,NL,NL
117946,1700078880,1700110980,32100,112346,161929,TR,TR
63907,1700193420,1700200320,6900,127281,83694,NL,NL
112977,1700738520,1700768760,30240,44021,7108,TR,TR
137238,1699244100,1699260420,16320,93277,164308,US,US
161276,1700329020,1700333880,4860,83518,98444,GB,GB
18191,1700709360,1700744520,35160,91930,150116,TR,TR
174833,1700716140,1700719740,3600,166454,41485,NL,NL
122637,1699748460,1699758480,10020,132328,20240,IT,IT
96001,1699536240,1699565040,28800,119858,14215,TR,TR
150235,1700075580,1700107140,31560,167817,73895,TR,TR
93755,1700618820,1700624400,5580,29791,104266,GB,GB
60346,1699886580,1699899480,12900,8993,105084,SK,CZ
52101,1700129040,1700164320,35280,188618,114989,TR,TR
102921,1698989760,1698995580,5820,38803,6625,GB,GB
114487,1699536360,1699562220,25860,43394,132415,PL,DE
33298,1700428740,1700445660,16920,183800,5584,AT,AT
114962,1698865800,1698879660,13860,179873,148740,US,US
11044,1699970520,1700001240,30720,191513,24132,TR,TR
14846,1699452420,1699460760,8340,21993,36097,IT,IT
38247,1700739060,1700767260,28200,88213,19681,PL,DE
184875,1699131120,1699165980,34860,57372,79707,TR,TR
65010,1699499220,1699510500,11280,180727,21608,US,US
142201,1699497420,1699531980,34560,103105,24095,TR,TR
167149,1699733640,1699738680,5040,155922,133539,NL,NL
173598,1700367120,1700402880,35760,63500,5677,TR,TR
189419,1699016880,1699023420,6540,131344,77292,GB,GB
181671,1699342500,1699356300,13800,44612,93927,US,US
24625,1699059720,1699063320,3600,122280,55189,NL,NL
105348,1700501100,1700535120,34020,42745,132890,TR,TR
3769,1700852100,1700869860,17760,31464,156176,CZ,CZ
55446,1699695960,1699699560,3600,172066,31495,NL,NL
68060,1699477680,1699501020,23340,126816,97808,PL,PL
197120,1699295280,1699308480,13200,145411,51276,CZ,DE
186491,1700520960,1700535240,14280,74601,55390,US,US
93392,1699290360,1699315200,24840,110905,163716,BR,BR
184366,1698801960,1698823020,21060,13085,50205,FR,BE
199004,1699136700,1699141680,4980,191175,149462,GB,GB
181534,1700262900,1700274480,11580,166222,166671,US,US
83400,1698944760,1698948360,3600,169930,68410,GB,GB
34455,1700162580,1700194200,31620,86292,91248,TR,TR
85230,1699456440,1699491360,34920,143537,17074,TR,TR
121470,1699234320,1699257240,22920,19248,43130,DE,DE
5166,1700091360,1700098260,6900,114442,190283,NL,DE
113790,1700031180,1700045340,14160,4097,65440,IT,FR
27733,1700314380,1700343780,29400,107433,67663,TR,TR
139475,1699580940,1699592340,11400,20942,162546,US,US
175718,1700861580,1700878620,17040,170452,154788,US,US
130365,1699720920,1699724520,3600,142395,21199,GB,GB
125350,1699240380,1699255500,15120,180513,34538,US,MX
110070,1699983060,1699994160,11100,121973,33376,HR,HR
72749,1699397280,1699433460,36180,192671,102708,MX,MX
70191,1700703480,1700738520,35040,180583,91456,TR,TR
191631,1700047920,1700083620,35700,98822,24644,TR,TR
140357,1699613400,1699628700,15300,130660,98363,US,US
160169,1698990960,1699001220,10260,5148,81909,IT,FR
175032,1700528100,1700538540,10440,70686,23819,SK,SK
34530,1699539780,1699574400,34620,138373,73209,TR,TR
75446,1699525680,1699533180,7500,115125,176596,IT,LU
149470,1699565040,1699579980,14940,167835,6153,FR,DE
4047,1700583840,1700616240,32400,145535,91236,TR,TR
197405,1699461900,1699465500,3600,65133,190126,GB,GB
76220,1700231220,1700234820,3600,194517,33470,GB,GB
131761,1699399920,1699412400,12480,191126,128666,RS,RS
714,1699764780,1699799400,34620,183990,196330,TR,TR
4343,1699507440,1699539180,31740,143681,161651,TR,TR
25063,1699988100,1700017080,28980,124272,125153,TR,TR
50170,1699085820,1699120560,34740,29781,164905,TR,TR
54215,1699961100,1699978260,17160,185243,28736,US,US
7030,1699549680,1699582380,32700,13373,68722,TR,TR
48909,1700819700,1700833920,14220,29694,76501,IT,IT
142466,1698850500,1698854100,3600,167634,190567,GB,GB
48382,1699117980,1699149480,31500,13982,191914,TR,TR
23238,1699837860,1699870680,32820,189077,152701,TR,TR
109634,1699061040,1699096800,35760,121597,37883,TR,TR
171292,1699870620,1699895100,24480,18506,12411,HU,AT
139054,1699786620,1699799100,12480,28053,45858,IT,IT
44197,1700599980,1700609760,9780,5506,181870,PT,PT
57926,1699714080,1699728060,13980,30234,73405,HR,HR
29143,1700422320,1700434080,11760,52725,6957,ES,ES
153601,1699711800,1699724520,12720,61948,130629,IT,IT
64655,1699984680,1699991940,7260,85623,98486,HR,HR
13054,1699639740,1699643340,3600,152180,92046,GB,GB
116623,1698982980,1699015920,32940,102606,149271,TR,TR
95975,1700791560,1700809140,17580,17816,71666,US,US
29364,1700783280,1700815680,32400,138281,129489,TR,TR
185711,1699911900,1699925160,13260,71492,10240,PT,PT
61784,1699807740,1699831560,23820,94632,47523,PL,PL
3333,1700207340,1700210940,3600,52728,174310,NL,NL
108347,1698957840,1698989820,31980,149025,138690,TR,TR
183304,1699342800,1699365720,22920,69522,122315,CH,BE
23571,1699491480,1699503660,12180,88531,173698,US,US
43542,1699882860,1699909860,27000,135483,24797,BA,DE
57645,1699034820,1699047180,12360,194410,117588,AT,SK
39816,1700109420,1700139960,30540,10780,32471,TR,TR
21677,1699502100,1699505700,3600,86248,44872,NL,NL
177073,1700454960,1700482260,27300,102945,8864,BA,HR
32951,1700162340,1700195280,32940,91103,167710,TR,TR
79835,1700399820,1700403540,3720,175876,13762,GB,GB
5333,1700752980,1700765100,12120,186649,115877,IT,IT
24892,1700162040,1700165640,3600,68856,135072,NL,NL
66523,1700733240,1700767740,34500,64442,47427,MX,MX
70701,1699883880,1699919400,35520,39058,74325,TR,TR
49164,1700501220,1700521800,20580,117974,159152,BE,DE
82383,1700293740,1700305920,12180,132054,48618,ES,PT
163827,1700726460,1700743020,16560,78863,110527,US,US
40708,1699308720,1699316880,8160,12294,115687,IT,IT
2478,1699746480,1699777440,30960,131660,13703,TR,TR
29116,1699783020,1699794600,11580,158514,155698,AT,AT
141279,1700449020,1700462820,13800,132922,193044,IT,IT
197705,1700240040,1700296200,56160,153871,6269,BG,AT
184418,1699359480,1699363080,3600,186062,25868,NL,NL
7144,1699771980,1699802640,30660,9908,105376,TR,TR
132138,1700191620,1700204700,13080,57437,197626,RS,RS
76444,1699633260,1699641240,7980,39390,28353,IT,IT
74666,1700392500,1700424900,32400,123714,42952,TR,TR
39989,1699563840,1699585560,21720,121658,51705,DE,DE
115317,1698900780,1698918660,17880,23157,119363,US,US
114502,1699842060,1699854600,12540,141753,194175,ES,ES
53898,1699722300,1699730160,7860,42260,94158,IT,PT
195617,1700709660,1700713260,3600,20243,18296,NL,NL
6727,1700759580,1700782500,22920,132423,139422,DE,DE
62993,1699691640,1699695240,3600,140949,53466,NL,NL
89467,1698946920,1698954660,7740,75443,118799,HR,HR
58567,1699434480,1699469220,34740,183115,116034,MX,MX
169024,1699243500,1699277460,33960,64134,96297,TR,TR
852,1700031840,1700044440,12600,4568,169466,IT,IT
171105,1699245960,1699253460,7500,2345,35837,PT,PT
130768,1699019400,1699047060,27660,68084,18848,CH,ES
43921,1699559400,1699563000,3600,99802,113403,NL,NL
27904,1699923540,1699955040,31500,161209,98484,TR,TR
94335,1700862840,1700875920,13080,5161,84368,PT,PT
24081,1698938040,1698953640,15600,130390,78362,US,US
3881,1698900060,1698905220,5160,16335,198412,GB,GB
161755,1699485120,1699492620,7500,74065,122135,IT,IT
58778,1700620200,1700623800,3600,34134,62166,GB,GB
174692,1699816260,1699829040,12780,192215,51453,SK,AT
50964,1699781940,1699798260,16320,172071,13830,FR,IT
153893,1698969420,1699004280,34860,68202,46196,TR,TR
57857,1699945140,1699974540,29400,38253,118797,TR,TR
14763,1698849000,1698876000,27000,76034,144147,DE,HU
125788,1699666320,1699697820,31500,194008,43986,TR,TR
173382,1699450380,1699485840,35460,89204,140417,TR,TR
179961,1698951720,1698981060,29340,76278,88237,TR,TR
117645,1699660380,1699666440,6060,82282,139991,GB,GB
190867,1700158800,1700188920,30120,114110,114003,TR,TR
88288,1699387140,1699398960,11820,91984,43383,US,US
146589,1699954380,1699988580,34200,70099,124903,TR,TR
38309,1700620980,1700625120,4140,44735,56996,GB,GB
42553,1699210380,1699240440,30060,75172,54699,TR,TR
131713,1699041120,1699052820,11700,184773,162338,US,US
44006,1699084140,1699114260,30120,142654,171892,TR,TR
159463,1698937020,1698971520,34500,146575,75231,TR,TR
28857,1700724600,1700756160,31560,50818,28229,TR,TR
78883,1698937140,1698968520,31380,182157,60636,TR,TR
172219,1699904340,1699937400,33060,112829,124639,TR,TR
83554,1700395740,1700413560,17820,41109,1519,US,US
120084,1700007420,1700034180,26760,70198,3229,DE,CH
197726,1699131300,1699143360,12060,68399,57320,IT,CH
21880,1700578260,1700584920,6660,78218,43701,NL,NL
156473,1700561700,1700593860,32160,17775,125575,TR,TR
183527,1699530480,1699562640,32160,197263,772,TR,TR
57429,1700491140,1700506020,14880,194330,161134,US,US
117495,1699531020,1699541340,10320,33426,81398,IT,IT
45148,1699000560,1699008120,7560,19422,144079,IT,IT
23515,1699144620,1699174620,30000,12943,31597,TR,TR
96921,1699515780,1699548780,33000,21609,26795,TR,TR
181018,1699426680,1699430280,3600,178186,73021,GB,GB
73161,1700128140,1700157660,29520,118830,130508,TR,TR
61247,1698809700,1698813300,3600,194961,198450,GB,GB
59657,1699632780,1699637460,4680,72337,129065,GB,GB
2473,1699151580,1699155180,3600,148623,189824,GB,GB
30647,1700328960,1700332560,3600,138536,138175,GB,GB
125366,1699576020,1699606020,30000,37218,134949,TR,TR
107958,1698991560,1699006320,14760,178797,180340,US,US
20766,1698921840,1698953040,31200,90942,159962,TR,TR
188548,1699726440,1699754340,27900,32289,188402,DE,GB
21283,1698838680,1698848220,9540,61906,48432,IT,IT
58229,1700049120,1700052720,3600,118926,118729,GB,GB
29983,1700005740,1700020800,15060,8433,179120,US,US
88318,1698876060,1698891360,15300,28102,65451,US,US
48860,1699009320,1699012920,3600,92515,141764,GB,GB
183360,1699206240,1699228320,22080,73157,162562,PL,PL
67260,1700505900,1700515140,9240,148403,158543,SK,DE
150970,1699426980,1699430580,3600,137616,43301,GB,GB
150722,1700277420,1700289960,12540,67468,161564,AT,AT
20126,1699785960,1699789560,3600,54968,53878,GB,GB
130355,1700254680,1700261940,7260,102658,189483,AD,FR
9774,1700374860,1700404320,29460,83811,96033,TR,TR
191442,1699809360,1699815060,5700,92246,143234,GB,GB
106712,1699199160,1699229520,30360,144762,92976,TR,TR
129947,1699498560,1699527360,28800,103157,194917,TR,TR
142139,1699396740,1699430940,34200,191099,116713,TR,TR
57599,1699527600,1699540680,13080,43727,192787,IT,IT
43044,1700458140,1700470980,12840,45124,57791,AT,AT
48741,1700548620,1700573160,24540,59378,2519,DK,DK
148471,1699745520,1699769760,24240,99273,112237,RO,RO
142116,1699964460,1699986060,21600,196735,184884,SI,RS
107782,1700511840,1700523000,11160,52696,17451,IT,IT
176532,1698819360,1698853800,34440,143729,63552,TR,TR
119506,1700081280,1700095140,13860,106087,53384,US,US
58438,1699853160,1699888980,35820,49800,182078,TR,TR
47068,1699920900,1699951380,30480,151044,114251,TR,TR
80629,1700534040,1700557860,23820,7938,14359,HU,AT
154748,1700771040,1700785080,14040,142184,154784,IT,IT
120781,1699501680,1699515480,13800,38436,93458,US,US
75828,1699964940,1700000760,35820,147958,68628,TR,TR
21840,1699737720,1699767540,29820,96374,141720,TR,TR
189956,1698921300,1698956040,34740,101244,137713,TR,TR
150478,1700134260,1700167920,33660,172368,3988,TR,TR
199963,1698942720,1698960060,17340,163758,101736,US,US
166053,1698828960,1698842580,13620,15194,159136,HR,HR
19446,1700271780,1700289060,17280,127421,11735,US,US
89855,1700578680,1700608140,29460,115192,35489,TR,TR
73796,1700460240,1700493180,32940,4565,173699,TR,TR
92363,1700677380,1700680980,3600,111005,59586,GB,GB
161183,1699208760,1699242420,33660,88145,81828,TR,TR
186296,1699652880,1699676340,23460,47873,198996,AL,MK
83727,1700146080,1700158200,12120,100741,1069,US,CA
94054,1700382240,1700390280,8040,138338,30573,HR,HR
136102,1698804780,1698820140,15360,91136,65854,US,US
194646,1698897660,1698910440,12780,24853,174268,AT,BG
152055,1699122900,1699134120,11220,74297,8815,IT,IT
89310,1699869180,1699881720,12540,190085,109994,US,US
17746,1699743120,1699750920,7800,99799,33203,AD,ES
185750,1699504260,1699508520,4260,9448,140587,GB,GB
148836,1700756820,1700760420,3600,138395,67044,NL,NL
57851,1700166540,1700198820,32280,142210,57682,TR,TR
199121,1700113440,1700144880,31440,127084,186902,TR,TR
173267,1700167500,1700198580,31080,15181,92283,TR,TR
137130,1699407660,1699413600,5940,196397,145064,GB,GB
15129,1699661520,1699678140,16620,156696,36370,CZ,CZ
20671,1700805000,1700817960,12960,31764,187635,CZ,CZ
87753,1700851680,1700882760,31080,28683,11474,TR,TR
44448,1699988520,1700003700,15180,128100,165490,US,US
119464,1699493880,1699497720,3840,53863,38236,GB,GB
6927,1699717620,1699728000,10380,127479,17060,IT,IT
67416,1700001480,1700052420,50940,9946,177795,BG,TR
57102,1700836440,1700871000,34560,25600,117593,MX,MX
113742,1700608020,1700641500,33480,48920,166195,TR,TR
77951,1698955980,1698986280,30300,182480,5030,TR,TR
106746,1699311600,1699341720,30120,65874,193343,TR,TR
106700,1699881840,1699912440,30600,151442,32572,TR,TR
188539,1700660700,1700670660,9960,68159,176462,ES,FR
177256,1700310180,1700344560,34380,138267,48986,TR,TR
92853,1699308780,1699322220,13440,183019,148489,IT,IT
2969,1699359600,1699363200,3600,103236,7532,GB,GB
35828,1700497620,1700531160,33540,12158,138655,TR,TR
159069,1699096920,1699117680,20760,90149,151619,FR,FR
37492,1700312820,1700320140,7320,152308,117494,IT,IT
169281,1700658120,1700661720,3600,139227,182031,GB,GB
111621,1699496460,1699500060,3600,36502,88720,GB,GB
180829,1699286160,1699297140,10980,177958,153629,IT,IT
167270,1700633700,1700664120,30420,98504,134500,TR,TR
95227,1699514100,1699547760,33660,73891,56966,MX,MX
97177,1700089020,1700101140,12120,107554,144953,IT,IT
5674,1699265760,1699280100,14340,71072,8099,IT,IT
129259,1699189920,1699219020,29100,69282,9188,TR,TR
114618,1699977000,1699987620,10620,78552,91900,IT,IT
43247,1698813180,1698828180,15000,5824,120483,CA,US
49503,1698923460,1698955260,31800,197636,35431,TR,TR
176605,1700147820,1700155680,7860,176925,80345,IT,IT
145,1699267200,1699298220,31020,131726,193017,TR,TR
83190,1699837080,1699870200,33120,193855,105262,TR,TR
140158,1700773800,1700785980,12180,26447,91190,IT,IT
85126,1700178000,1700210460,32460,187663,164715,TR,TR
41078,1700049360,1700061420,12060,184302,87076,US,US
96793,1700866140,1700869740,3600,180087,153582,GB,GB
106856,1699171020,1699200360,29340,34608,103963,TR,TR
65993,1700220780,1700255820,35040,80338,181029,TR,TR
24612,1700149440,1700154360,4920,52802,58374,NL,NL
80216,1699160220,1699168440,8220,158491,95426,IT,IT
144878,1699293660,1699320600,26940,83778,98600,RO,RO
196444,1699902840,1699926000,23160,148353,36689,BR,BR
9312,1699839480,1699843080,3600,17376,175762,GB,GB
102494,1699936020,1699970520,34500,104083,58560,MX,MX
31466,1699934940,1699940280,5340,40240,142329,GB,GB
4865,1700152800,1700157540,4740,119379,135811,GB,GB
100155,1698915720,1698922860,7140,128121,129971,NL,NL
116732,1699437420,1699450680,13260,45710,30487,IT,IT
66487,1699056540,1699091820,35280,14356,28029,TR,TR
194289,1699713900,1699739760,25860,145958,109534,BR,BR
168011,1700189940,1700219100,29160,44419,183331,TR,TR
67641,1699244700,1699280280,35580,27514,120669,TR,TR
193452,1699476120,1699502820,26700,142667,149633,BA,BA
102148,1700100060,1700132640,32580,45255,62,TR,TR
175659,1700392140,1700407380,15240,159334,190159,US,US
157832,1700412900,1700428980,16080,145154,143231,BE,PL
3890,1699360320,1699373520,13200,117757,107642,US,US
130204,1698979500,1699010760,31260,29742,156264,BA,RS
8712,1700137440,1700149860,12420,167260,195716,US,US
169380,1699978560,1700011560,33000,111975,125002,MX,MX
67255,1700363340,1700394720,31380,184779,23422,TR,TR
169459,1698999840,1699005840,6000,155650,83753,NL,NL
175368,1700374980,1700407200,32220,40344,3470,TR,TR
21563,1699096680,1699100280,3600,27059,131026,NL,FR
160954,1700860680,1700890740,30060,192456,41376,TR,TR
126169,1700193000,1700196600,3600,120126,9727,GB,GB
119901,1699731420,1699762800,31380,119896,78948,TR,TR
78585,1699679460,1699687020,7560,72935,16591,SK,AT
142415,1700131500,1700164260,32760,99728,14452,TR,TR
153947,1700828940,1700852880,23940,45752,80616,DE,DE
37832,1699528920,1699561560,32640,45343,4352,TR,TR
171131,1699703040,1699737780,34740,67653,130310,TR,TR
108170,1700762280,1700795160,32880,132603,39793,TR,TR
193259,1699936620,1699940220,3600,169087,187180,GB,GB
128673,1700199660,1700232480,32820,77357,13668,TR,TR
32102,1699263720,1699272060,8340,95443,32761,IT,IT
35930,1698817380,1698835260,17880,90081,85096,RS,RS
152210,1699432260,1699466940,34680,117179,113936,TR,TR
170707,1699788660,1699805940,17280,144693,115481,US,US
128078,1698930420,1698947160,16740,23447,164020,RS,RS
114833,1699170420,1699175520,5100,68415,114010,NL,FR
191279,1699387920,1699422360,34440,93362,132791,TR,TR
37332,1699596360,1699608660,12300,172207,72386,IT,DE
43262,1699878900,1699914720,35820,114309,87292,TR,TR
120923,1700709660,1700725740,16080,71714,176415,US,US
132812,1699065720,1699101660,35940,150386,43248,MX,MX
158444,1699753800,1699789440,35640,189828,63764,MX,US
27892,1699428720,1699462560,33840,155271,18828,TR,TR
190865,1700600820,1700635500,34680,59049,12302,TR,TR
133955,1700442480,1700472360,29880,62896,60187,TR,TR
63425,1699119840,1699123440,3600,92122,94415,NL,NL
100447,1699521420,1699551840,30420,186037,84794,TR,TR
146705,1699005480,1699036200,30720,25758,198799,TR,TR
103287,1700495760,1700499360,3600,107445,33618,NL,FR
167247,1698840060,1698843660,3600,189685,41014,GB,GB
148623,1699983720,1700013900,30180,51710,133923,TR,TR
185902,1700352060,1700386140,34080,53808,111005,TR,TR
137209,1700517060,1700548080,31020,117748,133517,TR,TR
166314,1700386200,1700400840,14640,34091,106923,AT,AT
76229,1700645940,1700662260,16320,10035,9132,FR,BE
13213,1699131360,1699157220,25860,35638,182581,PL,PL
108996,1699221780,1699237740,15960,85708,52151,US,US
191214,1699986000,1699997280,11280,134774,92116,IT,IT
142916,1700128680,1700142360,13680,186163,179503,ES,ES
7436,1700379180,1700409120,29940,81795,42183,TR,TR
117271,1699827480,1699834020,6540,122756,54991,EE,EE
130920,1699686420,1699697700,11280,126223,169173,US,US
159511,1700627880,1700633700,5820,150465,55716,NL,NL
197992,1699721580,1699756020,34440,171178,21066,TR,TR
145981,1699159200,1699170600,11400,148911,194405,US,US
100503,1699226100,1699248000,21900,83705,35252,DE,DE
70276,1700736960,1700757660,20700,58091,192251,FR,BE
51687,1699637280,1699672140,34860,122227,116326,TR,TR
16659,1699070460,1699087200,16740,37066,62650,US,US
42994,1699430160,1699447080,16920,140466,28695,RS,HR
41153,1700534760,1700559540,24780,30221,96125,DE,CH
80435,1700112120,1700141760,29640,122356,199157,TR,TR
176736,1700564820,1700575620,10800,57601,63175,CZ,CZ
124789,1699819200,1699845120,25920,139804,164301,DE,DE
99140,1700835120,1700862540,27420,73981,8518,DE,DE
139243,1699689600,1699746300,56700,49441,154730,BG,DE
13794,1700786340,1700789940,3600,172664,25671,GB,DE
191135,1700262180,1700295180,33000,81592,127421,TR,TR
90346,1699416480,1699427940,11460,139373,66670,US,US
172216,1699946760,1699968720,21960,144217,199997,PL,DE
188579,1700266920,1700277480,10560,21310,93293,HR,HR
137595,1699260300,1699275780,15480,70792,171230,AT,DE
12147,1700309760,1700340600,30840,75746,80170,TR,TR
176726,1700302500,1700330760,28260,11445,126516,BR,BR
52827,1700019480,1700055180,35700,164635,89612,TR,TR
180324,1698802980,1698838080,35100,154768,15899,TR,TR
17906,1699692960,1699705140,12180,99604,58347,IT,IT
64203,1700231700,1700263920,32220,4063,9100,TR,TR
57246,1699473060,1699502700,29640,50632,116057,TR,TR
153044,1700098320,1700101920,3600,9618,138805,GB,GB
103558,1699156020,1699191780,35760,1896,126595,TR,TR
3584,1698963180,1698992820,29640,181634,118649,TR,TR
147690,1700622900,1700626500,3600,197376,73137,GB,GB
153814,1699905780,1699934580,28800,73154,16636,TR,TR
139060,1698949440,1698961320,11880,52588,18507,IT,IT
21005,1700274000,1700288040,14040,15310,36011,US,US
39087,1699537860,1699541460,3600,17327,196730,GB,GB
182719,1699784940,1699790580,5640,53750,137572,NL,NL
65803,1699251600,1699255980,4380,148002,36710,CL,CL
169480,1700526720,1700530320,3600,85497,181983,GB,GB
22605,1700225280,1700246400,21120,61760,150968,BE,FR
92053,1699715220,1699734000,18780,132732,171278,FR,IT
64902,1700151420,1700161860,10440,48066,46894,HR,HR
60568,1699852200,1699868940,16740,4351,102991,US,US
133839,1698971760,1698975360,3600,142039,31530,GB,GB
139912,1699702620,1699714800,12180,28599,88275,US,US
180256,1700589840,1700610900,21060,119023,76337,FR,NL
132443,1699907280,1699917060,9780,24015,178350,HR,HR
97652,1699097340,1699123800,26460,154817,150774,RO,MD
78452,1700569380,1700581980,12600,145835,49436,IT,IT
48303,1698915660,1698949200,33540,65651,21788,TR,TR
91997,1698982920,1698986520,3600,36507,171761,GB,GB
192436,1699146180,1699179120,32940,190728,148059,TR,TR
18918,1700671740,1700684760,13020,158753,91698,ES,ES
144002,1698950520,1698957960,7440,194035,192900,PT,PT
101500,1699800120,1699815180,15060,129035,169737,US,US
39450,1699862880,1699872060,9180,78094,115846,ES,ES
42286,1699281240,1699304760,23520,75094,135167,MD,RO
18903,1699142160,1699177740,35580,187501,65652,TR,TR
180785,1700002380,1700031720,29340,94310,20563,TR,TR
166638,1700331420,1700366220,34800,196810,17622,TR,TR
98363,1699382880,1699411980,29100,47365,66919,TR,TR
137963,1699432860,1699450680,17820,14184,41115,US,US
164169,1699644600,1699679280,34680,179947,182322,TR,TR
34791,1699578540,1699612320,33780,125646,12993,TR,TR
54143,1698983040,1699018440,35400,131920,24860,TR,TR
99015,1700702520,1700737200,34680,187290,35883,MX,MX
139271,1700692680,1700710020,17340,159628,140094,AT,AT
52573,1699876740,1699902840,26100,25473,190474,PL,PL
151555,1700307180,1700342700,35520,194181,125535,TR,TR
132466,1699818780,1699846920,28140,191711,174188,HU,DE
41267,1700178660,1700182260,3600,136238,147234,GB,GB
139591,1699047360,1699081200,33840,30121,139450,TR,TR
174285,1700295420,1700324340,28920,52410,43448,TR,TR
158963,1699790760,1699808160,17400,14164,37450,FR,FR
141478,1699513080,1699527480,14400,183379,144710,US,US
49242,1699897980,1699932660,34680,127545,148770,TR,TR
137694,1698908160,1698921180,13020,111677,31452,PT,PT
190631,1698990600,1698994200,3600,176482,35781,NL,NL
32815,1700468940,1700487720,18780,93701,49747,FR,FR
192958,1699177560,1699181160,3600,178432,193602,GB,GB
161592,1700594820,1700599320,4500,156614,42208,GB,GB
37597,1699511160,1699538400,27240,160620,129000,PL,DE
146814,1699281720,1699299360,17640,120331,13906,US,US
29621,1700618520,1700631960,13440,109227,22241,IT,IT
45472,1699269300,1699293000,23700,14932,189860,DK,DE
38312,1699605900,1699619160,13260,41440,137267,RS,RS
43076,1699225980,1699258320,32340,132151,104410,TR,TR
67645,1700584440,1700616600,32160,11242,130046,TR,TR
59420,1700362320,1700392080,29760,179805,144683,TR,TR
801,1700231940,1700266860,34920,88357,28064,TR,TR
23748,1698854580,1698859860,5280,108177,170898,GB,GB
116070,1700639220,1700668980,29760,73897,140446,TR,TR
147779,1700682420,1700698980,16560,100366,129631,US,US
18518,1698848220,1698881460,33240,162513,68448,TR,TR
64797,1700761500,1700793360,31860,11014,149028,TR,TR
30266,1698861480,1698871200,9720,184095,115432,ES,AD
7077,1699245360,1699266900,21540,91685,117930,FR,FR
131785,1699754820,1699784400,29580,149433,100268,TR,TR
171380,1700633520,1700642160,8640,49563,180696,HR,HR
168857,1700041200,1700064900,23700,160874,184264,DE,AT
10432,1699746660,1699768020,21360,169268,167143,FR,CH
3122,1700508360,1700544120,35760,75421,160250,TR,TR
73358,1700822220,1700834160,11940,171114,65844,IT,IT
176485,1700214060,1700245080,31020,172267,39676,TR,TR
89099,1700218500,1700251440,32940,24908,88356,TR,TR
147916,1700393820,1700406600,12780,28787,159589,IT,IT
151336,1700618160,1700649900,31740,101376,108808,TR,TR
65064,1699915800,1699925220,9420,193655,133884,IT,IT
110167,1700832420,1700843520,11100,100534,44550,IT,IT
38386,1700173980,1700203860,29880,115582,42900,TR,TR
85219,1698877980,1698890340,12360,39644,8732,RS,RS
166867,1700679180,1700685240,6060,164785,35361,NL,NL
174005,1699610160,1699613760,3600,196732,82012,NL,NL
196997,1699466760,1699470360,3600,120100,60800,GB,GB
95139,1700210220,1700245200,34980,169298,184951,TR,TR
126599,1698975180,1698978780,3600,70791,179176,NL,ES
50959,1699805040,1699838580,33540,83894,50364,MX,MX
44143,1700545200,1700574000,28800,71950,13141,TR,TR
77518,1699116840,1699124760,7920,65263,149121,IT,IT
1316,1699825320,1699856100,30780,78369,119543,TR,TR
83428,1700580660,1700593320,12660,62408,143,US,US
179254,1699183740,1699196640,12900,112632,172578,AT,AT
120458,1699546800,1699569120,22320,109994,76044,PL,DE
190374,1699107780,1699115940,8160,9333,100382,IT,IT
100306,1699703280,1699706880,3600,19364,75356,GB,GB
55576,1700336520,1700369700,33180,193525,96583,TR,TR
40265,1699343280,1699377240,33960,68533,80909,TR,TR
193878,1698806460,1698816420,9960,72417,23614,HR,HR
197032,1699647900,1699683240,35340,193941,131592,TR,TR
117033,1700703960,1700718840,14880,17175,88669,CZ,HR
149563,1700813760,1700824440,10680,148373,174941,PT,ES
36382,1699829280,1699864800,35520,136841,112320,TR,TR
110760,1700545260,1700562960,17700,27033,99496,US,US
165208,1699299060,1699302660,3600,78041,191311,NL,NL
132577,1699721280,1699750920,29640,187616,65744,TR,TR
30723,1699988280,1699999560,11280,119911,117477,US,US
183328,1700138340,1700169780,31440,44657,58737,TR,TR
41679,1700459100,1700464380,5280,78786,19657,GB,GB
197511,1699289100,1699324500,35400,10078,198316,TR,TR
157534,1699872840,1699883700,10860,120804,87154,US,US
26921,1698935820,1698959160,23340,30466,6410,DE,BG
124468,1699440000,1699454760,14760,194430,86666,US,US
102083,1700643900,1700670960,27060,150470,86975,RO,RO
124233,1699420260,1699428840,8580,168916,119553,IT,IT
129836,1699484760,1699494660,9900,158795,130270,ES,FR
36546,1698954960,1698985260,30300,36360,183057,TR,TR
181935,1700644020,1700651160,7140,25843,182325,GB,GB
171323,1700146620,1700152860,6240,92059,110311,GB,GB
62647,1699796880,1699826040,29160,184544,74235,TR,TR
186933,1698987720,1699021920,34200,146432,153201,TR,TR
116438,1699029900,1699044240,14340,90329,113066,IT,IT
12406,1700458680,1700487780,29100,102197,72223,TR,TR
40316,1700853060,1700907180,54120,140807,190963,BG,DE
7325,1699339260,1699351860,12600,54229,42100,US,US
61570,1699193880,1699224060,30180,143333,83609,TR,TR
65288,1699235460,1699241220,5760,74376,83560,EE,FI
23233,1699766580,1699779360,12780,178472,59138,HR,HR
76712,1699296900,1699308900,12000,156387,15056,PT,PT
57760,1699401660,1699411980,10320,91121,2246,HR,HR
15889,1700191920,1700221740,29820,59777,151458,TR,TR
16185,1700330640,1700352600,21960,137346,143900,NO,SE
191715,1700141880,1700145480,3600,43428,169705,GB,GB
92077,1699167780,1699203360,35580,31273,72984,TR,TR
135156,1698850260,1698861780,11520,161994,130335,US,US
10089,1698839280,1698862860,23580,72239,63744,RO,RO
129909,1699139460,1699145820,6360,32272,137495,GB,GB
94533,1699710780,1699727940,17160,169183,198013,AT,PL
187403,1699904820,1699940220,35400,63905,172565,TR,TR
72680,1700457420,1700469120,11700,147039,77562,US,US
66844,1699724880,1699746960,22080,122851,143179,DE,IT
127951,1700845740,1700873040,27300,139595,162466,DE,NL
60896,1700213580,1700230860,17280,172432,191098,US,US
175259,1700761800,1700796660,34860,7513,162410,TR,TR
113611,1699326060,1699346520,20460,426,149295,FR,FR
78399,1700518860,1700534940,16080,123306,174163,US,US
144375,1699982640,1699986240,3600,195759,99181,NL,NL
186532,1699877220,1699910460,33240,129857,30577,TR,TR
106752,1699182180,1699217460,35280,93490,92500,TR,TR
115090,1700587800,1700622600,34800,171327,92681,TR,TR
58905,1699502520,1699536900,34380,132264,42690,TR,TR
11074,1700507100,1700513040,5940,175105,43215,NL,NL
185452,1699537080,1699571340,34260,93270,107638,TR,TR
76246,1700796840,1700810640,13800,56049,62937,SK,DE
181832,1700059020,1700096700,37680,55030,90279,MX,MX
60649,1700190600,1700226360,35760,78661,14077,TR,TR
40191,1699096620,1699113420,16800,164059,20813,US,US
161750,1699217760,1699251660,33900,171061,161340,TR,TR
93276,1699473540,1699486500,12960,194901,193865,IT,IT
186679,1699267860,1699272060,4200,156969,162091,GB,GB
138629,1699373040,1699401180,28140,185992,137256,BR,BR
42295,1699082940,1699092180,9240,55317,182542,HR,HR
70108,1700274120,1700286540,12420,66376,75351,HR,HR
63077,1699635300,1699670160,34860,194027,127815,TR,TR
65216,1699594200,1699625100,30900,100655,31902,TR,TR
40723,1699820580,1699830960,10380,58680,65205,SK,SK
193692,1699793160,1699802820,9660,30856,178171,IT,IT
175097,1700012400,1700016000,3600,189807,192598,GB,GB
170675,1700850660,1700862900,12240,111038,140158,IT,IT
140042,1699190820,1699220220,29400,150533,16178,TR,TR
41060,1699576740,1699580340,3600,150784,188724,NL,NL
9535,1699942620,1699957740,15120,45733,161689,US,US
158022,1700144640,1700161380,16740,75994,100395,US,US
176379,1699934460,1699964640,30180,125886,155873,TR,TR
69746,1699631100,1699664760,33660,36003,37674,TR,TR
165228,1698934860,1698947280,12420,187278,157376,US,US
177202,1699985940,1700001420,15480,81972,137246,US,US
182696,1699428180,1699434480,6300,106312,155104,NL,NL
138273,1700187360,1700218620,31260,96712,84247,TR,TR
73305,1699153860,1699170180,16320,19029,9941,US,US
6500,1699311060,1699325880,14820,30587,140804,US,US
142983,1699525560,1699532280,6720,183696,40371,GB,GB
198288,1698920040,1698932940,12900,43466,7381,US,US
10513,1700204760,1700218080,13320,140075,33083,US,US
71652,1699152360,1699157580,5220,193585,176665,GB,GB
98697,1699046940,1699050540,3600,178189,105562,GB,GB
23765,1700351160,1700383560,32400,97716,30082,TR,TR
169941,1700216700,1700232720,16020,189754,2229,RS,SI
134699,1699378500,1699391040,12540,27733,159866,IT,IT
185954,1699373700,1699377300,3600,191733,159236,GB,GB
25666,1698978000,1698990240,12240,138796,146156,AT,AT
131325,1699910400,1699920360,9960,165002,122766,IT,IT
32624,1699608180,1699612260,4080,5124,77795,GB,GB
88327,1699231140,1699264140,33000,152008,166555,TR,TR
180547,1699183740,1699215960,32220,112000,102109,TR,TR
149520,1700729400,1700746560,17160,111253,53797,US,US
153415,1699458180,1699462620,4440,62035,13743,GB,GB
102649,1700044860,1700058840,13980,41722,160112,ES,ES
67802,1700816880,1700847360,30480,101484,185320,TR,TR
164099,1700764680,1700774820,10140,55831,9766,IT,IT
196707,1700180880,1700196300,15420,84671,146181,US,US
131097,1699313220,1699320120,6900,25032,187033,NL,DE
42411,1700367660,1700382060,14400,22288,24173,US,US
90780,1699843860,1699857000,13140,11644,179462,IT,IT
4558,1700841180,1700847000,5820,147998,75347,GB,GB
136417,1700735760,1700748300,12540,17557,180572,CA,CA
170024,1700501400,1700533320,31920,44880,120648,TR,TR
73381,1700490420,1700504100,13680,4894,69089,US,US
113640,1700085480,1700117820,32340,190331,162444,TR,TR
172564,1699425780,1699448220,22440,101090,91990,DE,DE
110627,1700269560,1700301120,31560,72731,171650,TR,TR
147445,1699734360,1699746240,11880,69038,121286,US,US
46233,1699226580,1699239180,12600,81232,169942,HR,HR
73418,1699065600,1699069800,4200,148083,42389,NL,NL
135992,1699431720,1699461780,30060,110236,92520,TR,TR
100705,1698846660,1698859620,12960,64306,179338,US,US
7356,1700476020,1700490180,14160,123130,101865,US,US
99726,1699760340,1699792440,32100,198209,159782,TR,TR
155764,1699904400,1699918080,13680,96876,54335,HR,HR
125300,1700598420,1700602560,4140,67494,116242,GB,GB
105263,1700032020,1700065320,33300,144704,93152,TR,TR
135730,1698921600,1698938700,17100,130157,185216,FR,FR
112619,1700644260,1700679300,35040,133207,11814,TR,TR
44834,1699598160,1699614720,16560,32815,110052,FR,PL
38810,1700127840,1700134800,6960,9754,23417,NL,NL
48764,1699606860,1699620480,13620,174822,137116,HR,HR
54820,1700678400,1700682420,4020,39054,137696,GB,GB
77708,1700048640,1700061600,12960,105934,63554,PT,PT
195027,1699364460,1699389300,24840,93304,77607,DE,UA
101356,1700094360,1700114700,20340,194769,156549,FR,BE
136013,1700198760,1700205240,6480,2846,73669,GB,GB
102139,1699728600,1699739940,11340,84732,9127,IT,HR
17377,1699118400,1699133820,15420,138527,184897,US,US
18676,1700512140,1700525580,13440,94808,113892,HR,ME
86738,1700119380,1700154240,34860,93390,62722,TR,TR
179408,1699818480,1699822080,3600,55652,81591,NL,GB
125265,1699579680,1699595640,15960,187345,38790,US,US
110652,1699081800,1699113480,31680,135228,176087,TR,TR
142381,1699879860,1699887540,7680,91406,66009,IT,IT
145212,1698850020,1698878760,28740,12206,84838,PL,CZ
68499,1700055300,1700062380,7080,179290,32099,GB,GB
64275,1699872300,1699905600,33300,174495,84207,TR,TR
25007,1699756680,1699786980,30300,137480,182780,TR,TR
18446,1699316460,1699332360,15900,110181,33235,AT,BG
103264,1700477700,1700481300,3600,182254,132487,NL,NL
143516,1699090680,1699121940,31260,131877,75059,TR,TR
137228,1699370280,1699380420,10140,85332,56016,HR,HR
137474,1699628580,1699643340,14760,168485,52182,AT,HU
159482,1698922440,1698954780,32340,85560,148792,TR,TR
196919,1699598820,1699637220,38400,110718,122413,MX,MX
11852,1700003460,1700020860,17400,163140,193964,US,US
114405,1700734200,1700737800,3600,87579,149657,GB,GB
140194,1700331180,1700345220,14040,152587,110256,IT,IT
88005,1700471460,1700491320,19860,1802,78967,FR,FR
56266,1699841460,1699873380,31920,77143,144847,TR,TR
29761,1700067780,1700096760,28980,152802,125748,TR,TR
94644,1699374840,1699409160,34320,41946,49917,TR,TR
45622,1699607880,1699622160,14280,35308,27796,US,US
75407,1699934880,1699938480,3600,181843,134612,NL,NL
37565,1700111280,1700144940,33660,92920,16590,TR,TR
148905,1699696140,1699709040,12900,94449,113480,US,US
160678,1698948360,1698980820,32460,17892,143353,MX,MX
92978,1700222220,1700254740,32520,70517,67594,TR,TR
147707,1699656060,1699661220,5160,66220,31086,GB,GB
133334,1699475940,1699511160,35220,2245,38349,MX,US
2338,1699177740,1699210980,33240,16527,185271,TR,TR
158918,1699701660,1699705260,3600,66613,117258,GB,GB
8781,1700398200,1700417220,19020,125075,44805,FR,FR
91113,1699723020,1699736220,13200,174506,145745,US,US
63218,1700602080,1700613120,11040,138414,131368,IT,IT
118840,1699971960,1699984860,12900,124007,88756,US,US
175619,1700824920,1700830140,5220,22766,182299,GB,GB
122318,1699644780,1699676820,32040,112061,146830,TR,TR
3567,1699611420,1699650000,38580,35162,83232,MX,MX
65716,1699233120,1699265640,32520,99415,35638,TR,TR
30445,1699511820,1699541040,29220,174756,91829,TR,TR
48632,1700186100,1700204580,18480,36830,197524,FR,FR
46614,1700378100,1700414040,35940,137221,128234,TR,TR
195126,1699851780,1699866420,14640,199238,82492,US,US
140951,1699277040,1699307280,30240,157657,62312,TR,TR
122250,1698916020,1698929580,13560,61587,108842,US,US
144457,1699395900,1699406940,11040,95616,87819,US,US
114440,1699219260,1699252020,32760,146584,128351,TR,TR
138094,1699021860,1699026600,4740,106600,179591,GB,GB
147637,1699221000,1699237800,16800,151232,111914,CZ,CZ
64183,1699968600,1699972740,4140,50165,22879,GB,GB
2627,1699762440,1699798200,35760,4555,166608,TR,TR
112798,1699906980,1699911060,4080,161848,173594,GB,GB
54078,1699487040,1699495980,8940,23623,113377,PT,PT
177864,1700436300,1700440740,4440,121077,29950,NL,NL
118484,1700710380,1700741220,30840,128309,67130,TR,TR
153640,1700097960,1700101560,3600,83342,112797,NL,NL
187558,1700321640,1700335380,13740,97369,159046,AT,AT
126464,1700712960,1700728680,15720,194463,83692,RS,RS
116502,1699521420,1699555140,33720,196176,144488,TR,TR
144586,1700472120,1700477820,5700,135645,57347,NL,NL
78386,1700717940,1700749560,31620,157577,138516,TR,TR
24851,1700148840,1700179140,30300,130622,131437,TR,TR
5731,1699424280,1699440060,15780,104520,172691,FR,AD
84452,1699745040,1699762740,17700,1763,182174,US,US
97885,1698979860,1698983460,3600,100764,101639,GB,GB
164821,1699726500,1699758780,32280,97788,160379,TR,TR
65132,1700746140,1700765940,19800,20288,150640,FR,FR
165310,1700844480,1700857980,13500,70456,194905,IT,IT
126281,1700453760,1700484240,30480,67258,141253,TR,TR
129986,1699616700,1699650900,34200,62764,161498,TR,TR
141998,1700449980,1700483640,33660,111705,81503,TR,TR
192443,1699920600,1699955580,34980,71675,38158,TR,TR
85249,1700034000,1700044320,10320,47261,103871,IT,IT
92971,1699076520,1699127520,51000,170780,50146,BG,BG
56498,1700498280,1700527800,29520,37895,91169,TR,TR
154937,1699791900,1699830360,38460,41169,145274,MX,MX
49773,1700084040,1700109120,25080,194894,68753,DE,DE
196417,1700597100,1700602560,5460,198121,2914,GB,GB
166807,1699827900,1699841820,13920,62407,96274,IT,IT
110002,1699661160,1699666080,4920,31843,135325,GB,GB
192919,1699914420,1699944960,30540,98379,98710,TR,TR
95480,1700547300,1700580540,33240,152869,180100,TR,TR
151238,1699468920,1699492620,23700,11333,116199,DE,NL
160123,1700140860,1700173140,32280,52985,2267,TR,TR
172318,1699046520,1699079460,32940,98941,43232,TR,TR
110233,1699735620,1699766040,30420,134371,111951,TR,TR
83601,1699668660,1699689300,20640,85431,174916,SE,DE
123989,1700677680,1700701740,24060,45692,139100,PL,DE
95606,1699794360,1699797960,3600,76329,104559,NL,NL
126814,1699857840,1699890720,32880,166448,113804,TR,TR
33667,1699872120,1699909740,37620,186075,146275,MX,MX
155237,1699597020,1699650180,53160,30055,127233,BG,DE
119027,1700630340,1700636820,6480,173732,8600,GB,GB
167881,1700696640,1700700240,3600,182384,124813,GB,GB
63555,1699385400,1699396320,10920,17980,98519,CZ,SK
27959,1700148180,1700156040,7860,22226,74386,IT,IT
131614,1699041240,1699058940,17700,48334,19369,RS,HR
73300,1699730820,1699766160,35340,43108,194847,TR,TR
54898,1699576380,1699601400,25020,119563,170886,DE,BG
49534,1700482380,1700515260,32880,20358,83236,TR,TR
11732,1700805300,1700816160,10860,198652,40614,US,US
5119,1700680920,1700688240,7320,88991,97406,IT,HR
54537,1699568460,1699601580,33120,96642,6615,TR,TR
51667,1699795860,1699803120,7260,91415,90172,IT,IT
29302,1699723560,1699734840,11280,17148,191974,US,US
180909,1699976100,1700009280,33180,162601,43289,TR,TR
38601,1700130180,1700151960,21780,32963,114865,DE,DE
172064,1700733780,1700750100,16320,40968,59697,CZ,SK
95235,1700564640,1700577600,12960,95494,78555,US,US
8821,1699460940,1699464540,3600,79718,147799,GB,GB
78583,1699079400,1699087440,8040,170965,3634,PT,PT
177005,1700562120,1700575980,13860,5190,46285,IT,IT
51264,1699047240,1699077900,30660,175071,56342,TR,TR
174546,1700181720,1700198580,16860,140690,126457,US,US
15492,1699276800,1699307520,30720,107026,167211,TR,TR
166845,1699797960,1699828140,30180,74476,42015,TR,TR
111798,1700637900,1700646900,9000,1118,120432,FI,EE
62346,1699884180,1699899240,15060,167274,185938,BE,NL
64611,1700571000,1700577120,6120,138581,153519,GB,GB
40531,1699430460,1699447980,17520,24958,37384,US,US
177436,1699358400,1699363440,5040,98764,98524,GB,GB
58502,1699650840,1699657620,6780,23682,123581,NL,NL
104414,1699824780,1699857660,32880,37402,33692,TR,TR
115567,1700865180,1700879460,14280,170122,22097,IT,FR
63953,1700305380,1700319660,14280,185391,185121,US,US
145065,1700406240,1700435220,28980,158057,98645,TR,TR
190826,1700117160,1700146620,29460,149695,121911,TR,TR
191418,1700780040,1700815740,35700,126811,159107,TR,TR
84986,1699643820,1699676880,33060,67230,126140,TR,TR
160968,1700584260,1700604660,20400,147448,133251,FR,FR
159245,1698820680,1698833400,12720,18602,57050,IT,IT
128784,1700773680,1700798400,24720,158565,131993,DE,DE
118795,1699629120,1699641240,12120,69995,190774,US,US
82530,1699069140,1699100700,31560,166042,110886,TR,TR
151463,1699134000,1699167180,33180,153015,186735,TR,TR
176447,1700318580,1700347500,28920,46329,122143,TR,TR
105048,1700040060,1700055840,15780,115671,103799,US,US
72280,1700105640,1700137680,32040,16529,130526,TR,TR
149898,1700347260,1700378880,31620,17612,147993,TR,TR
123654,1700209080,1700241300,32220,146972,162429,TR,TR
89778,1700253120,1700266740,13620,65144,166867,IT,IT
193377,1700678580,1700694960,16380,151016,163974,FR,FR
36505,1700285640,1700317500,31860,117734,175360,TR,TR
169523,1700835480,1700844780,9300,94961,98886,PT,PT
124746,1700799240,1700826960,27720,105144,181873,DE,NL
154968,1699013940,1699023120,9180,165497,63235,IT,IT
130994,1699228260,1699241820,13560,102966,161684,IT,DE
20274,1700622600,1700634360,11760,38004,152600,HR,HR
146565,1700200860,1700209980,9120,191618,74491,IT,IT
177406,1700804400,1700818920,14520,165356,68852,CZ,CZ
160547,1700673720,1700680800,7080,68965,35758,NL,NL
65151,1698822900,1698836160,13260,163285,77366,US,US
113369,1699768020,1699784040,16020,195724,75533,FR,FR
69122,1700695020,1700730000,34980,116534,179032,TR,TR
35721,1699441200,1699473300,32100,176941,54848,TR,TR
54337,1699926540,1699936800,10260,194281,122243,HR,HR
160050,1699559280,1699589700,30420,18712,199856,TR,TR
64339,1699597380,1699617180,19800,159415,171655,BE,FR
147908,1700113500,1700140380,26880,123066,192564,DE,DE
143809,1699726080,1699759560,33480,138952,134278,TR,TR
129377,1699671360,1699682580,11220,59862,56714,IT,IT
118021,1699113960,1699117560,3600,54230,105349,NL,NL
95251,1699114680,1699143840,29160,89422,90105,TR,TR
148315,1700239500,1700250720,11220,84164,92397,AT,DE
120263,1699222320,1699256940,34620,190282,85547,TR,TR
8351,1699315620,1699330620,15000,62023,119903,US,US
66948,1699472280,1699479180,6900,117753,43127,NL,NL
168179,1700428440,1700439000,10560,7549,122170,IT,IT
80322,1699594200,1699613220,19020,21149,116022,FR,FR
198791,1698819480,1698837000,17520,23182,164429,US,US
35807,1699649400,1699684020,34620,89719,55339,TR,TR
156644,1700643420,1700651820,8400,1921,144903,HR,HR
11036,1700483520,1700495160,11640,176818,54261,US,US
180977,1699745940,1699753020,7080,82340,116465,GB,GB
54308,1700626080,1700655900,29820,169032,145328,TR,TR
60656,1699690020,1699694460,4440,188080,434,GB,GB
139778,1699011840,1699045140,33300,185486,30558,TR,TR
150285,1699131240,1699160100,28860,61159,80016,TR,TR
144587,1699928760,1699951920,23160,192690,106942,DE,IT
112110,1699348320,1699382040,33720,90631,12167,TR,TR
110107,1700351460,1700356860,5400,42449,11804,GB,GB
173143,1700540820,1700576100,35280,158530,108231,TR,TR
8654,1699111260,1699145700,34440,117086,133909,TR,TR
141419,1700764680,1700798880,34200,77891,12867,TR,TR
8012,1699986060,1700019840,33780,140276,121106,MK,RS
62203,1699836960,1699870140,33180,59135,53605,TR,TR
84166,1700142600,1700150940,8340,64825,2365,EE,EE
103642,1699405080,1699417680,12600,17899,179288,CA,US
57555,1699680480,1699694460,13980,138996,159524,ES,ES
48458,1699984200,1699996800,12600,36199,149224,IT,IT
162985,1699313340,1699326720,13380,108252,5279,US,US
28031,1698948360,1698957000,8640,91804,87737,PT,PT
133032,1700155200,1700168040,12840,49739,161471,IT,IT
1648,1700740620,1700754660,14040,166397,78206,AT,UA
16729,1699604580,1699627740,23160,117691,178915,DE,DE
35754,1700773620,1700808840,35220,189535,138749,MX,US
111820,1700305020,1700311560,6540,56145,142952,NL,NL
55245,1699094340,1699110840,16500,121742,156759,US,US
94580,1700495940,1700509380,13440,125014,62469,IT,IT
197784,1698833160,1698863640,30480,85666,7899,TR,TR
54822,1699157520,1699189740,32220,78,184365,TR,TR
58598,1699239060,1699242660,3600,7574,28998,GB,GB
68568,1699761540,1699791600,30060,51651,67500,TR,TR
55374,1699623540,1699630680,7140,65325,183146,GB,GB
176049,1699968900,1699984440,15540,144961,7739,US,US
142353,1700376960,1700409420,32460,160141,54617,TR,TR
192935,1698806880,1698829920,23040,133903,72963,DE,PL
36068,1699581540,1699595880,14340,36226,118188,AT,AT
85957,1700386380,1700397540,11160,103944,192709,US,US
41659,1699437240,1699469280,32040,131337,188360,TR,TR
169392,1699846080,1699857120,11040,15942,184491,AT,DE
10256,1699469280,1699493700,24420,156227,110450,DE,DE
52703,1699171560,1699206960,35400,22142,94898,TR,TR
56497,1699189980,1699194180,4200,126864,156324,GB,GB
91288,1700529060,1700532660,3600,171493,7029,GB,GB
192487,1700035140,1700068500,33360,31221,78350,TR,TR
66451,1700434740,1700443140,8400,177496,80830,IT,IT
114351,1699742760,1699773360,30600,75529,146812,TR,TR
25006,1700285040,1700288940,3900,183081,48933,GB,GB
15326,1700075340,1700085240,9900,38219,82058,HR,RS
141114,1700823420,1700827020,3600,160776,72045,NL,NL
186583,1699429620,1699442220,12600,149420,17264,CA,CA
73085,1700201640,1700237580,35940,110068,150503,TR,TR
197692,1700011860,1700022720,10860,118162,146999,IT,IT
3605,1700352120,1700358060,5940,52171,56046,GB,GB
113395,1699891440,1699924920,33480,144926,168113,TR,TR
3981,1699360440,1699371720,11280,5147,190192,CA,CA
7846,1699729260,1699757460,28200,157426,63950,BR,BR
163051,1700245740,1700260020,14280,164706,55476,CZ,HU
82061,1700530800,1700534400,3600,146597,123741,GB,GB
181754,1699095600,1699112040,16440,121462,178883,US,US
76883,1699291800,1699320960,29160,105329,88651,TR,TR
45100,1698834300,1698863400,29100,131703,159291,TR,TR
92568,1699353480,1699384920,31440,94919,172403,TR,TR
72237,1699187340,1699192740,5400,40681,23918,GB,GB
103975,1699176960,1699210860,33900,145182,121738,TR,TR
77579,1699785600,1699790880,5280,13386,190997,NL,NL
147815,1700601120,1700605260,4140,148039,102252,NL,NL
47647,1699835760,1699839360,3600,141381,25887,GB,GB
11266,1699266900,1699302240,35340,106765,18165,TR,TR
36784,1699391520,1699399080,7560,93619,119938,PT,PT
159984,1699815300,1699845060,29760,141421,160271,TR,TR
191759,1700805600,1700836980,31380,179989,112281,TR,TR
11415,1699390380,1699401720,11340,75429,35125,IT,IT
150678,1699976760,1699989180,12420,3140,120717,US,US
57944,1699414920,1699449120,34200,168382,9958,TR,TR
172164,1699356720,1699370820,14100,153455,39791,AT,AT
107455,1699629600,1699661700,32100,26042,97758,TR,TR
118551,1700509920,1700544840,34920,70631,149623,TR,TR
39114,1700443440,1700472960,29520,41989,4551,TR,TR
153879,1699773960,1699789980,16020,86625,38980,US,US
66838,1700732940,1700736540,3600,10040,118156,GB,GB
1816,1700141940,1700145960,4020,79903,57783,GB,GB
22041,1700852940,1700861760,8820,54249,183112,IT,IT
34539,1699764000,1699767600,3600,75708,14683,GB,GB
68362,1699403460,1699432620,29160,133581,105402,TR,TR
194022,1699459080,1699472040,12960,838,88724,US,CA
65185,1699732320,1699745640,13320,64838,153829,US,US
33107,1698973860,1698997980,24120,37638,104663,BR,BR
53204,1700616600,1700640480,23880,9392,159037,RO,RO
1482,1700313780,1700343240,29460,70006,104790,TR,TR
62923,1699596300,1699626120,29820,3052,140879,TR,TR
16540,1699159680,1699189380,29700,4183,1496,TR,TR
6614,1700616060,1700645340,29280,31918,19844,TR,TR
20509,1699908420,1699925580,17160,14826,76831,US,US
146107,1700449320,1700469360,20040,36183,197696,FR,FR
128969,1699281600,1699291260,9660,61698,76557,IT,IT
49933,1698802920,1698823920,21000,184540,105618,DK,DK
23212,1700272380,1700296440,24060,199192,178903,DE,DE
130606,1698905640,1698919920,14280,43,40569,US,US
176189,1700336760,1700371260,34500,50123,98074,TR,TR
129959,1698807840,1698821520,13680,186580,134356,US,MX
151582,1700200620,1700234100,33480,54036,168328,TR,TR
41089,1699941420,1699951080,9660,91131,195253,IT,IT
94150,1698836760,1698840840,4080,123495,94260,GB,NL
136061,1699221480,1699225080,3600,173457,108662,GB,GB
189406,1699805640,1699840620,34980,50636,104,TR,TR
144554,1699520100,1699548960,28860,49638,8070,TR,TR
177151,1699961700,1699973220,11520,46344,128744,ES,ES
175712,1700816280,1700847780,31500,104923,17850,TR,TR
11757,1699463580,1699473720,10140,20149,43494,IT,IT
108746,1699795200,1699805340,10140,119356,161137,IT,IT
1442,1699214160,1699245000,30840,127143,102660,TR,TR
48736,1699981080,1699984680,3600,14081,96332,GB,GB
63447,1700717100,1700733840,16740,92249,2659,BE,FR
16897,1699583820,1699616040,32220,54761,194830,TR,TR
58233,1700789160,1700798640,9480,66027,159100,IT,IT
49819,1700859300,1700894040,34740,183069,19870,TR,TR
31173,1699600620,1699634940,34320,146527,193966,TR,TR
183272,1699234140,1699245960,11820,41478,96784,US,US
99929,1699608600,1699640100,31500,131274,64353,TR,TR
5156,1699287420,1699298400,10980,194084,167826,US,US
156228,1700604300,1700662560,58260,78765,73421,UA,HU
135718,1699255620,1699270080,14460,109832,88620,US,US
13699,1700050680,1700079600,28920,122693,15766,TR,TR
62931,1700111100,1700125260,14160,42935,60599,US,US
270,1699738380,1699767480,29100,65275,173375,TR,TR
115302,1699838640,1699861140,22500,147951,133013,DE,FR
86638,1699549680,1699563720,14040,169049,84351,ES,ES
15488,1699989600,1699993200,3600,9101,166121,GB,GB
87697,1698900780,1698914940,14160,18373,35369,HR,HR
102634,1699021020,1699030200,9180,165409,114048,HR,HR
83305,1699851300,1699860720,9420,151568,110050,IT,IT
162833,1699881660,1699893300,11640,129641,129877,US,US
69534,1700698200,1700728200,30000,33077,21645,TR,TR
159455,1700784900,1700815560,30660,164370,25916,TR,TR
95567,1700391780,1700415420,23640,77745,135774,BR,BR
157590,1699140300,1699171860,31560,114660,12216,TR,TR
20349,1700432760,1700436360,3600,10382,199901,NL,NL
26495,1699449720,1699481100,31380,159761,131209,TR,TR
134944,1700363700,1700386800,23100,190294,21841,DE,PL
127649,1700094540,1700131920,37380,136122,131118,MX,MX
188623,1699790520,1699802760,12240,171465,54138,IT,IT
41074,1699900320,1699907280,6960,30012,70938,GB,GB
175788,1699824180,1699835040,10860,120697,169735,RS,RS
165055,1699680060,1699695000,14940,118319,148465,RS,BA
195387,1699635060,1699643160,8100,93802,31203,IT,IT
54841,1700029980,1700041380,11400,84092,81891,RS,HR
166363,1699577520,1699609680,32160,175166,148241,TR,TR
9211,1700560140,1700584020,23880,5007,194006,DK,RO
106443,1700465040,1700497200,32160,155335,149765,TR,TR
125688,1699237260,1699255740,18480,48827,88556,FR,NL
94139,1700647440,1700658360,10920,22780,132522,HR,HR
163995,1699548600,1699552200,3600,82196,176272,NL,NL
9830,1699732080,1699755540,23460,145928,94059,DE,DE
131811,1700836200,1700839800,3600,197369,46008,NL,NL
139442,1699838280,1699870860,32580,199110,65732,TR,TR
9092,1699402920,1699414980,12060,182285,66489,ES,FR
27089,1699284780,1699302180,17400,181505,82143,US,US
81144,1699940400,1699950840,10440,140000,185198,IT,IT
194009,1699167000,1699175640,8640,188595,130711,HR,HR
82676,1699384440,1699417440,33000,134111,142192,TR,TR
195376,1699105260,1699134540,29280,31664,97129,TR,TR
193023,1700157780,1700192160,34380,14225,11007,TR,TR
160597,1698988740,1699024140,35400,19978,190178,TR,TR
181202,1699056360,1699070760,14400,46264,156370,US,US
40472,1699146240,1699157580,11340,24711,135700,HR,HR
114150,1700623620,1700653920,30300,60775,181739,TR,TR
44789,1699415940,1699447140,31200,157802,2080,TR,TR
114702,1699187040,1699191780,4740,162181,34167,GB,GB
158120,1700322180,1700325780,3600,142037,50526,GB,GB
199864,1700707320,1700739600,32280,132380,143994,TR,TR
45920,1700727360,1700743560,16200,116914,57824,AT,AT
155353,1699330260,1699356840,26580,88729,118744,RO,MD
23666,1700010120,1700045100,34980,153415,119499,TR,TR
87076,1699630500,1699634100,3600,69460,197202,GB,GB
155146,1699441020,1699474320,33300,108217,186340,TR,TR
53306,1700246700,1700251380,4680,18747,199722,NL,NL
10634,1700110020,1700145480,35460,191271,147713,TR,TR
36655,1699982700,1700014680,31980,88829,119143,TR,TR
57822,1699335780,1699343340,7560,147518,88553,HR,HR
129674,1700050020,1700060520,10500,81371,137159,EE,FI
72126,1700604780,1700611740,6960,34710,88608,NL,NL
123865,1700825760,1700843640,17880,123890,59542,FR,FR
2658,1700390640,1700403480,12840,184948,105191,US,US
51739,1698886800,1698890400,3600,132997,71450,GB,GB
170314,1698915240,1698949800,34560,106768,82327,TR,TR
116067,1700447040,1700482320,35280,113975,64095,TR,TR
183221,1700149620,1700158560,8940,190464,154654,HR,HR
12126,1699781220,1699816620,35400,25252,1591,TR,TR
148860,1699886100,1699914300,28200,100824,45580,DE,DE
173172,1700370360,1700403480,33120,147736,33475,TR,TR
52061,1700486580,1700498820,12240,104257,98567,CZ,CZ
40724,1699417500,1699454400,36900,156848,180782,MX,MX
158317,1698875880,1698911220,35340,64241,145202,MK,DE
173191,1700457720,1700488380,30660,84387,100926,TR,TR
13017,1698886740,1698922500,35760,92101,101461,TR,TR
6616,1700336340,1700349300,12960,61354,191453,IT,IT
198142,1699631220,1699666980,35760,144190,195960,MX,MX
52406,1700197920,1700232660,34740,1139,153637,TR,TR
152946,1700318400,1700322000,3600,181596,65941,GB,GB
168518,1699291440,1699323780,32340,2464,99102,TR,TR
192783,1699618980,1699654140,35160,25106,109336,TR,TR
110079,1699060080,1699082220,22140,115987,93452,DE,PL
92788,1699292880,1699303740,10860,50824,119365,US,US
89854,1700109840,1700127480,17640,197591,35755,US,US
92186,1700456460,1700467080,10620,88464,184544,SK,CZ
90787,1699786320,1699797600,11280,149169,73184,US,US
140476,1699995060,1700027160,32100,122144,19004,TR,TR
76176,1700728620,1700741580,12960,115359,15713,US,US
166834,1700664180,1700668320,4140,33488,24206,GB,GB
137589,1699843680,1699858380,14700,75362,108495,US,CA
18452,1700474460,1700507160,32700,51786,20089,TR,TR
90744,1699968540,1699981860,13320,70911,90924,PT,PT
62503,1699930020,1699963320,33300,42983,64707,TR,TR
22563,1699781580,1699785180,3600,87079,10381,GB,GB
4507,1700009040,1700025780,16740,134179,184647,US,US
58776,1699839900,1699849620,9720,43630,127081,IT,IT
125804,1700123040,1700149500,26460,24667,197592,DE,HR
33750,1699919820,1699923420,3600,2781,144048,NL,NL
21576,1699759740,1699793280,33540,28907,9752,TR,TR
98075,1699585200,1699614120,28920,24054,192348,TR,TR
65065,1699289280,1699305360,16080,177408,58076,US,US
1192,1700227500,1700256180,28680,86293,31967,PL,DE
18432,1699970220,1700003940,33720,141709,82555,TR,TR
26964,1700619660,1700634360,14700,18738,116779,US,US
119913,1700162760,1700191920,29160,172632,135049,TR,TR
91592,1699249740,1699253340,3600,32605,143264,GB,GB
76449,1700503620,1700539500,35880,61411,170581,MX,MX
183276,1699553580,1699586640,33060,82574,8015,TR,TR
10098,1698882660,1698886260,3600,6579,36148,GB,GB
160135,1700598120,1700601720,3600,133372,46803,NL,NL
98748,1700125740,1700139360,13620,101349,117740,US,US
126745,1700081220,1700107320,26100,45555,72794,BA,HR
178425,1698797100,1698828900,31800,120015,162966,TR,TR
31381,1700222700,1700237340,14640,82243,36688,US,US
123772,1699292580,1699301640,9060,51100,125229,IT,IT
167362,1699498860,1699503060,4200,91725,49464,NL,NL
96029,1699643820,1699679340,35520,105775,123831,TR,TR
167979,1700525640,1700529240,3600,115908,123070,GB,GB
173355,1699177740,1699181340,3600,94029,41789,GB,GB
4114,1700392680,1700404020,11340,53605,77832,IT,IT
176495,1699958460,1699969980,11520,91619,123526,US,US
197829,1699011480,1699027140,15660,102400,90866,US,US
176563,1700038140,1700073060,34920,64529,35853,TR,TR
136322,1700736060,1700761080,25020,14791,140541,DE,DE
136704,1699640040,1699656240,16200,85488,23619,RS,ME
148431,1698966120,1698970920,4800,129056,135132,EE,FI
80050,1700166480,1700172780,6300,166714,116384,GB,GB
47206,1699191240,1699216440,25200,187753,113974,DE,DE
84898,1699924380,1699957080,32700,95671,89134,TR,TR
150065,1699486680,1699539720,53040,75367,140483,BG,DE
141249,1700529120,1700542200,13080,18435,187556,US,US
129990,1700214300,1700229900,15600,89786,79249,US,US
134172,1700622060,1700648880,26820,77211,92529,DE,PL
157325,1699519380,1699554840,35460,11414,76525,TR,TR
47000,1700844960,1700874480,29520,34364,1174,TR,TR
82488,1699083600,1699094760,11160,47286,160933,CZ,CZ
136575,1698906600,1698946140,39540,194791,63976,MX,MX
140984,1699419180,1699452660,33480,145240,150323,TR,TR
12350,1699888380,1699921320,32940,199937,115284,TR,TR
92840,1700824680,1700859600,34920,20950,28291,TR,TR
115966,1700038200,1700072160,33960,42150,44530,TR,TR
156933,1700028360,1700060700,32340,94917,117745,TR,TR
63757,1700864280,1700878800,14520,138336,27392,US,US
152249,1698915780,1698930780,15000,3145,51961,AT,AT
194461,1698812400,1698824220,11820,187016,138170,US,US
28149,1700766840,1700780280,13440,179228,42434,US,US
190459,1700537760,1700572920,35160,144649,63250,TR,TR
99620,1699572360,1699587780,15420,186788,120805,US,US
68475,1699698660,1699729260,30600,125462,91849,TR,TR
145557,1699379520,1699393980,14460,56724,93981,US,US
78906,1700060520,1700066700,6180,106850,77565,EE,EE
76886,1700536680,1700553480,16800,63808,12334,FR,CH
48408,1700313000,1700318100,5100,14777,121291,EE,EE
155653,1698882900,1698893880,10980,107426,172780,US,US
50272,1699835820,1699861740,25920,44076,50144,BA,HR
90430,1699521720,1699530360,8640,94548,119474,IT,IT
129530,1699747260,1699761600,14340,81740,135711,IT,IT
62420,1699793820,1699797420,3600,146442,174089,NL,NL
163955,1699689540,1699720080,30540,174228,22970,TR,TR
101723,1699228260,1699262280,34020,126977,93043,TR,TR
68078,1699529700,1699565460,35760,11286,191889,TR,TR
117111,1700170920,1700182620,11700,53383,132330,US,US
143767,1699502160,1699519860,17700,193944,151131,US,US
184830,1700013780,1700025240,11460,21783,166747,US,US
87216,1700162400,1700175600,13200,36231,159929,US,US
59750,1700156400,1700170740,14340,7952,58124,IT,IT
136229,1699972560,1699978980,6420,157164,335,NL,NL
127496,1699665180,1699668780,3600,179811,130243,NL,NL
154237,1699188780,1699212900,24120,152073,72415,DE,RS
38671,1700806380,1700817600,11220,14705,199626,ES,ES
164992,1700244360,1700267940,23580,47313,129383,DE,DE
52951,1700188080,1700209140,21060,182754,183084,BE,FR
61191,1699011480,1699046400,34920,192063,94099,TR,TR
101411,1698955620,1698972660,17040,180258,71834,BE,GB
4750,1700745720,1700760900,15180,9932,69146,US,US
31309,1698920460,1698928200,7740,33580,69069,IT,IT
116775,1699318080,1699321680,3600,39548,181751,NL,NL
155016,1700170500,1700174100,3600,164750,49172,NL,NL
54171,1698824820,1698860460,35640,28254,68752,TR,TR
114680,1700416920,1700430420,13500,39723,22025,AT,AT
154666,1700122200,1700153160,30960,85629,197468,TR,TR
30618,1699605300,1699644360,39060,155572,161658,MX,MX
192649,1699272900,1699303020,30120,128994,126045,TR,TR
100333,1699644900,1699648500,3600,27739,156594,GB,GB
104296,1699689660,1699702740,13080,45749,185220,HR,BA
122644,1698981300,1698993000,11700,16722,137464,IT,IT
70725,1699183980,1699215840,31860,125809,40495,TR,TR
143380,1700155860,1700184660,28800,188145,132450,TR,TR
188248,1700744580,1700765640,21060,120757,40193,FR,FR
129679,1700062620,1700067420,4800,63374,198029,NL,NL
29202,1699278600,1699307520,28920,80202,186869,TR,TR
163634,1700723940,1700753580,29640,34490,156000,TR,TR
25026,1700198220,1700230200,31980,84665,122004,TR,TR
53463,1700634360,1700646660,12300,33733,79959,HR,HR
165308,1700458920,1700496120,37200,164661,83644,MX,MX
98202,1699874580,1699904880,30300,11798,160802,TR,TR
168540,1699298100,1699331160,33060,125833,107866,TR,TR
45097,1700394780,1700412720,17940,166470,159263,RS,RS
68738,1700618220,1700621820,3600,152194,191599,GB,GB
90575,1700427300,1700459340,32040,112047,52285,TR,TR
8223,1699070280,1699077660,7380,108101,168627,IT,IT
96192,1699377360,1699411740,34380,30511,88102,TR,TR
45401,1700711040,1700747460,36420,14655,194061,MX,MX
112694,1699651080,1699672980,21900,61011,82433,DE,DE
186513,1699847340,1699850940,3600,52115,161786,NL,NL
105065,1700546640,1700580960,34320,170450,170560,TR,TR
109276,1700757540,1700761140,3600,111960,106657,GB,GB
51273,1699407000,1699412160,5160,38429,114190,NL,NL
118987,1700407260,1700410860,3600,196345,198883,GB,GB
117782,1700392680,1700404260,11580,155989,173001,US,US
182567,1698968820,1698982260,13440,95492,7411,US,US
147563,1700024280,1700037360,13080,91370,125903,ES,AD
119442,1700187660,1700214900,27240,171856,55629,DE,DE
115391,1699388820,1699402620,13800,131415,78178,AT,AT
93025,1699442520,1699477800,35280,15589,32189,TR,TR
43750,1699756860,1699760460,3600,10747,112056,NL,NL
32333,1699077360,1699089900,12540,164724,66702,RS,RS
76862,1698978960,1698985020,6060,134250,39942,GB,GB
90035,1699244340,1699277880,33540,80748,89346,TR,TR
55909,1699368120,1699393260,25140,155886,82664,BR,BR
74652,1700478360,1700513100,34740,63106,160363,MX,MX
36757,1699426320,1699461720,35400,134092,198958,TR,TR
86102,1700204340,1700219700,15360,54134,173782,AT,SK
169778,1700548920,1700560320,11400,43144,45958,AT,AT
64943,1698985020,1698999660,14640,45497,110269,RS,ME
30870,1700617560,1700644260,26700,169789,147849,PL,HU
162650,1700840100,1700863620,23520,112264,13320,CH,DE
71327,1700158980,1700172480,13500,155830,137739,ES,ES
8058,1700866560,1700872860,6300,103232,49321,GB,GB
181851,1699552080,1699555680,3600,181662,36556,GB,GB
63266,1699634760,1699649400,14640,56632,81463,CZ,CZ
127316,1698836580,1698865920,29340,145896,8830,TR,TR
171276,1700014200,1700043660,29460,31646,90336,TR,TR
40043,1700087700,1700121060,33360,99820,145744,TR,TR
29211,1698926940,1698935340,8400,8827,154803,IT,IT
40714,1700647140,1700651460,4320,104937,89495,GB,GB
96423,1699690500,1699695120,4620,132647,44716,GB,GB
135365,1700671500,1700704620,33120,38680,123951,TR,TR
114970,1700146080,1700170680,24600,113353,166073,PL,PL
105628,1700466900,1700474040,7140,184044,122833,GB,GB
186882,1698961020,1698993360,32340,184711,183689,TR,TR
84693,1700836920,1700849220,12300,148673,76742,CZ,CZ
185241,1699473180,1699476780,3600,184864,114765,NL,NL
26022,1698873900,1698886680,12780,29575,138840,ES,AD
80898,1699402980,1699406580,3600,40705,81533,NL,NL
100855,1700185140,1700219700,34560,55370,170321,MX,MX
114470,1700385360,1700390340,4980,159593,3799,NL,NL
105991,1699871220,1699901880,30660,101261,79113,TR,TR
68483,1698925020,1698929340,4320,71228,161464,NL,NL
20246,1700210400,1700243340,32940,88328,7077,TR,TR
73959,1698982440,1698998460,16020,22267,96074,US,US
37393,1699720920,1699752120,31200,154921,191418,TR,TR
139094,1698945360,1698968880,23520,160104,19925,DE,NL
170403,1700860680,1700896320,35640,138398,171307,TR,TR
118631,1699190880,1699226220,35340,199849,12016,TR,TR
148212,1699573680,1699601460,27780,149933,153647,DE,PL
45468,1699056720,1699085940,29220,65042,4013,TR,TR
61008,1699872240,1699904340,32100,66657,136411,TR,TR
83661,1698803640,1698835620,31980,194941,12950,TR,TR
160537,1699498440,1699532160,33720,85395,158893,MX,MX
22146,1700366100,1700391720,25620,95375,151294,DE,DE
187784,1698937380,1698974460,37080,39955,108719,MX,MX
62881,1700294460,1700307120,12660,135136,181562,IT,IT
93369,1700686680,1700718180,31500,11833,93867,TR,TR
97649,1699904640,1699915740,11100,21367,65617,US,MX
34491,1700586900,1700598240,11340,129656,72824,IT,IT
971,1700133420,1700137020,3600,115466,106653,GB,GB
178030,1699756860,1699788840,31980,70182,37042,TR,TR
173089,1699949640,1699966980,17340,45561,178362,US,US
39452,1700798760,1700832540,33780,21568,54158,TR,TR
41817,1699443480,1699477560,34080,14344,110030,TR,TR
119418,1699476000,1699506660,30660,115185,37655,TR,TR
21515,1699878780,1699911360,32580,141246,92692,TR,TR
139695,1700616840,1700646060,29220,12314,142047,TR,TR
84147,1700527560,1700547900,20340,175249,113918,BE,NL
138209,1699073280,1699104240,30960,81314,163386,TR,TR
79141,1700290860,1700325120,34260,172009,48482,TR,TR
34395,1699012320,1699017960,5640,45770,122548,GB,GB
140996,1700738460,1700742240,3780,146880,186714,NL,DE
35899,1698969480,1698976140,6660,99515,189971,GB,GB
144559,1700624580,1700655060,30480,113176,53538,TR,TR
130134,1699098720,1699131720,33000,77163,5157,TR,TR
65184,1700209020,1700213820,4800,184567,115969,GB,GB
76570,1699923480,1699936800,13320,139030,174557,IT,IT
61291,1700223480,1700256540,33060,160971,187660,TR,TR
13602,1699251720,1699284600,32880,917,160620,TR,TR
43919,1699280940,1699284540,3600,80695,120554,NL,NL
34059,1699909620,1699921920,12300,25421,30948,US,MX
189668,1699516620,1699520220,3600,54289,160434,GB,GB
50548,1699742700,1699751760,9060,97407,181614,IT,IT
133668,1699140720,1699152360,11640,196537,59698,US,US
185408,1700572740,1700588640,15900,74010,27154,US,US
69600,1699833060,1699866540,33480,151664,54050,TR,TR
106191,1699056540,1699090860,34320,65202,111333,TR,TR
165489,1700196060,1700215680,19620,76572,35983,BE,NL
150222,1699301520,1699318020,16500,69847,76486,FR,FR
4183,1699227300,1699282800,55500,20658,143484,BG,DE
102249,1698829260,1698860760,31500,50627,156902,TR,TR
155371,1700529000,1700540040,11040,130882,88119,US,US
28666,1699345020,1699359540,14520,65413,35240,CA,CA
128769,1700090880,1700117820,26940,179812,81941,BR,BR
46463,1700252040,1700264880,12840,7152,46576,ES,ES
71063,1699186680,1699190280,3600,53789,103591,NL,NL
96126,1699136160,1699156320,20160,171829,188474,SE,DE
149463,1700574180,1700590920,16740,122849,48882,US,US
161381,1700369580,1700399040,29460,61453,170854,TR,TR
47562,1699749840,1699782540,32700,135777,115193,TR,TR
165081,1700105220,1700137020,31800,143559,167161,TR,TR
26626,1700048580,1700062920,14340,23330,134851,IT,IT
82249,1700865060,1700873160,8100,182478,67901,IT,IT
124550,1700849160,1700866140,16980,104904,161642,AT,BG
81268,1700656440,1700688840,32400,72080,129368,TR,TR
113612,1699275240,1699283460,8220,49580,111694,IT,IT
15393,1700608500,1700612100,3600,84980,194269,NL,NL
25144,1700409840,1700419680,9840,134989,162187,IT,IT
113951,1700381580,1700396700,15120,115401,62670,US,US
163931,1699331760,1699346760,15000,10568,32085,US,US
3645,1700715480,1700731680,16200,27867,35136,US,US
649,1700538540,1700549460,10920,111790,97657,IT,IT
198689,1699300140,1699318080,17940,20928,160937,US,US
184015,1700702340,1700713080,10740,561,17358,IT,IT
83101,1700698680,1700714400,15720,81656,80673,FR,FR
198695,1699380420,1699409280,28860,156979,98450,TR,TR
106055,1699094100,1699126080,31980,155907,84764,TR,TR
193060,1699418700,1699448280,29580,29913,109062,TR,TR
89784,1700743620,1700772780,29160,30791,9159,TR,TR
191731,1699045620,1699080360,34740,169329,19167,TR,TR
21135,1700336340,1700369640,33300,106357,2265,TR,TR
57825,1700360580,1700392740,32160,108910,91959,TR,TR
127883,1700819760,1700825700,5940,186044,149139,NL,NL
68000,1700075580,1700105760,30180,16800,24854,TR,TR
31912,1699879860,1699895100,15240,189943,183492,US,US
154699,1699770840,1699782480,11640,96485,123372,US,US
138114,1699057440,1699061040,3600,127428,190584,GB,GB
7603,1700134200,1700148000,13800,47450,88423,US,US
172816,1698931380,1698954600,23220,165251,45446,PL,UA
39606,1700280000,1700288220,8220,193201,64927,IT,IT
152375,1698837420,1698844020,6600,180558,110947,NL,NL
160280,1699975680,1700006280,30600,40392,160757,TR,TR
48337,1699480680,1699513500,32820,144614,49229,TR,TR
44141,1699310340,1699346280,35940,175629,16205,TR,TR
76069,1700456880,1700469900,13020,75029,15950,RS,RS
116110,1699638000,1699652100,14100,148223,21719,IT,IT
65528,1699386060,1699415880,29820,48788,51751,TR,TR
26663,1700571420,1700606940,35520,85705,41598,TR,TR
138412,1700146800,1700175660,28860,16516,179987,TR,TR
76161,1700094840,1700100180,5340,195382,99449,GB,GB
10036,1699444740,1699476840,32100,36436,189785,TR,TR
74750,1700230320,1700259300,28980,142172,4119,TR,TR
196388,1699140300,1699156800,16500,173323,114970,SE,SE
193061,1699017720,1699025940,8220,33064,45532,SK,SK
11475,1700024520,1700028840,4320,115660,79945,GB,GB
74408,1699992720,1699997400,4680,183442,135613,GB,GB
118243,1700444880,1700451060,6180,164920,160908,NL,NL
48810,1700017500,1700035140,17640,141828,38248,US,CA
26110,1699363560,1699393380,29820,133882,23011,TR,TR
136941,1699419120,1699435200,16080,149604,161675,FR,FR
163617,1699631220,1699634820,3600,98140,152078,GB,GB
54014,1699431360,1699438320,6960,943,151981,GB,GB
107671,1699027320,1699060620,33300,27801,81746,TR,TR
190819,1700580960,1700588820,7860,199530,33676,HR,HR
176923,1699437120,1699470720,33600,101611,67546,TR,TR
101206,1700573160,1700576760,3600,67378,104305,GB,GB
1407,1700580900,1700595600,14700,9379,66408,US,US
164068,1699108620,1699141980,33360,125029,193118,TR,TR
80259,1700270760,1700304240,33480,65870,15061,TR,TR
140305,1698794880,1698808860,13980,119566,152655,ES,ES
145143,1699659960,1699665780,5820,81946,46668,GB,GB
33203,1700688360,1700722740,34380,197540,46377,TR,TR
181205,1700249340,1700259060,9720,159677,34301,IT,IT
188365,1699045920,1699080360,34440,191115,123073,TR,TR
197752,1700057160,1700084100,26940,140209,196241,BA,AT
94544,1700554800,1700589480,34680,66403,10094,TR,TR
27918,1700083200,1700090340,7140,116176,99065,GB,GB
55461,1699404060,1699408920,4860,146966,72570,NL,NL
47681,1699797900,1699832580,34680,160941,95979,TR,TR
126853,1700492040,1700515740,23700,90484,52625,DE,DE
143716,1699068180,1699102380,34200,18169,112614,TR,TR
158162,1698935220,1698965820,30600,52663,65335,TR,TR
44636,1699697820,1699712580,14760,32262,154232,FR,FR
120779,1699540440,1699568940,28500,180289,33638,BR,BR
155725,1698818880,1698855900,37020,2997,190361,MX,MX
147903,1700542260,1700546820,4560,154013,26456,GB,GB
132238,1699617240,1699648200,30960,186602,92176,TR,TR
83409,1700614800,1700642460,27660,12933,171226,DE,FR
129599,1699361520,1699365120,3600,19375,73750,GB,GB
110398,1699684440,1699695360,10920,140162,115060,US,US
70590,1700377860,1700381460,3600,51969,36742,NL,NL
11750,1699407660,1699438320,30660,171155,173743,TR,TR
129020,1698898680,1698933300,34620,162969,83059,MX,US
128956,1699621680,1699634100,12420,109264,164327,IT,IT
105842,1699204560,1699217940,13380,23244,78573,IT,IT
335,1699850760,1699882800,32040,112673,190170,TR,TR
191465,1700527560,1700549760,22200,79151,45904,PL,PL
75403,1699810620,1699850100,39480,26764,198678,MX,US
117204,1700259240,1700273340,14100,78450,90721,CZ,FR
37040,1700662560,1700691660,29100,180740,2494,TR,TR
84156,1698897660,1698926520,28860,160765,5877,TR,TR
131426,1699894200,1699923720,29520,42509,91674,TR,TR
75665,1699427340,1699434060,6720,43543,183544,GB,GB
185373,1698808800,1698835800,27000,45244,148103,PL,AT
641,1700353440,1700366160,12720,126352,43813,US,US
142968,1698941520,1698945780,4260,108929,121521,GB,GB
157146,1699657080,1699681380,24300,50594,38361,HU,AT
158989,1699050900,1699078020,27120,72187,16537,RO,RO
112779,1699818660,1699844940,26280,125957,61963,DE,DE
121904,1700823840,1700836200,12360,179321,47310,IT,IT
112382,1699990500,1699995480,4980,110352,51583,NL,NL
99546,1700271180,1700305860,34680,47045,158482,TR,TR
63049,1700110200,1700164020,53820,178263,77953,BG,BG
108676,1700102580,1700131620,29040,22728,27827,TR,TR
41068,1698833040,1698863100,30060,15400,195318,TR,TR
81276,1698967500,1698998640,31140,177818,172960,TR,TR
71887,1700014920,1700023920,9000,34042,7848,SK,SK
67996,1699042860,1699055220,12360,157241,113766,US,MX
189761,1700731680,1700764440,32760,149609,3414,MX,MX
177747,1698892980,1698919620,26640,25156,155942,BR,BR
99753,1699182480,1699201380,18900,20999,146369,SE,SE
178726,1699840380,1699879680,39300,7780,182376,MX,MX
187352,1699164480,1699168800,4320,179835,11767,NL,FR
95533,1700611200,1700644200,33000,27802,123890,MX,MX
98626,1699575240,1699578840,3600,36277,106319,GB,GB
150099,1700325960,1700338620,12660,110348,65809,IT,IT
4032,1700518080,1700522880,4800,197545,112722,GB,GB
6923,1699779660,1699815240,35580,190737,18199,TR,TR
48026,1699018680,1699049220,30540,9182,13721,TR,TR
41152,1699741080,1699747320,6240,106587,44572,NL,IT
182651,1699139100,1699156200,17100,157216,146721,US,US
152516,1699092600,1699096200,3600,22681,23092,GB,GB
47015,1700366100,1700399400,33300,124268,159593,TR,TR
82156,1700231400,1700235000,3600,21243,116232,GB,GB
31863,1698862320,1698866160,3840,7970,145671,NL,NL
18159,1699581660,1699586160,4500,110118,11710,GB,GB
175463,1700393340,1700397300,3960,25846,138877,GB,GB
91206,1699811160,1699814760,3600,67761,53096,NL,NL
199964,1700421000,1700424600,3600,129600,12529,GB,GB
136964,1700276160,1700314020,37860,191605,18728,MX,MX
56300,1699506300,1699542120,35820,197749,126217,TR,TR
7602,1700063580,1700097480,33900,136013,85836,TR,TR
36940,1700428860,1700458800,29940,30385,160571,TR,TR
137780,1699606500,1699622820,16320,40521,14555,US,US
120247,1700440320,1700476380,36060,26665,163409,MX,MX
69906,1700702160,1700731200,29040,145849,172705,TR,TR
127382,1699976640,1700011140,34500,54642,92988,TR,TR
173739,1699674600,1699696380,21780,61175,178424,BR,BR
50583,1699237320,1699274820,37500,80923,109213,MX,US
147185,1700789640,1700803380,13740,192871,34429,HR,HR
23392,1699811760,1699818780,7020,195837,198873,NL,NL
7161,1699773360,1699782120,8760,144103,192135,IT,IT
17100,1700282400,1700309940,27540,188163,183075,DE,IT
10120,1699234860,1699242540,7680,144823,101679,IT,IT
1869,1700644080,1700660280,16200,177612,37131,US,US
196331,1699740000,1699773540,33540,72340,128285,TR,TR
99873,1700859660,1700882640,22980,100235,88381,DE,CH
173218,1700381820,1700417400,35580,97281,184787,TR,TR
186856,1699186800,1699222320,35520,43129,145382,TR,TR
171675,1699372140,1699377240,5100,153390,27454,GB,GB
83242,1699104060,1699108080,4020,58509,175032,NL,NL
18557,1700538180,1700549640,11460,170681,91976,US,US
187160,1699387320,1699401060,13740,185502,38353,ES,FR
71740,1699608060,1699641780,33720,164044,121774,TR,TR
127210,1700405640,1700417340,11700,98997,78415,US,US
8845,1699103760,1699133040,29280,18810,185485,TR,TR
77145,1699532280,1699535880,3600,93512,192520,GB,GB
133752,1699998420,1700026620,28200,169915,159614,PL,CZ
13489,1700542260,1700572860,30600,180315,68430,TR,TR
60732,1699457760,1699468080,10320,34516,56899,IT,IT
173266,1699424880,1699443780,18900,67981,12219,BE,RO
173936,1699469220,1699498860,29640,175695,143883,TR,TR
73250,1700154420,1700185320,30900,64234,145674,TR,TR
17699,1699976040,1699979640,3600,18715,150270,NL,NL
161971,1700416980,1700449860,32880,163809,72200,TR,TR
131732,1698847440,1698882360,34920,33532,93173,TR,TR
698,1699350720,1699361100,10380,32956,23189,IT,IT
158073,1699630380,1699662540,32160,173438,47582,TR,TR
44538,1700634600,1700666160,31560,132165,67318,TR,TR
184226,1700315100,1700347440,32340,124645,126075,TR,TR
62809,1699142220,1699177680,35460,119916,106339,TR,TR
46351,1700745060,1700779320,34260,187769,27760,TR,TR
198097,1700435580,1700448360,12780,139815,165040,US,US
84379,1700428200,1700458920,30720,123333,171825,TR,TR
42943,1700835780,1700851020,15240,39470,44421,FR,IT
182783,1699958100,1699969560,11460,11397,148067,US,US
93814,1700832120,1700841840,9720,57707,136218,IT,IT
134989,1699468920,1699476660,7740,3782,108095,HR,HR
56086,1699710660,1699744020,33360,88043,180357,TR,TR
62786,1700031600,1700047440,15840,152772,187490,US,US
24078,1698937440,1698948660,11220,119354,94652,US,US
159792,1700697120,1700713320,16200,8089,121464,IN,IN
166146,1700228100,1700241180,13080,35332,74557,ES,ES
136708,1699545840,1699560240,14400,193953,61357,FR,FR
191166,1699116240,1699147260,31020,127774,143494,TR,TR
65439,1700706480,1700718360,11880,70409,72853,US,US
156274,1699926780,1699932540,5760,108272,52408,NL,NL
165842,1700510400,1700527260,16860,106835,112767,US,US
65659,1699820640,1699856340,35700,168392,106357,MX,MX
3207,1700752800,1700782200,29400,174264,139048,TR,TR
185594,1699994700,1700021880,27180,2155,30533,BR,BR
57248,1698871200,1698906540,35340,35493,196059,TR,TR
132166,1699316400,1699345860,29460,75846,95672,TR,TR
104493,1699643100,1699656420,13320,185826,159630,US,US
56018,1699270620,1699306980,36360,95417,165735,MX,MX
174510,1700290140,1700323920,33780,178439,23577,TR,TR
171485,1699908720,1699924740,16020,180675,72978,US,US
75405,1700060460,1700095920,35460,92302,53018,TR,TR
101496,1700372280,1700407680,35400,160928,111969,TR,TR
17181,1699667880,1699698420,30540,54294,39341,TR,TR
29719,1700461980,1700473080,11100,125490,118843,RS,SI
65651,1699866720,1699879500,12780,46951,129282,HR,HR
119368,1698978480,1699009140,30660,34083,99825,TR,TR
199960,1700305980,1700317500,11520,51420,90222,ES,ES
30353,1699533000,1699540320,7320,8847,109127,FI,EE
176214,1700298180,1700327940,29760,56659,116245,TR,TR
92911,1700037300,1700053080,15780,15517,115000,US,US
39774,1699536480,1699552080,15600,20266,89016,US,US
63961,1700489280,1700523360,34080,64703,30248,TR,TR
183176,1700223420,1700237700,14280,120690,78269,IT,IT
119613,1700475900,1700480940,5040,63696,153131,AD,FR
29777,1699501920,1699505520,3600,55843,34066,NL,NL
197951,1700391900,1700405520,13620,85226,49537,IT,FR
185385,1699688520,1699696980,8460,126790,49297,HR,HR
148974,1700410020,1700439420,29400,121591,3008,TR,TR
79914,1698904380,1698936120,31740,182968,30784,TR,TR
100089,1700284080,1700318820,34740,30840,188526,TR,TR
51062,1700335860,1700339460,3600,96040,195417,GB,GB
163422,1699608540,1699623120,14580,102214,55992,US,US
110620,1700594040,1700603640,9600,71443,540,PT,PT
154941,1700637480,1700643180,5700,171781,55573,GB,GB
110328,1700660460,1700695500,35040,75233,136073,TR,TR
42763,1700636040,1700648040,12000,148689,9677,HR,HR
176701,1699528020,1699538460,10440,41353,165756,IT,IT
150682,1700185440,1700205480,20040,184425,188162,FR,FR
74427,1700082180,1700118060,35880,125218,95103,TR,TR
154339,1700258460,1700265300,6840,134911,169064,GB,GB
25822,1699545600,1699578900,33300,82204,166180,TR,TR
7163,1699620420,1699638000,17580,123213,91670,US,US
86607,1699854420,1699866180,11760,65766,67648,AT,BA
120471,1699331340,1699353840,22500,111755,129691,DE,IT
97675,1699120260,1699126260,6000,142038,39335,GB,GB
149334,1698864840,1698880200,15360,31829,10640,US,US
140319,1700634540,1700668020,33480,7215,118079,TR,TR
110585,1700265360,1700280840,15480,106756,184455,RS,RS
45590,1700487300,1700521740,34440,62101,13424,TR,TR
85982,1699106220,1699120740,14520,126461,129710,US,US
199686,1699497840,1699507320,9480,60103,194987,IT,IT
53141,1700496480,1700511960,15480,142865,183762,US,US
147181,1699112220,1699147860,35640,76372,162334,TR,TR
196863,1700447340,1700462820,15480,163629,3373,US,US
174287,1699287840,1699305360,17520,20397,61700,US,US
170113,1699727460,1699761000,33540,11209,110264,TR,TR
23779,1699889700,1699900680,10980,153858,46038,US,US
72496,1699904640,1699933500,28860,133456,128804,TR,TR
170069,1700075700,1700092800,17100,103841,56594,BE,FR
134218,1700708880,1700717160,8280,45574,108498,HR,HR
85079,1700254920,1700289900,34980,110339,156192,MX,US
143737,1699167360,1699198980,31620,121720,187555,TR,TR
92684,1699807800,1699824480,16680,164616,101875,US,US
128743,1700078580,1700088480,9900,56850,26692,IT,IT
111510,1699676760,1699707300,30540,163698,196459,TR,TR
74178,1699304700,1699336800,32100,178195,64125,TR,TR
99740,1699338120,1699341720,3600,78906,95593,GB,GB
12530,1699228380,1699234260,5880,109855,55770,NL,NL
148684,1699000560,1699008360,7800,2429,149924,EE,FI
126223,1700752020,1700765700,13680,82015,60200,IT,IT
135957,1698838320,1698868860,30540,196139,182459,TR,TR
1383,1700401920,1700414040,12120,7063,178492,US,US
85825,1699474200,1699482840,8640,162158,25032,IT,IT
14795,1700464200,1700468040,3840,173148,167494,GB,GB
1456,1698922260,1698925860,3600,90368,174987,GB,GB
8862,1700729880,1700741640,11760,28208,110811,IT,IT
63812,1699609860,1699642980,33120,133644,49074,TR,TR
166316,1700372820,1700406000,33180,189988,195622,MX,MX
22361,1699467900,1699482240,14340,9621,37163,US,US
153464,1700460300,1700495460,35160,156064,27012,TR,TR
85228,1699457280,1699489440,32160,188824,19357,TR,TR
123018,1700226180,1700231700,5520,129015,114289,GB,GB
119921,1699684440,1699714980,30540,93631,170465,TR,TR
137193,1700808780,1700838540,29760,151181,172673,TR,TR
198025,1699209540,1699215540,6000,156561,28928,GB,GB
168353,1700082420,1700094720,12300,10052,199221,IT,IT
170651,1699890600,1699925040,34440,25216,3698,TR,TR
105980,1700811120,1700830860,19740,25079,30376,FR,AD
46422,1700442720,1700455260,12540,176989,76229,US,US
88890,1699130700,1699139640,8940,173971,87761,HR,BA
38361,1700015640,1700046000,30360,90833,165937,TR,TR
131140,1699424880,1699459680,34800,34541,85306,TR,TR
44533,1700232420,1700261820,29400,42305,157124,TR,TR
51575,1699373040,1699404600,31560,34572,125227,TR,TR
199020,1699874400,1699892160,17760,12033,34028,FR,PL
143469,1699313820,1699317420,3600,114001,51772,NL,IT
188039,1700690160,1700721720,31560,79841,88980,TR,TR
26669,1698987780,1699002060,14280,122325,84042,IT,PL
192110,1699600260,1699634640,34380,61844,158665,TR,TR
167066,1700656740,1700690700,33960,89803,130369,TR,TR
17043,1700036520,1700067240,30720,37928,47798,TR,TR
2333,1700792220,1700804820,12600,175781,109594,RS,RS
78564,1699796820,1699814040,17220,82157,21474,US,US
11494,1698976680,1698995580,18900,50021,179850,DK,DK
142396,1699626960,1699638780,11820,50015,137032,US,US
103960,1700865840,1700901360,35520,154540,3877,TR,TR
99627,1699784100,1699795200,11100,188601,140877,IT,DE
37439,1699001640,1699011900,10260,138761,5553,SK,AT
12493,1700695380,1700726040,30660,143177,45712,TR,TR
130250,1700756760,1700791680,34920,27619,79911,MX,MX
107185,1699754340,1699758780,4440,113125,131491,EE,EE
45290,1699307580,1699336680,29100,51467,111790,TR,TR
8420,1698991260,1699027020,35760,40234,14139,TR,TR
103825,1700082660,1700116560,33900,82798,82811,TR,TR
3352,1700259660,1700263920,4260,162978,50352,GB,GB
101473,1700136180,1700150100,13920,198510,11014,PT,PT
78897,1700074440,1700089260,14820,90197,148729,US,US
152950,1700425500,1700457300,31800,69824,191846,BA,AT
146897,1700774820,1700810160,35340,49063,64614,TR,TR
192579,1699515900,1699546020,30120,174580,164512,TR,TR
180290,1699950540,1699971840,21300,23551,64006,BE,FR
61906,1700612940,1700637660,24720,10666,58075,DK,DK
196648,1699080180,1699114440,34260,61238,134238,TR,TR
35927,1699581780,1699593000,11220,162064,57176,US,US
159284,1700259180,1700271480,12300,168467,9879,US,US
39879,1699877220,1699881360,4140,93166,157785,EE,LT
16495,1700034000,1700039760,5760,32714,35299,GB,GB
130869,1700246700,1700255760,9060,44602,182027,IT,IT
69050,1699889400,1699922520,33120,137681,8474,TR,TR
50840,1700050080,1700082300,32220,2110,108925,TR,TR
160038,1699580220,1699594260,14040,138701,110769,CZ,CZ
61277,1699841580,1699876800,35220,107624,117433,TR,TR
194284,1699063560,1699068000,4440,134157,39717,NL,NL
95335,1699253640,1699283520,29880,74343,23998,TR,TR
176621,1699348260,1699354020,5760,48627,191076,NL,NL
134084,1700654400,1700689860,35460,134717,37322,MX,MX
78749,1699890360,1699942860,52500,35040,18155,BG,DE
66650,1699444500,1699455780,11280,1045,9491,IT,IT
22057,1700540220,1700551500,11280,148873,35803,US,US
69237,1700774580,1700810520,35940,60702,118959,TR,TR
35228,1699606260,1699640940,34680,140220,26055,TR,TR
10130,1700053620,1700060520,6900,1812,192085,NL,NL
41278,1699314360,1699329600,15240,71385,189253,US,US
65171,1699417320,1699445940,28620,173998,187457,BR,BR
179963,1699306620,1699319940,13320,98034,115656,IT,IT
118276,1699510320,1699539840,29520,96498,170939,TR,TR
96351,1699698960,1699704420,5460,130142,189032,NL,NL
73762,1699882980,1699917660,34680,188143,37653,TR,TR
184404,1699147500,1699157820,10320,15202,72875,ES,ES
59370,1699545960,1699558740,12780,172954,182643,IT,CH
82332,1699473420,1699504200,30780,64933,100014,TR,TR
65381,1699154340,1699187520,33180,59184,168814,TR,TR
171697,1699654500,1699685160,30660,171287,69863,TR,TR
167898,1700701800,1700735460,33660,23077,197535,TR,TR
107344,1699365720,1699372020,6300,24197,176834,NL,NL
101722,1700642220,1700675880,33660,80807,99470,TR,TR
14600,1700385540,1700396640,11100,3041,142664,US,US
96146,1700522100,1700525700,3600,124601,137494,NL,NL
20271,1700297580,1700332080,34500,22721,186455,TR,TR
55376,1699543560,1699571160,27600,18528,147520,DE,BE
166756,1699494840,1699529520,34680,164330,19927,TR,TR
95951,1699059360,1699073160,13800,92946,101306,US,US
179857,1700799840,1700830560,30720,31791,172949,TR,TR
91720,1700207520,1700220540,13020,180433,165128,HR,HR
157723,1699931760,1699944360,12600,152889,181134,CZ,CZ
53633,1700285040,1700317500,32460,178027,149962,TR,TR
101718,1700462700,1700474160,11460,104091,42870,IT,IT
75703,1700040540,1700047860,7320,137809,180176,IT,IT
142067,1699952760,1699969260,16500,103832,12433,US,US
61027,1700865960,1700869560,3600,65947,68921,NL,NL
77565,1700220300,1700233860,13560,172829,126851,IT,IT
29877,1699619100,1699642080,22980,167574,10300,DE,FR
113722,1699035300,1699045500,10200,146630,24685,IT,DE
33597,1700054400,1700073840,19440,113175,37262,FR,FR
54647,1699946460,1699959600,13140,194735,185541,IT,IT
162622,1698845280,1698859620,14340,190935,174842,IT,IT
82094,1699843680,1699857540,13860,137772,109101,RS,RS
168363,1699899360,1699921800,22440,174557,12675,PL,UA
165817,1700453340,1700488740,35400,114191,122212,TR,TR
37049,1700070900,1700099400,28500,180487,162227,DE,DE
79959,1698903840,1698910320,6480,175755,129041,GB,GB
30862,1700780160,1700814900,34740,86382,67701,TR,TR
11030,1700042700,1700047920,5220,139284,191753,GB,GB
88368,1699455480,1699460400,4920,76505,60177,GB,GB
188401,1699624980,1699638600,13620,151419,40878,US,US
95394,1699478940,1699509840,30900,146589,6672,TR,TR
60247,1700223300,1700253360,30060,57,144384,TR,TR
77930,1700306160,1700341320,35160,160676,183220,TR,TR
46974,1698900240,1698931500,31260,193472,52472,TR,TR
20035,1699115820,1699140000,24180,81399,50311,DE,FR
89175,1699293420,1699300980,7560,38299,25679,ES,FR
3045,1700535900,1700549460,13560,137205,119857,CZ,PL
50810,1699962600,1699976400,13800,161491,60236,IT,FR
118181,1700227260,1700258760,31500,93322,122691,TR,TR
166445,1699545480,1699575900,30420,69439,11078,TR,TR
43784,1698940500,1698962760,22260,164930,56553,SI,RS
182226,1698946020,1698965160,19140,5360,87450,FR,FR
157257,1699645740,1699649340,3600,68336,177095,NL,FR
143665,1700780520,1700797260,16740,15155,107844,FR,GB
148679,1698941820,1698970860,29040,72197,6567,TR,TR
51484,1700220120,1700225160,5040,163599,139074,GB,GB
84938,1700664060,1700683020,18960,34841,109989,BE,FR
157743,1699920300,1699925760,5460,106350,92374,GB,GB
3094,1700527320,1700537400,10080,100704,94232,PT,PT
188355,1698860520,1698864120,3600,137917,83535,GB,GB
49300,1699492260,1699505820,13560,194160,34598,IT,IT
15807,1699587660,1699602000,14340,117462,187679,IT,IT
164016,1700752260,1700768160,15900,115740,37035,AT,AT
133222,1699652460,1699660920,8460,141808,78798,IT,IT
116982,1700436180,1700459580,23400,145048,28459,HU,DE
25180,1700574360,1700604840,30480,135272,67250,TR,TR
18953,1699994220,1700007240,13020,57349,90564,ES,FR
115032,1698880560,1698910200,29640,9748,182663,TR,TR
132115,1699159080,1699194420,35340,77458,24234,TR,TR
46362,1699474440,1699507920,33480,147832,125746,TR,TR
3232,1699056900,1699064400,7500,165776,69214,HR,HR
60182,1700047020,1700050620,3600,152759,24217,NL,NL
69035,1699923840,1699942140,18300,87357,146161,DK,SE
156246,1699912680,1699946280,33600,55637,4882,TR,TR
7669,1699201020,1699206060,5040,168367,125978,NL,NL
113700,1699059780,1699065300,5520,58275,1525,NL,NL
166961,1700111280,1700130180,18900,81830,120009,FR,FR
80009,1700213640,1700249400,35760,191217,119873,TR,TR
197506,1699365840,1699374420,8580,173590,116622,IT,IT
178410,1699188840,1699214100,25260,120971,52858,DE,FR
97668,1699230900,1699260780,29880,51743,4647,TR,TR
127700,1700706840,1700710440,3600,2620,49564,NL,NL
112263,1699981440,1700010540,29100,91792,28289,TR,TR
97172,1700449020,1700465520,16500,164520,131176,US,US
170613,1699236900,1699268820,31920,139982,79369,TR,TR
123439,1699636080,1699639680,3600,64150,119599,GB,GB
94877,1700009880,1700013480,3600,21041,125408,GB,GB
80051,1699802340,1699807260,4920,192794,36408,GB,GB
5130,1700219940,1700255760,35820,120177,125368,TR,TR
128132,1700269500,1700300760,31260,151494,41878,TR,TR
111931,1700248080,1700256120,8040,166249,198919,PT,PT
195044,1698847800,1698860340,12540,41356,139416,US,US
79307,1699938600,1699971900,33300,21421,4844,TR,TR
178776,1700435640,1700439240,3600,16783,41743,GB,GB
76763,1700199180,1700231040,31860,195941,85883,TR,TR
180025,1700714100,1700738760,24660,123717,15073,DE,IT
57112,1700039640,1700051940,12300,128132,197006,IT,IT
90417,1698807600,1698841680,34080,137024,96815,TR,TR
143839,1700740920,1700747160,6240,94047,43541,GB,GB
41785,1699407540,1699419600,12060,73662,13404,US,US
146310,1699418760,1699454160,35400,112956,17802,TR,TR
42429,1700668680,1700697900,29220,90550,47912,TR,TR
33233,1699689480,1699699620,10140,41504,60256,CL,CL
45885,1700637060,1700653560,16500,16839,180864,US,US
49267,1699258860,1699285020,26160,49865,127571,PL,AT
56164,1699519200,1699546500,27300,15171,161282,RO,RO
126958,1699697880,1699704300,6420,53587,109600,NL,DE
83308,1699073760,1699106880,33120,70672,170525,TR,TR
120165,1698877980,1698912000,34020,68784,18101,TR,TR
57142,1699150140,1699164240,14100,219,34945,US,US
17754,1699722300,1699749780,27480,169359,19066,PL,PL
40625,1700288280,1700299560,11280,59516,99275,US,US
41163,1699780500,1699794180,13680,25247,45810,IT,IT
152118,1699098960,1699113840,14880,106033,136305,US,US
51823,1700310540,1700326680,16140,180524,31332,US,US
175697,1700187840,1700196840,9000,43832,174894,PT,PT
114141,1699538340,1699544640,6300,155392,81262,EE,EE
83296,1698901560,1698910200,8640,136327,125237,HR,HR
141042,1700536500,1700570640,34140,165412,147039,TR,TR
131198,1699208940,1699212540,3600,57575,34545,NL,NL
17697,1700273580,1700278260,4680,197532,17813,NL,NL
181152,1699302960,1699310760,7800,99063,166243,IT,IT
91322,1699753080,1699774800,21720,182454,191784,RO,RO
72799,1699660200,1699663800,3600,137206,69810,NL,NL
63493,1700213100,1700224500,11400,37213,98995,IT,FR
160277,1700551020,1700561760,10740,130756,117953,PT,CH
170197,1700483820,1700519460,35640,65647,198559,TR,TR
192284,1700225700,1700235540,9840,122688,101097,PT,PT
94634,1700128620,1700156220,27600,100490,34768,RO,IT
12445,1700009160,1700019180,10020,156500,23979,PT,PT
68002,1699159860,1699195140,35280,9321,133908,TR,TR
62094,1699069380,1699104780,35400,150262,72078,TR,TR
107985,1699639680,1699652820,13140,28935,180140,IT,IT
127945,1700718780,1700749800,31020,24312,68980,TR,TR
118837,1700423940,1700452800,28860,1746,176590,TR,TR
95612,1700072160,1700083140,10980,112386,198319,RS,RS
163366,1699249440,1699281360,31920,144088,67360,TR,TR
90315,1700360340,1700395980,35640,87047,65254,TR,TR
28027,1698827880,1698835020,7140,157100,16460,GB,GB
29038,1698829140,1698832740,3600,74334,199923,GB,GB
2395,1700093880,1700128680,34800,4820,121091,TR,TR
40458,1700609400,1700625120,15720,129644,73929,RS,RS
99011,1699502460,1699537860,35400,17705,10254,TR,TR
116372,1699789200,1699823520,34320,76390,104359,TR,TR
27018,1700325540,1700337120,11580,191894,36456,US,US
179318,1700817120,1700826960,9840,195726,106894,HR,HR
102761,1700692860,1700725620,32760,55596,115185,TR,TR
137275,1699246260,1699249860,3600,105532,11714,GB,GB
44976,1700655900,1700690700,34800,197246,166968,TR,TR
65990,1699448880,1699472880,24000,80112,85691,DE,DE
87441,1700365980,1700390220,24240,92311,126304,CH,FR
58004,1700771760,1700780400,8640,155950,83539,IT,IT
79719,1699215180,1699233720,18540,191829,124835,BE,FR
9079,1699948620,1699959000,10380,148139,167830,IT,IT
117055,1699122120,1699157100,34980,111052,152226,TR,TR
78503,1700392980,1700428080,35100,66754,153161,TR,TR
192425,1698925380,1698935880,10500,177910,124221,IT,IT
120383,1699329000,1699346280,17280,10865,125788,US,US
187969,1699638720,1699651020,12300,157356,88390,US,US
156280,1699441020,1699470780,29760,97205,79303,TR,TR
176583,1700517900,1700521500,3600,162774,10016,NL,NL
2531,1699874820,1699905600,30780,26982,142403,TR,TR
64980,1699786260,1699798260,12000,72997,12721,SK,SK
76163,1699680720,1699714380,33660,39676,130406,TR,TR
93457,1699821420,1699852680,31260,195415,66417,TR,TR
5520,1699925460,1699939620,14160,186734,192092,US,US
82346,1700013120,1700019480,6360,174098,29244,NL,NL
46093,1700260860,1700264760,3900,65644,127544,NL,NL
118365,1699756800,1699790580,33780,151935,143187,TR,TR
158245,1699493520,1699513620,20100,189293,131386,FR,FR
82165,1700834340,1700871540,37200,137188,37855,MX,MX
122042,1700479860,1700515680,35820,124978,133446,TR,TR
67876,1699522440,1699551720,29280,126214,106733,TR,TR
195850,1700303520,1700331240,27720,56764,137843,BR,BR
9186,1700642040,1700645640,3600,181804,115289,GB,GB
73809,1700253360,1700256960,3600,76378,180071,GB,GB
140454,1700546400,1700578440,32040,39952,150953,TR,TR
153666,1700626740,1700657400,30660,185257,119395,TR,TR
96970,1700360880,1700375400,14520,93429,115942,AT,AT
64488,1700381820,1700435100,53280,6210,180339,BG,AT
113880,1699454580,1699458180,3600,9007,123996,NL,NL
132616,1698808140,1698821880,13740,67336,22129,US,US
189608,1699958940,1699992480,33540,174895,66589,TR,TR
6615,1699872840,1699901760,28920,149829,187407,TR,TR
11489,1699509300,1699540620,31320,19511,65191,TR,TR
129182,1700771820,1700776680,4860,192851,44609,NL,FR
87564,1700367000,1700396580,29580,186581,192378,TR,TR
64448,1698923820,1698938820,15000,182462,15615,US,US
172425,1699214040,1699236000,21960,192032,28707,RO,RO
184034,1698797100,1698810960,13860,127069,17151,US,US
58775,1700057460,1700092020,34560,157308,78680,TR,TR
35500,1699303140,1699311000,7860,118428,186020,AD,FR
196104,1698885180,1698901380,16200,130503,192664,US,US
113122,1700512860,1700520840,7980,132990,151655,IT,IT
138639,1700742240,1700768280,26040,193756,145996,BR,BR
19097,1700675100,1700727120,52020,88203,63210,BG,DE
130017,1698854160,1698861720,7560,69613,162206,PT,PT
109885,1700746200,1700775900,29700,33450,34950,TR,TR
130934,1700403360,1700417700,14340,77227,2859,PT,PT
35055,1700665080,1700698080,33000,138785,59562,TR,TR
14137,1700017320,1700030100,12780,15468,12,PT,PT
149695,1700632920,1700663340,30420,59903,182510,TR,TR
103489,1700636760,1700669280,32520,109257,90453,TR,TR
85166,1700704020,1700716380,12360,95947,41511,HR,HR
120146,1700338200,1700359800,21600,74408,17323,BR,BR
49829,1699681800,1699714680,32880,60924,179135,TR,TR
196123,1700335980,1700369400,33420,168063,19173,TR,TR
78745,1699282500,1699314300,31800,34023,156167,TR,TR
71246,1699644300,1699655040,10740,189712,157385,ES,ES
180376,1700818440,1700843160,24720,81790,116523,DE,PL
44659,1699646940,1699653420,6480,61753,195406,EE,EE
76471,1700115240,1700148000,32760,136799,154353,TR,TR
62116,1700538840,1700545680,6840,176890,191829,GB,GB
139968,1700127480,1700160900,33420,102788,165886,TR,TR
89062,1699342080,1699366380,24300,16197,115292,PL,PL
179309,1700051820,1700066520,14700,169241,179702,US,US
58854,1699558320,1699576200,17880,79092,58058,US,US
17832,1698883140,1698888300,5160,89145,194390,GB,GB
177670,1699747800,1699752960,5160,177797,197307,GB,GB
110663,1700064660,1700081400,16740,102453,127595,US,US
81292,1699245300,1699256460,11160,132669,12669,RS,DE
38893,1698846360,1698859380,13020,84929,199093,US,US
58056,1699120140,1699155540,35400,58030,169566,TR,TR
111616,1700654160,1700691120,36960,104956,46879,MX,MX
90746,1699591620,1699616340,24720,125057,41909,DE,DE
108764,1700848560,1700852160,3600,55130,41705,NL,NL
11841,1700800560,1700831760,31200,73073,77915,TR,TR
22285,1699950000,1699966320,16320,103223,122708,US,US
39185,1700284860,1700299980,15120,199564,17187,US,US
43314,1699981980,1700012640,30660,127588,80098,TR,TR
82877,1699956900,1699992000,35100,64182,121766,TR,TR
167013,1699813860,1699841280,27420,46793,61037,DE,NL
29974,1699546680,1699579680,33000,138727,31978,TR,TR
42702,1700565420,1700596860,31440,77575,146177,TR,TR
2362,1699607040,1699620300,13260,198559,114337,IT,MK
55949,1699144920,1699148520,3600,118937,166117,GB,GB
57015,1700403360,1700419500,16140,85966,198472,AT,AT
153713,1699167300,1699172400,5100,123628,63892,NL,BE
63481,1700062740,1700077500,14760,98089,117372,BE,NL
163145,1699584960,1699611720,26760,136742,122636,RO,RO
195015,1700379900,1700390880,10980,36095,56446,IT,NL
145685,1699542240,1699546560,4320,79904,194611,GB,GB
410,1698814440,1698844320,29880,192462,91267,TR,TR
174578,1698848640,1698877980,29340,182842,36592,TR,TR
28581,1700608800,1700612700,3900,99898,181521,GB,GB
44420,1699652640,1699686300,33660,37358,106986,TR,TR
20849,1699960860,1699974720,13860,27827,28261,HR,HR
194133,1699645440,1699654560,9120,117417,56560,ES,ES
125670,1700798220,1700809440,11220,110564,98765,HR,HR
139974,1700478540,1700493660,15120,60456,165971,US,US
84913,1698807900,1698819480,11580,41009,199866,CZ,CZ
131080,1699645260,1699662900,17640,178854,36258,US,US
138110,1699780140,1699815480,35340,60947,16462,TR,TR
87884,1700533920,1700538900,4980,177814,141595,NL,NL
122403,1700448360,1700464020,15660,25073,148493,FR,FR
91875,1698830340,1698844680,14340,78185,113676,IT,IT
67928,1699687260,1699695060,7800,179036,59235,ES,FR
9626,1699920840,1699950780,29940,196191,78767,TR,TR
111594,1700544300,1700574120,29820,62702,92156,TR,TR
88399,1699767660,1699779360,11700,10521,39640,US,US
34974,1699263240,1699294440,31200,43287,129526,TR,TR
7282,1699382100,1699412940,30840,15283,6493,TR,TR
21073,1699659120,1699674240,15120,60300,9785,US,US
92448,1700127060,1700138160,11100,153315,4555,US,US
117481,1700439240,1700455380,16140,17714,38731,FR,FR
112733,1698920520,1698928200,7680,164297,42170,ES,AD
155041,1700580540,1700617620,37080,145866,106062,MX,MX
158376,1699606920,1699637220,30300,188058,12710,TR,TR
162303,1700063700,1700070900,7200,57723,9869,PT,PT
5296,1699189800,1699200900,11100,181442,42490,US,US
133768,1699822440,1699857060,34620,88190,5415,TR,TR
147785,1699710840,1699746420,35580,50009,190015,TR,TR
36372,1699109880,1699121940,12060,167620,123773,AT,HU
137546,1700020020,1700049900,29880,143967,168856,TR,TR
115029,1700607600,1700641500,33900,184626,89117,TR,TR
23439,1699979160,1700001300,22140,61742,114199,DE,PL
41722,1699259520,1699277040,17520,93078,148314,FR,DE
51176,1699015920,1699030260,14340,16495,39660,CZ,CZ
24202,1698963240,1698980820,17580,90306,91357,US,US
26370,1700044320,1700074980,30660,46389,32677,TR,TR
58737,1700790900,1700805660,14760,148498,12005,US,US
160815,1699476540,1699493280,16740,112409,20673,US,US
1268,1700865000,1700878560,13560,60002,149936,US,US
152484,1700322000,1700332380,10380,15736,3411,IT,IT
160398,1699999920,1700013600,13680,100287,5914,IT,SK
176050,1700406360,1700416680,10320,68476,135688,IT,IT
28414,1699861440,1699876800,15360,72359,82448,AT,SK
45014,1699842540,1699846140,3600,173217,141821,GB,FR
148619,1700458380,1700468820,10440,76929,739,HR,HR
191894,1700835840,1700869080,33240,33681,191441,MX,MX
55053,1698832560,1698846600,14040,454,12571,US,US
45864,1698879480,1698885660,6180,73051,91124,NL,NL
60867,1699276380,1699279980,3600,33002,161212,NL,DE
56377,1699307280,1699314660,7380,105813,110828,AD,FR
15455,1700315340,1700318940,3600,179152,160309,NL,NL
61870,1699503480,1699517340,13860,183041,168216,US,US
167725,1699348380,1699377900,29520,187578,55586,TR,TR
123038,1699658280,1699671420,13140,194548,66630,PT,PT
36214,1699724940,1699730520,5580,140968,78150,NL,NL
45810,1700497140,1700509680,12540,113520,94608,PT,PT
117508,1699597020,1699624020,27000,5192,116282,RO,RO
1219,1700557260,1700587020,29760,129511,133669,TR,TR
150635,1700682000,1700685600,3600,180494,152264,NL,NL
69664,1700066400,1700077080,10680,53832,174316,IT,IT
62613,1699029960,1699045200,15240,193372,17142,US,US
185327,1699888680,1699894560,5880,191312,153431,NL,NL
146454,1700494020,1700529420,35400,127429,98313,TR,TR
13647,1699738440,1699753920,15480,18409,127207,US,US
83568,1699740840,1699754580,13740,47245,176607,AT,AT
162974,1700621400,1700651700,30300,49449,30992,TR,TR
91178,1700274420,1700282940,8520,189728,145643,IT,IT
42543,1699331460,1699364160,32700,101987,73259,TR,TR
95917,1698945420,1698955320,9900,15076,7685,ES,PT
188014,1699018440,1699031520,13080,6985,186294,US,US
40342,1699513560,1699538700,25140,192470,138563,PL,CZ
15859,1700139480,1700172120,32640,162928,172915,TR,TR
139792,1700568000,1700598180,30180,115366,109525,TR,TR
68619,1700544960,1700568720,23760,60026,121459,DE,DE
192320,1699616640,1699623720,7080,169275,63005,GB,GB
112421,1700190420,1700219760,29340,148753,117160,TR,TR
121761,1698900600,1698923820,23220,48977,195301,BR,BR
27512,1698872580,1698883980,11400,17865,125486,US,US
90299,1699496940,1699531080,34140,53487,199003,TR,TR
168613,1699755060,1699784340,29280,143514,36346,TR,TR
94163,1699045440,1699049040,3600,112165,129870,GB,GB
111458,1700488200,1700523540,35340,5818,6966,TR,TR
98722,1699722420,1699728420,6000,145212,89599,GB,GB
141782,1700124300,1700138880,14580,191026,77616,US,US
123604,1699980480,1699992780,12300,54926,26690,AT,AT
84491,1700740920,1700744520,3600,48578,181603,NL,NL
31438,1699125660,1699154820,29160,3261,31554,TR,TR
129916,1699610460,1699629180,18720,137765,116646,FR,FR
79570,1700357400,1700361000,3600,170551,70368,GB,GB
170073,1699519380,1699554120,34740,25873,106675,TR,TR
160230,1700297100,1700310420,13320,91777,139826,US,US
106494,1699316160,1699333500,17340,98084,147718,US,US
176876,1700145060,1700149200,4140,148187,176126,NL,NL
170428,1698835620,1698839220,3600,119707,84955,GB,GB
94628,1700117460,1700152620,35160,36762,151996,TR,TR
196076,1700455920,1700465520,9600,108378,97671,HR,HR
173407,1699444620,1699475700,31080,66813,110330,TR,TR
149731,1698908100,1698942060,33960,198997,48297,TR,TR
94574,1700149500,1700163300,13800,5013,197690,US,US
133055,1699807440,1699842600,35160,132436,65063,TR,TR
86425,1700258820,1700271660,12840,49041,59686,HR,HR
457,1698990840,1699019220,28380,175124,153227,BR,BR
194484,1699333380,1699338660,5280,28978,89770,NL,NL
14287,1699676280,1699702500,26220,186964,130757,PL,PL
159498,1700160360,1700163960,3600,84733,131012,NL,NL
86039,1700591220,1700618460,27240,172948,92764,DE,DE
193332,1699714500,1699741560,27060,8596,76503,PL,PL
70810,1699154340,1699166100,11760,126631,72669,US,US
68454,1699447260,1699460220,12960,188968,90775,US,US
116040,1700162460,1700197140,34680,193604,28865,TR,TR
133611,1699947180,1699950780,3600,91019,92722,GB,GB
101790,1699883580,1699892940,9360,95826,183837,PT,PT
81339,1700146980,1700150580,3600,144545,92238,NL,NL
197297,1700774400,1700781300,6900,168267,85542,NL,NL
137800,1700258880,1700263500,4620,44406,55216,GB,GB
114690,1700727480,1700731080,3600,86936,136676,GB,GB
106346,1699190460,1699211700,21240,131808,49777,BE,NL
126880,1698926460,1698953040,26580,137672,150136,DE,PL
125238,1699323660,1699358100,34440,158390,57840,TR,TR
125250,1699815000,1699828980,13980,140094,95551,IT,IT
87265,1699147320,1699181640,34320,56046,198200,TR,TR
40436,1700192580,1700222040,29460,77177,71061,TR,TR
127120,1700582880,1700594940,12060,175035,13913,RS,RS
114384,1699587480,1699619100,31620,95776,57049,TR,TR
52049,1699719660,1699726860,7200,10284,43822,IT,IT
54831,1700368440,1700387340,18900,46048,1764,FR,BE
40575,1699978800,1699983000,4200,64067,155721,GB,GB
41527,1700558280,1700569080,10800,58507,174158,SK,SK
124049,1700075400,1700087100,11700,104760,131610,US,US
122383,1700696100,1700699700,3600,62550,84572,GB,GB
119324,1699291560,1699315380,23820,191488,110499,RO,RO
109949,1700519400,1700531760,12360,123052,11173,US,US
125029,1700129400,1700161200,31800,69272,60226,TR,TR
122756,1700619780,1700645400,25620,41051,106459,BR,BR
80678,1700050620,1700082840,32220,185678,3802,TR,TR
52910,1699221720,1699254900,33180,91962,106112,TR,TR
20249,1699410780,1699443240,32460,75316,164771,TR,TR
198583,1700382060,1700414880,32820,58771,99286,TR,TR
77769,1700645940,1700680740,34800,198506,37920,TR,TR
158200,1700734920,1700740320,5400,112706,17714,GB,GB
22863,1699192560,1699225860,33300,113448,97581,TR,TR
126267,1700795820,1700800860,5040,20908,148880,GB,GB
49855,1700317020,1700327940,10920,153132,111695,US,US
69591,1699235640,1699239540,3900,74754,182971,CL,CL
62652,1699151580,1699177920,26340,139557,50488,RO,RO
178805,1700730240,1700763360,33120,125897,96910,TR,TR
197189,1700176440,1700190000,13560,149810,104326,PT,PT
183209,1698907740,1698945660,37920,57328,108105,MX,MX
185972,1699094220,1699121280,27060,161221,146499,PL,DE
179931,1700567340,1700584440,17100,137169,65510,US,US
114096,1700544600,1700577540,32940,41649,30969,TR,TR
72752,1698860640,1698886500,25860,54590,175784,PL,DE
38469,1699747680,1699787160,39480,185947,86847,MX,MX
159939,1700391780,1700421540,29760,18846,156164,TR,TR
69957,1699674720,1699704240,29520,126684,25302,TR,TR
60076,1700158080,1700191260,33180,131990,176262,TR,TR
87666,1700691360,1700723160,31800,12430,181252,TR,TR
131310,1700035800,1700064840,29040,65416,48291,TR,TR
88926,1700020800,1700053320,32520,66131,169504,TR,TR
126735,1700252160,1700258880,6720,37495,145987,GB,GB
160702,1700843700,1700847300,3600,72044,26561,NL,NL
133262,1699386120,1699397220,11100,59148,109832,US,US
36520,1700278740,1700314560,35820,84265,80881,TR,TR
172349,1699728480,1699739220,10740,120882,107486,EE,LT
3740,1700068020,1700071620,3600,46174,193456,NL,NL
87508,1699634880,1699638480,3600,19873,112998,GB,GB
93564,1700070900,1700105820,34920,47014,191069,TR,TR
174379,1698911460,1698943260,31800,60667,190067,TR,TR
115522,1700297340,1700311680,14340,121744,45496,HR,HR
149699,1700598120,1700609100,10980,144005,174412,AT,AT
90381,1700128020,1700145420,17400,62165,196901,CZ,CZ
93341,1699671600,1699698480,26880,74765,67158,RO,RO
161162,1700781840,1700794020,12180,58495,76536,AT,HU
39035,1700285640,1700297400,11760,99383,87435,CZ,HR
62861,1700039220,1700073000,33780,37228,67818,MX,US
182799,1699402440,1699431300,28860,57039,102073,TR,TR
104381,1700289060,1700309280,20220,174964,8675,FR,FR
34772,1700086980,1700101560,14580,162129,20996,CZ,PL
131553,1700623620,1700654880,31260,67462,76112,TR,TR
180941,1700047080,1700077260,30180,161502,127790,TR,TR
52431,1699639740,1699647360,7620,48315,43066,IT,IT
11244,1700395800,1700426520,30720,175778,145089,TR,TR
68392,1699832820,1699861860,29040,3802,10273,TR,TR
131023,1699740420,1699757460,17040,194541,191931,US,US
113910,1699776900,1699780500,3600,6407,71180,GB,GB
163000,1700431020,1700442660,11640,147526,13874,US,US
32968,1699872780,1699905900,33120,72150,48791,TR,TR
120398,1700619600,1700637060,17460,332,139293,US,US
78334,1700022780,1700028300,5520,114786,126409,GB,GB
100357,1700142720,1700176680,33960,100902,20574,TR,TR
96703,1700308320,1700312280,3960,42518,46672,NL,NL
197419,1698953880,1698964860,10980,1655,50861,PT,PT
11788,1698937080,1698943980,6900,63331,95559,GB,GB
34569,1699091280,1699102380,11100,63570,176701,US,US
19083,1699705920,1699712940,7020,61926,170625,GB,GB
20466,1700035200,1700065860,30660,68749,147373,TR,TR
188076,1698856860,1698886140,29280,191263,79483,TR,TR
117064,1699147260,1699180020,32760,198489,28647,TR,TR
159534,1698798240,1698827580,29340,100451,26090,TR,TR
7216,1699033920,1699037520,3600,87356,194665,GB,GB
139120,1700696580,1700729040,32460,171792,174997,TR,TR
8454,1700064780,1700094240,29460,197614,113863,TR,TR
174196,1699572660,1699578300,5640,84423,158638,GB,GB
150962,1700066640,1700100300,33660,5288,81153,TR,TR
138370,1700102160,1700105760,3600,45353,15621,GB,GB
108255,1699228920,1699240920,12000,93885,63991,IT,IT
86003,1699081080,1699102080,21000,50944,118470,FR,FR
8676,1699668900,1699692840,23940,49157,43116,RO,RO
185068,1700774580,1700804820,30240,177767,74223,TR,TR
5413,1700494680,1700525280,30600,98283,94953,TR,TR
32278,1698886740,1698911640,24900,109011,68160,DE,DE
183740,1699448580,1699453920,5340,197479,143240,NL,NL
101999,1699784460,1699807920,23460,129324,195437,BR,BR
104253,1700514660,1700519640,4980,134523,196127,GB,GB
138321,1699335720,1699369200,33480,16090,134679,TR,TR
146120,1699499100,1699513980,14880,193967,7729,US,US
99757,1699925700,1699932120,6420,83527,139486,GB,GB
136020,1700858460,1700869080,10620,77884,82232,HR,HR
49250,1699955880,1699988160,32280,127103,85599,TR,TR
28076,1700657760,1700692500,34740,188275,18513,TR,TR
186106,1699636380,1699673640,37260,154392,183725,MX,MX
156041,1699826640,1699836780,10140,28075,127291,IT,FR
102312,1699344540,1699380240,35700,58071,167908,TR,TR
116477,1700287200,1700319840,32640,136526,74466,TR,TR
75227,1700592900,1700625720,32820,195914,117751,TR,TR
132272,1699897680,1699905780,8100,18022,107319,PT,PT
119477,1700292960,1700322660,29700,117089,196261,TR,TR
13696,1700299080,1700302680,3600,36852,121614,GB,GB
198597,1699194540,1699209780,15240,127913,53215,US,US
4541,1700133720,1700151120,17400,71170,81912,US,US
40571,1698910200,1698914700,4500,91088,2991,GB,GB
92867,1699711920,1699742220,30300,92116,3828,TR,TR
134128,1700671380,1700676120,4740,33614,157645,GB,GB
23922,1700766360,1700797260,30900,97862,132894,TR,TR
139241,1698920100,1698923700,3600,155723,50636,GB,GB
30621,1700796840,1700831100,34260,192514,56695,TR,TR
23022,1700417520,1700448480,30960,139752,53874,TR,TR
187631,1699287120,1699322160,35040,198103,50433,TR,TR
23328,1700120460,1700147340,26880,91689,92260,PL,PL
56927,1699330500,1699338000,7500,19888,174251,IT,IT
148424,1699641240,1699649940,8700,11729,18640,HR,HR
126200,1699524300,1699559760,35460,196832,117080,TR,TR
197343,1700297580,1700307540,9960,69401,198222,IT,IT
110657,1699860360,1699863960,3600,133204,148794,NL,NL
6690,1699490520,1699516680,26160,57296,52821,CH,DE
63864,1699291800,1699325880,34080,8756,65060,MX,MX
121763,1700246520,1700277240,30720,296,7861,TR,TR
50666,1700532060,1700542440,10380,154687,194401,IT,IT
17156,1700525220,1700534760,9540,154058,88949,IT,IT
186438,1700444940,1700477820,32880,194068,32817,TR,TR
192101,1699025640,1699054740,29100,176498,57505,TR,TR
117403,1699350720,1699363200,12480,35651,117195,US,US
107794,1699927560,1699936500,8940,126747,193073,IT,ES
82444,1699566720,1699599960,33240,127998,165549,TR,TR
112015,1700210700,1700219460,8760,53749,10626,ES,ES
35894,1700052840,1700069520,16680,176492,117000,US,US
95018,1699590480,1699599360,8880,82416,130131,HR,BA
148236,1700305560,1700338920,33360,146293,36830,TR,TR
111810,1698912300,1698944520,32220,56381,26234,TR,TR
139099,1699080720,1699095300,14580,92191,72644,US,US
191588,1700116380,1700148540,32160,23619,10468,TR,TR
157537,1699491720,1699526460,34740,68021,162259,TR,TR
16999,1700428620,1700432220,3600,45816,168361,NL,NL
142548,1700388600,1700392200,3600,115840,84228,NL,NL
172730,1700161380,1700195940,34560,24638,42576,TR,TR
55783,1700794560,1700807040,12480,165256,126624,US,US
134427,1699583640,1699619100,35460,27013,15380,TR,TR
17371,1700395440,1700429640,34200,232,55651,MX,MX
135548,1700167860,1700180160,12300,179713,110983,IT,FR
183017,1699647780,1699676880,29100,139687,2811,TR,TR
123827,1699621740,1699651560,29820,101500,69908,TR,TR
141693,1699339500,1699343580,4080,71024,109843,EE,EE
85571,1699066380,1699069980,3600,195683,31868,GB,GB
1205,1700733300,1700744700,11400,90567,191478,IT,IT
47675,1698866280,1698890280,24000,62347,2853,DE,AT
76214,1700669460,1700705220,35760,125876,150470,TR,TR
130168,1700095320,1700111220,15900,91639,90998,US,US
74222,1700439120,1700450880,11760,168767,87506,IT,IT
169416,1700709900,1700743320,33420,33854,95939,TR,TR
165796,1699069320,1699100580,31260,33314,99005,TR,TR
174868,1698881280,1698908280,27000,3362,85588,ME,BA
8935,1700050980,1700064480,13500,58650,199412,US,US
190480,1700769600,1700786760,17160,83460,90238,US,US
167350,1699014660,1699036380,21720,105043,121962,MD,RO
13784,1699834080,1699850520,16440,412,46088,US,US
173973,1699160220,1699193160,32940,11896,188135,TR,TR
177081,1699163460,1699171320,7860,88803,89645,ES,ES
152566,1700310000,1700344980,34980,94923,93923,TR,TR
167225,1700088960,1700100300,11340,197349,84971,IT,IT
8493,1700797140,1700808120,10980,11387,182897,IT,IT
54921,1699301160,1699304760,3600,32219,153952,GB,GB
178087,1700247780,1700270640,22860,7716,166158,CH,DE
12054,1699995780,1700024340,28560,182912,138220,BR,BR
50201,1699048680,1699062180,13500,81852,38323,IT,IT
52141,1699650240,1699679400,29160,140496,196896,TR,TR
42083,1699114020,1699123680,9660,111556,105526,IT,IT
15769,1700115000,1700125020,10020,59091,10097,PT,PT
105876,1699551240,1699554840,3600,69827,16745,GB,GB
13308,1700056860,1700073780,16920,146938,155051,US,US
94201,1699280460,1699292160,11700,157507,163470,IT,IT
158733,1698824040,1698832320,8280,27258,2077,IT,IT
77836,1699534620,1699570380,35760,197817,2059,TR,TR
72850,1699273560,1699278660,5100,7399,186166,GB,GB
30529,1700221620,1700250000,28380,176862,44058,BR,BR
193166,1700114220,1700130720,16500,48952,102501,US,US
42394,1699464900,1699478760,13860,26975,60288,RS,MK
68615,1699725900,1699738680,12780,112466,98155,PT,PT
24366,1699648440,1699684320,35880,82552,127249,TR,TR
93536,1699397340,1699430220,32880,198123,155205,TR,TR
32643,1700032860,1700066520,33660,159084,115252,TR,TR
36558,1700312820,1700341440,28620,189363,187143,RO,RO
136309,1699738980,1699769100,30120,109654,58352,TR,TR
165065,1700639220,1700656860,17640,93233,3178,CA,CA
130801,1699525680,1699542480,16800,102448,156650,BE,HR
154274,1699666800,1699702260,35460,88074,80409,TR,TR
76789,1700578260,1700593860,15600,42729,80298,RS,HR
39847,1698924420,1698933120,8700,112901,73387,IT,IT
92459,1699489020,1699504200,15180,118410,192739,FR,IT
177569,1699823520,1699858680,35160,142613,164183,TR,TR
58158,1698796080,1698830100,34020,18466,69806,TR,TR
101586,1699106940,1699137120,30180,119100,178488,TR,TR
3801,1699794720,1699823640,28920,18843,13925,TR,TR
138531,1698849780,1698857340,7560,115083,122983,HR,BA
61678,1699686300,1699690260,3960,30638,116606,NL,NL
10962,1699930500,1699963680,33180,157633,33699,TR,TR
188082,1699531860,1699543560,11700,73159,191934,US,US
192027,1699003620,1699016460,12840,119030,14123,IT,IT
186649,1699214460,1699222020,7560,159592,191322,IT,IT
186048,1699663620,1699680840,17220,119908,32907,US,US
95962,1700211960,1700243640,31680,25804,123088,TR,TR
37892,1700592900,1700603760,10860,19791,69497,HR,HR
127508,1699832820,1699848600,15780,88305,149365,FR,FR
188290,1699917540,1699952340,34800,164193,189900,MX,MX
141901,1700259360,1700262960,3600,88034,152323,GB,GB
190303,1700646360,1700677440,31080,25886,55744,TR,TR
106495,1699441500,1699459140,17640,106352,176949,SE,NO
130485,1699616820,1699645800,28980,189458,109104,TR,TR
79875,1700150400,1700175900,25500,130200,121064,DE,BG
98965,1699079040,1699100880,21840,199186,75342,CH,PT
172289,1700545740,1700550540,4800,115473,189334,GB,GB
84917,1699234500,1699248120,13620,169352,178815,US,US
103707,1700678940,1700690340,11400,41299,37465,AT,PL
193040,1700666940,1700705280,38340,43617,68270,MX,MX
166249,1700745060,1700776620,31560,50602,72855,TR,TR
36180,1700701500,1700734260,32760,98112,147660,TR,TR
64097,1700194620,1700202300,7680,119656,195235,ES,ES
181521,1700093100,1700103660,10560,91954,179060,HR,HR
192756,1700316480,1700348820,32340,98344,73134,TR,TR
11039,1699504680,1699537980,33300,185170,35412,TR,TR
7993,1698998280,1699032720,34440,64121,84465,TR,TR
111542,1700306520,1700320800,14280,119039,75087,US,US
84153,1699549080,1699552680,3600,146676,192238,GB,GB
1153,1700861400,1700878500,17100,87338,151746,FR,HR
142651,1699939860,1699951620,11760,12614,151598,PT,PT
90484,1699693320,1699713540,20220,87010,123707,FR,FR
45853,1699575720,1699579440,3720,197380,147705,NL,NL
172118,1700402220,1700434980,32760,91339,169203,TR,TR
12944,1700448960,1700487600,38640,36125,185668,MX,MX
166372,1700439000,1700453760,14760,176993,187577,US,US
187479,1699333020,1699336620,3600,128746,127319,GB,GB
125228,1700274360,1700292120,17760,182685,84486,US,US
98797,1700367120,1700399580,32460,191012,145932,MX,MX
35442,1699528980,1699558860,29880,45791,81451,TR,TR
46100,1699313580,1699349340,35760,171892,73401,TR,TR
109308,1700746800,1700783400,36600,182270,175740,MX,MX
190048,1698811680,1698840600,28920,44087,195270,TR,TR
183695,1700466960,1700499840,32880,44207,153255,TR,TR
40677,1699216380,1699220700,4320,135864,9256,GB,GB
131075,1700030880,1700061480,30600,156953,154171,TR,TR
19368,1698948120,1698952560,4440,118660,180213,GB,GB
162704,1700035200,1700043000,7800,72989,154111,IT,IT
155981,1700628360,1700665920,37560,2719,186584,MX,US
26157,1700288280,1700313720,25440,67692,27102,CH,DE
126737,1700587200,1700600820,13620,81398,190107,IT,IT
115231,1698992940,1699027380,34440,161458,55981,TR,TR
91971,1700019660,1700048760,29100,23076,87545,TR,TR
86740,1699920300,1699950840,30540,266,135003,TR,TR
78304,1700158440,1700162520,4080,10289,172655,NL,NL
194595,1700226960,1700234640,7680,130840,46476,IT,IT
120738,1699545660,1699580880,35220,28130,73480,TR,TR
45570,1699547760,1699558860,11100,127845,128951,ES,ES
43019,1700193900,1700202300,8400,77406,67199,EE,EE
149068,1699319220,1699335780,16560,62297,34453,US,US
116562,1699794240,1699823820,29580,75681,53917,TR,TR
192441,1698796260,1698821640,25380,147301,175838,DE,BG
73597,1700316060,1700330760,14700,25203,192194,US,US
93130,1700741220,1700744820,3600,38430,877,GB,GB
175859,1700672520,1700684760,12240,99576,183626,US,US
88222,1700322660,1700326260,3600,130381,134788,GB,GB
20177,1700098260,1700113140,14880,48633,181077,US,US
197156,1699457520,1699461120,3600,84869,122347,GB,GB
131870,1700076360,1700092080,15720,147309,62530,US,US
171844,1700267040,1700298480,31440,84989,198479,TR,TR
143247,1700388540,1700396040,7500,91183,152792,AD,ES
63295,1700176260,1700199120,22860,145838,188817,PL,DE
172047,1699227120,1699234740,7620,186594,73008,EE,EE
164164,1699225260,1699239180,13920,149570,26325,US,US
10670,1700349420,1700358720,9300,103820,113334,IT,IT
74970,1700423580,1700433240,9660,94493,50755,IT,IT
47854,1698875940,1698910680,34740,117546,104155,TR,TR
16400,1699332120,1699359240,27120,75826,58396,BR,BR
139736,1700684580,1700716860,32280,193608,56320,TR,TR
27719,1699674720,1699691700,16980,46820,23203,US,US
15212,1699517820,1699522140,4320,82233,39388,GB,GB
187129,1700714820,1700727660,12840,121213,178119,PT,PT
106203,1700839440,1700862900,23460,407,146641,PL,PL
17850,1700582820,1700599740,16920,147138,77532,RS,DE
49354,1700209380,1700214120,4740,66331,155083,GB,GB
167665,1700250960,1700279160,28200,142781,65777,DE,BG
129363,1700159700,1700184660,24960,153026,107803,BR,BR
150092,1698887280,1698916560,29280,98639,184002,TR,TR
106927,1700698800,1700703420,4620,22162,60057,GB,GB
35263,1700200140,1700232300,32160,28238,123761,TR,TR
183243,1699736160,1699743360,7200,144324,188497,IT,IT
90348,1698807900,1698837840,29940,52804,166712,TR,TR
136273,1699485240,1699498740,13500,82088,128716,US,US
101856,1699249260,1699252980,3720,60922,101845,GB,GB
113389,1699513320,1699523820,10500,63674,45422,EE,EE
70899,1700707380,1700723940,16560,132068,37559,CZ,CZ
39508,1700825700,1700859960,34260,160302,142579,TR,TR
81005,1700162460,1700194980,32520,93749,80277,MX,MX
80694,1700288400,1700320320,31920,179353,9896,TR,TR
25949,1700719080,1700751300,32220,55127,159379,TR,TR
163645,1699176660,1699208940,32280,110169,22504,TR,TR
140914,1700682120,1700712840,30720,89656,186275,TR,TR
188880,1700117580,1700134860,17280,135935,28985,US,US
80591,1699957320,1699963740,6420,179148,62334,GB,GB
105581,1700802660,1700824620,21960,192308,78147,DE,DE
28366,1699752060,1699755660,3600,125166,65842,NL,NL
48193,1699800480,1699815780,15300,145232,188654,FR,ES
88902,1699209060,1699223700,14640,44314,69177,US,US
117806,1699355340,1699360680,5340,41224,34296,GB,GB
12440,1700686380,1700721000,34620,190353,71114,TR,TR
171880,1700175000,1700185860,10860,148542,79565,US,US
107043,1699143300,1699159800,16500,95917,43644,US,US
125757,1700623260,1700636100,12840,63488,128299,PT,PT
63626,1700349000,1700354160,5160,88457,73233,EE,DE
5208,1699869720,1699874820,5100,27728,56769,GB,GB
156794,1699098780,1699105380,6600,113963,87244,GB,GB
100957,1700427660,1700434980,7320,73128,75908,HR,HR
151105,1700615160,1700628300,13140,76501,138198,RS,RS
133714,1699177320,1699196580,19260,18454,4329,BE,ES
159139,1700680500,1700716320,35820,96012,37418,TR,TR
85753,1698826500,1698857220,30720,90034,89090,TR,TR
67525,1700517180,1700550000,32820,98683,116472,TR,TR
195559,1700441580,1700475780,34200,40411,133559,TR,TR
111686,1699677960,1699681560,3600,67371,109451,GB,GB
67280,1699602180,1699631400,29220,48753,181519,TR,TR
127497,1699693920,1699725960,32040,101778,159886,TR,TR
163228,1699604760,1699618380,13620,191453,160246,IT,IT
32927,1699225320,1699244820,19500,80355,121121,FR,FR
175597,1699588920,1699605360,16440,160235,180190,US,US
188374,1699318200,1699352160,33960,81345,115008,TR,TR
107590,1700626440,1700645940,19500,47329,88157,IN,IN
143544,1700236020,1700251980,15960,150234,147293,RS,RS
173754,1699734240,1699744620,10380,76296,5159,PT,PT
3244,1698850500,1698884760,34260,92851,19701,TR,TR
135193,1699004340,1699013280,8940,159750,88835,FI,EE
163309,1699190760,1699223160,32400,14951,75799,MX,MX
141655,1700386260,1700389860,3600,83253,16833,GB,GB
86875,1699228920,1699234020,5100,84453,175477,NL,NL
55796,1700073360,1700106780,33420,66853,152543,TR,TR
75433,1699778520,1699807500,28980,158018,44357,TR,TR
117710,1700358240,1700380200,21960,177801,142897,DE,FR
16507,1700181000,1700187180,6180,7462,52979,GB,GB
53796,1700090100,1700120760,30660,4072,12092,TR,TR
190265,1699796460,1699830720,34260,116205,50209,TR,TR
58245,1700056260,1700089800,33540,83732,41016,TR,TR
78492,1700106120,1700135100,28980,75477,134981,TR,TR
102176,1699751580,1699764180,12600,39513,63584,US,US
93113,1699041540,1699076460,34920,112306,7639,TR,TR
19532,1699390500,1699422540,32040,18159,4409,TR,TR
131388,1699323480,1699337940,14460,64676,95553,US,US
151869,1700442660,1700455560,12900,63296,47747,ES,ES
186893,1699595880,1699611540,15660,116465,71584,US,US
151820,1699127100,1699161120,34020,120604,57460,TR,TR
40210,1700494320,1700504580,10260,173072,7921,ES,FR
177905,1700524800,1700532840,8040,117945,176513,ES,AD
140488,1699742220,1699771680,29460,38716,960,TR,TR
156452,1699228140,1699239600,11460,185700,16390,US,US
48296,1699329240,1699344420,15180,79743,55457,US,US
128822,1700063820,1700077200,13380,130242,31467,HR,HR
98330,1700736900,1700759700,22800,33226,171683,PL,UA
137159,1699311840,1699323960,12120,112958,8984,IT,IT
107739,1700478060,1700504340,26280,38694,181754,DE,IT
74035,1700038200,1700051700,13500,167481,151836,US,US
32081,1699870440,1699874040,3600,90009,100536,NL,NL
40124,1699518360,1699532160,13800,83686,90312,IT,IT
111860,1699319880,1699329240,9360,45677,108152,IT,IT
101541,1699449480,1699454880,5400,197440,13686,GB,GB
138116,1698917760,1698952980,35220,77376,90685,MX,MX
19700,1700718540,1700749560,31020,176296,4890,TR,TR
9944,1699364520,1699370040,5520,146568,103347,GB,GB
122983,1700779920,1700794140,14220,143380,59111,CA,CA
111110,1700097360,1700111100,13740,8606,146417,US,US
189575,1699071360,1699084260,12900,174355,95224,US,US
143714,1700317080,1700330340,13260,142645,117396,RS,SI
157614,1699317840,1699331640,13800,113524,175460,US,MX
70098,1698911520,1698929160,17640,157535,198622,US,US
165516,1699086180,1699116420,30240,71498,147915,TR,TR
193944,1700779080,1700814360,35280,56493,83818,TR,TR
130496,1700193660,1700211120,17460,128842,5585,US,US
184198,1699843740,1699876860,33120,186148,51161,TR,TR
143739,1699665300,1699696440,31140,99964,140465,TR,TR
53865,1699211400,1699224120,12720,134750,18424,SK,AT
47111,1700238360,1700243400,5040,142199,21080,NL,NL
54009,1698971760,1698975360,3600,60223,71277,GB,GB
3629,1699596300,1699603980,7680,93219,40793,IT,IT
102876,1699168860,1699200660,31800,64254,95737,TR,TR
124088,1700850540,1700862120,11580,165876,5766,US,US
133580,1700421600,1700425200,3600,194528,102686,GB,GB
99926,1700757660,1700790420,32760,129532,67974,TR,TR
147410,1700203320,1700214300,10980,97916,147492,IT,IT
117777,1698891420,1698907200,15780,84440,136091,US,US
67044,1700375700,1700389380,13680,3130,187780,IT,IT
185955,1700627400,1700656920,29520,172323,33708,TR,TR
83306,1700039160,1700044380,5220,15129,115218,GB,GB
4850,1699289460,1699301820,12360,78682,54196,AT,RS
118405,1700570880,1700584860,13980,149313,104497,IT,IT
112130,1700019540,1700051640,32100,111771,154443,TR,TR
47590,1700283960,1700317440,33480,158407,38491,TR,TR
16881,1700715480,1700747160,31680,18386,125337,TR,TR
174482,1699234140,1699246860,12720,81688,128256,PT,PT
130135,1699935060,1699951800,16740,24268,123723,RS,RS
27449,1699764360,1699767960,3600,148192,13957,GB,GB
101620,1699790940,1699823400,32460,80684,154666,TR,TR
112466,1699550340,1699554780,4440,108664,162253,GB,GB
75932,1699270800,1699281780,10980,162826,1518,IT,IT
24778,1698859560,1698889440,29880,188179,83340,TR,TR
164096,1699782540,1699798920,16380,68627,134601,AT,HU
91649,1699482720,1699508280,25560,185604,83800,RO,RO
175139,1700708400,1700718420,10020,84734,73731,ES,PT
80666,1699126860,1699130460,3600,50683,62032,GB,GB
49692,1700301000,1700336580,35580,13688,160345,TR,TR
9530,1698904980,1698938760,33780,82948,117064,TR,TR
42195,1699502640,1699524060,21420,51469,89940,AL,MK
197713,1699714440,1699746360,31920,36477,156525,TR,TR
33565,1699466700,1699478220,11520,108581,68061,AT,AT
55253,1699631700,1699667340,35640,154681,188170,TR,TR
116550,1699751580,1699761120,9540,65251,106747,PT,LU
112598,1700103660,1700121300,17640,76114,189945,SE,SE
172033,1699838640,1699870740,32100,187118,1555,TR,TR
101067,1698897780,1698930840,33060,37128,111110,MX,MX
189257,1698970440,1699004160,33720,183050,53985,TR,TR
50603,1699940100,1699943700,3600,109481,197925,NL,NL
155926,1700431800,1700464680,32880,173181,88029,TR,TR
33234,1699776360,1699791900,15540,189676,194738,US,US
133023,1700099340,1700137380,38040,68246,185042,MX,MX
45069,1700426460,1700449560,23100,113657,153377,DE,BG
75732,1700851440,1700864400,12960,66307,194559,US,US
136751,1700449560,1700455080,5520,72669,148971,GB,GB
138512,1700542800,1700546400,3600,15303,189367,NL,NL
102307,1699380240,1699394460,14220,131849,113330,PT,PT
198,1700731080,1700738100,7020,6737,177479,NL,NL
114652,1699711080,1699738500,27420,147277,129009,PL,PL
111920,1700390400,1700399880,9480,80565,71496,HR,HR
190277,1700007120,1700010720,3600,59014,145470,NL,NL
175006,1700534340,1700546160,11820,21628,94302,CZ,CZ
37539,1699073400,1699082940,9540,44874,6816,IT,CH
27112,1700404140,1700407980,3840,107221,133374,GB,GB
38441,1699538100,1699566060,27960,85191,48785,PL,DE
59717,1699700160,1699703760,3600,20851,197753,NL,NL
160587,1700286120,1700298180,12060,72761,73390,US,US
94729,1699552200,1699556100,3900,165152,36659,GB,GB
55784,1699377720,1699386540,8820,170130,80454,HR,HR
76914,1699742760,1699775940,33180,199945,77073,TR,TR
135892,1700716800,1700747340,30540,144968,8703,TR,TR
7569,1700718000,1700752620,34620,86870,147760,TR,TR
9194,1699913640,1699947840,34200,114037,127223,TR,TR
85953,1699394220,1699408440,14220,82255,33018,US,US
106075,1699975260,1700000100,24840,150982,56602,CH,DE
168302,1699712340,1699715940,3600,54321,93537,GB,FR
33195,1699155720,1699159620,3900,198259,94606,GB,GB
162142,1699364460,1699394640,30180,82572,126725,TR,TR
169783,1699980900,1700010120,29220,155983,77007,TR,TR
31713,1700832240,1700845020,12780,152916,117860,RS,RS
100873,1699939860,1699956780,16920,123753,137880,RS,RS
43888,1700590680,1700604900,14220,77428,55822,ES,AD
90370,1698870720,1698901740,31020,183812,44554,TR,TR
62875,1700829960,1700846820,16860,84645,28932,US,US
113391,1699765920,1699781400,15480,129967,173701,RS,RS
58951,1699190640,1699206900,16260,75240,100994,US,US
81372,1699163580,1699176900,13320,84212,169011,RS,RS
130777,1699039800,1699050840,11040,131670,69821,IT,IT
145878,1700188440,1700213040,24600,32870,134370,PL,NL
133596,1700725200,1700756400,31200,75168,195807,TR,TR
11582,1700475360,1700508540,33180,124940,171059,TR,TR
176898,1700846100,1700881500,35400,8088,190055,TR,TR
4299,1700323680,1700327280,3600,137453,110797,NL,NL
46486,1699799280,1699806420,7140,84225,79825,GB,GB
147337,1699931820,1699935420,3600,176269,10709,GB,FR
65274,1698997260,1699018800,21540,152838,35860,FR,AD
140464,1699199760,1699209540,9780,64243,171063,IT,IT
157611,1700513640,1700546040,32400,50347,152824,TR,TR
31615,1700289480,1700301060,11580,89280,140042,IT,IT
119787,1700336640,1700345040,8400,11074,197695,SK,AT
15105,1699080360,1699114560,34200,122753,86831,TR,TR
132082,1700735340,1700738940,3600,156932,143003,NL,NL
114768,1700306640,1700318520,11880,87052,137137,US,US
131127,1700336640,1700370960,34320,13740,37966,TR,TR
122326,1699793580,1699806960,13380,41655,187478,HR,HR
186114,1700862540,1700874720,12180,141515,104675,IT,IT
72524,1699882620,1699895880,13260,49953,81229,US,US
149833,1700221200,1700228220,7020,174319,166070,NL,NL
27301,1700314860,1700343960,29100,10803,40638,TR,TR
64989,1699821480,1699825080,3600,75460,130676,GB,GB
106732,1699446000,1699452180,6180,169264,106821,GB,FR
131096,1700857800,1700864520,6720,38241,125099,GB,GB
103924,1700383920,1700396400,12480,183085,122586,ES,ES
64116,1699483140,1699501740,18600,32842,171645,FR,FR
99008,1699832880,1699865160,32280,121932,178879,TR,TR
99184,1698966540,1698977520,10980,76546,120068,US,US
92233,1700247900,1700281380,33480,96411,12651,TR,TR
170272,1700851620,1700858220,6600,99119,125487,NL,BE
99844,1700662680,1700696340,33660,86576,116081,MX,US
133233,1700001780,1700011500,9720,147418,105020,PT,PT
5218,1699595220,1699627200,31980,125165,123974,TR,TR
161862,1700204520,1700208300,3780,46621,124873,GB,GB
50965,1699000560,1699031700,31140,34574,174641,TR,TR
93243,1699031040,1699060920,29880,18541,52514,TR,TR
171166,1699625160,1699633320,8160,28471,93403,IT,IT
29932,1700535660,1700553960,18300,160587,70203,FR,FR
60027,1700660160,1700690340,30180,123005,122846,TR,TR
142711,1699748700,1699770840,22140,51279,58937,HU,AT
187131,1699348380,1699359540,11160,59013,97959,HR,HR
73020,1700726640,1700740500,13860,52905,119045,US,US
174110,1699284300,1699338480,54180,17948,34503,UA,HU
90316,1698987660,1698999540,11880,36051,5064,PT,PT
74243,1700725680,1700754840,29160,162327,129668,TR,TR
81992,1700065560,1700074860,9300,154206,153151,HR,DE
8881,1700032440,1700062080,29640,111562,21289,TR,TR
91966,1699953420,1699957020,3600,79932,189404,GB,GB
103509,1700504940,1700539800,34860,86038,109676,TR,TR
71401,1699996140,1700000400,4260,86785,41961,NL,NL
4125,1699585860,1699602720,16860,173618,62506,AT,PL
191010,1700409420,1700415180,5760,198623,42227,GB,GB
40710,1700308140,1700338020,29880,43154,80450,TR,TR
89876,1698852000,1698860160,8160,66371,51504,PT,PT
104696,1699236840,1699272420,35580,50152,147435,TR,TR
98493,1700337540,1700341140,3600,38404,22706,NL,NL
146809,1699277220,1699314660,37440,1389,1101,MX,MX
189721,1700721900,1700738580,16680,25419,127589,US,US
132,1700207940,1700242500,34560,12089,5965,TR,TR
891,1700094540,1700106960,12420,15127,27018,US,US
118004,1698940200,1698943800,3600,155118,161469,GB,GB
138433,1700401260,1700408280,7020,76358,101725,GB,GB
138570,1699720860,1699755480,34620,11066,48806,TR,TR
156828,1699347240,1699351680,4440,13247,111815,GB,GB
199097,1700751120,1700766840,15720,26033,85968,FR,FR
183415,1700692260,1700725740,33480,119131,93413,TR,TR
88359,1700499000,1700522100,23100,34658,141063,PL,PL
142816,1700104500,1700116020,11520,65079,43864,IT,IT
135474,1700141160,1700175660,34500,46239,84906,TR,TR
131856,1699776600,1699796280,19680,11340,163749,FR,FR
4967,1700036580,1700071020,34440,115189,27350,TR,TR
17608,1700700300,1700725140,24840,189449,110531,BR,BR
172542,1700757120,1700766060,8940,112335,160953,HR,HR
172684,1700042340,1700077200,34860,187213,114672,TR,TR
171179,1700107560,1700111160,3600,179009,34682,GB,GB
13663,1699146600,1699177320,30720,88602,145272,TR,TR
190837,1700479380,1700492520,13140,127310,18824,US,US
42162,1699561980,1699591080,29100,80693,19566,TR,TR
139456,1699929360,1699935660,6300,40496,43780,GB,GB
60455,1699322820,1699337520,14700,33917,94829,AT,CZ
197899,1699749780,1699782780,33000,187375,154142,MX,MX
102542,1699257840,1699266480,8640,74735,49092,IT,IT
42251,1699448940,1699479000,30060,87524,164515,TR,TR
134825,1699132440,1699136040,3600,120471,189089,GB,GB
6439,1699106700,1699122480,15780,178343,189674,FR,FR
186053,1700540700,1700571360,30660,140109,67618,TR,TR
181486,1700770140,1700800140,30000,194619,67605,TR,TR
18556,1699855260,1699861560,6300,156978,50045,CL,CL
123222,1699891980,1699895580,3600,95354,89107,GB,GB
187401,1699965180,1699978560,13380,5436,33570,US,US
166210,1699109460,1699127580,18120,96301,197023,DK,DK
135738,1700340060,1700371560,31500,40721,56897,TR,TR
15841,1700467320,1700502960,35640,153106,140363,TR,TR
55400,1699372620,1699407180,34560,98488,142473,TR,TR
5789,1700827740,1700854920,27180,38604,11093,CH,DE
29473,1699743420,1699774740,31320,112019,199492,TR,TR
148527,1699399800,1699413660,13860,123206,13144,PT,PT
180111,1700792820,1700796420,3600,61663,197829,GB,GB
35471,1699769520,1699782780,13260,173194,143086,US,US
165009,1699646760,1699653960,7200,120025,16777,FI,EE
149289,1698914400,1698919920,5520,193489,132453,GB,GB
100195,1699192440,1699196040,3600,32130,114423,NL,NL
145937,1700802000,1700824920,22920,142627,123044,DE,FR
50311,1698793980,1698800880,6900,39514,2023,EE,EE
199143,1699553220,1699556820,3600,170379,101128,NL,DE
47,1699116540,1699124220,7680,96125,137914,IT,IT
139138,1699266960,1699270560,3600,46164,104591,NL,NL
148329,1700569200,1700604540,35340,103987,130612,TR,TR
189988,1698951840,1698968640,16800,180091,131317,US,US
176619,1699639920,1699649340,9420,188760,131429,IT,IT
150113,1699930920,1699944540,13620,40806,91249,AT,AT
57489,1699027380,1699030980,3600,120039,186581,GB,GB
172391,1700755560,1700789100,33540,91612,17608,TR,TR
75288,1700655480,1700659080,3600,148358,31897,GB,GB
29367,1700608080,1700640060,31980,124931,24263,TR,TR
106044,1699286160,1699313400,27240,141872,191925,DE,BG
16994,1699109340,1699140240,30900,94639,112104,TR,TR
181891,1700082120,1700115660,33540,136997,44574,TR,TR
23509,1698961080,1698975720,14640,179895,63176,CZ,SK
35222,1699501260,1699522260,21000,38692,71917,FR,FR
79403,1700785680,1700790600,4920,187234,164057,GB,GB
39455,1699559700,1699589160,29460,16382,164067,TR,TR
7565,1700761680,1700777100,15420,196427,70973,US,US
102225,1700263620,1700298420,34800,37514,199212,TR,TR
58213,1699684320,1699701540,17220,16901,89132,FR,FR
58960,1699126740,1699130340,3600,173643,25442,GB,GB
79444,1699235940,1699266780,30840,65971,27630,TR,TR
121517,1699905420,1699924020,18600,33785,76655,DK,DK
87566,1699846740,1699876860,30120,2918,16365,TR,TR
156628,1700675640,1700687880,12240,166169,182380,AT,BG
88229,1700686320,1700719020,32700,180381,44039,TR,TR
161668,1699944360,1699974780,30420,60014,111538,TR,TR
141577,1700166900,1700197920,31020,17558,13766,TR,TR
5951,1699961400,1699997340,35940,36651,89533,TR,TR
8500,1700813400,1700818500,5100,62069,147547,NL,NL
143159,1699342680,1699377720,35040,27417,51682,TR,TR
79154,1699936560,1699972260,35700,124419,13322,MX,US
32762,1699200720,1699207080,6360,7094,153595,GB,GB
80655,1700454180,1700484840,30660,64714,180725,TR,TR
65259,1700093100,1700096700,3600,54733,40648,GB,GB
160157,1699861560,1699872300,10740,158111,51237,PT,PT
72473,1700023080,1700050680,27600,7428,93279,DE,DE
73680,1700461980,1700480580,18600,43272,39153,SE,SE
121125,1699004460,1699020300,15840,83909,128714,US,US
177535,1700454720,1700464860,10140,162566,146158,EE,EE
86297,1700218320,1700227800,9480,73555,39732,CL,CL
76510,1700010240,1700013840,3600,175353,138823,GB,GB
2004,1699188960,1699200420,11460,54649,50766,US,US
167420,1700065080,1700074260,9180,104915,136839,IT,NL
185978,1700251020,1700264880,13860,197295,107261,US,US
127887,1699379160,1699392360,13200,104056,7111,US,US
45315,1698996480,1699029300,32820,49797,54081,TR,TR
194131,1699720020,1699723620,3600,10391,174471,NL,NL
136734,1700249940,1700280240,30300,149607,123098,TR,TR
32385,1699816560,1699847520,30960,57214,50512,TR,TR
52998,1699402200,1699407360,5160,139661,74004,NL,NL
111675,1700734560,1700750820,16260,39321,88051,US,US
115210,1699475520,1699509780,34260,136528,146154,MX,MX
76238,1699361340,1699396080,34740,1119,156841,TR,TR
85740,1698914280,1698940260,25980,198545,90930,DE,DE
133699,1700431260,1700445900,14640,141792,92765,US,US
157168,1699807380,1699839120,31740,80529,22746,TR,TR
149590,1700296440,1700329500,33060,164040,193829,TR,TR
141834,1699939740,1699952580,12840,61168,104946,IT,IT
137385,1700195460,1700230740,35280,62368,187722,TR,TR
2346,1699807200,1699810800,3600,139556,101361,GB,GB
168191,1699980900,1699994460,13560,1502,51220,US,US
78141,1700531520,1700565840,34320,56742,92212,TR,TR
75034,1700289420,1700324160,34740,65572,112823,TR,TR
163968,1699562640,1699576500,13860,120534,135622,US,US
56703,1698793680,1698825660,31980,149927,104672,TR,TR
162818,1699215420,1699250040,34620,173990,77245,TR,TR
90895,1699697100,1699700700,3600,23325,72098,GB,GB
103822,1700130960,1700143920,12960,95807,91239,US,US
18383,1698837780,1698843960,6180,53746,65077,NL,NL
61512,1700096040,1700119860,23820,39678,27093,DE,DE
186815,1699697280,1699709520,12240,75412,36869,IT,IT
171842,1699110000,1699139820,29820,104930,183583,TR,TR
185395,1699076700,1699080300,3600,84364,139328,GB,GB
187084,1700087040,1700099100,12060,3476,23921,IT,IT
87427,1699741620,1699775760,34140,146376,195177,TR,TR
37057,1699102260,1699117320,15060,161212,64682,SE,SE
34270,1700630700,1700642280,11580,83945,67098,CZ,CZ
144493,1699265520,1699291740,26220,196529,188206,PL,DE
88908,1700525700,1700529300,3600,114830,106329,NL,NL
28709,1700012100,1700023800,11700,131933,86579,US,US
145726,1699920360,1699934040,13680,122264,76422,IT,IT
161884,1699580700,1699616160,35460,24102,135698,TR,TR
57051,1700646300,1700679480,33180,27957,66084,TR,TR
167603,1700736420,1700743020,6600,136190,129299,GB,GB
110511,1700800560,1700815500,14940,107042,13839,CZ,AT
128050,1700582160,1700607540,25380,128749,50058,BA,BA
158974,1700678400,1700682000,3600,53635,52081,GB,GB
60662,1700504040,1700513160,9120,55412,156508,HR,HR
53663,1700094360,1700111880,17520,184698,72254,FR,BE
36626,1699655400,1699682220,26820,39261,3397,ME,RS
190829,1698894360,1698897960,3600,122342,148289,NL,NL
31872,1699189260,1699192860,3600,104947,123919,NL,NL
160799,1699736340,1699768620,32280,129715,107883,TR,TR
89829,1699717800,1699731000,13200,103624,46201,IT,IT
79450,1699258560,1699267680,9120,126948,180498,EE,FI
3062,1699325160,1699355940,30780,163284,165413,TR,TR
160424,1700149860,1700177880,28020,59292,77688,BR,BR
85305,1700787660,1700799900,12240,186415,39678,IT,IT
30138,1700748060,1700783460,35400,133859,144499,TR,TR
159209,1699006860,1699010580,3720,117197,65736,NL,NL
7865,1699524720,1699534860,10140,70593,93950,IT,CH
73814,1700067720,1700100600,32880,124613,100076,TR,TR
130431,1700557740,1700564880,7140,66836,110099,GB,GB
164931,1699924920,1699954740,29820,139535,41654,TR,TR
29938,1700190360,1700194620,4260,78744,191868,GB,GB
52979,1700644800,1700679900,35100,147077,2721,TR,TR
28901,1700324640,1700358480,33840,168950,157202,TR,TR
197466,1699502460,1699526160,23700,72162,137918,HU,IT
40147,1699474020,1699484820,10800,166265,186666,IT,IT
135641,1700740380,1700775900,35520,180208,71003,TR,TR
199820,1699201380,1699235220,33840,7413,14008,TR,TR
168912,1700026620,1700030220,3600,128803,127469,GB,GB
88828,1700378520,1700391120,12600,30072,195277,CZ,CZ
100268,1700680500,1700692740,12240,106060,181336,US,MX
131048,1699559280,1699585740,26460,186424,132921,DE,DE
89746,1699340460,1699372320,31860,193747,166137,TR,TR
99064,1699304580,1699321560,16980,139563,76578,US,US
67383,1700283360,1700289180,5820,166430,103166,GB,GB
153674,1699705500,1699729500,24000,71612,180204,PL,PL
107170,1698943440,1698956880,13440,132735,70336,PT,ES
85303,1699148220,1699152240,4020,130890,33257,GB,GB
27664,1699262940,1699299360,36420,137239,110905,MX,MX
191559,1700526000,1700529600,3600,172433,81998,GB,BE
173190,1700111280,1700127780,16500,56437,179485,US,US
21795,1700610000,1700641140,31140,181729,21150,TR,TR
103182,1699734180,1699746600,12420,75967,68858,RS,RS
141722,1699600440,1699604040,3600,96263,57217,GB,GB
184648,1700779140,1700808780,29640,180071,177403,TR,TR
97322,1699674300,1699709940,35640,14978,146615,TR,TR
127791,1700438280,1700449860,11580,63902,143806,US,US
3577,1700392140,1700425740,33600,100333,195579,TR,TR
110808,1700314140,1700338380,24240,42606,50333,PL,CZ
147631,1699474380,1699503660,29280,170270,107970,TR,TR
172811,1699844280,1699876560,32280,36720,85446,TR,TR
91144,1699608180,1699626120,17940,6457,182926,US,US
25525,1700064300,1700081340,17040,178538,183701,US,US
109526,1700081460,1700110800,29340,18995,21445,TR,TR
39270,1699375200,1699386360,11160,137944,104735,HR,HR
193795,1699064820,1699076280,11460,40718,112093,AT,DE
13684,1699538160,1699572420,34260,88566,145186,TR,TR
107111,1700023140,1700039520,16380,196386,61604,CZ,CZ
35484,1699254540,1699262520,7980,22921,38230,HR,HR
193666,1699044660,1699076160,31500,183755,102641,TR,TR
114306,1700350200,1700362680,12480,21126,182023,US,MX
90972,1700565420,1700595600,30180,16089,132957,TR,TR
54791,1699903380,1699915800,12420,147130,122773,US,US
59060,1698833700,1698837300,3600,107948,15564,NL,NL
4727,1700699400,1700728440,29040,2342,158587,TR,TR
125105,1699414320,1699443840,29520,58010,186433,TR,TR
114272,1700120580,1700125440,4860,65899,171707,NL,NL
188501,1699644240,1699654920,10680,180379,121364,EE,EE
111696,1699100640,1699134120,33480,35464,195813,TR,TR
144276,1699606680,1699621080,14400,44873,146885,RS,RS
83277,1699212300,1699241640,29340,187863,150169,TR,TR
146615,1699270140,1699325400,55260,124689,178863,UA,PL
106171,1699796460,1699833300,36840,153332,33764,MX,US
28305,1699230720,1699234320,3600,196353,90031,GB,GB
39768,1699159080,1699162680,3600,2823,170814,NL,NL
129596,1698947520,1698973020,25500,133252,102474,DE,HR
39541,1700728500,1700762820,34320,124263,41299,TR,TR
176120,1699913760,1699947000,33240,157113,47646,TR,TR
29013,1698841500,1698853680,12180,15997,44616,IT,IT
47448,1700414280,1700444700,30420,9411,161257,TR,TR
84752,1699450500,1699467180,16680,113809,161670,US,US
38260,1698947280,1698959100,11820,32852,80729,RS,RS
67639,1699756860,1699765380,8520,27817,194394,IT,DE
115033,1699782240,1699814640,32400,18725,89079,TR,TR
74091,1700345100,1700358360,13260,95413,199265,PT,PT
62724,1700505180,1700510820,5640,56013,107464,NL,NL
39670,1699838880,1699851480,12600,32665,185062,US,US
54884,1699030260,1699061160,30900,123329,71159,TR,TR
98001,1700493540,1700510100,16560,25677,89582,RS,DE
102800,1699822860,1699829640,6780,122662,182144,GB,GB
100877,1699468860,1699499880,31020,172050,61805,TR,TR
154603,1700741340,1700748540,7200,44599,183841,HR,HR
161188,1700405880,1700438100,32220,136261,165778,TR,TR
25841,1700763840,1700775300,11460,39851,168500,HR,HR
74513,1699174560,1699188060,13500,164282,21705,RS,RS
31041,1700385180,1700421000,35820,39225,16133,TR,TR
57699,1699623660,1699632960,9300,123604,136107,IT,IT
104882,1700104560,1700140020,35460,18311,190118,TR,TR
72080,1699775520,1699789440,13920,58874,7819,HR,HR
59609,1698990480,1699000320,9840,83302,121787,IT,IT
54039,1699941060,1699944660,3600,2370,32541,GB,GB
16995,1700349900,1700383620,33720,103520,14190,TR,TR
143147,1700511840,1700525280,13440,10100,19286,US,US
21556,1699149660,1699185600,35940,142783,150089,MX,MX
41284,1700340960,1700374200,33240,36510,70080,TR,TR
994,1700016180,1700031360,15180,19230,111199,US,US
163678,1700313840,1700329260,15420,23583,162940,AT,HU
61198,1699910400,1699939440,29040,127827,192299,TR,TR
165498,1699326660,1699338660,12000,62246,125896,US,US
108480,1700423820,1700452980,29160,198971,196447,TR,TR
33934,1698942660,1698957600,14940,127083,2116,US,US
88384,1699865100,1699877940,12840,6382,147867,PT,PT
190232,1699754340,1699780560,26220,182813,139837,BR,BR
176510,1700166900,1700170500,3600,80228,36115,GB,GB
76378,1699914840,1699922220,7380,113185,14813,IT,IT
152177,1699203240,1699206840,3600,76383,88360,NL,NL
147939,1700553420,1700567580,14160,72196,79326,HR,HR
123714,1700668500,1700703960,35460,152619,44695,TR,TR
97356,1700497260,1700500860,3600,174929,21638,NL,BE
115213,1699676520,1699707840,31320,177664,69544,TR,TR
20569,1700488560,1700494500,5940,196959,54518,GB,GB
40795,1699386420,1699397640,11220,57476,173145,IT,IT
86924,1699145820,1699174920,29100,14153,142042,TR,TR
24378,1699958520,1699981800,23280,112713,76594,DE,BA
11072,1699747200,1699753920,6720,46280,182592,NL,NL
139720,1700613000,1700628840,15840,161628,172022,US,US
176246,1699825620,1699840380,14760,164322,140368,FR,HR
31128,1700235600,1700268420,32820,15047,125718,TR,TR
89993,1699368900,1699399380,30480,83161,152556,TR,TR
34516,1700356380,1700373780,17400,120366,19009,US,US
157689,1700082360,1700094180,11820,39977,92193,US,US
173023,1699095360,1699126080,30720,38202,8103,TR,TR
72656,1700092020,1700098860,6840,33378,131370,GB,GB
83120,1699653180,1699661460,8280,60277,51906,ES,FR
10388,1699229040,1699245960,16920,18527,18248,US,US
157490,1699224960,1699264140,39180,76542,61497,MX,MX
79725,1699514040,1699521840,7800,172879,43558,SK,SK
153553,1700763000,1700813880,50880,137746,167525,BG,AT
21042,1698939240,1698970980,31740,127753,14917,TR,TR
120570,1700647620,1700660400,12780,64518,69938,US,US
167599,1699079520,1699101180,21660,45626,10607,NO,DK
197498,1699738980,1699769640,30660,61666,6282,TR,TR
107654,1698822060,1698846780,24720,66837,10164,BR,BR
162416,1700219100,1700229660,10560,170082,136518,FI,EE
44706,1700105340,1700134200,28860,104692,172166,TR,TR
81977,1700802180,1700805780,3600,154548,162088,GB,GB
199940,1700581080,1700584680,3600,4600,124258,GB,GB
193923,1699799220,1699802820,3600,99390,13621,NL,NL
6523,1699083780,1699096920,13140,70835,37898,US,US
188890,1700229600,1700242500,12900,98598,163224,US,US
65265,1699325940,1699339200,13260,124201,40115,US,US
198123,1699658520,1699692600,34080,69556,113029,TR,TR
72649,1699237620,1699246860,9240,133528,62658,IT,IT
14601,1700504520,1700533560,29040,191035,15443,TR,TR
97425,1700389020,1700400120,11100,179383,29690,PT,PT
25891,1699526220,1699535220,9000,86908,50082,IT,IT
98073,1699502340,1699532880,30540,181185,102894,TR,TR
154758,1700733420,1700753160,19740,75463,187415,LT,PL
19023,1700474100,1700487960,13860,54123,156743,US,US
137838,1700802000,1700833800,31800,179828,122181,TR,TR
148088,1699493520,1699524960,31440,24454,86043,TR,TR
157088,1699934520,1699938120,3600,45799,22400,GB,GB
8975,1700681340,1700689440,8100,12401,32977,IT,IT
139323,1700043420,1700078280,34860,152825,42910,TR,TR
6676,1699556580,1699560780,4200,150553,91368,NL,NL
186276,1700816280,1700845740,29460,182035,26472,TR,TR
163832,1700421780,1700437560,15780,23920,88550,FR,PT
68071,1700568780,1700573160,4380,191122,124593,NL,NL
37802,1699377660,1699386060,8400,27530,95281,IT,IT
145576,1699395000,1699416720,21720,156483,28763,DE,AT
182201,1699205820,1699222980,17160,126250,35065,FR,DE
54946,1699156200,1699169580,13380,127073,155362,IT,IT
62511,1699227120,1699236240,9120,40568,4726,ES,ES
43982,1699484220,1699496280,12060,70287,37927,US,US
51830,1699173960,1699181100,7140,142564,133178,NL,NL
80352,1700423760,1700446680,22920,122677,77843,RO,RO
20500,1699267080,1699278660,11580,127547,62579,IT,IT
50754,1700525160,1700529600,4440,47680,43603,GB,GB
50835,1700789400,1700819700,30300,48014,132812,TR,TR
109392,1700127900,1700156040,28140,171482,27769,DE,DE
145091,1698975360,1698987120,11760,154808,93893,CZ,CZ
162971,1700803200,1700807820,4620,173892,174857,GB,GB
165812,1699116300,1699148220,31920,129514,126710,MK,RS
135611,1700297940,1700332200,34260,87805,116275,TR,TR
96920,1700716260,1700745480,29220,115670,54513,TR,TR
59512,1699394400,1699401780,7380,81574,146252,IT,FR
23787,1699205880,1699238280,32400,81307,8811,TR,TR
102621,1700208180,1700236980,28800,20758,9182,BA,DE
43517,1700302440,1700317800,15360,112286,12696,FR,FR
11835,1700331780,1700357820,26040,137913,63911,HU,RS
4064,1699564320,1699596240,31920,114604,176754,TR,TR
137439,1699933980,1699938900,4920,153310,185381,GB,GB
132095,1700624040,1700659440,35400,110363,58518,TR,TR
84005,1699968780,1700004480,35700,112033,85752,TR,TR
44658,1698893280,1698919020,25740,110894,97536,RO,RO
133477,1699102020,1699114200,12180,193443,68317,IT,IT
175170,1699556700,1699584720,28020,194471,7392,DE,BG
18507,1699847820,1699883700,35880,7527,87515,MX,MX
186919,1700032800,1700063760,30960,128764,27662,TR,TR
43955,1699746900,1699758660,11760,181876,150949,IT,IT
176137,1700194080,1700209380,15300,46293,29986,US,US
75531,1700140560,1700176200,35640,130424,82421,TR,TR
145871,1700533200,1700536800,3600,199590,32650,NL,NL
155425,1699681020,1699696380,15360,35155,44182,US,US
58273,1698801420,1698839640,38220,90997,23612,MX,MX
71848,1700805240,1700816040,10800,149268,154632,IT,IT
130439,1698926160,1698938820,12660,127716,27309,CZ,CZ
120408,1698946500,1698980220,33720,112380,128197,TR,TR
192265,1698861660,1698875940,14280,64122,105255,US,US
185756,1699163460,1699174860,11400,66162,186717,US,US
8734,1699814100,1699846620,32520,59268,198455,TR,TR
199204,1699651620,1699682160,30540,19990,199693,TR,TR
155137,1699092900,1699128840,35940,87567,174478,TR,TR
101833,1700574120,1700591280,17160,131,131796,US,US
123688,1700122020,1700154840,32820,100387,55158,TR,TR
47638,1700297460,1700329920,32460,97896,113501,TR,TR
109583,1700255340,1700286000,30660,42303,67830,TR,TR
9625,1700190360,1700225400,35040,33693,152959,TR,TR
133528,1700617260,1700625420,8160,4863,29088,IT,IT
101712,1699003560,1699021140,17580,62606,181689,AT,RS
29551,1699284360,1699311480,27120,21924,138005,RO,RO
71045,1698864720,1698868320,3600,51940,100274,GB,GB
193656,1700211060,1700225160,14100,199149,31309,PT,PT
129908,1699989480,1699998120,8640,4535,78973,EE,EE
51966,1700497560,1700501160,3600,24527,193817,NL,NL
161658,1699382040,1699408560,26520,37440,140636,DE,DE
34020,1698865620,1698895860,30240,192941,155981,TR,TR
121038,1699019340,1699054440,35100,64470,122580,TR,TR
152317,1699028280,1699031880,3600,38983,113517,GB,GB
149618,1698858960,1698883560,24600,189908,108433,DE,DE
194661,1699458120,1699487100,28980,98317,182758,TR,TR
51125,1699150800,1699163340,12540,190106,25159,IT,IT
109630,1700541900,1700547300,5400,26163,173237,GB,GB
170855,1700424480,1700459640,35160,22084,188601,TR,TR
2619,1699593120,1699600320,7200,14848,25304,IT,IT
61608,1699178640,1699211460,32820,55726,101920,TR,TR
173440,1700386920,1700422680,35760,21131,181769,TR,TR
141940,1700835780,1700839380,3600,173138,175715,NL,NL
158,1700682000,1700697360,15360,36602,73575,US,US
150296,1699334280,1699363800,29520,50016,85640,TR,TR
83240,1699656900,1699686600,29700,5459,40619,TR,TR
157869,1700065080,1700098260,33180,90483,137346,TR,TR
56694,1700354280,1700357880,3600,94780,87575,GB,GB
44379,1700238000,1700272080,34080,181829,70208,TR,TR
4062,1700454540,1700484780,30240,183509,141613,TR,TR
93980,1699596420,1699627920,31500,149952,35660,TR,TR
66480,1699762500,1699774620,12120,116132,98119,AT,AT
71693,1700048340,1700076900,28560,9814,20288,DE,CZ
36098,1700607660,1700638740,31080,149795,159743,TR,TR
31791,1699432620,1699465320,32700,135304,180215,TR,TR
53666,1700496180,1700509320,13140,8100,149010,AT,BG
70610,1699603740,1699610880,7140,414,94570,NL,NL
16025,1699015140,1699023780,8640,182964,89324,IT,IT
175832,1700744880,1700755980,11100,26063,38238,CA,CA
44523,1698938340,1698969600,31260,9032,77564,TR,TR
125889,1698982680,1699017180,34500,195485,41800,TR,TR
18500,1698794340,1698801480,7140,121686,67660,GB,GB
54013,1700139420,1700174760,35340,26645,171208,TR,TR
175800,1700298000,1700327640,29640,153797,198147,TR,TR
9653,1698833580,1698864300,30720,67968,128225,TR,TR
156783,1700845080,1700869080,24000,144047,191611,DE,RS
21186,1700634360,1700637960,3600,102938,151536,GB,GB
110338,1700163540,1700192940,29400,169832,63562,TR,TR
8548,1700314380,1700346180,31800,71257,9848,TR,TR
116811,1698815940,1698824340,8400,168188,11330,IT,IT
88462,1700684280,1700713740,29460,51963,76417,TR,TR
53215,1700328540,1700359800,31260,54083,106303,TR,TR
43085,1699743960,1699758840,14880,158313,36159,RS,RS
122727,1698865260,1698901080,35820,55105,1216,TR,TR
181809,1698949860,1698963540,13680,95521,142355,US,US
147441,1700424120,1700458380,34260,76332,144897,TR,TR
11943,1699558680,1699573860,15180,84084,135910,AT,AT
190623,1699401480,1699413960,12480,9261,108277,AT,AT
182397,1700490000,1700525220,35220,122320,34436,TR,TR
128551,1699456320,1699462920,6600,27466,29494,NL,DE
4810,1699566600,1699601340,34740,16000,159223,TR,TR
20755,1700311740,1700346360,34620,92523,189323,TR,TR
20093,1700397300,1700404560,7260,125382,41265,ES,AD
18684,1699446420,1699458600,12180,110103,47355,AT,SK
48144,1699673520,1699703400,29880,166544,84475,TR,TR
47431,1699750860,1699781700,30840,48699,22489,TR,TR
182793,1699627680,1699639980,12300,147417,183824,US,US
57492,1699147380,1699173000,25620,146846,56110,CH,DE
115622,1699602300,1699638000,35700,99379,32191,TR,TR
13790,1700307480,1700315520,8040,19217,78900,PT,PT
173902,1699397220,1699401060,3840,169941,197849,NL,NL
182990,1699059720,1699092840,33120,180517,63715,TR,TR
182941,1700151540,1700166840,15300,14608,117690,US,US
128855,1699972020,1699998960,26940,172023,198468,PL,PL
36803,1699741020,1699755480,14460,6955,127197,US,US
152873,1700823900,1700851380,27480,74053,2772,DE,DE
26150,1699799940,1699811160,11220,25837,34370,IT,IT
117978,1699051920,1699062180,10260,10999,135633,IT,IT
139498,1699184760,1699189920,5160,110347,25114,GB,GB
92050,1700182860,1700217900,35040,130597,173466,TR,TR
129204,1700331420,1700365380,33960,113379,59199,TR,TR
102552,1699101240,1699104840,3600,145396,56538,GB,GB
96837,1700708220,1700714040,5820,191070,61196,GB,GB
152782,1700757780,1700792220,34440,76839,33117,TR,TR
143403,1700775420,1700807280,31860,193186,133588,TR,TR
19162,1699058040,1699093800,35760,21613,101115,TR,TR
32030,1700849940,1700857260,7320,73243,38601,SK,SK
169165,1699662780,1699686180,23400,147471,120853,DE,DE
160663,1698901260,1698904860,3600,95137,90322,GB,GB
74226,1699127280,1699162560,35280,136978,164068,MX,US
114478,1699352520,1699386360,33840,182692,194458,TR,TR
83578,1700824800,1700854200,29400,154875,145897,TR,TR
55753,1699424040,1699456380,32340,18468,127456,TR,TR
188845,1700709240,1700739360,30120,38689,174737,TR,TR
53246,1699725540,1699740840,15300,99542,108561,US,US
72410,1699911060,1699914660,3600,139144,188737,NL,NL
155414,1699859940,1699866060,6120,155623,169733,GB,GB
171561,1699264800,1699295520,30720,98414,51481,TR,BG
17895,1699555680,1699559880,4200,104362,3954,NL,NL
121367,1699401480,1699405080,3600,46375,187903,GB,GB
137173,1700582760,1700596920,14160,141089,106897,IT,IT
3922,1699956900,1699960500,3600,69762,168409,GB,GB
115296,1700534580,1700548440,13860,102137,178945,IT,IT
94917,1700519520,1700535180,15660,197794,9862,SE,SE
119671,1699279980,1699312800,32820,159958,30075,TR,TR
49771,1699273560,1699296840,23280,95435,174658,BR,BR
155457,1699782300,1699794000,11700,121008,96447,HR,HR
79239,1699269180,1699275600,6420,183986,113781,NL,NL
57935,1699540860,1699575600,34740,60375,68235,TR,TR
135556,1699797840,1699803600,5760,156612,117686,NL,NL
184772,1699111500,1699142640,31140,112889,199437,TR,TR
115393,1700046300,1700076540,30240,146592,148874,TR,TR
53704,1699647120,1699675980,28860,111684,140383,TR,TR
157494,1700429580,1700437560,7980,31925,124307,IT,DE
17326,1699443300,1699478100,34800,70785,186724,TR,TR
112528,1699693860,1699720500,26640,31201,71220,RO,RO
121050,1698917100,1698932100,15000,96951,107961,FR,DE
24362,1699893540,1699919280,25740,64858,108008,DE,DE
164349,1700124720,1700159100,34380,19830,174195,TR,TR
99014,1700314500,1700321100,6600,13032,45803,NL,NL
87943,1698999000,1699027200,28200,174380,20329,DE,UA
134721,1700547360,1700582760,35400,78266,128281,TR,TR
83697,1699712400,1699723920,11520,76487,36292,US,US
102394,1700760120,1700794740,34620,72462,105383,TR,TR
48361,1699929840,1699961040,31200,128639,30308,TR,TR
171020,1700732100,1700766120,34020,98591,156558,TR,TR
158982,1699600500,1699611900,11400,68307,187916,RS,RS
17149,1699448580,1699465380,16800,68987,185429,US,US
154888,1700527260,1700560260,33000,9774,189782,TR,TR
29238,1700042520,1700057340,14820,77646,98762,US,US
157380,1699091400,1699110960,19560,61531,14014,FR,FR
147952,1699399620,1699403220,3600,136940,93667,GB,GB
84793,1699071300,1699080900,9600,175306,141520,IT,IT
544,1700335560,1700344200,8640,187053,47775,IT,IT
136015,1700106180,1700134920,28740,45983,56911,DE,DK
179600,1699974000,1699985280,11280,127419,15191,IT,IT
6852,1700103480,1700137260,33780,179465,146319,TR,TR
118542,1699295460,1699309740,14280,172577,42311,AT,AT
102723,1699422780,1699455300,32520,150265,30488,TR,TR
153806,1699030920,1699060860,29940,145909,132825,BA,HR
102745,1700259720,1700295660,35940,9949,170075,TR,TR
199175,1699112280,1699127700,15420,6089,79108,US,US
66775,1699532100,1699535700,3600,168396,140208,GB,GB
131836,1699965840,1699973340,7500,75411,132593,HR,HR
183094,1700250900,1700265900,15000,89074,147818,AT,SK
73547,1699462680,1699496040,33360,75837,18607,TR,TR
54905,1700854200,1700867400,13200,69599,3222,PT,PT
193410,1699286940,1699316820,29880,100397,94365,TR,TR
181920,1700400480,1700408940,8460,128679,80386,IT,IT
2723,1700104320,1700139540,35220,35504,57191,TR,TR
120238,1700512320,1700545140,32820,46659,196853,MX,MX
17557,1700389260,1700419200,29940,108742,124707,TR,TR
120519,1699349940,1699353540,3600,194535,121335,GB,GB
14912,1699450980,1699480200,29220,23906,57898,TR,TR
196523,1700664120,1700697000,32880,175649,125175,TR,TR
122903,1700856780,1700861160,4380,36356,166814,GB,GB
25528,1699417860,1699437900,20040,9438,70497,FR,FR
197314,1699980180,1700015340,35160,169727,53860,TR,TR
45016,1700398980,1700402580,3600,138749,133316,NL,NL
5451,1699709280,1699725720,16440,22686,37012,FR,NL
129855,1700430120,1700458440,28320,143251,145845,DE,BG
70090,1700406300,1700409900,3600,64891,87136,GB,GB
69131,1699448400,1699453200,4800,119344,15911,GB,GB
118319,1700463600,1700496900,33300,176312,36611,TR,TR
128554,1700133180,1700144940,11760,119698,189721,US,US
196442,1698808080,1698841920,33840,14962,138312,TR,TR
81897,1699414980,1699449720,34740,1503,80128,TR,TR
109830,1700165040,1700188140,23100,88121,159350,PL,PL
110352,1699608960,1699618740,9780,99939,92079,IT,IT
73604,1699962960,1699997700,34740,177578,147212,TR,TR
8423,1700788200,1700818140,29940,155730,75606,TR,TR
117225,1699760160,1699772580,12420,6494,82169,AT,SK
172843,1700570220,1700601420,31200,192098,3154,TR,TR
180831,1699183980,1699191420,7440,4765,49734,IT,IT
101813,1700515740,1700547780,32040,122462,125034,TR,TR
58719,1699592580,1699625280,32700,99304,56476,TR,TR
137909,1699933620,1699937520,3900,193831,76146,GB,GB
10756,1698898560,1698929460,30900,166962,136960,TR,TR
45647,1700264520,1700268540,4020,45721,48041,GB,GB
35433,1698952500,1698983580,31080,171332,139210,TR,TR
68913,1699732260,1699758540,26280,131440,133734,BR,BR
140762,1700308500,1700317560,9060,153910,29604,IT,IT
139819,1700418060,1700428320,10260,27021,93822,IT,IT
56879,1700577420,1700611620,34200,46602,139653,MX,MX
100138,1699740540,1699749540,9000,154262,198492,AD,ES
170347,1699103040,1699106640,3600,39647,13625,GB,GB
106248,1700511060,1700542200,31140,159566,111436,TR,TR
80702,1700159400,1700192640,33240,161899,76920,TR,TR
59397,1699274040,1699306260,32220,21753,113037,TR,TR
139899,1698830760,1698844080,13320,134136,140397,IT,IT
74723,1699816800,1699851180,34380,42164,136566,TR,TR
135010,1699747920,1699778400,30480,69131,12780,TR,TR
69868,1698822000,1698836100,14100,101104,1689,US,US
194912,1699110480,1699115820,5340,59341,46233,EE,EE
105070,1700316720,1700345520,28800,57278,100672,TR,TR
199623,1700569080,1700604780,35700,150580,192357,TR,TR
54938,1699955100,1699970940,15840,143852,81925,US,US
147297,1699964880,1699979220,14340,113761,150879,US,US
153785,1699962840,1699988460,25620,58288,45093,PL,PL
6414,1699504320,1699517340,13020,71671,25510,IT,IT
150321,1700759040,1700762700,3660,141008,76903,GB,GB
124825,1699284000,1699288680,4680,78034,194078,GB,GB
27730,1700860680,1700876820,16140,37840,139372,US,US
136621,1699731600,1699760520,28920,193340,169265,TR,TR
64721,1700286600,1700299920,13320,19475,43376,AT,AT
43577,1700044980,1700080200,35220,20711,27714,TR,TR
173547,1700392680,1700397360,4680,115771,14016,GB,GB
199918,1698809280,1698824520,15240,17470,101995,AT,AT
146509,1699389480,1699393080,3600,42993,110507,NL,NL
91068,1699716900,1699751580,34680,33771,3441,TR,TR
146912,1699061940,1699065540,3600,102549,71817,NL,AT
48155,1700408460,1700445840,37380,88688,156220,MX,MX
145868,1700333940,1700341260,7320,69501,76119,IT,IT
58815,1699785300,1699802700,17400,68823,94460,FR,DE
157851,1700623800,1700649360,25560,71728,61324,RO,RO
155168,1699325460,1699336380,10920,101252,47246,PT,PT
113158,1700829600,1700841600,12000,157739,136812,IT,IT
80473,1699883460,1699898760,15300,58927,102194,FR,FR
13974,1700578500,1700595240,16740,163262,146567,US,US
159423,1700094420,1700102280,7860,112761,91273,PT,PT
30684,1700479800,1700515500,35700,17689,96353,TR,TR
163465,1700160840,1700171820,10980,106148,194492,US,US
77896,1700039760,1700075040,35280,83963,132942,TR,TR
189984,1699602840,1699628160,25320,41118,27609,BR,BR
106429,1700426100,1700441220,15120,66812,146341,US,US
188333,1700006460,1700019120,12660,19416,141530,IT,IT
68674,1700328000,1700363340,35340,59192,56972,MX,US
192326,1700456160,1700491260,35100,55422,114527,TR,TR
147829,1698824100,1698858180,34080,145695,18133,TR,TR
84900,1699199580,1699226520,26940,46865,49471,BR,BR
4287,1699598040,1699627860,29820,41679,164891,TR,TR
177367,1700733300,1700746140,12840,107413,30916,US,US
129862,1698998520,1699027620,29100,66035,45368,TR,TR
104767,1699245540,1699271220,25680,57076,191082,DE,DE
146686,1700261880,1700273100,11220,83151,35558,IT,IT
165934,1700000340,1700017080,16740,163362,166705,US,US
107312,1699067280,1699073580,6300,94223,104184,GB,GB
74519,1700645880,1700652660,6780,179991,83064,GB,GB
58347,1698920220,1698949920,29700,168280,174150,TR,TR
22235,1699555980,1699569420,13440,132729,3609,IT,IT
144691,1699714800,1699728780,13980,134460,71653,AT,AT
88852,1699065960,1699098000,32040,26898,180042,TR,TR
107472,1698960000,1698963600,3600,104682,54602,GB,GB
18448,1699086240,1699120320,34080,14798,9641,TR,TR
95755,1699584960,1699594200,9240,183391,130981,HR,HR
110735,1699993560,1700005920,12360,174144,129077,US,MX
137926,1699427640,1699431240,3600,11768,152434,GB,GB
32295,1699059960,1699073100,13140,169225,11989,US,US
71232,1700544180,1700568960,24780,199980,75543,BR,BR
114455,1699054980,1699060620,5640,194253,43731,GB,GB
164646,1698981960,1698989820,7860,88283,46761,SK,SK
13124,1699276980,1699284960,7980,88549,188272,IT,IT
167717,1699590120,1699620720,30600,6527,90818,TR,TR
90562,1699566000,1699573200,7200,195665,78286,IT,IT
163424,1699682100,1699709760,27660,59344,180492,PL,PL
30973,1699735380,1699750740,15360,198436,52009,US,US
154326,1700694300,1700707440,13140,195911,20331,HR,AT
185344,1699308360,1699338120,29760,67699,196791,TR,TR
186564,1700758020,1700769660,11640,9956,128173,US,US
48822,1700698560,1700707080,8520,127622,133718,IT,IT
68097,1700399280,1700402880,3600,95332,122470,GB,GB
133226,1700455140,1700485380,30240,193110,176730,TR,TR
120082,1700427240,1700431380,4140,133881,99679,GB,GB
93149,1698907440,1698913800,6360,142285,120044,NL,IT
82811,1699006140,1699018620,12480,172252,161136,IT,IT
144677,1699270620,1699304340,33720,155932,27360,TR,TR
179522,1699021020,1699042980,21960,111363,143330,DE,BA
46083,1700765340,1700826180,60840,104311,94791,UA,PL
188647,1700317980,1700351160,33180,132479,95615,TR,TR
14411,1700416080,1700431800,15720,25648,170097,US,US
115760,1699770420,1699788000,17580,199551,138421,FR,DE
120459,1699860780,1699872240,11460,121350,86722,IT,IT
138822,1699382520,1699397880,15360,14289,186884,FR,FR
43071,1699692960,1699704540,11580,178287,50880,US,US
137996,1698827100,1698850500,23400,17278,167590,DE,DE
80120,1699633860,1699637640,3780,160955,153200,GB,GB
150185,1699538940,1699551780,12840,48394,132758,IT,IT
131608,1699706340,1699733220,26880,86545,36065,DE,NL
82003,1699093740,1699120920,27180,50861,98181,BR,BR
105034,1699566240,1699573140,6900,148647,114960,NL,NL
187893,1699549620,1699583460,33840,191984,118145,TR,TR
15592,1699624380,1699631460,7080,66998,142022,GB,GB
64876,1699430400,1699435260,4860,189240,175123,GB,GB
81102,1700040660,1700075700,35040,112643,79609,TR,TR
92453,1698943260,1698981300,38040,185014,84409,MX,MX
90436,1699096200,1699105380,9180,110421,105869,ES,ES
168277,1699689840,1699721100,31260,81096,187734,TR,TR
186905,1699220520,1699233060,12540,142797,186660,US,US
2398,1699006260,1699037820,31560,28819,2904,TR,TR
131733,1698872400,1698901980,29580,64940,2674,TR,TR
38098,1699232820,1699262340,29520,64509,110237,TR,TR
8078,1699054980,1699066560,11580,181654,152293,US,US
145432,1699329180,1699332780,3600,98775,47046,NL,NL
8607,1700126760,1700162460,35700,36042,121692,TR,TR
7280,1698800400,1698835680,35280,177199,101130,TR,TR
179830,1700055060,1700088360,33300,124797,62859,TR,TR
67430,1700237100,1700270100,33000,43593,158736,TR,TR
196871,1699423200,1699435560,12360,119870,181493,US,US
140999,1698847620,1698851220,3600,132088,101796,GB,GB
136977,1699043580,1699075680,32100,173580,82222,TR,TR
88496,1699666500,1699700640,34140,42663,197330,TR,TR
137882,1699133040,1699144260,11220,167097,27527,US,US
147317,1700241120,1700270460,29340,110247,174498,TR,TR
184088,1700655840,1700689560,33720,57174,168584,TR,TR
180444,1700488860,1700498940,10080,1701,89641,HR,DE
5265,1700380980,1700394900,13920,53996,167985,US,US
92477,1699190460,1699219020,28560,11982,5938,BR,BR
127793,1700536680,1700571300,34620,176155,190653,TR,TR
76341,1699662900,1699686900,24000,180169,155146,RO,AT
16239,1699351320,1699354920,3600,181906,137219,GB,GB
192197,1700716440,1700720040,3600,26741,109433,NL,NL
139704,1700511960,1700545740,33780,17319,1241,TR,TR
45741,1699941660,1699945260,3600,85952,91254,GB,GB
82051,1699600860,1699615980,15120,32793,12592,US,US
124509,1700655780,1700668920,13140,61716,69088,IT,IT
45109,1699595220,1699620540,25320,79564,172816,BA,HR
38259,1700683740,1700693160,9420,22391,60117,IT,IT
166035,1699033740,1699046460,12720,132189,79608,HR,HR
49053,1699217220,1699246500,29280,20217,166182,TR,TR
79281,1700041140,1700074800,33660,124620,92859,TR,BG
194247,1700299200,1700335680,36480,38657,112762,MX,MX
166706,1698886680,1698915660,28980,172552,47732,TR,TR
907,1700022000,1700043960,21960,151991,83796,DE,FR
195550,1699607520,1699664880,57360,146312,109584,UA,PL
154832,1699701240,1699734180,32940,29496,189312,TR,TR
49763,1700248800,1700279220,30420,133948,109965,TR,TR
100381,1700096880,1700135280,38400,35533,150178,MX,MX
130311,1699049700,1699057560,7860,199447,117157,IT,IT
148634,1698996000,1699004700,8700,150296,126439,IT,FR
166450,1698865860,1698884700,18840,117832,133250,FR,FR
111867,1699954560,1699987800,33240,173710,95621,TR,TR
75252,1700640060,1700656860,16800,25740,13949,FR,FR
148313,1699879560,1699897200,17640,196743,144319,US,US
122698,1699603260,1699606860,3600,58009,63264,NL,NL
88641,1699584240,1699590300,6060,99638,31670,GB,GB
192934,1699494360,1699516800,22440,160860,83611,LT,PL
189966,1700405940,1700412240,6300,130296,104054,GB,GB
4856,1699274100,1699298400,24300,127968,115316,DE,DE
142893,1700720160,1700730420,10260,43195,94100,PT,PT
1821,1699712160,1699741440,29280,137293,66596,TR,TR
186507,1700634480,1700638380,3900,160185,63896,EE,EE
116958,1700041080,1700076120,35040,117239,99,TR,TR
181053,1699861260,1699892820,31560,40245,77294,TR,TR
154466,1700866380,1700873760,7380,160606,157523,HR,HR
47697,1700385660,1700415660,30000,48954,147453,TR,TR
841,1699568160,1699577880,9720,78092,170626,IT,IT
188932,1700787660,1700820660,33000,129487,112225,MX,MX
99871,1700461080,1700477700,16620,39369,28804,US,US
38839,1700743200,1700780220,37020,58160,32480,MX,MX
11391,1699964760,1699971720,6960,138320,1814,EE,FI
2710,1699272360,1699302120,29760,145827,104003,TR,TR
163793,1699394940,1699424220,29280,16387,129257,TR,TR
92457,1699697820,1699728480,30660,141586,199263,TR,TR
99868,1699982160,1700016420,34260,195032,168705,TR,TR
117,1700193720,1700201580,7860,104447,153657,IT,IT
121088,1700597820,1700601420,3600,23698,14326,NL,NL
193767,1699623900,1699659720,35820,194034,10630,TR,TR
5115,1699595280,1699603020,7740,41158,141603,IT,IT
19420,1698827880,1698831480,3600,129891,37440,NL,NL
127536,1698949920,1698979020,29100,174124,22865,TR,TR
35925,1700554080,1700586900,32820,26968,4293,TR,TR
130807,1699596000,1699631820,35820,96162,36850,TR,TR
141321,1698801540,1698807300,5760,28386,188532,GB,GB
30376,1699743300,1699777800,34500,199948,182341,TR,TR
106845,1700051940,1700061420,9480,14126,21272,IT,IT
129940,1700778420,1700807700,29280,39295,156457,TR,TR
187852,1700658120,1700688060,29940,101174,91771,TR,TR
86991,1700783040,1700815620,32580,13257,101453,TR,TR
45727,1698940620,1698967800,27180,10221,57028,DE,DE
17375,1700386800,1700392260,5460,184468,112842,AD,ES
5385,1699424220,1699459860,35640,117398,78372,TR,TR
141780,1698802080,1698805680,3600,34194,962,GB,GB
198878,1699938120,1699951620,13500,69146,188190,CA,CA
74888,1699072740,1699079460,6720,91056,100848,EE,FI
126449,1700328600,1700363880,35280,25870,45022,TR,TR
88783,1700118780,1700137260,18480,173160,114234,SE,DK
195982,1700814000,1700841660,27660,114328,181560,DE,HU
174816,1699308840,1699312440,3600,197528,87594,NL,NL
59726,1700138760,1700155560,16800,74633,45551,US,US
101089,1699051020,1699107060,56040,170749,95627,BG,DE
153686,1699536480,1699544760,8280,94693,151068,PT,PT
144137,1700244660,1700274180,29520,12318,141977,TR,TR
156838,1700802360,1700809140,6780,116586,65615,GB,GB
113464,1698883500,1698894600,11100,117730,85732,US,US
173785,1700044320,1700048760,4440,1186,75325,GB,GB
16434,1699618740,1699622340,3600,169985,180534,GB,GB
111962,1699441560,1699450080,8520,39260,56179,HR,HR
160629,1699021560,1699027500,5940,96361,25365,GB,GB
34573,1700593740,1700598960,5220,196490,138215,GB,GB
179182,1699084680,1699120320,35640,60206,11217,TR,TR
31576,1699642800,1699670280,27480,110182,182224,DE,BG
187545,1700530980,1700553900,22920,72873,31727,DE,DE
188075,1700688840,1700701800,12960,43487,24293,HR,HR
87832,1699605000,1699636080,31080,11772,148090,TR,TR
181179,1699881000,1699887300,6300,88219,48472,EE,FI
144292,1699962420,1699970280,7860,32579,97734,FI,EE
127481,1700138520,1700171880,33360,34143,13965,TR,TR
18893,1700744580,1700777220,32640,175960,88355,TR,TR
76169,1699453020,1699459560,6540,100351,146085,GB,GB
131408,1699881240,1699887360,6120,192241,195854,GB,GB
37884,1700171880,1700189280,17400,16575,38157,US,US
112092,1699937940,1699941540,3600,61582,197393,NL,NL
105523,1700744280,1700750220,5940,80448,21360,GB,GB
120025,1700659920,1700690460,30540,188109,22631,TR,TR
131931,1699462380,1699492020,29640,175231,36676,TR,TR
87137,1700839140,1700866380,27240,174912,108826,PL,DE
16890,1700308560,1700321100,12540,124433,174208,US,US
14276,1699679040,1699707180,28140,169717,43867,DE,AT
113180,1698799440,1698813660,14220,139068,146092,IT,IT
112782,1699909020,1699916880,7860,193654,112546,HR,HR
106859,1699537800,1699563960,26160,185731,77443,PL,CZ
159557,1699438740,1699468800,30060,196332,56361,TR,TR
115739,1700199360,1700231520,32160,13736,94266,TR,TR
176890,1699710780,1699721940,11160,150475,128783,CZ,CZ
35748,1700661960,1700675100,13140,43122,133891,SK,SK
158116,1699807620,1699837200,29580,172113,20548,TR,TR
21281,1699024380,1699058280,33900,135113,184788,TR,TR
10825,1699406100,1699436280,30180,37023,25684,TR,TR
129479,1700432460,1700448060,15600,132626,146366,FR,BE
112837,1700271600,1700280060,8460,151469,67969,PT,PT
172733,1699460460,1699471620,11160,67550,116329,US,US
187700,1700750040,1700807220,57180,145326,1167,BG,BG
34519,1698917220,1698922320,5100,79045,168573,GB,GB
108325,1698816660,1698828780,12120,128713,96913,IT,IT
37624,1698979020,1698985620,6600,19,77350,GB,GB
36297,1700637120,1700668920,31800,108790,179012,TR,TR
57949,1699814400,1699849800,35400,171265,135171,TR,TR
101501,1700052240,1700078580,26340,152163,126103,ME,RS
33196,1699657500,1699673100,15600,60735,25657,FR,IT
18149,1699062300,1699080600,18300,2223,95451,FR,DE
14553,1699658940,1699662540,3600,150055,97573,GB,GB
95637,1700113680,1700127480,13800,124990,164712,ES,ES
143239,1699860120,1699895340,35220,57100,84008,TR,TR
36387,1699795980,1699802940,6960,8736,40964,GB,GB
82325,1700035920,1700068800,32880,157472,30220,TR,TR
42599,1700658480,1700689020,30540,135103,56445,TR,TR
47727,1698951780,1698963600,11820,155482,155441,US,US
51901,1700852400,1700861820,9420,9353,185276,PT,PT
56586,1700783520,1700817300,33780,179695,180402,TR,TR
64408,1700067600,1700073060,5460,28370,105472,NL,NL
190704,1700308740,1700340840,32100,94915,14409,TR,TR
15542,1700150460,1700159460,9000,98741,88161,FI,EE
11546,1699160520,1699164120,3600,86571,23463,GB,GB
109742,1698889680,1698912360,22680,95214,94355,PL,PL
95768,1700185620,1700208000,22380,1908,19293,PL,PL
53289,1700221320,1700224920,3600,68765,21127,GB,GB
172963,1700313780,1700336100,22320,71461,54213,HU,PL
64373,1699261200,1699275420,14220,177772,159257,US,US
52825,1699930680,1699961820,31140,194381,154139,TR,TR
12606,1699896120,1699908360,12240,21019,53293,AT,BA
44800,1698965280,1698978300,13020,133129,197373,IT,IT
95509,1700862420,1700895300,32880,171124,17170,TR,TR
136972,1700739180,1700770920,31740,174806,68472,TR,TR
33015,1699732800,1699747020,14220,155934,43792,RS,MK
178851,1699425060,1699432680,7620,47510,3683,IT,HR
19172,1700400420,1700430420,30000,74005,175952,TR,TR
72701,1699351260,1699378260,27000,176162,198821,PL,NL
71983,1699271700,1699288920,17220,150878,121153,US,US
42701,1700327100,1700360700,33600,131170,43587,TR,TR
155667,1700557560,1700586840,29280,46330,190268,TR,TR
45310,1700725380,1700742660,17280,102008,195785,FR,DE
107392,1700286480,1700301780,15300,105413,95825,RS,ME
3720,1699470480,1699500480,30000,137609,98866,TR,TR
17589,1700114280,1700122800,8520,170307,35392,SK,AT
74155,1700142900,1700146500,3600,125175,180858,NL,NL
161543,1700458380,1700489160,30780,53023,75000,TR,TR
6379,1699815540,1699839060,23520,33730,75701,DE,BG
36445,1700040180,1700073660,33480,37137,72117,TR,TR
19961,1700165640,1700169240,3600,178342,60858,GB,GB
15523,1699341000,1699346160,5160,150452,7254,NL,NL
146521,1700094480,1700098320,3840,143373,111871,NL,AT
195814,1700582520,1700595180,12660,102129,114804,ES,ES
46814,1699688700,1699721100,32400,4079,82212,TR,TR
32117,1699509000,1699512600,3600,41218,1315,GB,GB
61158,1699604040,1699613340,9300,24634,30803,EE,EE
90419,1700726280,1700760180,33900,143482,180812,TR,TR
184564,1700753580,1700765220,11640,88288,148560,US,US
33204,1700505480,1700518560,13080,74123,74697,IT,IT
87580,1700124840,1700137920,13080,92612,161372,HR,HR
72299,1698852960,1698856560,3600,192876,125043,GB,GB
17892,1699556340,1699583760,27420,77610,59589,CH,IT
3861,1700012040,1700044260,32220,60828,1676,TR,TR
140233,1700156400,1700188260,31860,52398,129336,TR,TR
128063,1699144620,1699180380,35760,84644,180906,TR,TR
77772,1699323540,1699377360,53820,29454,84325,BG,AT
75785,1699097280,1699129380,32100,115645,182457,TR,TR
64067,1699352700,1699386420,33720,7651,41051,TR,TR
86672,1700089740,1700097960,8220,172559,73798,PT,PT
47904,1699091640,1699110300,18660,177470,70278,FR,FR
113805,1699792320,1699824720,32400,44315,53129,TR,TR
113617,1699091100,1699121700,30600,188194,31600,TR,TR
187911,1700546340,1700558640,12300,80992,52799,US,US
107266,1699792860,1699807500,14640,65895,82302,US,US
30057,1700115060,1700128500,13440,53051,167109,HR,DE
194846,1700497860,1700507340,9480,38762,94461,GR,BG
89171,1700624400,1700642340,17940,167013,117604,US,US
53086,1699403100,1699413300,10200,163463,176790,HR,HR
80827,1699327260,1699343640,16380,131115,2321,US,US
69549,1699242000,1699253340,11340,162562,104884,IT,IT
47583,1700242860,1700252340,9480,194589,128022,HR,HR
13754,1699286040,1699319820,33780,88844,134874,TR,TR
190843,1699011600,1699016040,4440,183965,92706,GB,GB
33023,1699701480,1699714440,12960,190026,76701,US,US
179415,1699492860,1699505160,12300,40814,194664,ES,ES
130767,1700813760,1700823840,10080,141794,65109,IT,IT
131359,1699840860,1699857540,16680,75712,19517,US,US
118982,1700484720,1700515440,30720,17979,54824,TR,TR
62852,1700823960,1700840460,16500,143925,37705,FR,FR
56302,1699404840,1699427220,22380,107528,167818,CH,IT
6425,1700798280,1700812620,14340,58323,103414,US,US
67739,1699299420,1699327080,27660,195481,56072,DE,DE
189481,1699090620,1699094220,3600,81041,147203,GB,GB
8483,1700595840,1700604240,8400,67914,137942,IT,IT
181270,1699547640,1699551240,3600,177654,48126,GB,GB
169580,1698821520,1698850560,29040,15544,104273,TR,TR
18439,1700815560,1700819160,3600,67898,182623,GB,GB
116820,1700421120,1700445720,24600,39912,47405,DE,MK
116633,1700837400,1700841000,3600,105980,20443,NL,NL
197092,1700548020,1700565000,16980,86702,96896,FR,NL
28934,1699181820,1699214460,32640,102569,56590,TR,TR
130745,1700443800,1700459760,15960,77587,94345,FR,FR
119827,1699218900,1699223580,4680,183004,196333,GB,GB
166383,1700383140,1700416440,33300,78987,109957,TR,TR
182161,1699729980,1699763820,33840,28114,179536,TR,TR
98588,1698861180,1698895200,34020,22185,106067,TR,TR
123537,1699132080,1699146060,13980,70433,198543,IT,IT
43405,1700149560,1700153880,4320,16718,198421,NL,NL
28307,1700087820,1700120460,32640,166226,104011,TR,TR
102509,1699155720,1699186560,30840,52729,147416,TR,TR
43651,1700264820,1700299440,34620,122145,26271,TR,TR
170857,1699971840,1700003820,31980,115031,17243,TR,TR
134869,1700386740,1700420760,34020,126626,180385,TR,TR
176561,1699620720,1699652880,32160,134836,95000,TR,TR
164241,1700320860,1700329680,8820,36957,175,HR,BA
7162,1699673760,1699697460,23700,83263,181583,HU,AT
149863,1699733100,1699766100,33000,87967,83202,TR,TR
139495,1699968240,1700006880,38640,2321,39233,MX,US
176657,1699966680,1700001180,34500,197665,16826,TR,TR
82881,1700520000,1700551500,31500,170922,47909,TR,TR
94763,1699333860,1699363920,30060,68353,69387,TR,TR
182170,1700372400,1700380740,8340,66444,4007,IT,IT
144104,1699788840,1699817640,28800,61556,121901,TR,TR
73284,1699471380,1699477200,5820,91354,182036,GB,GB
158393,1700198100,1700215560,17460,59928,8924,FR,FR
124980,1699641780,1699673820,32040,191330,43781,TR,TR
127,1699784280,1699821600,37320,142467,56756,MX,US
42561,1699904760,1699934460,29700,51078,34455,TR,TR
165275,1699700940,1699716180,15240,14616,191435,AT,AT
114939,1699289340,1699325820,36480,86113,58818,MX,MX
56514,1699672440,1699702920,30480,44689,148040,TR,TR
168082,1700305440,1700343960,38520,12078,2171,MX,MX
36412,1700196060,1700209440,13380,159190,85034,IT,IT
97778,1698939360,1698969120,29760,167872,22801,TR,TR
86797,1698960300,1698990240,29940,108915,40506,TR,TR
34097,1699274940,1699304040,29100,51859,158887,TR,TR
54295,1700662800,1700702280,39480,69416,55944,MX,MX
133625,1699050900,1699058820,7920,124705,156318,IT,HR
182772,1699630200,1699660020,29820,98627,78118,TR,TR
172522,1698979980,1699013820,33840,108988,36443,TR,TR
46268,1700787840,1700804580,16740,125540,74203,US,US
104333,1700218380,1700250120,31740,62212,188022,TR,TR
36952,1698856260,1698885960,29700,87942,129956,TR,TR
84081,1700045880,1700059320,13440,183922,131567,CZ,CZ
166924,1699315140,1699318740,3600,65703,169857,NL,NL
59637,1700255160,1700263260,8100,32383,193492,IT,IT
112133,1699864260,1699869060,4800,95394,76950,GB,GB
152912,1699950960,1699985760,34800,92896,10117,TR,TR
163235,1699081980,1699090560,8580,136002,70084,PT,PT
158517,1700017200,1700034720,17520,68623,95257,US,US
158889,1700530560,1700561820,31260,84022,17092,TR,TR
5821,1700699640,1700703240,3600,43054,112163,GB,GB
130313,1699804860,1699808460,3600,2157,113284,GB,GB
52608,1699690500,1699694100,3600,119120,160752,NL,BE
89219,1700512140,1700523900,11760,44317,40305,US,US
191641,1699644720,1699653060,8340,92522,95076,IT,IT
76849,1700099940,1700130480,30540,7288,12390,TR,TR
47684,1699925520,1699961040,35520,101835,8592,TR,TR
194438,1700245200,1700249520,4320,171712,8014,NL,NL
68293,1700609280,1700612880,3600,135861,69251,NL,NL
52543,1700747100,1700758500,11400,162957,177551,CA,CA
51105,1699063080,1699075140,12060,4209,189141,US,US
185394,1700408100,1700418900,10800,192123,153095,PT,PT
73740,1700479020,1700493840,14820,10836,24568,FR,FR
29393,1699367040,1699383720,16680,179742,148623,US,US
107869,1700456580,1700468160,11580,123944,160439,IT,FR
140902,1698897720,1698928980,31260,139817,90145,TR,TR
91692,1700396940,1700427960,31020,116885,106808,TR,TR
79819,1700663040,1700695200,32160,9207,165641,TR,TR
190223,1699416540,1699422360,5820,115946,93512,GB,GB
113616,1699046400,1699065960,19560,80028,63097,DK,DK
166376,1698916800,1698930540,13740,134958,180814,ES,ES
62264,1699449600,1699480680,31080,50282,131739,TR,TR
38538,1699248480,1699277340,28860,14469,44101,TR,TR
163272,1700319420,1700323020,3600,33897,1325,GB,GB
181767,1700000160,1700032620,32460,93782,8543,TR,TR
2815,1699831320,1699846140,14820,19953,165195,US,US
153554,1700617980,1700622600,4620,186332,42120,NL,NL
37703,1699882500,1699886520,4020,11162,196604,GB,GB
139953,1699018800,1699035180,16380,111535,172681,FR,FR
132673,1699692300,1699728180,35880,58087,164152,TR,TR
24809,1700524380,1700557500,33120,150565,12837,TR,TR
164350,1700553900,1700571420,17520,42020,187126,FR,BE
68302,1700471340,1700487840,16500,10247,22767,FR,DE
155055,1698906720,1698939180,32460,121306,55731,TR,TR
58890,1700833140,1700859000,25860,38362,87051,PL,PL
83162,1699808040,1699818180,10140,26630,55719,IT,IT
47729,1699378200,1699411380,33180,41175,73442,TR,TR
86914,1699732920,1699768080,35160,91248,91717,TR,TR
177125,1699934820,1699969980,35160,51331,180859,TR,TR
33329,1700389680,1700407320,17640,177231,17260,US,US
68973,1700534040,1700558280,24240,103526,166883,BR,BR
80798,1700004300,1700039460,35160,31270,37907,TR,TR
98067,1699010220,1699035180,24960,142658,1796,DE,HR
104591,1700108040,1700141640,33600,113667,99683,TR,TR
57114,1700773260,1700791020,17760,123670,65493,RS,RS
7889,1700706000,1700709600,3600,102179,129696,GB,GB
28779,1699403160,1699410060,6900,154274,14686,GB,GB
167372,1699678020,1699691160,13140,124935,40388,ES,ES
175868,1699378860,1699408800,29940,56878,127608,TR,TR
51859,1699564800,1699578960,14160,117797,78129,IT,IT
161457,1699044360,1699050120,5760,32309,19592,NL,NL
125396,1700563380,1700578800,15420,80679,38571,US,US
190639,1700081820,1700115720,33900,71253,199380,TR,TR
59660,1699977060,1699993380,16320,96010,199785,US,US
86523,1700234280,1700240640,6360,32001,144679,NL,NL
90688,1700508540,1700528820,20280,43418,30857,BE,NL
22564,1700755500,1700762820,7320,149153,132020,IT,IT
69780,1700744640,1700771940,27300,87435,131963,DE,BG
131904,1699863240,1699875240,12000,196269,145204,PT,PT
76456,1700284320,1700289120,4800,32887,56226,NL,PL
30672,1699781220,1699800240,19020,96126,72906,FR,DE
31631,1700175960,1700209920,33960,49713,24316,TR,TR
125976,1700850960,1700861880,10920,35660,159558,US,US
103682,1700586300,1700620080,33780,104011,95012,TR,TR
95067,1700428920,1700458860,29940,165688,105846,TR,TR
34619,1698810720,1698844020,33300,150420,137615,TR,TR
141809,1700779380,1700794020,14640,5494,34431,US,US
76196,1699241100,1699253820,12720,18478,36986,IT,IT
124480,1699749420,1699762740,13320,46146,87909,CZ,CZ
167600,1699199400,1699203720,4320,133722,162633,GB,GB
30957,1699033320,1699037640,4320,128126,188117,GB,GB
50527,1698835080,1698865620,30540,115662,149154,BA,DE
10637,1699533600,1699566000,32400,116243,162145,TR,TR
120344,1700607660,1700662800,55140,4869,127312,UA,PL
106439,1700727960,1700747400,19440,65292,4544,FR,DE
86337,1700427540,1700455260,27720,93280,51406,BR,BR
56732,1700487000,1700518620,31620,5348,38130,TR,TR
7258,1698842220,1698873660,31440,187923,32190,TR,TR
29301,1700189520,1700219400,29880,170448,58724,MK,DE
43197,1699378140,1699404780,26640,123189,38916,DE,UA
169042,1698802620,1698806220,3600,92468,124067,NL,NL
86960,1699491420,1699522080,30660,130467,69491,TR,TR
151876,1700713740,1700728740,15000,118917,30768,US,US
101685,1700339700,1700358000,18300,78403,140650,FR,FR
60484,1699267500,1699297860,30360,183859,193722,TR,TR
128935,1700032560,1700057520,24960,90050,51299,BR,BR
92728,1700845740,1700854500,8760,122243,7285,HR,HR
64824,1700422920,1700441580,18660,117116,135533,SE,SE
145378,1700020860,1700036040,15180,81672,14775,US,US
199373,1699937820,1699954920,17100,3938,163088,US,US
178046,1699294560,1699329420,34860,13895,137968,TR,TR
180802,1700484660,1700491620,6960,175202,123854,CL,CL
35502,1700584200,1700587800,3600,164067,51968,NL,NL
35432,1699263780,1699273740,9960,162055,112628,IT,IT
93450,1699228020,1699263240,35220,87245,180848,TR,TR
54823,1699861800,1699891920,30120,47205,125394,TR,TR
59965,1700107440,1700115360,7920,26111,49440,SK,SK
62200,1699950300,1699984260,33960,39143,20001,TR,TR
44767,1699834020,1699851420,17400,61672,126462,US,US
192796,1699958820,1699971240,12420,48821,11442,US,US
150095,1699300860,1699315560,14700,54136,155246,AT,AT
77459,1699037640,1699065180,27540,168388,89938,DE,DE
4615,1699933320,1699969440,36120,132500,119041,MX,MX
157714,1700655540,1700668260,12720,119887,64673,US,US
193349,1700668380,1700697480,29100,152962,126442,TR,TR
46990,1698808380,1698815340,6960,129010,185050,EE,EE
172273,1700273460,1700283540,10080,147402,64486,PT,PT
96979,1699090380,1699125360,34980,189207,45959,MX,MX
47407,1699883700,1699887300,3600,133292,157282,GB,GB
127517,1699008180,1699037460,29280,186742,49930,TR,TR
158991,1699256220,1699265400,9180,131700,122062,IT,IT
38908,1699237980,1699246500,8520,185518,86303,PT,PT
92375,1699243320,1699274340,31020,53192,54458,TR,TR
35377,1700124360,1700128140,3780,34307,71442,GB,GB
20828,1699101180,1699132980,31800,90586,147575,TR,TR
147694,1698838980,1698893760,54780,66846,65403,BG,DE
27840,1699414440,1699449180,34740,136809,96140,TR,TR
128606,1700119500,1700141580,22080,15165,136770,DE,PL
76815,1700290440,1700294040,3600,59003,119379,GB,GB
140849,1699301820,1699313460,11640,139701,98353,PT,PT
36044,1699832460,1699836060,3600,105823,77488,GB,GB
179273,1699471860,1699475460,3600,159055,131357,NL,NL
39166,1699507740,1699538280,30540,156181,57764,TR,TR
110072,1700719980,1700737140,17160,383,13383,FR,AD
140795,1698917640,1698947640,30000,115948,20466,BA,RS
167092,1699242480,1699265820,23340,186091,194789,RO,RO
111637,1699370760,1699398900,28140,131876,138277,BR,BR
165054,1700665500,1700669100,3600,29857,136907,GB,GB
67227,1699538160,1699568220,30060,185376,47630,TR,TR
99530,1700102760,1700114340,11580,173115,2554,US,US
185654,1698873660,1698885120,11460,92660,28240,PT,PT
108969,1699043280,1699068780,25500,55198,183435,BR,BR
23854,1698864060,1698890940,26880,197602,137117,BR,BR
183859,1699735740,1699744080,8340,166779,72424,IT,IT
86984,1699090140,1699094460,4320,106186,49452,GB,GB
103566,1699552740,1699579740,27000,99920,48459,PL,PL
13386,1700727420,1700748120,20700,45785,67020,FR,FR
103248,1698862560,1698868860,6300,76775,44144,GB,GB
118636,1698925200,1698938340,13140,58225,4322,US,CA
181941,1699486560,1699499580,13020,140128,111721,IT,IT
106510,1699505520,1699531800,26280,160153,19502,DE,CZ
158115,1699658340,1699692540,34200,139989,53903,TR,TR
14579,1700097300,1700127540,30240,110935,128282,TR,TR
97382,1699340820,1699358340,17520,133421,165546,US,US
96269,1700147700,1700159340,11640,122557,65349,HR,HR
51238,1700670240,1700703780,33540,64609,109495,TR,TR
67804,1700094600,1700098200,3600,14018,191701,NL,NL
15644,1699674240,1699687860,13620,98447,179600,SK,AT
139920,1698950220,1698964980,14760,58148,134337,RS,HR
145267,1700571000,1700576340,5340,91823,160173,GB,GB
103889,1699494840,1699529400,34560,76074,31842,TR,TR
85611,1700346900,1700382240,35340,16728,110196,TR,TR
37588,1699514160,1699525560,11400,129998,110388,AT,DE
29421,1699582500,1699591080,8580,9890,75601,EE,EE
66578,1698824760,1698854100,29340,63677,12970,TR,TR
144485,1698997740,1699004280,6540,189932,107489,GB,GB
168348,1699474080,1699504140,30060,58900,96450,TR,TR
189360,1698824940,1698838320,13380,98657,30303,US,US
60841,1698942060,1698971640,29580,170069,80336,TR,TR
146664,1699336500,1699366140,29640,143594,154289,TR,TR
88295,1700309520,1700313120,3600,60141,183230,NL,BE
117871,1700397120,1700429580,32460,30908,93372,TR,TR
108432,1700136660,1700169060,32400,67758,87840,TR,TR
40093,1700310540,1700343060,32520,108832,85301,TR,TR
41303,1699784100,1699787700,3600,26649,177971,NL,NL
190080,1699750560,1699784160,33600,96445,192593,TR,TR
5960,1699513500,1699547700,34200,75200,152503,TR,TR
75229,1700425260,1700458680,33420,85767,103148,TR,TR
152733,1699247400,1699278600,31200,189093,37872,TR,TR
53393,1699832700,1699856580,23880,139811,175857,DE,DE
55342,1699256640,1699290420,33780,182831,96127,TR,TR
131735,1700470440,1700474040,3600,35240,7678,GB,GB
148806,1699384260,1699423620,39360,43856,144715,MX,MX
140426,1698801780,1698816960,15180,181371,8277,US,US
38951,1699661760,1699696440,34680,49533,59832,TR,TR
52613,1698937020,1698951480,14460,113264,15390,US,US
36207,1699931640,1699967520,35880,22250,79309,TR,TR
92476,1699207620,1699214700,7080,51494,62205,GB,GB
23581,1699872300,1699884240,11940,72033,97415,RS,RS
24286,1700056080,1700087580,31500,121609,87080,TR,TR
163284,1699619760,1699630620,10860,83065,177,US,US
165865,1699742520,1699775400,32880,121351,86398,TR,TR
185539,1700133720,1700139480,5760,1317,188340,GB,GB
67427,1700041200,1700044800,3600,194204,5007,NL,NL
13609,1700840100,1700852760,12660,171377,19980,US,US
59924,1700859420,1700895180,35760,128822,80300,TR,TR
128624,1699926060,1699938360,12300,52545,91556,CZ,UA
11141,1700797440,1700827860,30420,163066,74611,TR,TR
139476,1698963240,1698967320,4080,105222,109179,NL,NL
52382,1700836080,1700858220,22140,114849,33534,RO,RO
149024,1700287020,1700320260,33240,46351,23170,TR,TR
140957,1700258460,1700262060,3600,146308,166457,GB,GB
12148,1700003880,1700032800,28920,62866,4246,TR,TR
153003,1699057620,1699068240,10620,29442,11071,ES,ES
188900,1698794520,1698824520,30000,71509,170071,TR,TR
16491,1699755000,1699767660,12660,197829,175462,US,CA
24042,1700280600,1700304060,23460,9768,116937,HU,AT
113833,1699495680,1699499280,3600,76874,3428,NL,NL
167392,1699341540,1699347180,5640,97159,178309,NL,NL
106073,1699139040,1699147980,8940,163989,56808,FI,EE
189107,1700742780,1700759580,16800,17925,141210,US,US
4398,1698880020,1698898800,18780,21376,54494,FR,FR
185962,1699727280,1699762680,35400,109107,175115,TR,TR
170927,1700104200,1700137620,33420,154646,132320,TR,TR
153253,1699393860,1699406820,12960,148457,5131,IT,IT
85852,1699132980,1699150500,17520,106133,111554,SE,SE
144128,1699830240,1699842120,11880,184487,67878,IT,IT
39743,1699343100,1699372980,29880,164628,13471,TR,TR
62066,1700681040,1700688720,7680,189083,181980,IT,IT
101649,1700277840,1700311440,33600,135131,35222,TR,TR
128486,1700804940,1700808540,3600,196749,194082,GB,GB
68733,1699057500,1699064220,6720,104916,63466,NL,NL
22596,1699329840,1699363740,33900,109279,6468,TR,TR
88716,1699566120,1699570320,4200,170022,158045,GB,GB
170377,1698865380,1698868980,3600,59865,157927,GB,GB
86608,1700148480,1700165340,16860,192471,37232,US,US
142656,1699729320,1699759740,30420,152925,114710,TR,TR
131041,1699412880,1699443840,30960,110580,90406,TR,TR
74313,1698832680,1698866940,34260,109822,44651,MX,MX
32797,1700141760,1700155200,13440,177349,61652,AT,AT
132553,1698884640,1698896280,11640,14194,19396,IT,IT
92131,1699421220,1699438020,16800,161392,129058,AT,AT
48557,1700725260,1700733780,8520,15466,188569,IT,IT
167945,1698883920,1698888960,5040,106302,132473,NL,NL
40327,1699245480,1699281420,35940,142299,8158,TR,TR
171044,1700427660,1700461680,34020,120986,57755,TR,TR
136947,1699600980,1699634040,33060,27575,70655,TR,TR
122599,1700695020,1700698620,3600,156257,35160,GB,GB
41463,1699812900,1699818480,5580,159401,67798,GB,GB
147295,1700054460,1700080080,25620,182311,161991,DE,NL
50940,1699809540,1699825080,15540,32776,156849,US,US
17160,1700567280,1700578560,11280,68766,154303,HR,HR
132362,1699461240,1699490040,28800,145450,100797,TR,TR
75147,1700287140,1700297640,10500,131327,99695,IT,IT
71690,1698827580,1698858720,31140,40915,36741,TR,TR
69771,1699079220,1699111080,31860,143632,63779,TR,TR
90541,1700224140,1700237040,12900,65233,64781,HR,HR
90879,1699702800,1699727460,24660,55914,144423,HU,RS
30960,1699735680,1699749000,13320,126201,7324,US,US
74987,1700261520,1700284020,22500,105827,79558,PL,CZ
85499,1698841320,1698845400,4080,109544,76998,EE,EE
164573,1699528920,1699540020,11100,199013,160626,SK,SK
169433,1699073580,1699081860,8280,47016,100735,PT,PT
86482,1699305240,1699320360,15120,157036,125700,FR,FR
86818,1699507320,1699517640,10320,105535,169877,IT,IT
75235,1700753220,1700786220,33000,8711,5299,TR,TR
133096,1699863600,1699894920,31320,109569,55416,TR,TR
39660,1700355900,1700365800,9900,193913,170055,IT,IT
35813,1699835460,1699839060,3600,152923,3779,GB,GB
61097,1699239600,1699251360,11760,170041,47364,IT,IT
89896,1700001300,1700034540,33240,11893,43614,TR,TR
2574,1699979640,1699987800,8160,32513,145458,ES,ES
12601,1699724760,1699737240,12480,198296,13838,HR,HR
18933,1700610900,1700615340,4440,152355,152217,NL,NL
172698,1700696460,1700712240,15780,175082,146979,AT,AT
10527,1700404200,1700431020,26820,28512,58077,BA,DE
162854,1700428680,1700460660,31980,52535,103245,TR,TR
149340,1699993440,1700023140,29700,80901,159670,TR,TR
3364,1700342400,1700355660,13260,113014,20607,US,US
159929,1699321500,1699325100,3600,171931,75959,GB,GB
161066,1699357860,1699364340,6480,96303,159661,GB,GB
6055,1699647060,1699681740,34680,66291,191163,TR,TR
180503,1699393560,1699429380,35820,16749,23881,TR,TR
7302,1699041660,1699061580,19920,53368,114408,DK,DK
30856,1699226040,1699260720,34680,78784,65486,TR,TR
191489,1699614420,1699620720,6300,623,20575,NL,NL
182380,1699759200,1699762800,3600,159431,154562,GB,GB
3810,1699305480,1699314240,8760,165227,104851,ES,FR
10698,1700180880,1700215680,34800,56809,135556,TR,TR
92587,1700239020,1700242620,3600,11690,198740,GB,GB
54223,1700517780,1700538960,21180,51178,82151,DK,NO
32145,1699441080,1699444680,3600,155771,57039,GB,GB
133377,1699284120,1699297140,13020,20204,32741,ES,ES
65369,1700454660,1700470620,15960,12757,21637,US,US
23626,1700465760,1700478720,12960,134138,74831,US,US
159051,1698930660,1698955500,24840,161895,89464,RO,RO
20253,1698835320,1698847080,11760,41195,3949,US,US
126277,1700533200,1700547540,14340,20699,110639,US,US
95068,1699193280,1699196880,3600,157151,35713,GB,GB
137597,1700039460,1700049660,10200,34353,74478,PT,PT
73240,1700783940,1700796660,12720,191697,79385,IT,IT
86087,1699066440,1699090380,23940,163926,35506,DE,DE
147692,1699458840,1699471200,12360,65739,85407,CZ,EE
45427,1700416020,1700440080,24060,128106,66115,DE,DE
180896,1700819160,1700831220,12060,197789,88185,IT,IT
167307,1699156980,1699178880,21900,197313,62441,BR,BR
920,1700129040,1700133480,4440,15832,51152,GB,GB
113478,1700343060,1700369340,26280,14546,196580,DE,DE
75519,1699786740,1699791900,5160,170097,79379,EE,EE
90433,1700526840,1700540700,13860,153834,152957,IT,IT
146009,1698959820,1698966180,6360,169316,36003,NL,NL
47103,1700189280,1700192880,3600,148577,94623,NL,NL
177441,1699264560,1699268160,3600,15807,126312,GB,GB
5114,1699037460,1699048740,11280,121415,167706,IT,IT
13092,1698911340,1698914940,3600,189691,18315,NL,NL
121541,1700556420,1700577420,21000,152604,139585,MD,UA
198541,1699386240,1699421280,35040,36879,164157,TR,TR
170111,1699370820,1699386660,15840,158871,13945,US,US
189144,1699976880,1700004060,27180,178620,147734,BR,BR
7497,1699611060,1699621380,10320,170996,114476,IT,FR
71680,1700383500,1700405460,21960,167389,76530,DE,AT
74924,1700100060,1700111040,10980,110457,109762,US,US
76484,1700360760,1700383080,22320,103443,182032,DE,HU
58852,1699315860,1699349820,33960,178756,58589,TR,TR
67548,1700658060,1700687400,29340,28934,51266,TR,TR
22523,1699119780,1699154580,34800,125140,143465,TR,TR
120053,1699400400,1699408680,8280,124134,193809,HR,HR
197997,1699747740,1699758780,11040,73910,196289,CZ,DE
53938,1699370520,1699391640,21120,191395,92855,FR,FR
16332,1699766400,1699770000,3600,196281,78994,GB,GB
197324,1699085280,1699123980,38700,182818,139379,MX,MX
87024,1699335600,1699370520,34920,17946,56522,TR,TR
23331,1699065480,1699079700,14220,176980,36559,ES,ES
137454,1699965780,1699982100,16320,74113,174194,US,US
119013,1700738820,1700742420,3600,115761,131456,GB,GB
79729,1699523640,1699529940,6300,190489,184041,GB,GB
122808,1699085820,1699106700,20880,148464,13790,BE,HR
129321,1698824940,1698834120,9180,73855,193657,IT,IT
159031,1699836900,1699862640,25740,52323,52627,PL,PL
73424,1699616520,1699633860,17340,11898,17749,AT,BA
6751,1699869180,1699898640,29460,98789,93406,TR,TR
63225,1699769700,1699800120,30420,128077,196418,TR,TR
134540,1699834380,1699848900,14520,196588,59920,BE,SK
2982,1699785000,1699792800,7800,152711,2051,PT,PT
47238,1699491660,1699501920,10260,88967,116419,IT,IT
89097,1700245680,1700275380,29700,104367,94436,TR,TR
66818,1699461120,1699490340,29220,6844,71109,TR,TR
15427,1700331660,1700348940,17280,24191,121409,US,US
10099,1699516680,1699549680,33000,30964,111134,TR,TR
90332,1700821380,1700852100,30720,116665,89609,TR,TR
57579,1700685300,1700697660,12360,25463,4044,US,US
21586,1699939500,1699955580,16080,185783,68667,CA,US
119197,1698838980,1698874560,35580,75913,29327,TR,TR
107935,1699064520,1699078020,13500,45826,14565,US,US
1283,1700751660,1700760000,8340,87934,181392,IT,IT
75632,1700827980,1700836680,8700,132939,29319,EE,EE
9373,1699107480,1699137120,29640,54736,142890,TR,TR
97767,1699950720,1699983960,33240,134331,187584,TR,TR
141027,1700381880,1700391780,9900,148516,191346,EE,EE
150017,1700122920,1700153220,30300,84848,25161,TR,TR
122143,1699469040,1699480440,11400,154857,21510,IT,IT
95071,1700021280,1700027640,6360,41393,17357,NL,NL
185016,1700662980,1700690400,27420,138702,89331,RO,DK
55880,1700798460,1700816580,18120,24475,28612,FR,FR
169148,1698825300,1698850860,25560,133479,165387,PL,PL
150312,1699990080,1700019960,29880,51141,196285,TR,TR
6660,1699533540,1699537140,3600,193536,101138,NL,NL
98971,1699895100,1699899300,4200,151998,146020,AD,ES
73249,1698957720,1698969180,11460,67620,44711,HR,HR
63992,1699206000,1699214340,8340,42133,159232,PT,PT
160980,1700095980,1700108160,12180,82969,187155,IT,IT
120552,1699733160,1699762560,29400,120563,179582,TR,TR
181969,1699658460,1699688040,29580,9158,32614,TR,TR
64038,1698980760,1698993300,12540,4851,16738,US,US
194150,1699431180,1699443780,12600,9773,90360,US,US
95488,1700825640,1700832000,6360,125333,75830,GB,GB
164566,1700078340,1700102040,23700,106621,47674,DE,DE
74643,1699778760,1699814040,35280,103800,173627,TR,TR
115809,1699728900,1699743480,14580,169400,60733,US,US
63267,1700334420,1700356980,22560,85019,5689,RO,RO
44528,1699686240,1699703280,17040,18605,130341,US,US
106744,1700168160,1700174400,6240,174221,120751,NL,NL
169681,1699238040,1699250400,12360,156200,178422,ES,ES
45897,1699943820,1699952760,8940,135195,65786,IT,IT
150289,1699040220,1699045080,4860,101716,152355,NL,NL
117319,1699230420,1699234020,3600,108919,121264,GB,GB
110617,1698851940,1698855540,3600,66973,56574,GB,GB
158128,1699237200,1699244820,7620,148379,182943,IT,IT
30017,1700643660,1700674800,31140,76878,98480,TR,TR
20703,1700760120,1700794680,34560,191238,155251,MX,MX
12743,1699933560,1699956660,23100,142424,55396,CH,DE
67468,1700524020,1700551080,27060,90865,108545,DE,DE
193826,1700319120,1700351040,31920,114602,125075,TR,TR
167842,1699444560,1699496880,52320,131822,65691,BG,DE
78315,1699732020,1699747260,15240,166923,184093,CZ,CZ
57055,1700379780,1700390640,10860,118299,5275,SK,SK
66197,1699691460,1699720020,28560,189909,182945,DE,DK
131454,1699253820,1699281900,28080,153343,55463,DE,DE
14147,1700468280,1700471880,3600,49014,168127,GB,GB
173966,1699181160,1699198920,17760,124632,52741,CZ,UA
27340,1698960360,1698991080,30720,34569,23443,TR,TR
42810,1699255680,1699262760,7080,10546,38881,GB,GB
116513,1699860180,1699896000,35820,48217,156458,TR,TR
67675,1699261740,1699292880,31140,19182,97537,TR,TR
156005,1699432920,1699466640,33720,121280,84303,TR,TR
195467,1700611080,1700628300,17220,121254,166068,US,US
61860,1699176180,1699210920,34740,105523,154734,TR,TR
39376,1699838760,1699848360,9600,155442,28478,EE,EE
111389,1699802280,1699810680,8400,156199,153967,IT,IT
123093,1700005320,1700034600,29280,51623,106353,TR,TR
56323,1699331160,1699363500,32340,125174,159189,TR,TR
188332,1700669460,1700673600,4140,100583,115821,NL,NL
98380,1700180640,1700206200,25560,164279,35444,BR,BR
75361,1700208960,1700223480,14520,113868,60252,US,US
177159,1699327740,1699349280,21540,60191,156607,SI,RS
18088,1698997320,1699006860,9540,124841,120069,IT,IT
68634,1700198460,1700228220,29760,114466,125128,TR,TR
135158,1699954320,1699971960,17640,178947,64336,US,US
79392,1700204700,1700239320,34620,120080,93621,TR,TR
51463,1700658840,1700687100,28260,529,23397,DE,DK
132806,1698843360,1698872160,28800,187590,106097,TR,TR
134866,1699090920,1699126320,35400,19587,144458,TR,TR
194707,1699437360,1699473240,35880,27953,119780,TR,TR
27255,1700295300,1700327880,32580,163734,175401,TR,TR
2009,1699581480,1699591260,9780,59563,81384,IT,IT
63749,1698817680,1698853020,35340,136803,34014,TR,TR
112985,1700660820,1700693280,32460,141698,131902,TR,TR
51980,1699302660,1699309980,7320,50452,50000,EE,FI
98424,1699096980,1699109820,12840,63755,134727,US,US
71021,1700664180,1700681760,17580,184177,8008,US,US
56831,1700527680,1700531280,3600,121656,51245,NL,NL
159620,1699960320,1699972140,11820,158232,182018,US,US
119952,1698972720,1698997920,25200,76260,97738,PL,AT
132762,1700154300,1700167380,13080,23460,195143,IT,IT
46952,1699467360,1699481100,13740,159075,44514,HR,HR
83154,1699253160,1699257780,4620,36501,180294,NL,NL
73110,1699171380,1699179780,8400,179539,125321,ES,ES
4914,1699875060,1699878660,3600,112898,196895,GB,GB
90116,1700745840,1700770140,24300,72280,148375,DE,DE
56095,1699905540,1699911540,6000,125115,97499,GB,GB
110866,1700561580,1700587860,26280,82250,76753,BR,BR
27291,1698878700,1698904560,25860,115416,9194,HU,RS
81841,1699598100,1699630560,32460,49645,14680,TR,TR
47653,1698796800,1698800400,3600,67343,170424,GB,GB
80132,1699619640,1699651740,32100,118975,21966,TR,TR
45526,1698973920,1698983400,9480,142535,10146,IT,IT
159448,1699307160,1699341540,34380,115757,43249,TR,TR
197995,1700240160,1700243760,3600,80554,137291,NL,FR
152767,1699993620,1700018760,25140,103167,43861,SI,RS
154532,1699928640,1699960140,31500,118053,99805,TR,TR
190314,1700450640,1700460300,9660,78153,86189,IT,IT
16583,1700579040,1700601180,22140,144809,189712,HU,DE
199236,1699988760,1700003100,14340,166558,157205,IT,IT
143591,1699670520,1699695660,25140,61113,113833,HU,FR
102014,1699730700,1699765200,34500,98835,146395,TR,TR
102507,1699814280,1699830960,16680,94072,58217,CA,CA
187332,1699356120,1699386600,30480,198407,34969,TR,TR
14920,1700198160,1700212380,14220,6999,183849,IT,IT
5800,1700529720,1700533320,3600,94149,101434,GB,GB
167196,1698798960,1698831180,32220,118882,67725,TR,TR
95977,1700849100,1700853720,4620,77438,84892,GB,GB
128837,1700620020,1700640300,20280,88201,178137,FR,IT
64685,1700130600,1700167440,36840,20864,117119,MX,MX
53494,1700206380,1700222040,15660,164465,41446,FR,FR
114983,1700519100,1700532480,13380,197587,160178,AT,AT
79772,1700481060,1700493900,12840,69210,134988,US,US
161077,1699283940,1699290780,6840,97918,162232,GB,GB
78097,1700057880,1700074200,16320,116640,178902,AT,AT
124344,1699068300,1699090200,21900,18517,162294,PL,UA
190798,1699420740,1699424340,3600,199488,7780,NL,NL
49256,1700747100,1700780340,33240,7929,146548,TR,TR
4250,1700434320,1700437920,3600,139458,2193,NL,NL
43929,1699563060,1699566660,3600,97971,25164,GB,GB
48357,1699352280,1699355880,3600,189212,36503,GB,GB
96995,1698800640,1698834360,33720,114224,126702,TR,TR
196421,1699353060,1699388520,35460,100867,93523,TR,TR
115726,1700479620,1700493360,13740,42591,106990,IT,IT
25593,1700706360,1700720580,14220,158786,19279,CZ,CZ
123979,1699175280,1699180080,4800,88511,39541,GB,DE
169118,1700197560,1700232900,35340,146640,64315,TR,TR
92106,1699085400,1699092000,6600,151116,65536,NL,NL
72382,1700525160,1700539140,13980,168710,61885,HR,HR
127342,1699062060,1699068360,6300,116948,156623,GB,GB
196539,1700260860,1700276220,15360,141948,169238,US,US
38808,1699983180,1699986780,3600,154015,196764,GB,GB
75102,1700612280,1700639760,27480,93050,82931,BR,BR
24211,1699162140,1699195500,33360,118331,79860,TR,TR
53793,1700822640,1700843880,21240,144870,169707,FR,FR
115700,1698945060,1698975900,30840,168246,22089,TR,TR
137819,1699951020,1699977780,26760,79059,187954,PL,PL
124211,1699813380,1699825740,12360,115995,151161,US,US
191252,1700820900,1700856120,35220,178579,78432,TR,TR
180320,1700144580,1700174640,30060,101019,125609,TR,TR
80548,1700785080,1700796120,11040,71639,173554,PT,PT
40400,1699844340,1699871460,27120,26875,90203,HU,PL
22399,1699355100,1699373040,17940,90496,39930,FR,FR
31931,1700080680,1700097300,16620,159582,118856,AT,SK
99512,1699167960,1699178400,10440,189287,73709,PT,PT
167581,1699086780,1699115760,28980,94319,189867,TR,TR
5847,1698946440,1698958560,12120,154850,165741,CA,US
9078,1698899520,1698923400,23880,31609,62641,PL,PL
132420,1700399340,1700432220,32880,7649,50104,TR,TR
179155,1700656980,1700690700,33720,111858,80144,TR,TR
113538,1699720500,1699737840,17340,41790,115045,US,US
64224,1700783640,1700818380,34740,20730,193151,TR,TR
178011,1698925380,1698937440,12060,20325,195612,US,US
160042,1699019520,1699052280,32760,78898,19267,TR,TR
18255,1699573020,1699587300,14280,159374,2206,CA,US
171403,1700475360,1700506320,30960,163265,184363,TR,TR
39524,1699128960,1699159680,30720,18243,123655,TR,TR
44701,1700039280,1700073960,34680,12771,199601,TR,TR
35379,1700069640,1700100540,30900,189267,73888,TR,TR
130936,1699564860,1699576260,11400,110843,174843,HR,HR
115944,1699484820,1699497120,12300,24896,122828,IT,FR
53193,1699174320,1699188660,14340,58052,94909,US,US
7740,1699940520,1699955820,15300,160682,184699,RS,BG
37509,1698859920,1698877080,17160,62180,83622,FR,BE
105950,1699431180,1699434780,3600,163395,113174,NL,DE
193402,1700050560,1700088120,37560,144905,152696,MX,MX
44546,1699955340,1699985280,29940,102875,79789,TR,TR
60931,1700462040,1700474340,12300,40181,146077,PT,PT
9756,1698929820,1698940020,10200,94645,36216,IT,IT
50052,1699317420,1699335960,18540,105946,194105,FR,IT
77549,1698875400,1698909600,34200,3785,1010,TR,TR
298,1699168920,1699200120,31200,172028,76092,TR,TR
12846,1699784760,1699788360,3600,115876,193823,GB,GB
10260,1700652240,1700661060,8820,39929,52956,IT,IT
73843,1700636640,1700675460,38820,176865,49922,MX,MX
74758,1700351400,1700385120,33720,6033,112196,TR,TR
180563,1699043820,1699079280,35460,89913,6408,TR,TR
32795,1699558080,1699563060,4980,189025,113211,GB,GB
108288,1699992540,1700003580,11040,90268,165887,US,US
117303,1699560720,1699566360,5640,52375,37950,GB,GB
163925,1699516980,1699547700,30720,57137,27939,TR,TR
58127,1699902840,1699914060,11220,152721,285,US,US
169394,1700792580,1700822100,29520,12568,24004,TR,TR
30498,1699613880,1699628100,14220,101759,145296,US,US
182825,1700367780,1700398740,30960,185542,192128,TR,TR
25195,1700520660,1700539620,18960,139469,22581,FR,GB
155677,1699786980,1699816500,29520,7278,57567,TR,TR
170583,1699525440,1699536780,11340,58258,69749,IT,IT
90027,1698863160,1698898140,34980,51714,14954,TR,TR
59360,1700174820,1700178420,3600,72264,17068,NL,NL
18251,1699899420,1699911360,11940,115718,100261,US,US
173513,1699035480,1699050420,14940,123148,168152,US,US
188504,1699044480,1699080300,35820,24700,155788,TR,TR
125942,1700797740,1700802480,4740,52548,153334,NL,NL
50446,1698794940,1698809700,14760,24100,94999,FR,DE
104719,1699329000,1699333620,4620,51894,188670,FI,EE
24198,1699438140,1699471980,33840,155820,29049,TR,TR
99559,1700492760,1700524200,31440,150689,90738,TR,TR
103930,1700197800,1700229780,31980,96797,141267,TR,TR
48037,1699886580,1699917000,30420,2249,10165,TR,TR
82158,1699062120,1699073760,11640,23013,23198,US,US
167984,1700863860,1700879100,15240,11981,21483,FR,IT
118550,1699607220,1699640340,33120,179869,90954,TR,TR
185445,1700489160,1700501340,12180,137290,30162,HR,DE
108266,1699983780,1700012580,28800,105091,147069,TR,TR
55142,1700113440,1700117940,4500,170071,38612,CL,CL
130873,1700335260,1700349120,13860,88447,11286,IT,IT
185824,1699607580,1699646100,38520,1213,166948,MX,MX
59816,1700647440,1700653140,5700,176253,179828,NL,NL
167764,1699293900,1699310100,16200,195021,136713,AT,HU
166979,1699256160,1699272240,16080,196121,153978,BE,FR
132801,1700580840,1700591220,10380,183563,193446,EE,EE
84601,1698839100,1698856020,16920,84379,147677,FR,ES
130874,1699797420,1699815120,17700,51513,45232,FR,NL
97730,1699873800,1699895160,21360,126130,79399,BE,NL
16615,1699145760,1699176180,30420,95919,172769,TR,TR
164775,1699004100,1699029780,25680,141074,124726,HU,RS
101916,1700584920,1700595420,10500,9941,129527,IT,IT
36302,1700533560,1700558280,24720,42537,117371,DE,CZ
158611,1700080260,1700093520,13260,176047,97551,IT,IT
180617,1700341800,1700348940,7140,80626,50554,GB,GB
71347,1700001360,1700005320,3960,89389,119367,NL,NL
30991,1700109540,1700145420,35880,88294,124995,TR,TR
116993,1700282880,1700290260,7380,166911,107274,PT,PT
35738,1700080440,1700111640,31200,30887,3896,TR,TR
31828,1700570760,1700577720,6960,189486,110729,EE,FI
52555,1699976340,1699991160,14820,161024,15064,US,US
199207,1700816640,1700823300,6660,163581,7700,GB,GB
19801,1699606440,1699618260,11820,105776,69770,US,US
115053,1699428120,1699462860,34740,161249,124218,TR,TR
179001,1700534040,1700564460,30420,73020,193441,TR,TR
102028,1699844940,1699861320,16380,191913,46501,CZ,CZ
27234,1700554740,1700586240,31500,145757,43058,TR,TR
158909,1699453500,1699465200,11700,156208,186256,IT,IT
150409,1700015820,1700033040,17220,144313,14955,CA,CA
148741,1699510800,1699524660,13860,43150,123846,US,US
53280,1699506660,1699540860,34200,53650,109061,TR,TR
47781,1700730720,1700743680,12960,69835,53130,US,US
123065,1699205220,1699235460,30240,67074,27111,TR,TR
80990,1700517420,1700551980,34560,176071,51601,TR,TR
172833,1700796180,1700827560,31380,25702,45261,TR,TR
119762,1699296360,1699325640,29280,136050,50047,TR,TR
144114,1700382900,1700413200,30300,57512,23045,TR,TR
137102,1699895400,1699927860,32460,94662,109333,TR,TR
141585,1700597160,1700627400,30240,184275,177065,TR,TR
156105,1699507920,1699538880,30960,142367,164454,TR,TR
196409,1699885620,1699889220,3600,170999,17435,NL,NL
35125,1698806760,1698842520,35760,107895,45669,TR,TR
129697,1699786500,1699790100,3600,127070,134215,NL,NL
168567,1700606880,1700639520,32640,49024,120714,TR,TR
183654,1698839760,1698843360,3600,84339,74842,NL,NL
92361,1699433880,1699438020,4140,129349,177279,GB,GB
172615,1700812200,1700842320,30120,65039,28364,TR,TR
159432,1698873540,1698908280,34740,49624,80790,TR,TR
169793,1700771700,1700781000,9300,96077,64935,IT,IT
36744,1700581560,1700616960,35400,7603,34326,TR,TR
77699,1699040220,1699072320,32100,67472,26294,TR,TR
176750,1700816940,1700830860,13920,117334,36,US,US
51821,1700120820,1700134560,13740,80497,96756,HR,HR
131535,1699677840,1699692780,14940,31469,7656,US,US
88018,1698978180,1698996060,17880,36551,96202,US,US
153400,1700536020,1700570580,34560,12989,157299,TR,TR
5978,1700146320,1700161920,15600,32368,106520,FR,FR
89564,1699309140,1699344480,35340,130114,91311,TR,TR
9263,1700550600,1700563500,12900,67484,2414,US,US
146813,1699662360,1699687620,25260,163403,124399,RO,RO
183507,1700691360,1700725200,33840,186912,63776,TR,TR
50598,1700061720,1700095980,34260,28628,75401,TR,TR
7218,1700658480,1700694360,35880,76570,83798,MX,MX
179507,1698877560,1698895140,17580,149048,14830,FR,FR
91811,1699235160,1699253100,17940,12728,147950,US,US
191358,1699149900,1699184040,34140,11216,112377,TR,TR
160180,1699990200,1700021820,31620,25727,74784,TR,TR
183262,1699993740,1700002200,8460,105251,107543,IT,IT
54028,1700771760,1700804340,32580,16013,110136,TR,TR
11453,1700791080,1700796000,4920,46466,26751,NL,NL
117122,1699443060,1699450860,7800,31625,109648,AD,ES
104057,1700752560,1700785200,32640,66950,136060,TR,TR
44345,1699661100,1699670640,9540,84635,34961,ES,ES
128681,1699494540,1699551960,57420,174386,160325,UA,DE
130583,1699352640,1699356240,3600,82636,30568,NL,NL
141669,1700186580,1700218020,31440,49299,170054,TR,TR
156637,1700865060,1700881560,16500,89210,46231,RS,HR
73665,1699231320,1699234920,3600,96631,192912,NL,NL
89535,1699122360,1699158060,35700,143471,69559,TR,TR
45509,1698917520,1698921120,3600,75424,86774,GB,GB
119175,1700821740,1700834400,12660,163214,18750,US,US
12724,1698974280,1698977880,3600,9044,108169,GB,GB
21905,1700653920,1700665200,11280,54234,87262,IT,IT
80419,1699521720,1699554180,32460,150741,139976,TR,TR
162481,1699668120,1699697640,29520,113599,7200,TR,TR
75660,1699883640,1699901400,17760,177965,148169,CZ,CZ
81047,1699583340,1699618500,35160,91876,144317,MX,US
49091,1699469820,1699484160,14340,55718,144486,US,CA
56186,1699169280,1699199100,29820,104726,198918,TR,TR
89053,1698901260,1698934680,33420,93193,130055,TR,TR
190861,1698856440,1698885720,29280,86035,14570,TR,TR
104884,1700635020,1700638620,3600,186603,86866,NL,NL
192256,1700781240,1700798100,16860,151027,122876,FR,FR
97682,1699525740,1699530000,4260,126215,122933,GB,GB
32320,1700828220,1700841960,13740,91852,30307,IT,IT
189720,1700282340,1700285940,3600,3773,3092,NL,BE
24497,1699184940,1699189500,4560,26662,96512,GB,GB
100421,1700080920,1700113620,32700,165917,136209,TR,TR
5085,1699121220,1699153560,32340,20155,32581,TR,TR
154804,1700196540,1700218080,21540,159810,176049,FR,FR
155091,1699101960,1699117320,15360,60993,199995,US,US
153612,1700236560,1700242500,5940,198301,147965,GB,GB
157659,1699526940,1699539960,13020,99522,44163,US,US
91835,1700810760,1700814360,3600,113040,29812,NL,NL
162419,1700831160,1700844300,13140,155702,102306,IT,IT
5122,1699799160,1699818600,19440,107525,169016,BE,HR
85113,1699729020,1699752240,23220,42613,131036,DE,DE
196407,1699841100,1699854120,13020,104316,38351,SK,AT
179990,1699575840,1699604640,28800,64619,54553,TR,TR
176808,1698956760,1698974580,17820,104725,1152,US,US
111435,1699521840,1699535040,13200,77451,171711,US,US
189708,1700057160,1700062980,5820,55435,72338,NL,NL
135602,1700295480,1700326800,31320,167198,40397,TR,TR
53599,1699655340,1699670700,15360,11671,126438,AT,DE
65817,1700649300,1700661300,12000,36180,57776,US,US
77264,1700761020,1700775000,13980,144226,2114,US,US
53271,1698946680,1698957480,10800,19225,98295,HR,HR
94543,1700777940,1700808300,30360,89983,69887,TR,TR
114931,1700302500,1700307780,5280,140881,163276,NL,NL
97143,1699534320,1699538160,3840,66923,46929,AD,ES
98692,1699815900,1699848840,32940,104262,108322,TR,TR
159503,1699141380,1699156860,15480,111025,131969,BE,FR
77727,1699810920,1699818660,7740,7585,178646,PT,PT
123250,1699291260,1699303860,12600,92547,37613,IT,IT
142432,1700614260,1700649720,35460,114998,54583,TR,TR
14825,1700624940,1700660160,35220,22211,85364,TR,TR
60263,1700847180,1700860740,13560,83007,58545,IT,IT
36819,1699768260,1699795500,27240,9595,158028,DE,PL
5986,1698853920,1698864240,10320,20264,47650,IT,IT
180517,1700357040,1700366220,9180,77972,142559,PT,PT
177611,1700201640,1700220900,19260,161513,70276,AL,BA
12371,1700767200,1700781360,14160,9447,123130,US,US
89548,1699737960,1699741560,3600,100977,100175,GB,GB
179059,1698884340,1698898560,14220,32133,89752,IT,IT
161171,1699096380,1699115400,19020,181533,161570,FR,FR
5910,1698967020,1698978000,10980,197465,139931,IT,IT
66456,1700087400,1700121780,34380,136794,137826,TR,TR
144547,1699901760,1699916100,14340,44545,9702,PT,PT
23990,1698825060,1698828660,3600,43662,197097,GB,GB
100539,1700654160,1700688780,34620,156021,164314,TR,TR
38489,1699693440,1699703640,10200,53939,1488,IT,IT
76942,1700538660,1700569920,31260,101926,150708,TR,TR
193160,1700791440,1700827020,35580,198299,116352,TR,TR
36489,1699482240,1699513320,31080,179103,104635,TR,TR
65034,1699846560,1699876740,30180,57556,67099,TR,TR
167709,1700004600,1700008200,3600,53324,49318,GB,GB
38967,1700298300,1700330100,31800,52744,172541,TR,TR
72876,1700803200,1700834820,31620,145713,93163,TR,TR
138100,1699208280,1699240980,32700,16494,116188,MX,MX
95484,1699714140,1699734060,19920,153007,150439,MD,RO
129585,1699568220,1699572720,4500,43197,173937,GB,GB
103455,1698969780,1698983400,13620,131118,72277,US,US
175972,1699982160,1699994220,12060,3336,43593,US,US
156194,1699213980,1699217580,3600,162052,158778,GB,GB
59220,1700521680,1700552400,30720,35215,51594,TR,TR
24941,1700468460,1700484000,15540,82339,170311,US,US
11950,1700419620,1700445420,25800,58802,47510,DE,AT
126669,1700505720,1700541180,35460,64129,141048,TR,TR
183098,1699542600,1699547820,5220,101803,100181,GB,GB
199938,1699431660,1699445160,13500,183823,59207,CA,CA
181859,1700404980,1700439240,34260,36409,150090,TR,TR
124196,1698865980,1698874500,8520,197932,83816,EE,EE
4234,1699075860,1699079460,3600,41336,54087,NL,NL
155999,1699599000,1699620960,21960,148977,162016,RO,RO
133718,1700110920,1700117460,6540,33731,2763,GB,GB
84424,1699603740,1699615500,11760,56312,2409,RS,ME
84015,1698989220,1699024020,34800,61041,130259,TR,TR
78473,1700609040,1700635020,25980,54232,175119,DE,DE
197627,1699142220,1699175160,32940,77081,152266,TR,TR
97049,1699572000,1699607040,35040,102155,135956,TR,TR
46961,1698875940,1698891300,15360,19271,88597,US,US
198070,1700427180,1700452800,25620,61152,108642,BR,BR
120371,1699812180,1699821120,8940,140774,45378,IT,BE
13533,1700099220,1700102820,3600,105746,117141,GB,GB
63354,1700237220,1700249400,12180,103209,11746,HR,HR
41435,1699612920,1699638360,25440,178274,197371,DE,BG
165283,1698829380,1698835800,6420,151933,142660,NL,NL
175696,1700523840,1700537280,13440,107067,126214,IT,IT
16092,1699022340,1699055040,32700,70422,56090,TR,TR
91234,1700448840,1700466120,17280,2882,12702,FR,FR
28531,1700004180,1700031300,27120,46282,26150,RO,RO
128860,1699275600,1699279200,3600,145705,84168,GB,NL
28334,1700004420,1700018700,14280,62678,147986,IT,IT
34353,1700156220,1700166600,10380,15444,26736,AD,ES
33452,1700247060,1700263500,16440,46291,100876,FR,FR
13539,1699233420,1699249800,16380,73578,155305,AT,DE
197868,1700253540,1700266620,13080,36193,65584,AT,AT
166549,1700570040,1700579460,9420,30309,62114,CL,CL
79200,1700712120,1700719260,7140,30119,83029,GB,GB
34407,1699445040,1699460100,15060,21270,34379,US,US
165178,1699561860,1699588800,26940,42903,90625,PL,PL
136907,1700378760,1700384160,5400,192390,59301,NL,NL
82395,1700813760,1700827560,13800,165420,40730,IT,IT
14447,1700020680,1700055480,34800,157817,53947,MX,MX
38892,1700794380,1700797980,3600,28542,19737,NL,NL
108757,1699257420,1699261980,4560,2405,16664,GB,GB
104762,1700231460,1700247840,16380,40282,35542,US,US
131796,1699815120,1699829340,14220,146421,30327,IT,IT
29731,1699129800,1699142700,12900,4995,495,AT,AT
120000,1700466120,1700478180,12060,40066,63885,US,US
21185,1699426680,1699432200,5520,162442,73320,GB,GB
115358,1699617840,1699630620,12780,29466,52419,HR,HR
139932,1700508180,1700512140,3960,87217,20424,GB,GB
81392,1698976500,1699009440,32940,32928,56498,TR,TR
18972,1700091660,1700104260,12600,58720,115276,US,US
165673,1698815400,1698831660,16260,13532,24019,US,US
42338,1700443320,1700468160,24840,44396,75299,PL,FR
159730,1700536860,1700569800,32940,111594,142929,TR,TR
196469,1699072380,1699075980,3600,133426,77892,NL,NL
158565,1699912440,1699917480,5040,180696,8772,NL,DE
21535,1699674000,1699689120,15120,38264,155048,AT,AT
183682,1699017360,1699022760,5400,135080,172237,GB,GB
136000,1699146240,1699180320,34080,127465,198735,TR,TR
187614,1700008440,1700039580,31140,64831,184290,TR,TR
199109,1700547120,1700558520,11400,22165,130018,ES,FR
90196,1699174440,1699206480,32040,54377,119268,TR,TR
193100,1699737660,1699769040,31380,52757,185568,TR,TR
155908,1700356020,1700362980,6960,103475,158872,AD,ES
58990,1700262300,1700291400,29100,113588,19632,TR,TR
107653,1700305440,1700317680,12240,36179,169598,SK,AT
98570,1699977660,1700003880,26220,78961,22762,DE,DE
80760,1698943860,1698975180,31320,67870,137849,TR,TR
143489,1700784960,1700818620,33660,193824,38513,MX,MX
90610,1699869960,1699875240,5280,92149,43152,GB,GB
185738,1700314080,1700322360,8280,8848,175744,IT,IT
59602,1699271760,1699293600,21840,51360,90529,PL,AT
149562,1700603220,1700637000,33780,86209,189405,TR,TR
158549,1699070520,1699106280,35760,28559,186523,TR,TR
142421,1700729880,1700747820,17940,20938,21679,FR,FR
49889,1699668960,1699686420,17460,761,76427,FR,IT
180099,1699937880,1699950840,12960,36892,146330,US,US
157616,1699799700,1699815180,15480,142081,101357,RS,RS
28229,1699372380,1699375980,3600,157861,12856,NL,NL
164304,1698997260,1699000860,3600,78336,102999,GB,GB
143323,1700269500,1700301360,31860,80318,71059,TR,TR
39122,1700450040,1700471640,21600,132871,53774,DK,DK
189415,1699437300,1699470720,33420,52277,151838,TR,TR
30777,1698975480,1698989400,13920,43376,55085,RS,RS
135444,1699966260,1699977060,10800,158613,187287,US,US
30902,1698820500,1698855420,34920,34260,123231,TR,TR
19366,1699331880,1699343460,11580,101877,130544,US,US
166159,1699793880,1699827660,33780,139587,106034,TR,TR
1698,1699993620,1700028120,34500,169456,38358,TR,TR
78319,1699533780,1699565520,31740,65038,199245,TR,TR
148613,1698945780,1698967260,21480,146296,52770,FR,NL
171536,1698847440,1698857520,10080,64697,159205,ES,ES
82658,1700774700,1700786760,12060,63750,192659,US,US
88982,1700011320,1700045580,34260,111351,39536,TR,TR
162440,1699814460,1699830780,16320,44179,155613,US,US
102726,1699628400,1699662480,34080,95140,128565,TR,TR
8240,1699401720,1699429500,27780,185440,72777,DE,PL
74942,1700797020,1700807580,10560,152651,196513,IT,IT
96475,1700801640,1700817060,15420,95519,128190,FR,CH
33001,1699720800,1699749180,28380,16599,149127,BR,BR
84026,1700308980,1700323380,14400,92025,43498,FR,HR
38422,1699248060,1699261140,13080,40229,96384,RS,RS
124245,1700448240,1700456940,8700,19874,130689,IT,IT
76651,1700292060,1700326740,34680,55341,20655,TR,TR
5926,1698834540,1698869760,35220,29569,124147,TR,TR
316,1700686380,1700693460,7080,122338,73701,GB,GB
61411,1698982500,1698994380,11880,71964,132846,US,US
165264,1700574840,1700583240,8400,49430,125777,IT,IT
106975,1699309860,1699313460,3600,92783,133430,NL,NL
147272,1699807380,1699840500,33120,17905,165342,TR,TR
150739,1700859000,1700887620,28620,97650,64256,DE,AT
187494,1699183440,1699198740,15300,26085,62092,CZ,CH
53413,1699489320,1699499760,10440,138034,1242,IT,IT
33991,1699094040,1699126620,32580,146436,183190,TR,TR
157240,1700062740,1700094900,32160,115245,21641,TR,TR
1312,1700853900,1700886720,32820,33026,147674,TR,TR
132883,1699761960,1699797360,35400,109618,132318,TR,TR
92671,1699662780,1699677600,14820,159530,16596,US,US
28682,1699319340,1699323420,4080,118196,59963,GB,GB
134479,1699327920,1699352880,24960,17187,118898,DE,AT
20810,1698852120,1698884640,32520,50447,112812,TR,TR
5197,1700003220,1700008380,5160,182463,121655,GB,GB
96216,1700700960,1700733960,33000,129793,18885,TR,TR
1963,1700303220,1700308680,5460,158135,79328,NL,NL
108309,1700808240,1700840280,32040,104694,64330,TR,TR
134333,1700204340,1700217720,13380,82141,124908,AT,AT
154545,1700750340,1700779620,29280,193450,30589,TR,TR
21318,1700347920,1700351520,3600,131583,151181,GB,GB
51855,1700570340,1700575860,5520,106793,105162,GB,DE
148332,1699489140,1699492740,3600,146348,17652,GB,GB
36956,1700350440,1700358900,8460,168921,114113,IT,IT
13500,1698896340,1698902580,6240,74364,161025,GB,GB
87911,1700349480,1700365860,16380,182059,61243,US,US
144294,1698918780,1698927480,8700,11615,7568,EE,EE
191455,1699399560,1699421460,21900,32586,1929,DE,DE
16071,1699170600,1699181040,10440,151357,103924,IT,IT
87733,1699767960,1699776780,8820,109600,147167,IT,IT
163127,1700445000,1700480940,35940,38805,72712,TR,TR
95368,1699736400,1699746060,9660,193909,185181,IT,DE
191975,1699477980,1699491660,13680,61650,31603,HR,HR
109960,1699436820,1699440420,3600,110112,98587,GB,GB
105846,1700646960,1700679000,32040,182217,129026,TR,TR
110573,1699214100,1699226040,11940,81447,24611,US,US
188871,1700228100,1700240760,12660,128225,45584,HR,HR
140191,1699250940,1699285800,34860,158153,7306,TR,TR
83269,1699432680,1699452540,19860,55149,80913,MD,RO
69274,1700782800,1700795700,12900,76925,120509,US,US
65621,1699001220,1699034640,33420,104612,104033,TR,TR
35837,1699257300,1699287000,29700,87154,10183,TR,TR
20446,1700643480,1700654640,11160,27959,99009,US,US
185951,1700718300,1700750520,32220,416,99618,TR,TR
145972,1700443560,1700447160,3600,148855,159711,NL,BE
9748,1698893160,1698896760,3600,86237,22719,GB,GB
32218,1700757660,1700769900,12240,10679,106667,ES,ES
167128,1699464660,1699498680,34020,118368,19454,TR,TR
198819,1700620680,1700654100,33420,148573,50774,TR,TR
94498,1699740960,1699768500,27540,4951,69218,DE,DE
139859,1699304280,1699318980,14700,169406,149573,US,US
101793,1699712280,1699744500,32220,166288,83361,TR,TR
138670,1700273100,1700298540,25440,172350,58115,DE,FR
139395,1699906860,1699941720,34860,9876,120274,TR,TR
9761,1699649940,1699659300,9360,96625,44302,SK,CZ
106154,1699812360,1699841400,29040,20868,19411,TR,TR
196313,1700586120,1700620680,34560,165631,30459,TR,TR
169759,1699595640,1699613820,18180,50700,131867,MD,RO
69192,1698812340,1698827220,14880,124005,80762,AT,SK
181332,1700401200,1700430420,29220,153655,34030,TR,TR
34818,1699733220,1699765380,32160,42812,896,TR,TR
137858,1700853780,1700865900,12120,142434,176189,US,US
132198,1699375080,1699383360,8280,34700,76558,IT,IT
68566,1699434600,1699470480,35880,55730,12062,TR,TR
92061,1700158200,1700192520,34320,192138,55539,TR,TR
156302,1699908060,1699940580,32520,7044,20742,TR,TR
7761,1699115220,1699126980,11760,182919,2436,CA,US
167572,1700741940,1700754240,12300,172222,105155,CZ,RO
8828,1700448900,1700481300,32400,62539,87265,TR,TR
66977,1700100660,1700130720,30060,53339,38017,TR,TR
44042,1700767500,1700785020,17520,126438,93265,FR,FR
30676,1700624280,1700651160,26880,163062,71777,DE,CZ
192064,1699731720,1699762200,30480,84015,183371,TR,TR
114555,1700054580,1700070060,15480,119246,188824,AT,AT
103104,1699455060,1699485540,30480,3748,103397,TR,TR
74054,1700713320,1700716920,3600,105821,62724,NL,NL
140518,1700067360,1700099280,31920,75612,138016,TR,TR
79735,1700021640,1700037600,15960,128461,78875,AT,AT
126,1698968400,1699001040,32640,61123,118697,TR,TR
138574,1699831800,1699843920,12120,131063,32445,HR,HR
96309,1699571460,1699585260,13800,166152,11825,IT,IT
37155,1699492260,1699503240,10980,89915,132582,ES,ES
7525,1700728800,1700745000,16200,92675,41486,US,US
146816,1699659480,1699669140,9660,43497,112673,IT,IT
141758,1699593300,1699596900,3600,121389,20448,GB,GB
90171,1700048400,1700069880,21480,199889,33959,SE,SE
197365,1700227200,1700241780,14580,105714,148010,US,US
144753,1699288740,1699305300,16560,192526,124797,US,US
54225,1698812580,1698817200,4620,12904,13997,GB,GB
49466,1700082480,1700119740,37260,69635,13315,MX,MX
69911,1699045020,1699048620,3600,97215,157634,NL,NL
47315,1700751780,1700763420,11640,8341,10403,PT,PT
142667,1700826000,1700834580,8580,22569,160447,IT,IT
63936,1699401240,1699416780,15540,185484,10347,RS,RS
12026,1699813080,1699816680,3600,50881,104426,NL,NL
78552,1700672640,1700704920,32280,65288,127554,TR,TR
194428,1699629660,1699636080,6420,115981,15247,NL,NL
178889,1699476120,1699509420,33300,59895,150462,TR,TR
121914,1699849320,1699852920,3600,67047,130575,GB,GB
183923,1699980960,1700019240,38280,52312,27687,MX,MX
5065,1700409960,1700451960,42000,95540,62848,LU,PT
135436,1700626620,1700659920,33300,127033,163497,TR,TR
76461,1700160720,1700194560,33840,176142,34901,MX,US
164192,1699737420,1699753200,15780,88522,61397,CZ,DE
137312,1700222700,1700240940,18240,170672,2466,FR,BE
99428,1700547120,1700574240,27120,153621,933,DE,RO
75468,1699536600,1699555200,18600,135083,167802,BE,NL
10716,1699646340,1699659060,12720,30888,598,IT,IT
138178,1700075940,1700105940,30000,8487,6187,TR,TR
164465,1699982280,1699993140,10860,167811,116810,IT,IT
84949,1700283180,1700316960,33780,177002,89850,TR,TR
180287,1699858140,1699864980,6840,111708,12538,NL,BE
177861,1700859120,1700869320,10200,20031,15508,SK,SK
143161,1698835980,1698839580,3600,56227,50443,GB,GB
91132,1700325600,1700361360,35760,42592,77337,TR,TR
42151,1700411880,1700445060,33180,198890,153396,MX,MX
151567,1700188500,1700218020,29520,41426,142785,TR,TR
10541,1698842760,1698858180,15420,30903,22918,US,US
35261,1698836160,1698848580,12420,63375,168837,CZ,CZ
196364,1700292240,1700300220,7980,97652,148462,PT,PT
104348,1699840560,1699862340,21780,51381,186727,CH,IT
75621,1700596260,1700626320,30060,171568,16058,TR,TR
107336,1698837780,1698871740,33960,74217,7597,MX,MX
111786,1699664040,1699674960,10920,169,88181,RS,RS
38330,1698818040,1698850260,32220,14659,57978,TR,TR
92126,1699186980,1699211460,24480,153001,114115,RO,RO
162325,1699829400,1699883340,53940,79817,25230,BG,MK
190737,1699800300,1699831020,30720,178453,163112,TR,TR
160481,1700381700,1700415480,33780,93501,194481,TR,TR
123195,1699144020,1699155840,11820,172778,139861,HR,PL
194109,1700328180,1700352600,24420,151177,54176,SI,PL
150827,1699937400,1699971420,34020,72968,159011,TR,TR
29525,1699987080,1700022420,35340,156998,172017,TR,TR
15604,1700082420,1700113800,31380,120082,10429,TR,TR
2618,1699168260,1699183860,15600,94629,75393,US,US
8209,1700083260,1700114580,31320,76,60887,TR,TR
160008,1698998700,1699028940,30240,87654,57277,TR,TR
159948,1700025120,1700057520,32400,5343,147540,TR,TR
43885,1700483340,1700516400,33060,23797,95677,TR,TR
157033,1700149320,1700178720,29400,140786,103116,TR,TR
87994,1699763880,1699767480,3600,174859,134219,GB,NL
31373,1700339100,1700369100,30000,75807,67621,TR,TR
42952,1699162920,1699166520,3600,176593,6184,GB,GB
42407,1698878940,1698908700,29760,22434,58618,TR,TR
96098,1699096620,1699106400,9780,61646,97511,IT,IT
91229,1699600560,1699634940,34380,64367,152630,TR,TR
163496,1699912380,1699918980,6600,41206,138501,NL,NL
44673,1700768040,1700805900,37860,46933,49854,MX,MX
125944,1699442880,1699476060,33180,117048,92364,TR,TR
11029,1698975540,1698980940,5400,98763,135520,NL,NL
58577,1700423100,1700426700,3600,25638,196876,NL,NL
122218,1700137320,1700154840,17520,50758,116408,US,US
93836,1700393400,1700423160,29760,102236,36782,TR,TR
60652,1699040220,1699056120,15900,169000,171273,CA,US
28641,1700485020,1700494200,9180,17974,197029,IT,IT
94454,1699027020,1699062000,34980,43915,171229,TR,TR
26429,1699659900,1699694280,34380,141633,15517,TR,TR
48078,1700293140,1700304060,10920,108140,188749,US,US
64423,1700137500,1700150880,13380,68740,12194,IT,IT
128691,1699932120,1699936440,4320,136052,173382,GB,GB
183907,1699201020,1699233180,32160,141540,127746,TR,TR
87223,1699595760,1699602420,6660,131428,108112,GB,GB
22642,1699707840,1699731780,23940,18795,105467,PL,NL
102914,1700342700,1700373720,31020,146391,23571,TR,TR
157896,1698796800,1698829020,32220,70750,36229,TR,TR
154222,1698959460,1698974700,15240,93358,136728,US,US
138729,1699358880,1699362480,3600,7187,192879,GB,GB
122882,1699156800,1699160400,3600,20980,20744,GB,GB
52866,1700245500,1700258820,13320,22380,157612,PT,PT
151691,1700591460,1700597040,5580,130230,189691,GB,GB
20435,1700344800,1700348400,3600,109871,157016,NL,NL
28259,1700284080,1700289480,5400,58823,79088,NL,NL
128655,1699692780,1699726140,33360,131099,3856,TR,TR
192317,1699303800,1699316400,12600,91462,168989,US,US
80188,1699541640,1699601880,60240,89639,84708,UA,CZ
83436,1699325040,1699356180,31140,35393,170151,TR,TR
34477,1700203500,1700235480,31980,66727,41771,TR,TR
10118,1699734000,1699742220,8220,108382,21576,IT,IT
29177,1700058540,1700072820,14280,160899,47304,RS,RS
45182,1698995520,1699020900,25380,60866,110375,PL,PL
154011,1700679240,1700714220,34980,171077,149940,TR,TR
185595,1699083480,1699096920,13440,43698,96947,ES,ES
11752,1700084580,1700090520,5940,179937,125966,GB,GB
150333,1699844040,1699861560,17520,56900,180808,FR,FR
72475,1699536720,1699569120,32400,5122,142148,TR,TR
198019,1699933020,1699963860,30840,117626,89659,TR,TR
54182,1699220880,1699233060,12180,148649,176757,US,US
71352,1699105080,1699134000,28920,27723,31221,TR,TR
37265,1699829520,1699860240,30720,53751,69297,TR,TR
115572,1700674860,1700699820,24960,57491,42722,RO,MD
176891,1700398680,1700402280,3600,115345,164306,GB,GB
13745,1700807460,1700811180,3720,147923,157589,GB,GB
187216,1699073400,1699095240,21840,166617,110619,HU,CZ
137407,1698898260,1698909060,10800,88300,18739,US,US
72528,1700005800,1700035620,29820,197582,120277,TR,TR
39113,1700623740,1700630940,7200,161828,193083,IT,IT
80768,1700096340,1700110860,14520,171621,69767,US,US
32816,1700790180,1700797920,7740,172043,91835,IT,IT
36147,1699386360,1699416900,30540,79571,136847,TR,TR
146832,1700667780,1700680440,12660,182615,83400,US,US
133882,1700558520,1700589420,30900,100661,185437,TR,TR
53253,1698889020,1698920460,31440,97224,131714,TR,TR
101013,1698882960,1698908460,25500,65358,191961,DE,BG
13025,1700445300,1700448900,3600,154809,18573,NL,NL
124528,1699618980,1699632840,13860,91942,46145,RS,FR
110590,1699631400,1699649040,17640,86271,99614,US,US
39636,1700326380,1700353020,26640,49681,131021,PL,DE
160338,1699288980,1699305120,16140,38327,88855,US,US
3562,1699101000,1699135740,34740,67174,138615,TR,TR
112026,1699853220,1699860540,7320,100726,133272,IT,IT
59275,1699166520,1699175820,9300,156029,174927,PT,PT
20923,1700424960,1700429880,4920,184961,83293,GB,GB
199405,1700829720,1700863740,34020,25835,27144,TR,TR
174649,1700007540,1700018820,11280,197055,195398,US,US
72315,1698869160,1698877200,8040,106284,58727,IT,IT
108100,1700134560,1700138160,3600,18442,74239,NL,NL
160201,1700808000,1700836860,28860,199212,12715,TR,TR
181418,1699954260,1699967280,13020,154813,35576,IT,IT
81834,1699138440,1699153560,15120,31649,124565,US,CA
39598,1698931800,1698937440,5640,181809,134743,GB,GB
131446,1699281720,1699312620,30900,149824,136547,TR,TR
140202,1699865100,1699879560,14460,63576,185322,US,US
21009,1699963380,1699977360,13980,36918,126785,US,US
66652,1700862360,1700874720,12360,15018,77831,IT,IT
151535,1699586520,1699614180,27660,183778,77103,PL,DE
32508,1698967020,1698970620,3600,160363,100201,GB,GB
149144,1700100420,1700134680,34260,128477,46839,TR,TR
19705,1700851920,1700876940,25020,18248,113726,BR,BR
89902,1699347360,1699353120,5760,122327,83811,GB,GB
8736,1699948740,1699967820,19080,177575,22582,FR,NL
67242,1699641120,1699652820,11700,13929,119063,PT,PT
46269,1700225040,1700259960,34920,194038,56260,TR,TR
192262,1699129980,1699143780,13800,56786,197104,IT,IT
92825,1700398020,1700413680,15660,152145,37753,FR,CH
31470,1700836560,1700856180,19620,92757,96199,DK,DK
160825,1699033680,1699063260,29580,186347,21311,TR,TR
37781,1699924020,1699946280,22260,6933,33952,DE,AT
130420,1699024140,1699051140,27000,38811,134168,CH,FR
144183,1699117500,1699130820,13320,54715,194814,IT,IT
113840,1700287620,1700319720,32100,6332,32827,TR,TR
103575,1699181940,1699213920,31980,99503,153236,TR,TR
183171,1699062060,1699095540,33480,7445,89037,TR,TR
4428,1700377800,1700387880,10080,118473,172651,IT,IT
67483,1700270520,1700281860,11340,124898,89797,PT,PT
10167,1699291260,1699326900,35640,8764,105825,TR,TR
74731,1700430780,1700459280,28500,154065,124001,PL,PL
27481,1700109480,1700127300,17820,170595,110652,US,US
128627,1698851640,1698865980,14340,152186,97969,ES,ES
171374,1700493000,1700527560,34560,177800,67876,TR,TR
6560,1699231140,1699264620,33480,133307,95697,TR,TR
2625,1700813700,1700828880,15180,113757,75624,US,US
11443,1700347500,1700380920,33420,126366,41571,TR,TR
47357,1699659900,1699668840,8940,34583,117874,IT,IT
50324,1699189920,1699201680,11760,176679,124354,IT,IT
108463,1699533300,1699536900,3600,21883,80176,NL,NL
115206,1700729820,1700762460,32640,163016,168258,TR,TR
156489,1699236720,1699254660,17940,197316,2164,US,US
104708,1700014080,1700018460,4380,142492,145437,GB,GB
119968,1699042200,1699047300,5100,60450,138406,NL,NL
52322,1698857460,1698868560,11100,39501,166702,US,US
38692,1700636940,1700665860,28920,41873,152528,TR,TR
101252,1698877020,1698910140,33120,135857,197453,TR,TR
131846,1700263620,1700274840,11220,18615,86865,US,US
77562,1699880280,1699889520,9240,43582,28054,EE,EE
51207,1699979760,1699983360,3600,100053,108614,GB,GB
188851,1700319120,1700349780,30660,3284,81901,BA,DE
133744,1700864640,1700868240,3600,69853,21110,GB,GB
141304,1700345460,1700349060,3600,27784,93144,GB,GB
127626,1700113680,1700119740,6060,122525,116559,EE,EE
42263,1700817060,1700830560,13500,88742,48228,CZ,RO
125066,1699980240,1699990020,9780,10911,162031,HR,HR
1116,1699506660,1699522560,15900,2715,141480,US,US
21694,1699023420,1699028340,4920,5636,13663,GB,GB
30864,1699144980,1699165560,20580,192185,13562,DK,DK
68165,1700051640,1700063520,11880,159840,3742,US,US
194054,1699474980,1699505760,30780,29112,9622,TR,TR
187455,1700529900,1700563920,34020,75990,1838,TR,TR
14302,1699216920,1699226760,9840,99207,58847,HR,HR
132778,1700525880,1700541300,15420,50341,44627,US,US
152699,1698930060,1698960000,29940,155604,38540,TR,TR
106926,1698821400,1698847260,25860,30848,100799,CH,IT
123226,1700813700,1700817300,3600,39979,166104,NL,NL
53815,1699037100,1699047840,10740,101644,83031,IT,IT
122298,1699708680,1699723980,15300,104222,124964,CZ,NL
119902,1699399980,1699425240,25260,14099,167310,DE,DE
47857,1699106100,1699137240,31140,136187,138159,TR,TR
189173,1700028240,1700041920,13680,25291,146707,US,US
91922,1700717580,1700731020,13440,179022,100009,US,US
139163,1700326920,1700351220,24300,69725,119156,BR,BR
197913,1699714320,1699717920,3600,128028,104947,GB,GB
177720,1699304520,1699335600,31080,159152,139712,TR,TR
106662,1700706480,1700720040,13560,42154,4271,US,US
138011,1699452420,1699483260,30840,23022,59407,TR,TR
114941,1700065740,1700073780,8040,39420,127714,HR,HR
160349,1699573920,1699603980,30060,40881,15858,TR,TR
137919,1700680440,1700714100,33660,2326,41333,TR,TR
72276,1700589960,1700619120,29160,174315,160027,TR,TR
145404,1699113540,1699146360,32820,127377,190039,TR,TR
80475,1699932420,1699941840,9420,42834,120738,PT,PT
199485,1700265240,1700280240,15000,46131,94292,CA,CA
33494,1699964880,1699968480,3600,117400,15203,GB,GB
32939,1700572020,1700601180,29160,104786,75977,TR,TR
197991,1700300820,1700329800,28980,10182,55498,TR,TR
4444,1700342460,1700355960,13500,91528,8343,IT,IT
1804,1698838200,1698853500,15300,104346,135783,US,US
109384,1699402200,1699434960,32760,117213,17923,TR,TR
22007,1699510080,1699513680,3600,27806,64289,GB,GB
146566,1699866000,1699883220,17220,145556,42645,US,US
49333,1699711740,1699746420,34680,103009,104666,TR,TR
152397,1700505900,1700531220,25320,30047,159882,DE,DE
61435,1699123860,1699137000,13140,66764,37325,IT,IT
38283,1699601940,1699613760,11820,10734,74835,IT,IT
102095,1699516680,1699549440,32760,10520,61962,MX,US
9603,1699978260,1700013300,35040,116108,135034,TR,TR
36001,1699968540,1700002200,33660,113908,143213,TR,TR
151575,1699126620,1699152420,25800,72790,151730,PL,PL
130279,1699497480,1699526340,28860,181811,70824,TR,TR
18958,1699498920,1699511880,12960,60527,76175,US,US
185146,1699036320,1699044780,8460,95390,115583,IT,IT
157123,1699392240,1699397220,4980,185329,164492,NL,NL
193970,1699990380,1700025060,34680,167270,160227,TR,TR
161421,1700729880,1700733480,3600,108866,79534,NL,NL
146567,1699229760,1699243920,14160,179636,96509,IT,IT
157417,1699895820,1699905540,9720,153314,6275,IT,IT
153912,1699586460,1699613580,27120,149859,1235,DE,HU
72773,1700106000,1700109600,3600,163845,157437,NL,NL
106028,1700217420,1700227380,9960,190151,179057,IT,IT
64298,1699974480,1700002380,27900,173701,41470,BA,HR
14968,1700452260,1700482740,30480,2329,39495,TR,TR
102999,1700584560,1700597880,13320,38625,96165,IT,IT
49290,1699536060,1699541940,5880,45329,137598,GB,GB
51462,1700513040,1700526900,13860,57035,137197,SK,DE
17843,1700526840,1700553300,26460,199768,109999,BA,BA
156485,1699246020,1699249620,3600,40570,31123,GB,GB
179358,1700675880,1700681400,5520,54788,68564,GB,GB
19361,1698844500,1698868260,23760,71822,139215,RO,RO
145849,1699137840,1699172820,34980,149264,64028,TR,TR
171391,1699807560,1699842300,34740,952,6137,TR,TR
39228,1698858480,1698881040,22560,163206,69671,DE,BG
68679,1700561280,1700594700,33420,1346,29175,TR,TR
36422,1699565280,1699601100,35820,143278,159326,TR,TR
138919,1699666020,1699694280,28260,65701,16028,PL,PL
67971,1699365780,1699370760,4980,137828,140008,NL,NL
148713,1700729520,1700744940,15420,194445,80046,FR,BE
96545,1700413920,1700418000,4080,80020,196257,NL,NL
55364,1699779180,1699812600,33420,24585,11477,TR,TR
26623,1700011620,1700046540,34920,17035,147573,TR,TR
23651,1698869640,1698887700,18060,29959,88363,FR,ES
13726,1699198080,1699205100,7020,157374,122025,GB,GB
82019,1700070000,1700083620,13620,7511,180517,IT,IT
19901,1698870840,1698877320,6480,80413,16011,GB,GB
3177,1700697660,1700701260,3600,82100,103315,GB,GB
119727,1699810080,1699813680,3600,5562,54099,GB,GB
194578,1700589600,1700593200,3600,59924,141757,GB,GB
39219,1700458800,1700494020,35220,174997,143982,TR,TR
113114,1700639400,1700672100,32700,8076,114195,TR,TR
89201,1699437000,1699466820,29820,147269,9531,TR,TR
138702,1699065720,1699088460,22740,336,153425,BR,BR
45637,1700377920,1700408520,30600,148509,175233,TR,TR
22842,1700211600,1700215200,3600,168230,106361,GB,GB
81806,1699424940,1699480020,55080,55238,110757,BG,DE
97677,1699111080,1699122120,11040,19211,169936,US,US
41066,1700611500,1700621100,9600,75025,16965,IT,IT
82137,1699407360,1699417560,10200,91802,164992,IT,IT
148393,1699935420,1699952940,17520,152299,103875,FR,FR
112732,1699207020,1699246080,39060,132881,160900,MX,MX
6917,1699982340,1700001480,19140,75058,15070,FR,FR
198275,1700117220,1700123220,6000,84477,184008,NL,DE
80418,1699945200,1699979520,34320,110739,198584,TR,TR
175967,1700526060,1700530920,4860,123590,149437,NL,NL
134142,1700622300,1700638200,15900,140720,76404,FR,IT
137529,1699511460,1699543500,32040,170867,175511,TR,TR
53252,1700661060,1700687880,26820,186342,167280,PL,HR
9321,1699192740,1699223400,30660,13406,198835,TR,TR
40283,1700573700,1700603400,29700,88113,72243,TR,TR
115741,1699033740,1699041720,7980,2045,93487,HR,HR
79371,1700125440,1700129040,3600,39498,198225,GB,GB
191,1699455540,1699469040,13500,24263,190561,HR,HR
63739,1699621560,1699652580,31020,194515,39401,TR,TR
151865,1700796660,1700827080,30420,158744,84028,TR,TR
155833,1699050000,1699079820,29820,39394,97689,TR,TR
45156,1700785260,1700788860,3600,24368,65331,GB,GB
61012,1699188360,1699199220,10860,14671,15222,US,US
119375,1700016480,1700031600,15120,103090,115564,US,US
28672,1700803620,1700821020,17400,194405,20852,AT,AT
23770,1699053540,1699082520,28980,149726,96741,TR,TR
52705,1699392180,1699417020,24840,95266,104617,MD,RO
34333,1700118660,1700125020,6360,43696,121468,CL,CL
141930,1699038420,1699052400,13980,66786,27087,US,US
136106,1699223820,1699227840,4020,161806,192585,GB,GB
110042,1700711640,1700740980,29340,45007,128110,TR,TR
81250,1699643340,1699681080,37740,73524,143962,MX,MX
186427,1699105620,1699135740,30120,124379,18495,TR,TR
52288,1700295060,1700310780,15720,13256,34210,FR,ES
42461,1700324280,1700333580,9300,84914,97322,PT,PT
117114,1698976200,1698986820,10620,16282,191657,IT,IT
173357,1700312160,1700341620,29460,73019,169615,TR,TR
187473,1700262900,1700298300,35400,121881,123300,TR,TR
22809,1698977520,1699012980,35460,22557,123577,TR,TR
24727,1699307340,1699318080,10740,125301,19996,HR,HR
103414,1700745240,1700759880,14640,39928,86638,US,US
39311,1700250060,1700279700,29640,105040,76159,TR,TR
9934,1700544780,1700554980,10200,90125,46465,IT,IT
69815,1700013060,1700046540,33480,190479,159875,TR,TR
152172,1700514000,1700527740,13740,130633,71154,IT,IT
116376,1700454480,1700464140,9660,195040,103012,IT,IT
72509,1698831060,1698866220,35160,27158,161016,TR,TR
189330,1700237220,1700248860,11640,179780,175997,US,US
151047,1698831780,1698848700,16920,103574,50463,US,US
195788,1700037540,1700041140,3600,86951,117444,GB,GB
59139,1699726380,1699749540,23160,105058,33516,DE,DE
127752,1700654280,1700687460,33180,77250,170706,TR,TR
137643,1699119300,1699133940,14640,101262,11307,US,US
22758,1699765680,1699797840,32160,176399,94726,TR,TR
70528,1699020660,1699024260,3600,15968,136619,GB,GB
147695,1700824620,1700836260,11640,144446,136974,US,US
17618,1699431960,1699465860,33900,177166,191550,TR,TR
90340,1700397660,1700403840,6180,179700,120779,FI,EE
131179,1699476120,1699479720,3600,65839,134222,NL,NL
89823,1699868040,1699891920,23880,131389,3971,DE,DE
173338,1700720460,1700744760,24300,138632,114298,DE,FR
182066,1700104500,1700136720,32220,10398,84346,TR,TR
163458,1698854100,1698886320,32220,126560,196970,TR,TR
120531,1700070720,1700079660,8940,150372,187600,IT,IT
36648,1700299740,1700329080,29340,192632,184720,TR,TR
108445,1698870540,1698897180,26640,159924,84107,DE,AT
95836,1700627940,1700656320,28380,105633,109655,PL,PL
109044,1699953900,1699957500,3600,147113,17691,GB,GB
161401,1699971600,1700004060,32460,166359,97637,TR,TR
149939,1699650000,1699653600,3600,117992,197501,GB,GB
130277,1700016780,1700030280,13500,188605,107456,ES,RO
70017,1700599020,1700611380,12360,108924,191667,US,US
46194,1699692120,1699700460,8340,115818,20253,ES,ES
183470,1699125600,1699129200,3600,61839,152156,GB,GB
91268,1700031600,1700060700,29100,7804,92732,TR,TR
68232,1699446900,1699474560,27660,170818,62528,BR,BR
21786,1699743300,1699778100,34800,76596,39560,TR,TR
80966,1699283040,1699297740,14700,195890,48016,RS,RS
189177,1699416480,1699451940,35460,84952,28565,TR,TR
54389,1698858900,1698890940,32040,191403,5004,TR,TR
62995,1700582400,1700599260,16860,120594,119561,FR,DE
74921,1699882620,1699888320,5700,198948,44819,EE,EE
89912,1699462500,1699467720,5220,129301,191201,NL,NL
138061,1699000680,1699016160,15480,73875,129228,US,MX
106960,1700233440,1700238300,4860,147872,126420,NL,NL
49105,1700095560,1700100240,4680,152581,69738,NL,DE
111941,1699208640,1699230660,22020,155682,119530,MD,RO
59911,1699525260,1699537380,12120,38938,145559,US,US
175217,1699828500,1699857540,29040,16284,68228,TR,TR
151459,1700717580,1700768520,50940,88361,95720,BG,DE
101180,1700332560,1700345640,13080,135674,174610,PT,PT
156261,1700233320,1700236920,3600,51634,48485,NL,FR
84632,1700487240,1700499360,12120,56087,180834,AT,DE
178022,1699032360,1699048380,16020,154155,3056,US,US
31322,1699170960,1699194480,23520,139314,51774,PL,PL
173306,1699876560,1699880160,3600,111672,95774,NL,NL
163088,1700778900,1700809320,30420,28752,44911,TR,TR
181229,1698942180,1698945780,3600,4675,137695,NL,NL
174994,1699544040,1699573080,29040,157049,62337,TR,TR
120033,1698920940,1698938820,17880,102190,22711,US,US
95748,1700669400,1700698920,29520,133246,105166,TR,TR
51618,1699010220,1699036380,26160,161751,193525,BA,BA
149041,1699205760,1699218720,12960,71627,63238,PT,PT
132080,1699363560,1699382880,19320,122146,84811,FR,IT
167465,1699954260,1699977180,22920,62122,90672,DE,HU
33556,1698889680,1698893280,3600,4346,199894,GB,GB
13299,1700500200,1700529240,29040,88075,146451,TR,TR
36878,1700037840,1700050980,13140,96222,162800,US,US
100844,1699696680,1699711920,15240,64143,172175,US,US
125364,1699915680,1699949280,33600,94519,107936,MX,MX
57497,1700600580,1700629500,28920,128265,72466,TR,TR
35672,1700747700,1700777400,29700,1462,193547,TR,TR
197029,1700340900,1700344500,3600,175491,118701,GB,GB
10753,1700268900,1700286360,17460,45798,69100,US,MX
60355,1698901140,1698931080,29940,139974,153950,TR,TR
35595,1699219980,1699232820,12840,190161,184789,US,US
128087,1699849920,1699882380,32460,165785,191149,MX,MX
189701,1699338900,1699342500,3600,154830,173420,GB,GB
175522,1699332660,1699344240,11580,31780,986,IT,IT
20925,1700808360,1700842740,34380,109144,71748,TR,TR
31261,1698845460,1698862980,17520,133056,71211,SE,SE
87623,1699920660,1699924920,4260,148412,29932,NL,NL
67998,1699407300,1699410900,3600,71203,71598,GB,GB
64053,1700542140,1700546700,4560,33490,168069,GB,GB
163361,1699586880,1699620060,33180,46152,157281,MX,MX
54269,1700678040,1700713800,35760,50048,165513,TR,TR
869,1700591160,1700602920,11760,167353,75659,US,US
35881,1700833500,1700863080,29580,33988,76454,TR,TR
25999,1699215600,1699224660,9060,156392,181537,EE,EE
24988,1699580700,1699596300,15600,38760,106404,RS,SI
166671,1699842300,1699851480,9180,52061,59601,IT,IT
103502,1700653560,1700689140,35580,173668,104625,TR,TR
176034,1700789580,1700794500,4920,91051,72367,NL,FR
146721,1699434840,1699458720,23880,190751,25498,CH,IT
193364,1700749020,1700757780,8760,161966,89422,IT,DE
138070,1699066860,1699072980,6120,93836,40699,GB,GB
125806,1700599860,1700603460,3600,159422,83864,GB,GB
43467,1698967680,1698980340,12660,66416,177439,US,US
185969,1699476540,1699480140,3600,62105,155064,NL,NL
76511,1700777700,1700781300,3600,131140,38937,GB,GB
104404,1700710080,1700745960,35880,99127,41419,TR,TR
158858,1698857700,1698878460,20760,128599,179748,FR,ES
83983,1699965060,1699990920,25860,180102,177149,PL,PL
33069,1700460780,1700496360,35580,48318,161942,TR,TR
18719,1699271580,1699306980,35400,107682,117637,TR,TR
154781,1700412000,1700445420,33420,113318,36593,TR,TR
112908,1699991760,1700002200,10440,131297,116798,IT,IT
160152,1698961140,1698966960,5820,178219,192411,NL,DE
108240,1700743680,1700777340,33660,167752,160149,MX,MX
41930,1699135080,1699144260,9180,66182,69933,IT,IT
17642,1700161980,1700175540,13560,166118,150586,US,US
141595,1700736000,1700765760,29760,165766,139323,TR,TR
193524,1699504320,1699537440,33120,117518,147776,TR,TR
164572,1699359060,1699382940,23880,52138,23935,PL,PL
165849,1699831380,1699850580,19200,164915,162362,SE,SE
104447,1700766300,1700771340,5040,97686,96373,NL,NL
36871,1700843220,1700855040,11820,183795,137622,HR,HR
85869,1699177440,1699192380,14940,177540,117714,RS,IT
11058,1700780940,1700784540,3600,128806,68924,GB,GB
91749,1698955440,1698967800,12360,81434,39131,US,US
165212,1700761980,1700796900,34920,111338,74903,TR,TR
166628,1699480680,1699510260,29580,11519,64729,TR,TR
182449,1700259480,1700286780,27300,153972,166272,DE,DE
70390,1700042820,1700046900,4080,162506,93378,GB,GB
75771,1699692240,1699696020,3780,20700,197170,NL,NL
121314,1699184160,1699218960,34800,112861,24372,TR,TR
135385,1700208540,1700233680,25140,193633,114750,BR,BR
37753,1700261760,1700277720,15960,23338,21898,US,US
104416,1700386740,1700421720,34980,137704,126028,TR,TR
187771,1700205240,1700238840,33600,13571,175089,TR,TR
153409,1698997800,1699023060,25260,43547,86422,PL,LT
113853,1700368980,1700374980,6000,35365,33337,NL,NL
42000,1700617740,1700638320,20580,38695,49407,FR,FR
151513,1699875720,1699879320,3600,36511,16662,GB,GB
38503,1700157180,1700160780,3600,173291,179768,GB,GB
99811,1698950580,1698954180,3600,105417,72111,GB,GB
199799,1700343420,1700375880,32460,90232,115500,TR,TR
68025,1699349940,1699353540,3600,42831,26229,GB,GB
12185,1700087220,1700104680,17460,42392,84431,FR,CZ
13736,1700664420,1700695860,31440,85043,3027,TR,TR
156455,1699644900,1699656420,11520,198381,148235,US,US
174660,1699054860,1699085340,30480,154307,38745,TR,TR
1095,1700587860,1700591460,3600,55877,101410,GB,GB
139106,1698839280,1698869640,30360,54951,38924,TR,TR
62567,1698946620,1698965400,18780,60618,67906,FR,FR
90893,1700669760,1700690640,20880,31728,67465,FR,BE
112480,1699840800,1699844400,3600,166254,189573,GB,GB
28030,1700316840,1700322240,5400,150045,53678,AD,ES
154566,1699641600,1699645200,3600,136256,163031,GB,GB
183886,1699209300,1699238160,28860,189329,17319,TR,TR
143059,1699243500,1699272060,28560,178799,10286,PL,PL
512,1698873480,1698906300,32820,3749,87045,TR,TR
69984,1699216200,1699226640,10440,67873,168161,IT,IT
119129,1700701140,1700704740,3600,102422,138894,GB,GB
112374,1699142640,1699146240,3600,5651,135827,GB,GB
95491,1699752000,1699785660,33660,120103,146026,TR,TR
96069,1699378080,1699408500,30420,52200,16931,TR,TR
21655,1699392360,1699401960,9600,67188,2416,HR,HR
83491,1699020420,1699040400,19980,39234,38931,BE,NL
92210,1700513580,1700529960,16380,78000,84857,FR,FR
14345,1700206020,1700209620,3600,68564,40135,NL,BE
116644,1699034940,1699049460,14520,145111,34067,US,US
127785,1699670820,1699694340,23520,122591,173682,HU,AT
192428,1699730460,1699764480,34020,25876,56517,TR,TR
94169,1700380440,1700386560,6120,97558,61359,GB,GB
145178,1698912900,1698924600,11700,85962,20170,IT,IT
197015,1699628580,1699657680,29100,32995,124111,TR,TR
27117,1699632900,1699663260,30360,197722,166384,TR,TR
114154,1699936620,1699954500,17880,70459,69121,US,US
166255,1700274960,1700308260,33300,37904,162465,TR,TR
183041,1700535780,1700541120,5340,72504,55118,GB,GB
156154,1700300940,1700317080,16140,26973,174822,US,US
140310,1699151220,1699181460,30240,74966,84699,TR,TR
28096,1700303580,1700328360,24780,7320,184508,DE,HR
4229,1700053920,1700062320,8400,78061,141698,IT,IT
113013,1700827680,1700857560,29880,66184,166575,TR,TR
65745,1699829940,1699857540,27600,100224,105445,PL,PL
182336,1699626900,1699665600,38700,58158,76433,MX,MX
40517,1700797380,1700814480,17100,92253,58476,FR,ES
72559,1700094360,1700124180,29820,72598,8449,TR,TR
72778,1698887580,1698905220,17640,199932,157237,US,US
16465,1699866780,1699871940,5160,180863,124190,GB,GB
115167,1699692960,1699724400,31440,99685,66030,TR,TR
185441,1700850960,1700886420,35460,65496,132349,TR,TR
18538,1699663620,1699699320,35700,77678,81749,TR,TR
154210,1699691040,1699713000,21960,95888,149492,DE,BG
94862,1700832180,1700838000,5820,69749,86262,NL,NL
52938,1700583840,1700589840,6000,38155,41915,GB,GB
149688,1699069740,1699105500,35760,30504,21013,TR,TR
190202,1700411520,1700425080,13560,102956,19455,PT,PT
173522,1699784040,1699800600,16560,139308,21152,US,US
152876,1699632780,1699658520,25740,121659,140770,CH,IT
78278,1699445100,1699477980,32880,58334,49989,TR,TR
85403,1700012700,1700019480,6780,185080,67043,GB,GB
38700,1699359120,1699370100,10980,132408,76068,US,US
197923,1698953760,1698982440,28680,136782,34313,DE,DE
36182,1699249020,1699252620,3600,133321,41012,GB,GB
148247,1699124940,1699157280,32340,98987,159934,TR,TR
187298,1699462320,1699492860,30540,178070,76051,TR,TR
173433,1699890480,1699925160,34680,103787,196816,TR,TR
150196,1700341440,1700370180,28740,85733,57609,PL,AT
9877,1700196840,1700210760,13920,190322,151933,ES,ES
171582,1699728780,1699755720,26940,101211,98078,RO,PL
11661,1698857160,1698890220,33060,67115,27624,TR,TR
93077,1700400840,1700417220,16380,184772,29210,BE,FR
9786,1699239300,1699268940,29640,116789,168819,TR,TR
181650,1699828740,1699862700,33960,8147,97138,MX,MX
61876,1700673600,1700687160,13560,10980,22388,US,US
51237,1699999680,1700003280,3600,31261,33222,NL,NL
176511,1699825500,1699829100,3600,44488,29669,NL,NL
77002,1698948660,1698966300,17640,191882,45498,CA,US
186796,1699671840,1699702620,30780,179548,56168,TR,TR
103132,1700196660,1700226540,29880,56769,24852,TR,TR
198776,1700292060,1700325720,33660,119809,28454,TR,TR
168628,1700144280,1700178780,34500,166737,21432,TR,TR
33875,1698929220,1698961500,32280,106319,36652,TR,TR
71912,1700301600,1700327760,26160,164648,25559,DE,CZ
188363,1699003020,1699006620,3600,139340,95608,GB,GB
174850,1700115900,1700119500,3600,45725,125662,GB,GB
164947,1699464240,1699490940,26700,46501,56221,DE,IT
14157,1699259940,1699271160,11220,21110,17668,US,US
129354,1700637120,1700669100,31980,66189,136008,TR,TR
155337,1700752380,1700763900,11520,65218,197867,HR,BA
151011,1699407600,1699411200,3600,24291,196342,GB,GB
135045,1699235280,1699243860,8580,30193,195965,SK,SK
40503,1700853840,1700857440,3600,63520,168844,GB,GB
54695,1700534280,1700549400,15120,10380,138443,FR,NL
192446,1698850020,1698882660,32640,53915,85500,TR,TR
120124,1700237040,1700240640,3600,155347,188906,GB,GB
157645,1699103940,1699107540,3600,195839,13408,GB,GB
42647,1700841000,1700875020,34020,23668,138086,TR,TR
127670,1699312500,1699342800,30300,42650,12059,TR,TR
101635,1700070480,1700101800,31320,178635,164585,TR,TR
176160,1700558640,1700611800,53160,7212,180580,BG,DE
72489,1699083780,1699095360,11580,169397,189788,IT,BE
41711,1698946140,1698969840,23700,151959,35570,DE,CH
14853,1700143920,1700176080,32160,83555,83445,TR,TR
173395,1699545000,1699579080,34080,104546,147538,TR,TR
159622,1699308900,1699331460,22560,158328,192850,RO,MD
15712,1699097940,1699103700,5760,26443,59364,GB,GB
106339,1699944360,1699980420,36060,560,53335,MX,MX
136230,1700090040,1700118840,28800,164204,68218,TR,TR
155599,1700830980,1700834580,3600,167615,33085,GB,GB
38289,1700170260,1700202780,32520,151190,1130,TR,TR
32311,1699908180,1699921140,12960,130951,190060,HR,DE
171973,1699798920,1699816980,18060,178416,139305,BE,FR
119086,1700728860,1700743620,14760,183395,129860,US,US
199658,1699757820,1699789380,31560,20231,66638,TR,TR
92692,1699548420,1699582680,34260,7026,31426,TR,TR
41348,1700770140,1700776800,6660,104462,66976,NL,DE
97520,1700722620,1700754120,31500,12774,140116,TR,TR
102136,1700848020,1700877600,29580,105208,186407,TR,TR
23124,1699634640,1699650240,15600,60467,184421,US,US
160068,1699979040,1699999140,20100,127212,196017,FR,FR
29922,1699344060,1699364820,20760,40857,39504,BE,NL
194503,1699488720,1699500000,11280,22912,157515,US,US
103614,1699112220,1699147200,34980,53414,40896,TR,TR
108583,1700784300,1700797260,12960,51423,133343,ES,ES
972,1699654800,1699660620,5820,157695,65944,NL,NL
126667,1700693940,1700709600,15660,50000,92065,US,US
89882,1699044240,1699077000,32760,1024,81521,TR,TR
20898,1699128480,1699132080,3600,37920,61267,NL,NL
130383,1700393280,1700423940,30660,178522,14043,TR,TR
176935,1698804960,1698834420,29460,120811,31150,TR,TR
38953,1699810500,1699842780,32280,114892,111449,TR,TR
51661,1700756340,1700771280,14940,99692,5186,US,US
12913,1699609260,1699621620,12360,143560,183080,US,US
190784,1699394760,1699426800,32040,178409,149486,TR,TR
76773,1699934340,1699972080,37740,71698,105095,MX,MX
55264,1700189340,1700223600,34260,44242,27378,TR,TR
32921,1700468040,1700503860,35820,106149,197348,TR,TR
71886,1700333280,1700347800,14520,170883,118090,CA,CA
26067,1698939840,1698956520,16680,67135,43470,US,US
163167,1699705920,1699711020,5100,171157,107586,GB,GB
74578,1700549640,1700553240,3600,148676,182858,NL,NL
38294,1699269240,1699275840,6600,107321,20962,NL,BE
101807,1698952320,1698955920,3600,67070,38016,GB,GB
170671,1700260440,1700292240,31800,116629,119199,TR,TR
38038,1698863100,1698886560,23460,67845,187,DE,HR
95815,1699056480,1699070700,14220,197504,63623,IT,IT
185675,1700393760,1700400300,6540,42910,149095,GB,GB
157232,1699581780,1699595580,13800,107231,136499,US,US
115348,1699692360,1699702140,9780,51874,29130,PT,ES
76052,1700507580,1700524320,16740,32635,196587,US,US
156945,1700513400,1700517000,3600,5164,138792,GB,GB
783,1699992540,1700000340,7800,98071,32356,PT,PT
35436,1699890000,1699901940,11940,137236,135332,IT,IT
79039,1699341540,1699371000,29460,23962,59326,TR,TR
83037,1699558740,1699590900,32160,68981,187805,TR,TR
44760,1699910640,1699933560,22920,157361,25511,DE,DE
21327,1699373100,1699407600,34500,86250,71134,TR,TR
195362,1699659780,1699663380,3600,96316,176381,GB,GB
50688,1699137300,1699154640,17340,168775,105787,RS,RS
130388,1699877760,1699913640,35880,138649,48940,TR,TR
20633,1700455440,1700470860,15420,108785,24200,US,US
170118,1700469360,1700500440,31080,137869,167929,TR,TR
98505,1699363740,1699391880,28140,151060,187147,DE,RS
22607,1699050540,1699085520,34980,114113,135137,TR,TR
153973,1700631780,1700666700,34920,18337,157427,TR,TR
173633,1700204940,1700218020,13080,168578,160912,US,US
162609,1700853840,1700887440,33600,161230,58944,TR,TR
59413,1700309820,1700313420,3600,98445,144943,GB,GB
87962,1700742180,1700773500,31320,127050,191666,TR,TR
158752,1700069160,1700078640,9480,111292,95401,EE,EE
26706,1699157280,1699168620,11340,4367,140442,US,US
85797,1700234220,1700240520,6300,2229,69528,GB,GB
68370,1699929300,1699941900,12600,59099,99537,US,US
104385,1699705620,1699711860,6240,47549,149999,GB,GB
66845,1699173780,1699190940,17160,187572,4427,FR,FR
12955,1699906020,1699935720,29700,110761,30790,TR,TR
139518,1700109960,1700133300,23340,129780,162804,BR,BR
69555,1698958500,1698982200,23700,29009,124016,DE,SE
15797,1700164320,1700195340,31020,4352,25940,TR,TR
86025,1699324200,1699327800,3600,95786,18577,GB,GB
80675,1700817180,1700822280,5100,106180,111908,GB,GB
105258,1700450220,1700485680,35460,54976,10916,TR,TR
97088,1700720820,1700732340,11520,45476,23226,PT,PT
122583,1700058120,1700092860,34740,402,107941,TR,TR
151547,1699741080,1699768620,27540,127866,28927,PL,DE
47202,1699386960,1699395360,8400,122059,51540,PT,PT
35739,1698874980,1698904740,29760,148931,138337,TR,TR
40889,1699082340,1699092960,10620,39581,7803,IT,IT
17585,1699681380,1699716660,35280,72562,62235,TR,TR
199571,1700286420,1700291520,5100,50074,109417,GB,GB
160854,1700748120,1700773980,25860,50149,184624,BR,BR
178978,1699630440,1699645200,14760,26419,71691,US,US
168785,1699997760,1700015340,17580,53261,193962,FR,FR
122867,1700644620,1700648220,3600,76346,157796,GB,GB
4936,1700842620,1700856900,14280,181249,47295,US,US
53420,1700044320,1700058960,14640,164571,108833,US,US
84952,1700426880,1700458140,31260,168696,171832,TR,TR
194002,1698846180,1698879600,33420,38728,116018,TR,TR
199281,1700456100,1700460480,4380,194063,77211,CL,CL
148899,1700203080,1700206680,3600,96947,175631,GB,GB
85012,1698995520,1699024020,28500,46492,127878,PL,PL
174642,1700510460,1700546340,35880,123936,71388,TR,TR
129775,1700331120,1700346120,15000,175826,68302,US,US
170207,1699120920,1699154520,33600,196875,117850,TR,TR
198099,1700031180,1700045940,14760,27370,39277,AT,AT
131933,1700232900,1700263800,30900,58717,41622,TR,TR
182484,1700691840,1700703120,11280,181014,118858,PT,PT
118258,1700353440,1700357040,3600,166846,66582,GB,GB
161630,1700537820,1700548980,11160,19556,122256,AT,HR
170592,1698843240,1698846840,3600,174381,168846,GB,GB
191804,1700797740,1700801940,4200,157913,175956,NL,CZ
32928,1699979520,1699990500,10980,48505,6330,IT,IT
161168,1699755660,1699770120,14460,40482,10355,AT,SK
19065,1699191360,1699223640,32280,27975,37868,TR,TR
126652,1699062840,1699077060,14220,72410,159419,US,US
59421,1700079360,1700088720,9360,21392,105073,PT,PT
52856,1700713020,1700746920,33900,96428,132357,TR,TR
46443,1698825480,1698857100,31620,182090,157571,TR,TR
85533,1700334720,1700366400,31680,97172,41005,TR,TR
10378,1700148000,1700164920,16920,177923,115747,US,US
73636,1698794820,1698805440,10620,32627,167372,IT,IT
184175,1700745300,1700775000,29700,20672,31712,TR,TR
114993,1700790540,1700829720,39180,16118,71269,MX,MX
67820,1700545020,1700579760,34740,36426,15487,TR,TR
127378,1699222560,1699256940,34380,15321,142076,TR,TR
108880,1699816260,1699830060,13800,72122,175385,US,US
124107,1699217940,1699250280,32340,12083,63170,TR,TR
164967,1700431680,1700462820,31140,115525,26233,TR,TR
185662,1700798940,1700807100,8160,87395,165225,ES,FR
28081,1700763420,1700777340,13920,185760,8525,US,US
182674,1698825660,1698862140,36480,137354,141302,MX,MX
133557,1699631520,1699662600,31080,181272,47865,TR,TR
38724,1700591160,1700620320,29160,188657,1347,TR,TR
28410,1698985740,1699000800,15060,187742,58517,FR,FR
108098,1699343520,1699368420,24900,193061,83601,DE,PL
69063,1700068980,1700100840,31860,23219,102437,TR,TR
168311,1699100460,1699104060,3600,64003,25747,GB,GB
144009,1699021620,1699047840,26220,127251,184853,RO,RO
111649,1700234220,1700243820,9600,153105,128404,IT,IT
76145,1700099700,1700133060,33360,129791,50830,TR,TR
11323,1700567460,1700603400,35940,103838,38255,TR,TR
119119,1700384160,1700416200,32040,74069,81869,TR,TR
31343,1698862740,1698873720,10980,111364,31807,US,MX
76232,1700688300,1700717580,29280,124883,23700,TR,TR
167883,1699994760,1700029620,34860,38416,47375,TR,TR
3578,1699435680,1699447320,11640,149055,36808,US,US
187539,1698846600,1698858180,11580,38956,12296,IT,IT
31107,1699307340,1699323240,15900,196979,48012,FR,FR
81234,1698949860,1698982620,32760,129471,189344,TR,TR
126871,1700628960,1700659380,30420,61933,77995,TR,TR
159101,1699833600,1699857480,23880,137381,96958,BR,BR
31063,1700114520,1700120460,5940,174301,20095,NL,NL
172525,1699836780,1699867260,30480,159828,58109,TR,TR
49454,1700858580,1700893500,34920,964,90066,TR,TR
60024,1699488540,1699492140,3600,106374,158030,GB,GB
96305,1699077600,1699113060,35460,11650,100367,TR,TR
173934,1700362680,1700366280,3600,48972,36052,NL,NL
172784,1700333040,1700356860,23820,65967,58558,RO,RO
140857,1700711400,1700742780,31380,129412,174052,TR,TR
193827,1699516560,1699520160,3600,153036,49550,GB,GB
7039,1699047000,1699078020,31020,22507,149141,TR,TR
26639,1700177040,1700192220,15180,154126,22300,US,US
77267,1699960500,1699975260,14760,144841,155654,US,US
154866,1700728440,1700758260,29820,2569,153106,TR,TR
59812,1700630640,1700664420,33780,103685,51008,TR,TR
56676,1699786140,1699798620,12480,179628,115028,HR,HR
34116,1700249340,1700266500,17160,146114,14933,US,US
76716,1700126820,1700162640,35820,29333,147371,TR,TR
198483,1700680320,1700714760,34440,109195,81387,TR,TR
30835,1700796120,1700828640,32520,197775,178827,TR,TR
96434,1700656320,1700673840,17520,180633,52887,FR,FR
97189,1699032420,1699047660,15240,138323,37953,US,US
94090,1700391060,1700396400,5340,47368,33429,GB,GB
157636,1699873980,1699877580,3600,176089,199197,NL,NL
9023,1700148540,1700153280,4740,41664,43675,NL,NL
120079,1699224000,1699236480,12480,181542,43702,US,US
128150,1699892580,1699909860,17280,145550,188662,US,US
60758,1699584120,1699616700,32580,137032,113456,TR,TR
55733,1700758500,1700794200,35700,129457,158860,TR,TR
139207,1700577900,1700592060,14160,167643,100615,IT,IT
153820,1699002060,1699031160,29100,143436,142250,TR,TR
173058,1699618200,1699624740,6540,90116,88567,NL,NL
57160,1700777580,1700810160,32580,82997,180690,TR,TR
38983,1700181240,1700217300,36060,87015,100781,MX,MX
158875,1698825120,1698860880,35760,176250,14674,TR,TR
146900,1700805240,1700835180,29940,108201,68279,TR,TR
59846,1699809240,1699839660,30420,163207,77225,TR,TR
102983,1700487540,1700501400,13860,25017,40994,US,US
141461,1699626540,1699640640,14100,89894,114647,US,US
64958,1700833500,1700844840,11340,148341,167975,US,US
195642,1700716800,1700747580,30780,127832,108192,TR,TR
145885,1700853780,1700867400,13620,64568,195365,IT,IT
161919,1700185020,1700202060,17040,54533,55789,US,US
102424,1699993080,1700006100,13020,76164,176827,RS,RS
37082,1700154540,1700190240,35700,54138,106661,TR,TR
81469,1699022340,1699027080,4740,54407,159995,NL,NL
38685,1700294640,1700312040,17400,186729,106799,US,US
167459,1699048920,1699054860,5940,4373,181145,GB,GB
91938,1699379160,1699409640,30480,48745,131876,TR,TR
127449,1699873860,1699908180,34320,24652,329,TR,TR
180882,1699189500,1699220460,30960,65379,171700,TR,TR
67107,1700776320,1700793300,16980,80868,190517,US,US
75936,1700751000,1700762160,11160,157843,190276,ES,ES
175910,1699522920,1699548720,25800,118156,75870,BR,BR
67795,1700797980,1700809260,11280,157505,78893,US,MX
90585,1700372460,1700407560,35100,61216,191294,TR,TR
96416,1700031300,1700041140,9840,198542,11720,HR,RS
162117,1699780920,1699784520,3600,135222,170763,NL,NL
10522,1700118720,1700135220,16500,146747,99654,AT,BG
72780,1700047860,1700080740,32880,80627,40989,TR,TR
169670,1700513160,1700528160,15000,176302,167276,FR,FR
2838,1700212380,1700244000,31620,70265,186379,TR,TR
40010,1699591980,1699606020,14040,183998,128728,IT,IT
152341,1700626860,1700660160,33300,93319,121684,TR,TR
62152,1699300740,1699332780,32040,78752,192519,TR,TR
56030,1700185500,1700219160,33660,156745,69027,TR,TR
113652,1700435520,1700445720,10200,145449,193921,AD,ES
111479,1700203140,1700214180,11040,159481,178539,IT,IT
111875,1700006700,1700023620,16920,3037,6552,FR,CH
168181,1698957540,1698963840,6300,16100,38589,GB,GB
60761,1698914880,1698947940,33060,126025,28528,TR,TR
144922,1700249880,1700279760,29880,155026,141339,TR,TR
74457,1700514780,1700549040,34260,156911,186949,TR,TR
19199,1699226220,1699241340,15120,49379,2626,US,US
91180,1699666620,1699674720,8100,144162,159684,HR,HR
5087,1699648800,1699672800,24000,37878,5537,BR,BR
66081,1699550700,1699583280,32580,38918,154863,TR,TR
20232,1700039520,1700068920,29400,165043,65009,TR,TR
146920,1700865060,1700894100,29040,10080,180760,TR,TR
89647,1700707680,1700714760,7080,189913,51291,GB,GB
97487,1700814240,1700847540,33300,125545,158646,TR,TR
88524,1699404240,1699420740,16500,177060,136871,FR,FR
87620,1699232580,1699266900,34320,46386,159131,TR,TR
69722,1699860540,1699895520,34980,79034,8278,TR,TR
119287,1700043420,1700077860,34440,192169,110865,TR,TR
157377,1700219160,1700235300,16140,127011,171194,US,US
104174,1700439660,1700473260,33600,4605,106605,TR,TR
176154,1700663160,1700697660,34500,68494,150180,TR,TR
40461,1699042920,1699076580,33660,172374,171965,TR,TR
33531,1700376360,1700382300,5940,163973,16394,GB,GB
20028,1700109660,1700126820,17160,3992,115435,RS,RS
177014,1700818320,1700832480,14160,67464,3521,IT,IT
191366,1698946620,1698967440,20820,106206,61899,FR,BE
132172,1700407740,1700414880,7140,21330,173245,NL,NL
84057,1700278500,1700282100,3600,35030,79265,NL,NL
14418,1699248540,1699270440,21900,88100,51120,BR,BR
35482,1699596840,1699614720,17880,54231,87849,FR,DE
100245,1699828140,1699844880,16740,72442,47265,US,US
29840,1700840640,1700853300,12660,37634,66176,US,US
141591,1699102500,1699132980,30480,140122,190960,TR,TR
115582,1700808900,1700846400,37500,133289,163676,MX,MX
147195,1699762380,1699776420,14040,14224,45774,US,US
152390,1700536860,1700542140,5280,174425,17853,GB,GB
57746,1700254200,1700274540,20340,107400,38587,SE,NO
112180,1700475180,1700501520,26340,8841,133268,DE,BE
71759,1700309280,1700312880,3600,34822,83043,NL,NL
18086,1700759940,1700772060,12120,174052,174121,US,US
98941,1700600700,1700604300,3600,153779,58541,NL,NL
197530,1700346180,1700382300,36120,97149,77550,MX,MX
12716,1699335060,1699356000,20940,14493,107821,BE,DE
27284,1700109180,1700120580,11400,194567,29093,IT,IT
117642,1700423340,1700449620,26280,92933,2732,CH,DE
6188,1699818960,1699847160,28200,58111,130748,PL,PL
163121,1698857460,1698872820,15360,173665,28016,US,US
46485,1698983400,1699014180,30780,180483,60521,TR,TR
81416,1700743740,1700747400,3660,10151,26429,NL,DE
198786,1700447820,1700482860,35040,1734,150482,TR,TR
154320,1698818820,1698851760,32940,138020,22192,TR,TR
150383,1699634520,1699658460,23940,136369,32283,CH,DE
118422,1699180020,1699212780,32760,73620,59241,TR,TR
110837,1700388600,1700398080,9480,158782,108398,HR,HR
173744,1700081940,1700116200,34260,106419,126139,MX,MX
165634,1700256240,1700289600,33360,76913,187793,TR,TR
147346,1700091900,1700104440,12540,171632,44946,US,US
193025,1699844760,1699877040,32280,13606,124709,TR,TR
196809,1699036260,1699061340,25080,134669,106180,PL,AT
54976,1699678440,1699707360,28920,165814,115433,TR,TR
131242,1699276920,1699305720,28800,192595,191984,TR,TR
183561,1699370580,1699387920,17340,6063,84985,US,US
181664,1700379000,1700391840,12840,126825,155672,US,US
94551,1700211180,1700238420,27240,164981,122205,PL,PL
184958,1699889760,1699899360,9600,172678,13388,IT,IT
114992,1699136820,1699157820,21000,69716,31580,FR,FR
108083,1699943160,1699973400,30240,54922,121268,TR,TR
22721,1699837260,1699859640,22380,14882,122085,HU,HR
1045,1700227320,1700230920,3600,194903,137719,NL,NL
185849,1698964980,1698979020,14040,92614,52031,US,US
46077,1700294520,1700326500,31980,133862,187543,TR,TR
154613,1700395200,1700424300,29100,32544,170859,TR,TR
90802,1700531580,1700565600,34020,139952,70121,TR,TR
159615,1699931760,1699937160,5400,52701,168006,NL,NL
14816,1699084080,1699116720,32640,129168,25982,TR,TR
49652,1699495680,1699522620,26940,187461,89414,HU,DE
159404,1700260140,1700267580,7440,1832,47979,SK,SK
17171,1700274480,1700285820,11340,26100,148776,PT,PT
131877,1699410540,1699441560,31020,108845,149225,TR,TR
68688,1699056600,1699068120,11520,16243,147231,IT,IT
116262,1699354500,1699387020,32520,129816,182181,TR,TR
199927,1700035740,1700041680,5940,107141,71108,GB,GB
55230,1698990420,1699005480,15060,188818,167524,US,US
20333,1700303820,1700316300,12480,27828,76600,AT,AT
103335,1699938180,1699955040,16860,145939,182534,AT,PL
14596,1698823980,1698853740,29760,143734,126274,TR,TR
178876,1699872540,1699896600,24060,36392,85175,DE,PL
127416,1700731680,1700761980,30300,144863,181515,TR,TR
177146,1699794600,1699809300,14700,172242,18291,FR,FR
199161,1699586760,1699603260,16500,3486,100587,FR,FR
180142,1699042920,1699060440,17520,88888,182728,US,US
1540,1700255160,1700287800,32640,54225,96781,TR,TR
18435,1698856200,1698859800,3600,132601,130228,GB,GB
103934,1700732520,1700764560,32040,29502,3329,TR,TR
53098,1700459760,1700470080,10320,64360,123446,PT,PT
148787,1699675140,1699700640,25500,163427,110255,CH,IT
192483,1699449000,1699464240,15240,14355,138058,FR,ES
11714,1700279760,1700312640,32880,73214,188087,TR,TR
188008,1700483880,1700489100,5220,192206,77361,GB,GB
51915,1699900800,1699930740,29940,130317,156720,TR,TR
4164,1700464860,1700478840,13980,194606,123868,IT,IT
105270,1699217820,1699246140,28320,67408,177117,CH,PL
4090,1699750500,1699767060,16560,49972,157130,US,US
13727,1700796300,1700811480,15180,47656,114443,US,US
78083,1700254440,1700278560,24120,54193,79644,DE,DE
125851,1699672140,1699697040,24900,36761,38288,PL,UA
8920,1700600280,1700632980,32700,12369,3740,TR,TR
151050,1699832940,1699850340,17400,41271,57342,US,US
183018,1700792640,1700803320,10680,123136,11658,AD,FR
35306,1699548180,1699561560,13380,12986,134206,SK,SK
63509,1700757120,1700769000,11880,191017,179178,PT,PT
50706,1699668840,1699701420,32580,123004,38984,TR,TR
19466,1698840300,1698864540,24240,81605,53385,DE,MK
12202,1700845320,1700874120,28800,5129,14911,TR,TR
55938,1699222260,1699252980,30720,22705,37221,TR,TR
61747,1699851420,1699882140,30720,97396,76314,TR,TR
122137,1699614180,1699623780,9600,63433,141629,IT,IT
65627,1698979860,1699009020,29160,123989,16789,TR,TR
67736,1700567160,1700597280,30120,84534,33129,TR,TR
198125,1700813340,1700820060,6720,114214,193471,AD,ES
161488,1698940860,1698969060,28200,104159,38237,DE,SK
88750,1698865620,1698877380,11760,145052,143042,ES,ES
168783,1700865660,1700884560,18900,183783,182211,FR,FR
52046,1700146080,1700161440,15360,77676,197352,US,US
195413,1700503680,1700507280,3600,74766,39186,GB,GB
28653,1699023060,1699039200,16140,34422,153867,US,US
29959,1700336100,1700366460,30360,158852,145329,TR,TR
99480,1698949980,1698982500,32520,99514,44664,TR,TR
124000,1699214160,1699249500,35340,17802,6459,TR,TR
173527,1700407200,1700428620,21420,59030,86219,BE,FR
56741,1700786640,1700797320,10680,152178,52350,FI,EE
85558,1699267260,1699281360,14100,150441,141320,IT,IT
171758,1699759800,1699770840,11040,150311,178391,US,US
111447,1700824380,1700857380,33000,76827,96188,TR,TR
178421,1699561200,1699564800,3600,7100,69922,GB,GB
14896,1699330680,1699355220,24540,134896,71408,DE,UA
133127,1700218740,1700247120,28380,176716,34486,CH,IT
190239,1700269260,1700283660,14400,188452,27348,FR,FR
93850,1698844200,1698879240,35040,90849,51810,TR,TR
58076,1700552040,1700555940,3900,147202,119948,GB,GB
162171,1700145060,1700158380,13320,197510,159450,US,US
61795,1699760400,1699776540,16140,17562,130057,US,US
70908,1700408220,1700411820,3600,106327,116797,GB,GB
154517,1699182240,1699195500,13260,134024,189130,HR,HR
17729,1700571540,1700602080,30540,39144,5213,TR,TR
165955,1700144100,1700147700,3600,196255,175040,GB,GB
35808,1700655720,1700668920,13200,81290,174369,US,US
135279,1699014240,1699024440,10200,745,141421,EE,EE
194281,1699501320,1699534980,33660,101848,182130,MX,MX
37929,1699846440,1699876500,30060,10633,99878,TR,TR
34064,1699326300,1699359300,33000,89228,173523,TR,TR
159698,1700033820,1700065740,31920,16290,108336,TR,TR
76718,1699104300,1699110720,6420,134802,95591,GB,GB
76067,1698796260,1698829380,33120,42967,114433,TR,TR
29372,1699765680,1699783920,18240,48652,137709,FR,FR
143919,1700792460,1700825880,33420,128732,65562,TR,TR
416,1700263680,1700268840,5160,133144,50916,GB,GB
103903,1699776840,1699785360,8520,187091,121270,IT,IT
106413,1699607580,1699611180,3600,175366,149281,GB,GB
103821,1698966780,1698975180,8400,89590,183097,PT,PT
178289,1700194200,1700211420,17220,144730,127155,US,US
110819,1699299180,1699334580,35400,26844,184397,TR,TR
50035,1699592460,1699596060,3600,9454,153494,NL,DE
152248,1698990240,1698994200,3960,184103,47885,NL,NL
114573,1699336320,1699361580,25260,186539,72372,DE,DE
152081,1699343820,1699379700,35880,103128,18570,TR,TR
12560,1700798820,1700830920,32100,50930,32352,TR,TR
22098,1698951960,1698955560,3600,82165,17399,GB,GB
134509,1698932760,1698938220,5460,97340,183821,NL,NL
166713,1699933260,1699957260,24000,87415,175250,DE,DE
171689,1700254860,1700271960,17100,101306,162144,US,US
108680,1700257620,1700290680,33060,107290,94363,TR,TR
37813,1700165400,1700179440,14040,101345,149008,IT,IT
14793,1700565840,1700596440,30600,158926,43600,TR,TR
131893,1698848460,1698858000,9540,180561,118896,IT,IT
142886,1699506180,1699537560,31380,199236,84889,BA,BA
180853,1699440660,1699452240,11580,36967,29949,PT,PT
183893,1700566140,1700571840,5700,8676,157855,GB,GB
92524,1700836920,1700840580,3660,75930,195269,EE,EE
40144,1699532460,1699562160,29700,71436,187675,TR,TR
147861,1698920580,1698946440,25860,50714,14437,DE,IT
170515,1698846060,1698849660,3600,181768,93310,GB,GB
58697,1699651080,1699662840,11760,131566,37679,US,US
30493,1700496600,1700512200,15600,182760,186733,SE,SE
108327,1699255380,1699290720,35340,4948,169456,TR,TR
183107,1700468880,1700482440,13560,75975,145828,RS,RS
70639,1699612440,1699645080,32640,22252,67407,TR,TR
102188,1700705760,1700709900,4140,64634,81009,GB,GB
74150,1698952560,1698965340,12780,194334,102093,SK,AT
224,1700579400,1700584980,5580,170967,159027,GB,GB
3153,1699292460,1699324500,32040,74038,26685,TR,TR
103591,1700300520,1700332500,31980,172894,65005,TR,TR
86704,1699698960,1699706640,7680,116918,1034,PT,PT
92500,1699064280,1699067880,3600,172414,83527,NL,NL
164729,1699566060,1699576920,10860,57116,59675,US,US
158315,1698805380,1698816600,11220,11854,25091,SK,SK
83910,1699690080,1699710660,20580,128212,175094,SE,NO
31058,1700172900,1700176500,3600,190386,119302,GB,GB
24628,1700619900,1700628960,9060,2915,54675,AD,ES
94848,1699197660,1699231380,33720,89931,170028,TR,TR
4695,1699310280,1699317060,6780,193147,183362,GB,GB
195601,1700693820,1700716620,22800,146200,33003,DE,IT
104801,1699015260,1699039680,24420,96364,137698,DE,IT
134589,1699780380,1699816200,35820,42430,105424,TR,TR
47477,1700269740,1700287440,17700,141391,103114,US,US
63545,1700436000,1700467920,31920,136637,57238,TR,TR
84781,1698841140,1698872640,31500,37558,191660,TR,TR
86654,1700566080,1700569680,3600,131946,138265,NL,NL
150107,1699240080,1699252980,12900,119755,141983,IT,IT
56220,1700625540,1700660100,34560,159862,78735,TR,TR
169592,1700447940,1700482140,34200,177363,81866,MX,MX
151271,1699876800,1699907040,30240,142859,48567,TR,TR
164013,1700852100,1700879280,27180,72525,108628,DE,CH
183668,1699395480,1699401840,6360,185871,107322,GB,GB
179532,1700137140,1700143860,6720,8725,84414,GB,GB
175118,1700398440,1700402040,3600,170051,38362,NL,NL
89159,1700610540,1700643240,32700,152262,54274,TR,TR
36179,1698947280,1698960300,13020,10200,2089,CA,US
81334,1700451060,1700467680,16620,46176,100911,CZ,CZ
2949,1699242000,1699277940,35940,93467,175969,TR,TR
92414,1700166660,1700202480,35820,154265,111688,TR,TR
166782,1700510880,1700515860,4980,191574,66283,GB,GB
74932,1698829260,1698841680,12420,179057,159153,US,US
142001,1700165580,1700172780,7200,19164,79117,IT,IT
148124,1700429760,1700465040,35280,198282,36062,TR,TR
194667,1699686780,1699704480,17700,52749,18268,US,US
66701,1699126080,1699156080,30000,21056,195755,TR,TR
168588,1700183640,1700214000,30360,74915,177091,TR,TR
186997,1698818940,1698854460,35520,63278,122215,TR,TR
128839,1699614420,1699625520,11100,188113,86979,IT,IT
166062,1699078680,1699111620,32940,103011,183672,TR,TR
69860,1699747260,1699772040,24780,126171,45869,DE,DE
151160,1699836360,1699855080,18720,161519,63100,FR,FR
25252,1700753460,1700757540,4080,15157,189040,NL,NL
35120,1699128060,1699163700,35640,113738,139172,TR,TR
168049,1698929760,1698963300,33540,37054,97045,TR,TR
162566,1699767360,1699781040,13680,34632,24857,ES,ES
90678,1699779540,1699800900,21360,10306,116064,BE,FR
40268,1699625700,1699653540,27840,171473,29809,BR,BR
44095,1699177260,1699180860,3600,160746,190527,GB,GB
83903,1700336040,1700367600,31560,60208,165590,TR,TR
179897,1700039760,1700072280,32520,148585,33112,TR,TR
3572,1700765940,1700794920,28980,79193,122673,TR,TR
133540,1700257680,1700261280,3600,94959,62493,GB,GB
191141,1700824620,1700838120,13500,192251,51933,US,US
81692,1699082640,1699094100,11460,185417,150317,RS,FR
43243,1700752680,1700756460,3780,180190,132547,EE,EE
163467,1700279220,1700282820,3600,193023,1947,GB,GB
190756,1700826480,1700853060,26580,192384,117646,DE,NL
65416,1700805780,1700832300,26520,87625,55993,HU,CZ
181657,1698918540,1698934740,16200,166612,61263,US,US
182306,1699617060,1699629420,12360,22314,73368,IT,IT
135629,1699514100,1699537980,23880,198150,156739,DE,UA
78524,1700345580,1700353320,7740,64726,47721,IT,IT
19340,1699298460,1699312860,14400,195621,199593,RS,RS
113934,1700507160,1700540220,33060,18667,192740,TR,TR
135250,1700813880,1700827800,13920,120240,34101,US,US
6380,1700837100,1700843100,6000,16870,75960,GB,GB
159924,1699160340,1699178700,18360,166381,193150,FR,IT
93112,1698938100,1698959760,21660,144430,128594,RO,RO
167168,1700013060,1700028360,15300,151311,158798,US,US
83002,1699557360,1699570500,13140,136448,90045,IT,IT
140853,1698986460,1699015200,28740,192171,15779,BR,BR
87950,1699265220,1699294500,29280,141818,167407,TR,TR
80880,1700728860,1700752980,24120,76553,172733,HU,HR
50814,1699530600,1699539480,8880,8287,139559,SK,SK
36350,1700629080,1700662080,33000,175370,161,TR,TR
122076,1698860340,1698890760,30420,11321,137063,TR,TR
116460,1699628760,1699651680,22920,52704,125941,CH,DE
154945,1700520120,1700555640,35520,128917,100461,TR,TR
27961,1700714520,1700721300,6780,132825,61180,NL,NL
152221,1700783580,1700792880,9300,45376,135185,IT,IT
187062,1699982220,1699985820,3600,8857,137451,GB,NL
22771,1700193300,1700196900,3600,100085,129266,NL,NL
2936,1700464500,1700496960,32460,162184,34769,TR,TR
136318,1700281680,1700290080,8400,7589,29345,PT,PT
29251,1700020500,1700047560,27060,163222,127047,BR,BR
100418,1699330320,1699365300,34980,105096,77824,TR,TR
186140,1699451580,1699463640,12060,147644,75353,US,US
67896,1700352960,1700365860,12900,102321,54096,US,US
170944,1700164800,1700188080,23280,89154,109074,DE,DE
82072,1699743720,1699756620,12900,44192,181540,IT,IT
151085,1700082420,1700117160,34740,66734,52500,TR,TR
15351,1699388340,1699402260,13920,78844,119307,US,US
168044,1699439940,1699457520,17580,96874,135637,US,US
22868,1699330320,1699342980,12660,104717,3761,US,US
80101,1699078140,1699115880,37740,127491,79776,MX,MX
163867,1699713900,1699725120,11220,199916,45683,IT,IT
158291,1700778540,1700798220,19680,50030,64901,FR,FR
193132,1700834040,1700867040,33000,1113,186265,TR,TR
71404,1699309560,1699339980,30420,108155,87466,TR,TR
70966,1699760220,1699763820,3600,47453,51658,GB,GB
17684,1700227980,1700260020,32040,4064,156779,TR,TR
192979,1699036800,1699070880,34080,188421,34422,TR,TR
21842,1699767420,1699773720,6300,128048,109108,GB,GB
152919,1700046720,1700063460,16740,130928,10358,US,US
178302,1700398500,1700429100,30600,154956,145083,TR,TR
69320,1700866680,1700890680,24000,194811,95542,PL,DE
38718,1699059960,1699091160,31200,4394,35341,TR,TR
47285,1698986040,1699015020,28980,95282,142840,TR,TR
104830,1699261140,1699264740,3600,72119,16470,GB,GB
94469,1699011360,1699014960,3600,199098,76086,GB,GB
131715,1700325600,1700329200,3600,98337,136206,GB,GB
113804,1699309800,1699341780,31980,152558,27815,TR,TR
159197,1698991200,1698999600,8400,90437,134437,IT,IT
98039,1699426800,1699443240,16440,28155,83688,RS,HR
113052,1698943380,1698946980,3600,41199,149415,GB,GB
46963,1700595540,1700605440,9900,34744,193179,HR,ME
109780,1699670280,1699702080,31800,68390,120107,TR,TR
127293,1699694160,1699709100,14940,71130,191813,US,US
125614,1699143120,1699156860,13740,96292,32630,IT,IT
23211,1699585680,1699592760,7080,46228,55113,GB,GB
159356,1699337760,1699371180,33420,18778,118704,TR,TR
196147,1698858600,1698877620,19020,60711,62893,IN,IN
123596,1699756560,1699787340,30780,58510,86093,TR,TR
3641,1699178880,1699182720,3840,179819,79885,GB,GB
46298,1699947360,1699956420,9060,162027,117945,IT,DE
44246,1700728680,1700740020,11340,107107,76769,US,US
151014,1700628360,1700666100,37740,184661,63459,MX,MX
51923,1698815100,1698844020,28920,95324,168822,TR,TR
111134,1700787180,1700819520,32340,41362,71216,TR,TR
97004,1699179840,1699183440,3600,10672,106767,NL,BE
166846,1699555200,1699559580,4380,19784,129736,GB,GB
79707,1699866600,1699899780,33180,121459,74105,TR,TR
169971,1700441640,1700453640,12000,44944,25801,IT,IT
23733,1700567880,1700574720,6840,23398,185356,GB,NL
196180,1699734300,1699745280,10980,160379,111151,US,US
58566,1699118820,1699126560,7740,95406,150000,HR,HR
31170,1699176840,1699182840,6000,113723,149767,EE,EE
172690,1699340460,1699373280,32820,167845,159378,TR,TR
11544,1699545060,1699596840,51780,22789,58351,BG,RO
90108,1700200740,1700212860,12120,83357,12098,US,US
52115,1700275260,1700283540,8280,78956,182283,IT,IT
79910,1699414920,1699446240,31320,157291,60834,TR,TR
74049,1700803800,1700833680,29880,3441,199431,TR,TR
91490,1699820040,1699826880,6840,112462,187692,GB,GB
6672,1700293740,1700324940,31200,122758,188680,TR,TR
182037,1700411940,1700447160,35220,191219,78195,TR,TR
44861,1698953400,1698977280,23880,16313,92140,ME,RS
47775,1699093980,1699101540,7560,61379,183654,IT,IT
78823,1700808540,1700841840,33300,64343,100179,TR,TR
85217,1699333620,1699351500,17880,113838,111218,US,US
143408,1700100180,1700108400,8220,143330,182043,IT,IT
74938,1700843100,1700878620,35520,134535,147200,MX,MX
161074,1699500120,1699532400,32280,107468,114734,TR,TR
156421,1700369700,1700373300,3600,48311,86487,GB,GB
85449,1698837240,1698852720,15480,171491,197292,SE,SE
14942,1698984240,1699013460,29220,195025,16379,TR,TR
118012,1698904020,1698935820,31800,48515,190225,TR,TR
163691,1698966000,1698975540,9540,173266,166408,EE,EE
39892,1699165320,1699173600,8280,55159,82500,IT,IT
177228,1700467440,1700497680,30240,160055,113219,TR,TR
39498,1700599800,1700620500,20700,126336,139279,FR,FR
26754,1699767900,1699802280,34380,165240,186634,TR,TR
48664,1700793000,1700827620,34620,71217,300,TR,TR
167978,1700028660,1700088480,59820,37711,47321,UA,PL
132267,1699270320,1699303320,33000,115834,139214,TR,TR
114660,1698823800,1698863040,39240,55982,41586,MX,MX
144588,1698941760,1698975120,33360,136934,170449,TR,TR
130503,1698982080,1699017780,35700,93225,125146,TR,TR
172298,1700380980,1700384580,3600,139185,25299,GB,GB
72671,1699158780,1699193220,34440,140155,136277,TR,BG
84864,1700251980,1700282520,30540,94880,18001,TR,TR
85115,1699629720,1699633860,4140,131427,116814,GB,GB
194702,1700357280,1700389320,32040,69899,40317,TR,TR
85257,1699992060,1700049600,57540,76392,77038,BG,DE
93650,1699123560,1699127160,3600,119311,184612,GB,GB
178180,1700399880,1700403480,3600,186388,13004,GB,GB
124498,1699832220,1699847580,15360,91559,176862,US,US
183733,1699198020,1699225980,27960,87758,160632,DE,DE
22170,1698907320,1698913200,5880,171233,136718,NL,NL
171544,1699743720,1699769400,25680,34430,122512,BR,BR
133704,1700707440,1700720700,13260,119560,188854,RS,BA
178781,1700317560,1700351340,33780,10425,98397,TR,TR
177814,1699798440,1699833840,35400,103336,125992,TR,TR
10558,1700598900,1700609280,10380,47375,124462,PT,PT
178149,1699312200,1699320480,8280,32569,127598,IT,IT
157408,1700119440,1700151840,32400,163763,198324,TR,TR
79601,1699269540,1699326600,57060,38783,115970,BG,AT
45638,1699002300,1699005900,3600,1861,194668,GB,GB
122433,1699793400,1699825800,32400,103005,59081,TR,TR
160017,1700469240,1700484240,15000,129609,115392,FR,FR
115677,1700526120,1700561880,35760,3730,23117,TR,TR
15867,1700515920,1700550660,34740,59401,144781,TR,TR
23358,1699461120,1699472460,11340,106139,35076,US,US
70687,1699306740,1699310340,3600,176034,114539,NL,NL
146537,1700193720,1700202900,9180,49750,66266,IT,IT
47731,1699254540,1699281300,26760,34953,127777,CH,BE
148558,1700231220,1700242260,11040,11544,60928,US,US
135583,1699816200,1699827360,11160,56327,160640,IT,IT
180160,1699911120,1699946400,35280,81948,123182,MX,MX
198860,1700571420,1700577120,5700,166295,160125,NL,NL
57542,1698899700,1698913380,13680,139554,53329,US,US
9594,1698801720,1698819120,17400,126714,199453,US,US
163722,1699450680,1699483860,33180,139150,119947,TR,TR
170248,1699522140,1699551420,29280,133361,42066,TR,TR
19140,1700037900,1700068440,30540,55376,118437,TR,TR
30595,1700632020,1700646840,14820,35349,22891,US,US
97176,1699203960,1699230600,26640,101613,13017,PL,DE
143664,1700043900,1700057880,13980,120146,18388,ES,AD
2534,1700196300,1700208780,12480,128246,190747,US,US
94807,1700298060,1700329560,31500,85436,146947,TR,TR
34981,1699345020,1699355760,10740,26068,11722,IT,IT
130289,1699033560,1699062060,28500,120328,11887,DE,BE
176122,1700445480,1700461080,15600,117919,94169,US,US
84181,1699808400,1699812660,4260,54549,132081,GB,GB
50999,1700315640,1700319240,3600,34853,137347,GB,GB
97996,1699460940,1699475760,14820,163522,33269,FR,BE
600,1699618500,1699629420,10920,33843,74068,CZ,CZ
161343,1698837540,1698841140,3600,26440,145428,GB,GB
145150,1699552980,1699581780,28800,80772,148723,TR,TR
80535,1700321280,1700329740,8460,2000,164507,IT,IT
119891,1700779260,1700786760,7500,169129,11189,HR,HR
84529,1699596900,1699603680,6780,38727,27791,GB,GB
129618,1700257260,1700268120,10860,162717,33697,US,US
118674,1699943700,1699954980,11280,198987,156300,IT,IT
80771,1698804120,1698807960,3840,55872,87498,GB,GB
50549,1700112060,1700145480,33420,21445,197775,TR,TR
98969,1698870600,1698887160,16560,147924,11974,US,US
189722,1699691520,1699727220,35700,21303,19650,TR,TR
125647,1698810420,1698820020,9600,96809,143229,IT,IT
56033,1699585200,1699616880,31680,88349,151280,TR,TR
45758,1700670660,1700706360,35700,50795,140302,TR,TR
154993,1699866600,1699902420,35820,174284,35644,TR,TR
120910,1700535180,1700561520,26340,15472,56777,DE,DE
86346,1700238900,1700252100,13200,98980,153785,IT,IT
69278,1699170240,1699177680,7440,21766,76358,SK,AT
116814,1699524600,1699530240,5640,78281,6668,EE,EE
102780,1698892080,1698904200,12120,95368,9238,US,US
75413,1700714220,1700745960,31740,175017,122870,TR,TR
67320,1699415400,1699419000,3600,45754,138258,NL,NL
75572,1699493520,1699506900,13380,177237,135066,US,US
182533,1700451660,1700469120,17460,43127,115354,US,MX
193045,1699462140,1699468740,6600,26869,30769,GB,GB
8553,1700838060,1700841660,3600,30077,116267,GB,GB
16196,1700808900,1700813100,4200,92421,18145,GB,GB
145419,1700008560,1700026140,17580,183710,194951,US,US
140193,1699490700,1699503180,12480,29291,187931,IT,IT
41019,1700347140,1700358660,11520,64382,186736,AT,RS
106062,1698987780,1698998820,11040,84035,51331,IT,IT
193285,1699187580,1699198680,11100,115395,27987,IT,MK
135708,1699972620,1700005560,32940,101455,79934,MX,MX
55683,1700742960,1700776080,33120,149914,95582,TR,TR
142269,1699251360,1699267560,16200,154427,43083,US,US
153349,1700317440,1700331600,14160,164541,117390,AT,DE
172431,1700340120,1700367960,27840,66408,158467,BR,BR
47116,1698924960,1698937260,12300,12808,154126,US,MX
97026,1699333620,1699338780,5160,21217,100727,NL,NL
174749,1699710720,1699724400,13680,183942,46660,US,US
176219,1699325700,1699337160,11460,145053,177136,RS,RS
158182,1700819280,1700845440,26160,76099,18421,BR,BR
78017,1700227680,1700232120,4440,140108,44308,NL,NL
59542,1700247060,1700250660,3600,66333,20594,GB,GB
73348,1700533680,1700537280,3600,25661,128141,NL,NL
93119,1699972620,1699986960,14340,92719,26357,PT,PT
76667,1699983180,1699992540,9360,124951,28370,IT,IT
65253,1699062180,1699077720,15540,173486,108365,US,US
59840,1700032620,1700065740,33120,176909,41952,TR,TR
195473,1700747820,1700770140,22320,97116,171178,BR,BR
68481,1699762860,1699770240,7380,177571,99036,IT,IT
56954,1699929480,1699962000,32520,62938,37027,TR,TR
58426,1699059120,1699089540,30420,93200,132383,TR,TR
194757,1699859640,1699863600,3960,99673,34785,GB,GB
24983,1699892160,1699917120,24960,105983,90016,DE,DE
39829,1699040160,1699050660,10500,51661,55245,IT,IT
105404,1700612040,1700622360,10320,100241,166911,IT,IT
37681,1700148060,1700157780,9720,72036,164940,IT,IT
177817,1699397460,1699428780,31320,171634,154065,TR,TR
91479,1700241180,1700246460,5280,50251,133648,GB,GB
91030,1700221260,1700225760,4500,196183,43295,NL,NL
65456,1700641560,1700655600,14040,160233,26214,IT,IT
48227,1700501880,1700506020,4140,182365,144525,GB,GB
173360,1700094420,1700098020,3600,121911,45198,GB,GB
129268,1700862660,1700897100,34440,12493,74442,TR,TR
164233,1700317860,1700322780,4920,20747,22793,GB,GB
163576,1699642740,1699673220,30480,15741,74683,TR,TR
174765,1700244720,1700259720,15000,117317,124768,CA,CA
77871,1700739180,1700754840,15660,36910,166505,US,US
67284,1699615020,1699641240,26220,181172,87541,DE,DE
21935,1699448760,1699483860,35100,164887,30887,TR,TR
108038,1700478720,1700494020,15300,140899,109225,US,US
44399,1699342440,1699347180,4740,190287,155351,NL,NL
54002,1700652060,1700659860,7800,174285,146481,CL,CL
147284,1698884160,1698905460,21300,7867,68791,MD,RO
128352,1700789580,1700817120,27540,121628,156166,DE,PL
188410,1699012140,1699024140,12000,73045,55977,US,US
148335,1699103280,1699117800,14520,145672,147899,US,US
177627,1699829880,1699836060,6180,111366,19571,GB,GB
167073,1699719120,1699756320,37200,29630,71616,MX,MX
125709,1699994580,1699998180,3600,181971,13149,GB,GB
119888,1699631340,1699669620,38280,77062,183039,MX,MX
123606,1699342920,1699346880,3960,166898,184760,GB,GB
92770,1699839480,1699853100,13620,153599,61468,AT,AT
76265,1699156800,1699189200,32400,187283,90147,TR,TR
4966,1700008260,1700026740,18480,106678,94352,FR,NL
185764,1700513820,1700525760,11940,106471,57184,PT,PT
108934,1700349780,1700353380,3600,59281,184885,NL,FR
61304,1700631060,1700664780,33720,38998,104460,MX,MX
162898,1700749680,1700763840,14160,190037,79011,AT,AT
109760,1699287720,1699318860,31140,3663,147825,TR,TR
123084,1699959300,1699989720,30420,156677,169553,TR,TR
3345,1699704780,1699718280,13500,174516,111073,US,US
159618,1699275060,1699285680,10620,193498,166438,IT,IT
139869,1698877020,1698890640,13620,4333,118458,PT,PT
13597,1699922520,1699926120,3600,182103,163079,NL,NL
165382,1698871560,1698890880,19320,158992,5744,FR,FR
11520,1700560680,1700586360,25680,179023,19054,DE,HU
182500,1700169840,1700187960,18120,50871,16243,FR,FR
50565,1699821000,1699851060,30060,100043,33379,TR,TR
57063,1699096680,1699100280,3600,32071,187898,NL,NL
196751,1698904740,1698929340,24600,152363,91467,DE,PL
183422,1700250300,1700284560,34260,67034,9801,TR,TR
178505,1699913940,1699917540,3600,124140,160291,GB,GB
171130,1700684700,1700702340,17640,162949,27571,AT,AT
10161,1699773960,1699784880,10920,194645,16276,US,US
194186,1699368540,1699372140,3600,107902,185224,GB,GB
68728,1699815360,1699844340,28980,105310,79658,TR,TR
173871,1699866600,1699883340,16740,17640,44954,US,US
77666,1699029420,1699036500,7080,119660,38685,NL,NL
124068,1700565780,1700593800,28020,143673,169854,BR,BR
75529,1700269140,1700276160,7020,97934,157507,NL,DE
148591,1700801400,1700835720,34320,111401,167358,TR,TR
133779,1699805100,1699838100,33000,60413,6641,TR,TR
49367,1699447980,1699459380,11400,15755,119243,US,US
181506,1700755920,1700771280,15360,5458,165152,FR,FR
186284,1700771100,1700774700,3600,177446,190995,GB,GB
28744,1700781840,1700813100,31260,86996,78974,BA,DE
77740,1699915500,1699923240,7740,82042,85381,IT,IT
73544,1699969200,1700001840,32640,145005,117959,TR,TR
21949,1700321100,1700337600,16500,190296,94000,US,US
147253,1699645860,1699649460,3600,75110,163522,NL,NL
172943,1699847160,1699862880,15720,123552,135396,US,US
150561,1700765340,1700797560,32220,99129,45271,TR,TR
169815,1700186520,1700215980,29460,153111,143300,TR,TR
160488,1699571880,1699603320,31440,109126,546,TR,TR
133571,1698991560,1699002780,11220,161142,183291,US,US
110755,1699638540,1699672500,33960,177454,72494,TR,TR
150440,1699906380,1699932180,25800,198504,20091,DE,DE
14118,1699704000,1699707600,3600,6768,47880,GB,GB
158808,1699359840,1699370040,10200,8634,180485,IT,IT
31838,1699239420,1699271220,31800,48447,22601,TR,TR
41729,1699738380,1699742160,3780,54997,167126,GB,GB
184802,1700465220,1700481360,16140,136849,70808,US,US
142611,1700689200,1700695320,6120,184294,188330,GB,GB
73501,1700040420,1700048220,7800,24046,94305,HR,HR
107030,1698943440,1698952080,8640,138350,159331,PT,PT
110839,1699219200,1699234080,14880,68671,90314,US,US
32238,1700827380,1700832660,5280,3345,10897,NL,NL
80707,1699743720,1699757280,13560,144703,95347,US,US
137214,1700503920,1700519160,15240,57511,112032,US,US
116815,1700680500,1700713020,32520,37975,172292,TR,TR
93888,1699182840,1699188120,5280,177427,133676,NL,NL
120750,1699797240,1699812660,15420,85011,61944,CZ,CZ
151432,1700484420,1700493420,9000,16247,128015,IT,IT
22995,1699771500,1699785540,14040,48420,44463,IT,IT
103082,1699333680,1699337700,4020,87364,192530,GB,GB
50992,1700606640,1700617260,10620,88188,37972,IT,IT
73037,1700045580,1700073300,27720,59902,121006,BA,DE
198371,1700769900,1700804580,34680,157251,163876,TR,TR
38275,1700571240,1700591880,20640,71040,182439,DK,DK
105335,1698887580,1698916680,29100,39893,23030,TR,TR
119649,1698800040,1698831420,31380,127684,28554,TR,TR
129186,1699088700,1699093140,4440,179897,29362,GB,GB
84542,1700637120,1700651760,14640,18762,133876,US,US
88064,1698984540,1698992700,8160,188444,19274,HR,HR
175250,1699414740,1699438860,24120,109375,34976,CH,IT
196138,1700622600,1700641080,18480,121150,42986,IN,IN
184737,1700362860,1700387760,24900,93109,90125,DE,PL
89649,1700755380,1700765640,10260,45327,147207,HR,HR
181198,1698815100,1698837060,21960,94158,39097,DE,PL
185784,1700801280,1700805420,4140,186191,22189,GB,GB
82027,1699575480,1699585320,9840,26500,91853,IT,IT
173393,1699430640,1699443900,13260,162370,95413,IT,IT
117115,1700052660,1700080860,28200,87024,10432,RO,RO
13396,1700856060,1700911800,55740,91423,92357,BG,RO
93238,1700157120,1700188620,31500,100456,95236,TR,TR
53264,1699022340,1699035060,12720,38315,92023,US,US
191176,1700110080,1700122560,12480,179269,187743,US,US
44985,1700439480,1700467200,27720,183587,173370,DE,DE
167728,1700148720,1700181540,32820,90634,112956,MX,MX
173945,1700421300,1700454360,33060,139179,143453,TR,TR
97671,1699926960,1699939260,12300,42422,108971,CZ,AT
86865,1700243760,1700247360,3600,59946,39028,GB,GB
143026,1699724280,1699745400,21120,96227,174819,FR,FR
43464,1699792440,1699814580,22140,32557,42595,DE,NL
15169,1700562300,1700574180,11880,9819,166794,IT,IT
241,1699311180,1699347120,35940,48793,12703,TR,TR
189529,1699839000,1699848720,9720,181583,156158,IT,IT
162329,1699664640,1699699680,35040,72155,111360,TR,TR
150407,1699061880,1699072140,10260,60808,81313,IT,IT
161619,1699694220,1699726080,31860,31350,196412,TR,TR
31049,1700062620,1700098380,35760,39094,34074,TR,TR
26277,1699308300,1699311900,3600,37725,180951,GB,GB
70177,1700101860,1700116440,14580,76826,130960,US,US
105577,1700376180,1700392140,15960,142929,111488,US,MX
67612,1700750520,1700773020,22500,145803,9093,DE,DE
22194,1698814920,1698848340,33420,78587,99380,TR,TR
115734,1699643820,1699661340,17520,184895,61429,BE,NL
52917,1699365540,1699402140,36600,95327,98395,MX,MX
16576,1699428780,1699453260,24480,176836,139027,DE,BA
55524,1700671680,1700706420,34740,158681,110768,TR,TR
112582,1699712340,1699735860,23520,158708,178940,DE,DE
149794,1700622180,1700635860,13680,196384,195625,SK,AT
39635,1700637540,1700670300,32760,24821,70029,TR,TR
103096,1700145960,1700152380,6420,129250,160697,GB,GB
117362,1700461500,1700477340,15840,137679,180328,BE,ES
128999,1699859100,1699887960,28860,187152,148521,TR,TR
34225,1700328300,1700336940,8640,23296,34179,IT,IT
152344,1699923240,1699928520,5280,135628,95751,GB,GB
82377,1700246700,1700270280,23580,82230,113249,HU,IT
20136,1699814460,1699844040,29580,44001,114170,TR,TR
76018,1699396560,1699400160,3600,152015,149710,NL,NL
53013,1699374000,1699405200,31200,116213,81217,TR,TR
76133,1699539900,1699574580,34680,18234,44898,TR,TR
141547,1699499880,1699533120,33240,181682,68567,MX,MX
122210,1700818800,1700822400,3600,100416,20805,GB,GB
29252,1700529780,1700562120,32340,147108,190174,TR,TR
194085,1700379300,1700393160,13860,82993,109961,AT,SK
62161,1699025040,1699037700,12660,164394,86971,IT,IT
134285,1699315500,1699348680,33180,48448,124958,TR,TR
80130,1700322420,1700329320,6900,197882,68939,GB,GB
144610,1699073880,1699096980,23100,140451,104375,BR,BR
132211,1700802780,1700826600,23820,139976,102612,DE,DK
145329,1699357500,1699389360,31860,170294,58092,TR,TR
196543,1699630500,1699641960,11460,45694,184675,US,US
68584,1700081460,1700085060,3600,137362,423,GB,GB
1910,1699685760,1699697580,11820,44047,21906,IT,IT
70790,1699050720,1699063680,12960,198696,65999,RS,RS
180911,1700368320,1700398800,30480,95802,90382,TR,TR
134873,1699698600,1699702200,3600,18279,36223,GB,GB
145959,1698866520,1698870120,3600,110629,104240,NL,NL
22093,1700866140,1700895660,29520,46902,170229,TR,TR
112731,1700046360,1700078460,32100,7356,95227,TR,TR
163820,1699451520,1699460460,8940,11199,56708,PT,PT
163533,1699644720,1699678920,34200,61725,110846,TR,TR
3524,1699444800,1699479000,34200,71867,156480,TR,TR
132772,1699309980,1699333140,23160,155417,30398,PL,UA
76092,1699832760,1699836360,3600,147395,128006,NL,NL
72569,1700184720,1700218080,33360,161890,113307,TR,TR
143723,1699581180,1699610220,29040,172790,113530,TR,TR
134338,1700601240,1700618820,17580,139439,179803,US,US
195127,1699519860,1699540440,20580,50900,172929,FR,FR
27580,1698834120,1698837720,3600,52848,66327,NL,NL
56034,1699684140,1699714320,30180,159197,156579,TR,TR
151938,1700639400,1700653800,14400,177679,31704,US,US
13675,1700456520,1700473140,16620,128665,36523,RS,RS
165710,1699454160,1699509300,55140,7286,105988,BG,BG
50108,1699607040,1699618620,11580,28960,192468,US,US
136125,1700018220,1700033340,15120,35895,11406,US,US
39329,1698838440,1698874020,35580,27935,164127,TR,TR
81444,1698889080,1698917580,28500,118847,183794,DE,BG
12462,1700269560,1700303160,33600,188217,181669,TR,TR
123208,1700263200,1700295360,32160,81291,11569,TR,TR
166476,1700648460,1700676600,28140,94930,172092,DE,DE
108056,1700719680,1700723700,4020,22046,114146,NL,NL
124626,1699220460,1699252320,31860,196955,176847,TR,TR
106525,1700241600,1700272380,30780,80824,9279,TR,TR
167930,1699724940,1699738980,14040,198802,15942,AT,AT
79542,1699334700,1699348440,13740,67711,133864,US,US
3292,1700648940,1700664360,15420,92327,5527,US,US
195864,1700560920,1700577420,16500,84605,186448,US,US
40781,1700848740,1700854560,5820,171921,62446,NL,NL
100569,1700309940,1700327400,17460,46895,98747,RS,AT
11758,1700738760,1700768100,29340,182800,85492,TR,TR
191336,1700696760,1700735160,38400,126494,166138,MX,MX
93690,1698984180,1699011720,27540,93719,141171,PL,CZ
62677,1699915320,1699950360,35040,100747,69525,TR,TR
99133,1699866420,1699872720,6300,73367,149363,GB,GB
117090,1699566240,1699569840,3600,168399,148487,NL,NL
80640,1700136300,1700150520,14220,163276,43640,US,US
53479,1700138760,1700171040,32280,108665,156127,TR,TR
72520,1700808240,1700847660,39420,29500,121310,MX,MX
52818,1700256120,1700262720,6600,61122,57875,NL,NL
14402,1699986600,1699993680,7080,165668,130657,GB,GB
164781,1700033400,1700059020,25620,127301,135423,PL,PL
78335,1698909780,1698913380,3600,186740,105485,GB,GB
114328,1700431620,1700464320,32700,167684,192852,TR,TR
141462,1699970340,1700003820,33480,26881,123134,MX,MX
4204,1699799160,1699802760,3600,127352,177223,GB,GB
1345,1699792140,1699805280,13140,186105,135498,US,US
23943,1700328780,1700344920,16140,170081,102030,US,US
173699,1699365120,1699368720,3600,146631,191565,GB,GB
147513,1700510760,1700515620,4860,123037,180265,GB,GB
23561,1699299060,1699305840,6780,162047,3731,NL,NL
42358,1698944580,1698956400,11820,85134,152716,HR,HR
39902,1698822540,1698849420,26880,197340,101684,BR,BR
188052,1699823400,1699828740,5340,38969,142857,GB,GB
155817,1699135740,1699158600,22860,118564,96181,DE,DE
68537,1700221320,1700256060,34740,85459,131218,TR,TR
185646,1700643600,1700657280,13680,30247,197885,ES,ES
156086,1699351020,1699380840,29820,103234,152038,TR,TR
141874,1700050080,1700061780,11700,57226,196393,PT,PT
151510,1699275480,1699279080,3600,145260,117948,NL,NL
120110,1700216940,1700229600,12660,39694,39871,US,US
117010,1699713120,1699732260,19140,150920,80841,SE,NO
79953,1699978620,1700012580,33960,115481,75838,TR,TR
159636,1699568520,1699585260,16740,169800,75447,CZ,CZ
99611,1699803660,1699834440,30780,57397,92975,TR,TR
186363,1700159700,1700175660,15960,45665,65725,US,US
74020,1699527420,1699531020,3600,70250,171408,GB,GB
57310,1699995300,1700032920,37620,126914,13116,MX,MX
170071,1699689060,1699706520,17460,49253,62130,US,US
128840,1699527960,1699535220,7260,74954,60692,IT,IT
98710,1699396200,1699428600,32400,102588,71772,TR,TR
53676,1700520120,1700533080,12960,5741,170168,PT,PT
42823,1700631660,1700644740,13080,95026,99570,IT,IT
179549,1700644800,1700666280,21480,15679,54676,FR,BE
60651,1699854300,1699889580,35280,82427,151490,TR,TR
40627,1700823480,1700836020,12540,93624,57006,ES,ES
141783,1698806640,1698825660,19020,108545,190717,BE,NL
134930,1700667420,1700700600,33180,158427,189587,TR,TR
115697,1699352340,1699386600,34260,126108,72519,TR,TR
77898,1700647860,1700654100,6240,197478,40894,EE,EE
44551,1700864160,1700890740,26580,78662,180964,DE,DE
127240,1700649360,1700682180,32820,148250,168121,TR,TR
33585,1700415540,1700449800,34260,22905,158963,TR,TR
110545,1700120820,1700126640,5820,33302,136426,GB,GB
5462,1700754540,1700788860,34320,193554,183580,TR,TR
195200,1700115060,1700147640,32580,101340,66325,TR,TR
155791,1698873180,1698884220,11040,71316,87824,US,US
157095,1699624080,1699628760,4680,146893,81071,GB,GB
9629,1699765740,1699794540,28800,177526,13673,TR,TR
130310,1700419140,1700422740,3600,136982,107054,GB,GB
125071,1699446840,1699482000,35160,191152,110047,TR,TR
113504,1700001300,1700036640,35340,114460,109970,TR,TR
198938,1699228860,1699232460,3600,85897,87604,GB,GB
56099,1699743180,1699755960,12780,156698,83872,US,US
21524,1699739820,1699743420,3600,29744,107015,NL,NL
91298,1699318740,1699353540,34800,13964,127301,TR,TR
3152,1699112940,1699144560,31620,318,105165,MK,AL
199839,1698936900,1698945540,8640,112397,3978,IT,IT
61082,1700024280,1700057700,33420,146762,166341,TR,TR
194995,1700259960,1700291760,31800,83704,74517,TR,TR
114681,1700632260,1700639160,6900,108502,77698,GB,GB
27050,1698906060,1698940320,34260,1589,89301,TR,TR
90403,1699589880,1699603860,13980,94437,145491,US,US
123509,1700320740,1700336520,15780,148540,83062,US,US
65313,1700432640,1700444340,11700,135199,120165,US,US
105903,1699878840,1699896420,17580,50289,100280,US,US
3885,1699957620,1699969920,12300,123010,62223,HR,HR
171517,1699993500,1700008320,14820,183759,93840,US,US
171564,1700435940,1700464020,28080,189700,71766,BA,ME
62079,1699848840,1699884480,35640,171447,69569,TR,TR
53794,1699693500,1699716240,22740,187198,179623,BR,BR
15092,1700128620,1700140380,11760,12522,98332,RS,RS
86445,1699118340,1699149060,30720,195488,36172,TR,TR
48054,1699623780,1699656840,33060,37286,84716,TR,TR
110626,1700809680,1700844240,34560,11102,82120,TR,TR
33944,1700541600,1700573700,32100,54308,73969,TR,TR
79965,1700754420,1700768340,13920,125375,13336,US,US
170409,1698884820,1698888420,3600,95046,171818,GB,GB
116143,1698889620,1698894600,4980,168005,19604,GB,GB
48288,1699692180,1699703880,11700,132526,113189,US,US
56176,1698888840,1698892440,3600,133350,159633,NL,NL
56776,1700321760,1700355780,34020,127760,143338,MX,MX
85819,1700743200,1700752620,9420,163962,171668,IT,FR
159412,1699216740,1699225740,9000,163291,80268,CL,CL
160651,1699290060,1699324380,34320,187398,97930,TR,TR
106096,1698849000,1698861000,12000,132252,192011,IT,IT
53447,1700428920,1700442540,13620,153721,11692,US,US
20076,1699871040,1699886580,15540,168430,106476,CZ,NL
196662,1700210460,1700242020,31560,182989,191600,TR,TR
93089,1699131720,1699163940,32220,157333,142400,TR,TR
19776,1700084040,1700092440,8400,42168,187487,PT,PT
32260,1699956180,1699980780,24600,95290,131517,DE,DE
41411,1699712580,1699769520,56940,154181,78207,BG,GR
174260,1698914400,1698945300,30900,92879,196070,TR,TR
116754,1699583520,1699587120,3600,80676,29393,NL,NL
146854,1700516040,1700522460,6420,100646,182475,NL,NL
152551,1700022000,1700025600,3600,38566,62265,NL,NL
93076,1699793340,1699801440,8100,179783,142817,PT,PT
118423,1699271040,1699300440,29400,18183,112616,BA,DE
194212,1698796740,1698836160,39420,181948,144911,MX,MX
75467,1700550660,1700565360,14700,121883,160106,FR,NL
35840,1699355460,1699384440,28980,60780,88872,TR,TR
10286,1699850760,1699862640,11880,82486,2166,US,US
14644,1699827600,1699858800,31200,116641,103944,TR,TR
10511,1700335680,1700347140,11460,93641,190491,HR,HR
145032,1698843960,1698855060,11100,190500,4947,US,US
102416,1698951660,1698964980,13320,92856,167799,IT,IT
188876,1700038980,1700048400,9420,108967,30018,HR,HR
49878,1699578960,1699609980,31020,193320,98491,TR,TR
105089,1700229180,1700253840,24660,86885,82017,DE,DE
119627,1699673880,1699696800,22920,62140,161320,RO,RO
192135,1700736720,1700765940,29220,70717,34050,TR,TR
152714,1699152000,1699156200,4200,122840,171086,NL,NL
185124,1700677320,1700692980,15660,10893,83684,US,MX
135427,1699136340,1699150560,14220,46092,21891,ES,FR
91994,1700019360,1700026740,7380,75176,62146,IT,IT
88567,1700533560,1700560080,26520,92483,186638,BR,BR
166672,1699590360,1699625460,35100,45672,88621,TR,TR
38157,1699326540,1699330200,3660,55944,33441,NL,NL
107966,1700703480,1700713740,10260,165678,137901,HR,HR
94091,1699101000,1699104600,3600,15193,100754,GB,GB
22250,1699650060,1699682820,32760,137394,77017,TR,TR
67339,1698827400,1698836880,9480,75648,150267,EE,EE
19351,1700449920,1700473800,23880,150739,159274,PL,PL
183206,1699682580,1699707060,24480,12384,9420,DE,DE
153199,1699309440,1699322160,12720,62763,57390,US,US
195224,1699932960,1699943580,10620,109843,65805,IT,DE
57823,1699374360,1699391280,16920,118915,137080,US,US
183518,1699239000,1699272060,33060,124739,193854,MX,MX
186162,1699624260,1699635240,10980,162987,12931,IT,IT
65961,1700170140,1700209500,39360,5961,58360,MX,MX
18234,1700340120,1700346480,6360,82971,5132,GB,GB
93756,1700711520,1700741040,29520,101232,162193,TR,TR
121703,1699954140,1699986060,31920,78419,86980,TR,TR
85597,1699272060,1699294740,22680,148771,32796,DE,CZ
101562,1700368020,1700392020,24000,157986,96622,DE,DE
131056,1700300040,1700334900,34860,99396,6430,TR,TR
85394,1700404860,1700412660,7800,146431,102736,IT,IT
186105,1700337960,1700363640,25680,80582,88180,BR,BR
83274,1699323360,1699329300,5940,74860,101885,GB,GB
43759,1699248960,1699264080,15120,44783,45681,US,US
67488,1698929520,1698961500,31980,142322,28953,TR,TR
75270,1700476980,1700480580,3600,95976,191568,GB,GB
146929,1699791780,1699817520,25740,115388,88599,BR,BR
53629,1700008920,1700016540,7620,64490,129477,IT,IT
144633,1699460160,1699492320,32160,157001,43210,TR,TR
169753,1700088600,1700127660,39060,40021,164482,MX,MX
71599,1699608540,1699621380,12840,46374,147695,AT,DE
144707,1700160120,1700192820,32700,34994,153401,TR,TR
162005,1698835560,1698854340,18780,23171,90275,FR,FR
90941,1699783260,1699788060,4800,19908,53141,GB,GB
184658,1700453640,1700465520,11880,134555,63849,HR,HR
24555,1700761320,1700790720,29400,121999,90779,TR,TR
49727,1700413080,1700426100,13020,68453,75913,US,US
1922,1699600020,1699606560,6540,9491,20743,GB,GB
65914,1700065500,1700082360,16860,66096,8810,US,US
36242,1699497120,1699523700,26580,130984,31744,PL,DE
150964,1700262840,1700294640,31800,191971,181544,TR,TR
167236,1699003740,1699009380,5640,63350,2428,NL,BE
41968,1699338300,1699347960,9660,89521,171958,HR,HR
34480,1699429200,1699463280,34080,50559,179766,TR,TR
146466,1699065720,1699081380,15660,61262,122796,FR,AD
156545,1700139540,1700167680,28140,92601,22324,PL,PL
164338,1700075400,1700091840,16440,177216,115506,CZ,CZ
193752,1700801880,1700808780,6900,180446,55199,GB,GB
98365,1699122360,1699130280,7920,172572,59298,HR,HR
86386,1700323440,1700353620,30180,186670,174005,TR,TR
95852,1699390080,1699400340,10260,121887,78064,EE,EE
170249,1700639760,1700674620,34860,137952,177763,TR,TR
82020,1698871560,1698875160,3600,177253,107025,GB,GB
195654,1700628660,1700632740,4080,118267,183259,GB,GB
71066,1699859880,1699863480,3600,143086,52159,GB,GB
165233,1700059080,1700089140,30060,14152,181041,TR,TR
15532,1700723520,1700744760,21240,16324,130167,BE,PL
84678,1699165320,1699171080,5760,29067,160350,GB,GB
127395,1700140800,1700171640,30840,5581,106186,TR,TR
184633,1700492280,1700517420,25140,123349,1918,DE,CH
133308,1699876920,1699888140,11220,32932,46118,US,US
98115,1700702100,1700705700,3600,185430,168415,NL,NL
188528,1698963840,1698996720,32880,155944,196251,TR,TR
186501,1699486140,1699515540,29400,157416,60794,TR,TR
170136,1699941000,1699949940,8940,128380,16278,SK,SK
95834,1699590060,1699622400,32340,101397,80076,TR,TR
3508,1700366040,1700389320,23280,91253,71820,RO,MD
128386,1699644120,1699661760,17640,77445,77801,US,US
69031,1699602780,1699634880,32100,180580,144129,TR,TR
24406,1699521480,1699544460,22980,185619,62371,DE,CZ
37561,1699876620,1699907160,30540,42060,23974,TR,TR
19805,1700855040,1700894340,39300,59150,6870,MX,US
108320,1698964260,1698992460,28200,45407,17238,DE,DE
4445,1700618880,1700628180,9300,110399,18382,ES,ES
145583,1698795180,1698807780,12600,37819,17799,PT,PT
26627,1700033040,1700054760,21720,20267,76415,HU,IT
54681,1699193100,1699225380,32280,170400,156897,TR,TR
151288,1699640400,1699670640,30240,62459,120167,TR,TR
54736,1700420580,1700427720,7140,135379,11363,GB,GB
127238,1699972560,1699978440,5880,176735,68272,GB,GB
193274,1700536860,1700548800,11940,125709,62740,US,US
140584,1700013840,1700029080,15240,967,145556,US,US
124486,1700512500,1700547060,34560,175076,120327,TR,TR
185971,1699345680,1699373280,27600,90236,189833,DE,CZ
132756,1700334360,1700370120,35760,44025,159080,TR,TR
16037,1699345920,1699379820,33900,136624,107861,TR,TR
63687,1700047980,1700059260,11280,176950,103587,CZ,CZ
163930,1698938940,1698953880,14940,58394,78822,CA,CA
159540,1700001000,1700012520,11520,43004,162003,PT,PT
74250,1699771440,1699796400,24960,181679,52605,DE,IT
83685,1698812940,1698824520,11580,88578,133130,PT,PT
65214,1699414440,1699443960,29520,69792,22859,TR,TR
91932,1699776960,1699812600,35640,141196,184186,TR,TR
178176,1699833780,1699865400,31620,143103,148893,TR,TR
40134,1700498220,1700528820,30600,185631,140320,TR,TR
19680,1699976280,1700001120,24840,81267,46514,PL,DE
32020,1699028400,1699040340,11940,111527,128826,US,US
45743,1700608680,1700643300,34620,1755,68877,TR,TR
90625,1700489640,1700522820,33180,64036,68741,TR,TR
82639,1700057220,1700088120,30900,57261,134979,TR,TR
163600,1700723400,1700727960,4560,36572,167500,GB,GB
116011,1700587680,1700591580,3900,100693,197078,NL,GB
120919,1699783740,1699797180,13440,110495,43820,US,US
164001,1700433720,1700444460,10740,26728,157219,HR,HR
156953,1700307540,1700311140,3600,61634,65384,GB,GB
44089,1700149740,1700154660,4920,57097,166506,NL,BE
177503,1699214220,1699241700,27480,136800,161210,DE,PL
197342,1699957320,1699967940,10620,39780,91064,IT,IT
173963,1700312820,1700316420,3600,89231,67948,NL,NL
7183,1699172280,1699205400,33120,27878,48890,TR,TR
141819,1699584720,1699591680,6960,46794,19193,GB,GB
154735,1700180160,1700212620,32460,185096,50598,TR,TR
135253,1699350120,1699353720,3600,135830,14289,GB,GB
163026,1698868860,1698885240,16380,68483,169997,US,US
155860,1699245120,1699261680,16560,12202,149726,CA,US
101242,1699930920,1699965360,34440,65593,127296,MX,MX
22969,1699382880,1699390860,7980,146013,183571,IT,IT
84673,1699496940,1699524420,27480,159771,49704,PL,PL
189051,1699548600,1699566180,17580,195981,79509,US,US
42096,1699146000,1699150920,4920,76155,84848,NL,NL
76390,1699420980,1699438980,18000,171866,173830,SE,SE
193232,1700606880,1700631240,24360,156959,176921,RO,MD
139067,1699023000,1699039020,16020,51152,38978,US,US
149677,1699330260,1699358040,27780,155063,11558,DE,DE
53754,1699986660,1700016660,30000,144680,62866,TR,TR
124236,1700438460,1700453520,15060,21632,184810,US,US
164789,1698938220,1698970800,32580,18560,149403,TR,TR
127745,1700665380,1700694840,29460,61200,15836,TR,TR
73061,1699169280,1699198200,28920,21205,104586,TR,TR
179503,1700059320,1700076600,17280,32730,199850,AT,AT
171177,1700360460,1700373180,12720,132759,144804,US,US
183488,1699674600,1699696740,22140,23928,94635,PL,HU
86741,1700805480,1700820240,14760,122308,75465,US,US
75884,1699750800,1699754400,3600,19199,43148,GB,GB
44715,1699096320,1699133940,37620,13405,111144,MX,US
162647,1700152320,1700185620,33300,170050,53035,TR,TR
29124,1699447260,1699476120,28860,100108,187032,TR,TR
152501,1700311200,1700342340,31140,40862,42235,TR,TR
70508,1699477800,1699514220,36420,80524,148519,MX,MX
89974,1699208340,1699220400,12060,65123,193189,PT,PT
32386,1700659140,1700689860,30720,168806,70990,TR,TR
18126,1698972420,1698989280,16860,79724,109042,FR,FR
190016,1699040460,1699044240,3780,186398,138646,EE,EE
71749,1699377600,1699393380,15780,93338,78079,AT,BG
82007,1700337300,1700372220,34920,3830,173948,MX,MX
96503,1698978240,1698982680,4440,49617,169463,GB,GB
188923,1698826980,1698835800,8820,196595,172787,ES,FR
86394,1698841740,1698855120,13380,19108,144874,CZ,CZ
31332,1700277960,1700312400,34440,113601,155645,TR,TR
119467,1699218420,1699241460,23040,92949,83907,DE,RS
112097,1699522320,1699535100,12780,106735,39775,US,US
128874,1699684860,1699711200,26340,93841,123033,PL,DE
21808,1700276940,1700309940,33000,44280,191376,TR,TR
67756,1700173740,1700195700,21960,124000,42663,RO,RO
9848,1699940220,1699964160,23940,150177,196562,DE,FR
182529,1699423380,1699426980,3600,183109,144791,GB,GB
113699,1700400960,1700409000,8040,29505,140736,EE,EE
182740,1698818640,1698835200,16560,41911,141837,SE,SE
179147,1698874800,1698886560,11760,135213,165574,US,US
114008,1700765820,1700801220,35400,75988,87940,TR,TR
88108,1698805020,1698837180,32160,110355,57724,TR,TR
59040,1699509960,1699543860,33900,39713,83829,TR,TR
176443,1700020680,1700050920,30240,90249,190818,TR,TR
8983,1700547060,1700550660,3600,24260,175007,GB,GB
7430,1699310280,1699345860,35580,43634,114088,TR,TR
187571,1699983180,1699989360,6180,173262,24005,GB,GB
47964,1699468620,1699502100,33480,188808,86536,TR,TR
25078,1700184240,1700217960,33720,73769,188438,TR,TR
147715,1698998940,1699032900,33960,51239,176199,TR,TR
187487,1698841320,1698871860,30540,26920,5346,TR,TR
126855,1699599420,1699610640,11220,170163,125922,IT,DE
141933,1699545780,1699552260,6480,25997,189661,NL,NL
122833,1700292720,1700299500,6780,69295,22409,NL,NL
48656,1699120320,1699141140,20820,122944,198600,FR,NL
57370,1698810480,1698814080,3600,78993,95809,NL,NL
56199,1699685100,1699688700,3600,175953,137316,GB,GB
2609,1699948020,1699981560,33540,70931,63542,TR,TR
60883,1699381740,1699416840,35100,173158,95343,TR,TR
199169,1699416120,1699444860,28740,24053,2621,DE,PL
45742,1699093020,1699108920,15900,27856,111585,FR,NL
175862,1700691780,1700726700,34920,168788,151778,TR,TR
46121,1700265300,1700277780,12480,25986,79378,US,US
60248,1700864040,1700874240,10200,178899,196911,ES,PT
8563,1699305600,1699309860,4260,170013,54762,EE,FI
102306,1699868700,1699894440,25740,67688,167743,HU,DE
125639,1700579220,1700597160,17940,152253,104691,US,US
98895,1700393400,1700397000,3600,173690,34559,GB,GB
65647,1699207380,1699238520,31140,94363,78093,TR,TR
142585,1700193840,1700197440,3600,56731,42594,NL,NL
168831,1698949260,1698985620,36360,177063,120819,MX,MX
57729,1699545180,1699561080,15900,139802,49313,FR,FR
174656,1699921860,1699942920,21060,128542,72440,BE,FR
54318,1698951240,1698968760,17520,20599,81730,US,US
77820,1700800140,1700812200,12060,197179,147007,US,US
172210,1700124960,1700129040,4080,53220,43218,GB,GB
91751,1699540620,1699546380,5760,52243,28731,NL,NL
136194,1699444560,1699475400,30840,79144,101372,TR,TR
65754,1698842880,1698846480,3600,112626,121809,GB,GB
37785,1700158860,1700175660,16800,21651,35601,US,US
66368,1699343640,1699369140,25500,195060,55725,PL,DE
126026,1698926040,1698960420,34380,70779,170192,TR,TR
25274,1700539740,1700548800,9060,109665,81319,HR,CZ
989,1700630460,1700643480,13020,186346,156356,AT,AT
161339,1699284060,1699291740,7680,197967,74600,IT,IT
113914,1700251680,1700261700,10020,195024,10103,IT,IT
3870,1699179360,1699182960,3600,134563,91569,NL,BE
135722,1699509060,1699522380,13320,120147,128963,US,US
197379,1699386900,1699421160,34260,54016,149704,TR,TR
13020,1698878400,1698908640,30240,148888,141967,TR,TR
72389,1700747940,1700781240,33300,177555,7155,MX,MX
87626,1699284300,1699315440,31140,106579,133865,TR,TR
74315,1700256360,1700262360,6000,103109,438,GB,GB
92224,1699944300,1699978920,34620,136231,141123,TR,TR
75308,1700780460,1700809620,29160,164104,174766,TR,TR
97308,1699098300,1699127460,29160,70550,157805,TR,TR
17980,1700731560,1700762580,31020,182179,139571,TR,TR
172442,1699829220,1699859340,30120,171251,8848,TR,TR
17659,1700622120,1700632140,10020,111574,165520,PT,PT
161770,1699002480,1699006080,3600,115213,72147,GB,GB
85940,1700707800,1700726040,18240,64035,140771,FR,FR
65957,1699911180,1699942200,31020,167948,18324,TR,TR
94787,1699858860,1699889820,30960,977,185898,TR,TR
195230,1698807840,1698837540,29700,103377,58967,TR,TR
4654,1698899280,1698916680,17400,66880,141107,RS,RS
26441,1699997940,1700001540,3600,108855,84012,NL,NL
145925,1699116780,1699127820,11040,133371,100886,IT,IT
1303,1700769600,1700801940,32340,11654,44615,TR,TR
110946,1698917700,1698921300,3600,67537,115935,GB,GB
112610,1699909020,1699938420,29400,62103,163158,TR,TR
150787,1698900360,1698925080,24720,81478,108496,DE,NL
153772,1700369820,1700396520,26700,60942,89291,BR,BR
13911,1699032720,1699036320,3600,50099,85244,NL,NL
189686,1700585760,1700589360,3600,17629,95612,GB,GB
140733,1700389800,1700402460,12660,199134,11472,US,US
130306,1699275180,1699308420,33240,56421,132626,TR,TR
95081,1699980180,1699992060,11880,175344,106423,US,US
179880,1700716860,1700751840,34980,129299,78335,TR,TR
127246,1699596360,1699612260,15900,84195,164343,US,US
60876,1699572840,1699586040,13200,153805,114708,AT,DE
33375,1699639440,1699643040,3600,100885,66323,GB,GB
90544,1700606460,1700630220,23760,127448,69319,DE,DK
11295,1699722840,1699739280,16440,178380,82318,US,US
199676,1699867200,1699878600,11400,102145,172857,US,US
29358,1700005200,1700034120,28920,56268,44158,TR,TR
27989,1699018260,1699031220,12960,78267,196995,HR,DE
132916,1699059540,1699063140,3600,27154,75699,GB,GB
134880,1699094460,1699101120,6660,5827,139841,GB,GB
154126,1699335540,1699350720,15180,186339,90994,US,US
30107,1699065360,1699098480,33120,96393,189749,TR,TR
13435,1698959820,1698966840,7020,49757,52490,GB,GB
129239,1700094900,1700116140,21240,86192,190005,FR,FR
156499,1700571720,1700602620,30900,119640,3117,TR,TR
109356,1700667840,1700671440,3600,122737,49822,GB,GB
124141,1698886200,1698889800,3600,32267,19622,GB,GB
36428,1699144140,1699148580,4440,3694,22748,GB,GB
27889,1699362420,1699384020,21600,105819,150542,BR,BR
99492,1698843720,1698860700,16980,5907,17050,BE,FR
59154,1699129080,1699158360,29280,67333,187433,TR,TR
190948,1699505040,1699535340,30300,99975,166882,TR,TR
23244,1700569140,1700580720,11580,138480,60293,ES,CH
13685,1699004580,1699039860,35280,5300,121513,TR,TR
61682,1699408560,1699437180,28620,22031,71634,HU,DE
186159,1700380080,1700392260,12180,10645,148222,US,US
81521,1700042280,1700070900,28620,69729,121188,HU,RS
5189,1699993860,1700029200,35340,119826,142850,TR,TR
74412,1700171340,1700185320,13980,38660,154718,US,US
148949,1700598180,1700601840,3660,18829,169973,GB,GB
71591,1700251260,1700264400,13140,137761,3010,IT,IT
158241,1698819180,1698845100,25920,31753,38692,DE,NL
178533,1698942060,1698945780,3720,122014,162411,EE,EE
97132,1700067660,1700076420,8760,25394,27119,HR,HR
118543,1700491620,1700522040,30420,119126,131457,TR,TR
43990,1698838260,1698851100,12840,84813,85924,AT,BG
74149,1700392260,1700423160,30900,89022,101612,TR,TR
84544,1700590800,1700624100,33300,188493,58806,MX,MX
47423,1699181340,1699184940,3600,12112,63678,GB,GB
155991,1699891740,1699922280,30540,44959,195537,TR,TR
100216,1700636280,1700640900,4620,1436,4159,GB,GB
42005,1699327380,1699358160,30780,139548,85748,TR,TR
90905,1699238640,1699270020,31380,171427,113266,TR,TR
121728,1699841520,1699857060,15540,146065,120804,US,US
62088,1698931500,1698960060,28560,115222,132735,PL,CZ
926,1699869480,1699899780,30300,40163,192555,TR,TR
124682,1700276760,1700309760,33000,27006,76859,TR,TR
109247,1700657160,1700688120,30960,142560,15218,TR,TR
44697,1699074720,1699092120,17400,189352,130641,FR,IT
47587,1699693380,1699724880,31500,98360,173055,TR,TR
40924,1699604040,1699614780,10740,73248,127500,ES,AD
165025,1700854500,1700886120,31620,186052,35974,TR,TR
76502,1699835220,1699869900,34680,21481,82633,TR,TR
137262,1700775720,1700788380,12660,19066,73705,HR,HR
83608,1699624620,1699637820,13200,120544,108656,CZ,AT
114635,1699729500,1699760700,31200,105307,122011,TR,TR
95266,1699006440,1699028160,21720,76557,145605,DE,DE
117820,1699412520,1699424160,11640,136691,83352,HR,HR
92111,1700731680,1700763060,31380,99938,189374,TR,TR
23042,1700223780,1700258040,34260,82716,146730,TR,TR
23074,1699704060,1699738740,34680,19210,474,TR,TR
82042,1699797660,1699812120,14460,176533,18842,AT,DE
67077,1699573260,1699589640,16380,26893,159177,FR,FR
50333,1700375700,1700379300,3600,80857,64487,NL,NL
138821,1699215780,1699243560,27780,97412,83046,DE,MK
159523,1699048740,1699072920,24180,165174,125908,DK,NO
13555,1700231640,1700240880,9240,76918,134431,ES,PT
177337,1699844880,1699858320,13440,134046,70689,US,US
119011,1699542780,1699555920,13140,124581,158047,HR,AT
156500,1699587360,1699598880,11520,123081,190428,IT,IT
140593,1700451900,1700465220,13320,198665,102206,IT,IT
164833,1698854820,1698889620,34800,142550,60801,TR,TR
18626,1699760940,1699765920,4980,18076,62694,GB,GB
80138,1699980000,1699996380,16380,26677,65219,US,US
47561,1700725320,1700746740,21420,104835,193564,BE,NL
84484,1700348280,1700378220,29940,30779,187644,TR,TR
149259,1699932480,1699957740,25260,166347,127306,DE,DE
35724,1700109120,1700114280,5160,183909,60522,NL,NL
10898,1699671240,1699674840,3600,43028,172901,GB,GB
80918,1699584180,1699615500,31320,79263,194464,TR,TR
172319,1700534700,1700568720,34020,177750,83825,TR,TR
26917,1699699860,1699713180,13320,78054,173095,US,US
88042,1699432680,1699447140,14460,159546,128925,US,US
28568,1699319160,1699350900,31740,102026,165831,TR,TR
119417,1700523180,1700536260,13080,175383,111840,US,US
11339,1699899240,1699928100,28860,161623,194373,TR,TR
21075,1700219700,1700254320,34620,50906,135772,TR,TR
191855,1699942620,1699949700,7080,13114,146438,GB,GB
12457,1699925280,1699943220,17940,100745,168110,US,US
81068,1699002120,1699028280,26160,67429,2643,DE,DE
134666,1700731020,1700742180,11160,92391,7338,US,US
166593,1699017720,1699028700,10980,177782,82047,US,US
197265,1699462440,1699467000,4560,3956,165150,NL,DE
138086,1700177880,1700192040,14160,109762,64711,CA,US
38911,1699580880,1699595160,14280,160857,183067,US,US
7496,1700835900,1700847240,11340,56372,40180,US,US
164479,1700483700,1700512380,28680,140742,105535,DE,DE
128809,1699762260,1699794840,32580,19024,47366,TR,TR
154206,1700286120,1700320680,34560,71868,36019,TR,TR
17846,1699150020,1699182420,32400,198460,191410,TR,TR
98565,1700671200,1700700480,29280,111057,108602,TR,TR
147282,1700274660,1700309820,35160,93436,33549,TR,TR
117522,1699465020,1699481520,16500,88127,179556,US,US
110602,1699143540,1699176180,32640,62727,91373,TR,TR
35954,1699583760,1699614420,30660,73811,20441,TR,TR
158694,1700726280,1700729880,3600,76883,156155,GB,GB
39553,1700266440,1700278560,12120,35498,26460,IT,IT
141846,1699455360,1699489140,33780,99411,47200,TR,TR
115027,1698841380,1698849660,8280,42445,35310,IT,CH
176770,1700239260,1700254440,15180,139836,73618,RS,RS
120814,1700802360,1700807760,5400,155249,102175,GB,GB
8005,1700475000,1700510220,35220,109460,134372,TR,TR
148616,1699177200,1699195620,18420,185485,16868,BE,FR
122705,1700705940,1700721180,15240,31914,52132,AT,AT
35959,1699539900,1699556340,16440,59050,700,US,US
151497,1700809920,1700839740,29820,93814,193571,TR,TR
169676,1698920280,1698924900,4620,146591,68083,NL,NL
92508,1699847220,1699858260,11040,81653,47258,US,US
109281,1700446920,1700476860,29940,151183,123928,TR,TR
165220,1700503620,1700531160,27540,17686,14807,HU,AT
82909,1700529960,1700565120,35160,83619,170845,TR,TR
14298,1699409880,1699425240,15360,129493,29163,US,US
49676,1700074500,1700113680,39180,21834,149358,MX,MX
163694,1700342940,1700356020,13080,130413,92062,IT,IT
170958,1699095000,1699098600,3600,192015,18549,GB,GB
136022,1699078200,1699081800,3600,74062,12569,GB,GB
100683,1699412340,1699444020,31680,19512,885,TR,TR
76975,1698932340,1698956640,24300,14259,15343,DE,DE
85412,1699573260,1699608660,35400,5814,78199,TR,TR
132429,1699736400,1699767600,31200,30595,57621,TR,TR
186807,1698863220,1698870720,7500,36519,170610,SK,SK
79958,1698839940,1698874500,34560,114884,78628,TR,TR
154105,1699751220,1699755180,3960,90916,111892,NL,DE
93529,1700695800,1700705220,9420,21258,92554,ES,ES
76394,1699803780,1699809060,5280,112904,148980,NL,NL
13610,1700596620,1700600220,3600,110000,106118,GB,GB
140309,1699556820,1699588200,31380,13381,12894,TR,TR
136572,1699003020,1699023180,20160,190206,24919,BE,SK
185429,1699985040,1700013900,28860,84063,181670,TR,TR
6166,1700293560,1700298840,5280,51724,107811,GB,GB
153648,1699411560,1699423020,11460,184407,65003,AT,AT
133822,1698962400,1698966000,3600,131798,177970,GB,GB
168329,1700479500,1700513520,34020,28888,45983,TR,TR
111936,1699797960,1699803420,5460,146323,36976,GB,GB
195652,1699232400,1699268100,35700,60023,138884,TR,TR
78539,1699266780,1699274340,7560,103429,7595,AD,ES
190947,1700228700,1700232300,3600,84148,40757,GB,GB
9144,1700139240,1700144100,4860,13834,163672,GB,GB
12108,1699670820,1699683060,12240,154258,195743,US,US
132963,1699198140,1699204740,6600,50279,141456,NL,NL
91581,1698968400,1698977640,9240,146804,20390,IT,IT
78210,1698970440,1698977640,7200,160393,9875,IT,DE
55511,1700393820,1700428140,34320,62324,151522,TR,TR
52876,1700426220,1700429820,3600,100720,167739,GB,GB
82188,1699234080,1699242120,8040,191938,94198,HR,HR
27958,1699662240,1699665840,3600,75211,13679,NL,NL
179955,1700821200,1700832120,10920,186972,2787,IT,IT
89626,1699751760,1699781640,29880,59160,159946,TR,TR
59927,1699270980,1699286160,15180,16578,178772,BE,FR
179780,1700002920,1700037660,34740,124906,33276,TR,TR
24757,1700209920,1700227320,17400,90551,135205,US,MX
166463,1700425860,1700438760,12900,120665,95366,PT,PT
176165,1699876500,1699911660,35160,125830,22338,TR,TR
11837,1698812940,1698841980,29040,127922,160446,TR,TR
58932,1700232000,1700263200,31200,25392,65983,BA,HR
151386,1699844100,1699878480,34380,18591,130512,TR,TR
145681,1700289300,1700324280,34980,175062,128869,TR,TR
106253,1700290560,1700320800,30240,96100,89575,TR,TR
94106,1698972120,1698987780,15660,3106,64891,US,US
136562,1699584120,1699596660,12540,176016,35829,CA,CA
5565,1699673400,1699692480,19080,186252,36891,FR,FR
1851,1700157720,1700189700,31980,106468,30283,TR,TR
68763,1700209080,1700236860,27780,77046,131614,HU,PL
136357,1699848720,1699860480,11760,77313,143474,US,US
144187,1699713840,1699751340,37500,161039,131731,MX,MX
13665,1699241940,1699250400,8460,31660,17386,HR,HR
178418,1699279620,1699306560,26940,25136,59935,BR,BR
13853,1700699460,1700732700,33240,20078,20211,TR,TR
83598,1700654760,1700669880,15120,4271,50780,RS,RS
192195,1699231740,1699236660,4920,131777,16875,GB,GB
123725,1698923580,1698931380,7800,71058,86731,HR,IT
29204,1699954260,1699972080,17820,69470,97403,US,US
129508,1699260600,1699269120,8520,10892,83297,EE,EE
57744,1699618260,1699649520,31260,5862,185534,TR,TR
125037,1699830660,1699853580,22920,312,59883,DE,HR
81732,1698980700,1698995880,15180,126163,155106,CA,CA
121071,1699794300,1699822860,28560,149567,183348,DE,DE
2915,1698793200,1698815220,22020,96172,57387,DE,DE
166832,1699141080,1699172100,31020,194307,187304,TR,TR
30458,1699170480,1699195020,24540,89248,58523,DK,DK
102591,1700346540,1700364300,17760,142905,96316,FR,FR
45789,1700735760,1700745660,9900,166909,20847,PT,PT
136749,1699225740,1699255140,29400,86161,39256,TR,TR
107101,1700399340,1700403300,3960,160999,2224,GB,GB
112795,1699525680,1699531080,5400,95637,92262,NL,NL
55337,1700225880,1700236200,10320,100579,169378,IT,IT
171855,1700389380,1700421300,31920,152056,32516,TR,TR
6575,1699351140,1699381680,30540,30416,19178,TR,TR
69444,1699248360,1699254480,6120,132630,139900,NL,NL
197432,1699123380,1699156620,33240,77543,114585,TR,TR
867,1700021580,1700034540,12960,118600,190880,PT,PT
159426,1698997500,1699002480,4980,189797,134697,NL,NL
75945,1700238420,1700244720,6300,85087,154382,GB,GB
43493,1700218440,1700251680,33240,8883,13341,TR,TR
7022,1698983160,1698998520,15360,159,34911,US,US
187092,1699644660,1699675260,30600,76700,73507,TR,TR
144963,1699870020,1699895220,25200,3786,177133,DE,BA
126227,1700296260,1700299920,3660,38861,42559,GB,GB
4824,1699205940,1699222440,16500,192534,11198,FR,FR
111054,1700673000,1700690760,17760,29005,126798,CZ,CZ
124862,1699603020,1699625340,22320,155175,107458,CH,DE
41191,1700640120,1700646060,5940,183867,51098,NL,NL
187488,1699031940,1699045680,13740,30109,103267,IT,IT
28636,1699924080,1699933380,9300,54675,136223,IT,IT
135030,1699175040,1699182540,7500,25380,86877,HR,HR
136946,1699331940,1699365120,33180,33439,114247,MX,MX
5138,1699725660,1699757760,32100,80774,49334,TR,TR
192423,1698973620,1699002480,28860,62901,9239,TR,TR
47619,1699513680,1699530780,17100,109302,103306,RS,ME
76252,1700013240,1700017260,4020,14827,116284,NL,NL
194570,1698963600,1698996840,33240,121475,167689,TR,TR
194337,1699327620,1699333980,6360,88837,3794,GB,GB
179875,1700066940,1700100300,33360,100848,160557,TR,TR
99928,1699301700,1699317960,16260,172127,100506,US,US
196032,1699802040,1699807080,5040,109953,38890,NL,NL
126990,1700663640,1700694540,30900,28297,108815,TR,TR
164325,1700315400,1700349000,33600,107330,125905,TR,TR
60921,1699899000,1699913820,14820,137907,55653,US,US
99664,1700302260,1700320140,17880,96545,70635,US,US
43624,1700230200,1700241600,11400,69829,95964,ES,ES
13312,1700699040,1700704680,5640,158112,35440,NL,NL
35116,1699682100,1699692840,10740,64231,185075,PT,PT
140760,1699770360,1699805340,34980,120361,118093,TR,TR
20688,1699437540,1699469220,31680,163141,182955,BA,DE
97542,1699284600,1699296240,11640,195567,83458,US,US
77762,1699656480,1699664940,8460,137561,39917,HR,HR
6987,1699483020,1699505460,22440,60374,152980,PL,PL
115065,1699697760,1699719480,21720,161958,162082,PL,LV
185896,1699954140,1699980600,26460,90910,163512,PL,HU
14529,1699045200,1699051980,6780,145092,152048,GB,GB
39957,1700743080,1700793960,50880,25596,95170,BG,DE
69618,1700632020,1700656800,24780,86898,69255,DE,DE
165068,1700298000,1700333820,35820,88177,147552,TR,TR
109720,1700526240,1700534400,8160,114595,53360,HR,HR
155564,1700007540,1700041560,34020,164550,144546,TR,TR
110207,1699524180,1699556520,32340,91590,131177,TR,TR
49529,1700753040,1700756640,3600,169455,60352,GB,GB
156566,1700464140,1700480520,16380,123929,61732,US,US
179290,1700200980,1700235300,34320,94448,31016,MX,MX
38378,1699003500,1699016220,12720,29680,102951,IT,IT
194334,1699294980,1699312140,17160,39642,34908,US,US
149619,1699306860,1699338900,32040,151951,115780,TR,TR
136547,1700808840,1700815320,6480,13065,66368,NL,NL
96067,1699942500,1699976340,33840,37220,48007,TR,TR
82147,1700838900,1700875620,36720,197853,38910,MX,MX
34507,1699966380,1699998960,32580,165591,110816,TR,TR
94758,1699872060,1699878240,6180,148790,37096,GB,GB
3856,1700656740,1700663220,6480,32552,137765,GB,GB
172166,1699370700,1699382220,11520,151583,193323,AT,AT
178226,1698966960,1698970560,3600,26536,84467,NL,NL
118285,1699310220,1699323180,12960,182109,65909,PT,PT
118556,1699674900,1699709460,34560,79805,16732,TR,TR
6217,1698889740,1698900780,11040,132861,153160,RS,BA
54385,1699787580,1699791180,3600,80416,65645,GB,GB
96606,1699270020,1699303140,33120,11178,91883,TR,TR
152781,1699369560,1699408740,39180,134482,74492,MX,MX
89749,1699186380,1699190220,3840,46964,177201,GB,GB
83654,1700448720,1700461740,13020,194935,169711,HR,HR
122093,1699222500,1699254900,32400,146745,151642,TR,TR
27224,1699689840,1699707660,17820,2635,171109,US,US
60833,1699332300,1699369680,37380,29901,68690,MX,MX
91052,1699610700,1699618320,7620,189122,24721,IT,IT
53304,1698801540,1698832680,31140,175235,39102,TR,TR
63438,1699542960,1699578660,35700,192284,92200,TR,TR
10184,1700494080,1700508540,14460,55881,169626,CA,CA
183738,1700136180,1700142360,6180,146473,11737,NL,NL
143547,1699770900,1699804560,33660,47661,31734,TR,TR
87588,1700534400,1700553300,18900,66556,90091,BE,FR
91876,1699972500,1700007600,35100,30797,148782,TR,TR
123981,1700697840,1700758860,61020,70840,165109,UA,PL
46235,1699029300,1699035840,6540,64252,95231,GB,GB
695,1700708100,1700720520,12420,159414,123733,US,US
104658,1700305920,1700328900,22980,145255,150359,RO,RO
150732,1700136600,1700172240,35640,60978,128633,MX,MX
74415,1700152260,1700163600,11340,22245,77483,IT,IT
110478,1699088160,1699118100,29940,139631,46027,TR,TR
77651,1699306860,1699310460,3600,82182,153960,NL,NL
184471,1698878340,1698892620,14280,174792,29337,US,US
3982,1699911900,1699916100,4200,164042,171737,GB,GB
188721,1700843700,1700860980,17280,124311,199362,US,US
142337,1700375820,1700407740,31920,155640,192537,TR,TR
189652,1699513620,1699529400,15780,2799,163399,US,US
137621,1699444200,1699478820,34620,30530,160936,TR,TR
191143,1699172160,1699185960,13800,184852,173840,US,US
146614,1699550460,1699576680,26220,13577,186622,DE,HR
54514,1700815260,1700823960,8700,8969,68343,PT,PT
167278,1698817200,1698850140,32940,38224,135294,TR,TR
81831,1699878900,1699910520,31620,80438,31069,TR,TR
47664,1699146000,1699177020,31020,30366,152221,TR,TR
3794,1700773440,1700787420,13980,32277,113526,ES,ES
144719,1699922400,1699928700,6300,33255,105966,GB,GB
93677,1699772940,1699804440,31500,92945,181509,TR,TR
58873,1699850760,1699877880,27120,163835,65227,DE,FR
121138,1700750460,1700759880,9420,117156,11865,IT,IT
17168,1698891540,1698925740,34200,24027,102829,TR,TR
10090,1699895700,1699907040,11340,18648,109950,HR,HR
147477,1699285620,1699315020,29400,120046,12566,TR,TR
148391,1699405380,1699422240,16860,88565,142333,FR,BE
138489,1699629000,1699638900,9900,95755,148645,PT,PT
78943,1700385720,1700396700,10980,74001,44760,US,US
52181,1700329980,1700363040,33060,87821,2884,TR,TR
185255,1700369280,1700375940,6660,64804,146008,GB,GB
115192,1699458120,1699461720,3600,146378,105328,GB,GB
184094,1700294280,1700326320,32040,169181,63773,TR,TR
195563,1700393520,1700399460,5940,39589,154097,NL,NL
165180,1700757420,1700769720,12300,111647,189560,IT,IT
38972,1700374620,1700409480,34860,187748,164845,MK,AL
63337,1699301220,1699332300,31080,117012,46080,TR,TR
31647,1700341920,1700371800,29880,18091,159980,TR,TR
117261,1700014800,1700019480,4680,35926,192447,GB,GB
125578,1698975780,1699008120,32340,38732,8705,TR,TR
164127,1700762040,1700791560,29520,166839,157776,TR,TR
164135,1699474320,1699509060,34740,83892,68365,TR,TR
20572,1700504940,1700539440,34500,76316,6964,TR,TR
199943,1700401260,1700427120,25860,7172,142623,DE,PL
57810,1700636580,1700672040,35460,10210,67284,TR,TR
113103,1700302140,1700318520,16380,47254,50317,AT,AT
156720,1699235400,1699266240,30840,80860,36015,TR,TR
43050,1699033440,1699067640,34200,143941,69104,TR,TR
177063,1700032320,1700040960,8640,51843,73107,EE,EE
179331,1700169780,1700201940,32160,194404,42345,TR,TR
99124,1700082300,1700095320,13020,28038,148358,US,US
137634,1700292240,1700324700,32460,47954,79272,TR,TR
109955,1700606700,1700640660,33960,17874,41939,TR,TR
62805,1700313180,1700321520,8340,91620,182864,EE,EE
198552,1699884480,1699914900,30420,38260,168,TR,TR
199660,1700223720,1700256960,33240,172546,8931,TR,TR
135856,1699434600,1699467420,32820,180718,47094,TR,TR
89802,1700113980,1700122440,8460,161545,157831,HR,HR
42220,1699436160,1699444920,8760,170839,62494,HR,HR
64829,1698931980,1698959340,27360,185184,19393,HU,DE
173011,1700169180,1700180340,11160,163668,35100,US,US
33883,1698926520,1698937740,11220,96395,176809,IT,IT
96340,1699350120,1699360980,10860,79190,167243,US,US
22923,1700619120,1700649180,30060,40423,31275,TR,TR
175874,1700585700,1700616960,31260,44078,58335,TR,TR
27380,1700481540,1700492700,11160,49988,11271,IT,IT
78807,1700028300,1700031900,3600,186974,58010,GB,GB
146757,1699543620,1699547220,3600,91896,430,GB,GB
115242,1699288320,1699300920,12600,18269,18181,US,US
68859,1698874440,1698905700,31260,7873,162717,TR,TR
143645,1699950240,1699953840,3600,96727,103569,GB,GB
13468,1699501200,1699535100,33900,117130,173366,TR,TR
62432,1700077860,1700099460,21600,2604,171440,PL,PL
66351,1699507620,1699541160,33540,157419,113788,TR,TR
139820,1700315640,1700327460,11820,18175,72676,IT,IT
131687,1700593980,1700602620,8640,63872,109834,PT,PT
82159,1700584860,1700592420,7560,155513,130043,AD,ES
160660,1698870900,1698879060,8160,66153,155699,PT,PT
16936,1700665260,1700680440,15180,74696,196691,FR,FR
158618,1698799440,1698828300,28860,61569,186046,TR,TR
73281,1700036580,1700040180,3600,91391,160692,GB,GB
64748,1700349360,1700363700,14340,117708,49902,US,US
78862,1698939600,1698969720,30120,21333,79186,TR,TR
74580,1698904260,1698940200,35940,116350,188644,TR,TR
169475,1699957320,1699975200,17880,82414,46853,FR,BE
127624,1699220880,1699249860,28980,37774,105415,TR,TR
153818,1700510940,1700540820,29880,1528,189688,TR,TR
94707,1698954780,1698986400,31620,29540,107871,TR,TR
21864,1699940100,1699969080,28980,168944,139673,TR,TR
86093,1698963960,1698997260,33300,90438,107460,TR,TR
100935,1699088040,1699117020,28980,41943,191336,TR,TR
159153,1698822780,1698855240,32460,106079,149424,MX,MX
71854,1699558680,1699587960,29280,107881,60457,TR,TR
155360,1699205460,1699217280,11820,14521,25741,IT,IT
190458,1700820660,1700834400,13740,127360,52767,US,US
24626,1699858380,1699876080,17700,84689,188993,FR,IT
180979,1700673420,1700677020,3600,129774,46085,GB,GB
37796,1700426880,1700449140,22260,176584,101671,PL,PL
150275,1698965400,1698971880,6480,179800,147168,GB,GB
180710,1700790720,1700821020,30300,58617,71901,TR,TR
2516,1700641980,1700672880,30900,163258,58753,TR,TR
51660,1699611120,1699630200,19080,79935,124973,FR,FR
175043,1699054920,1699070100,15180,170615,181486,FR,FR
194353,1700809800,1700822280,12480,195679,146586,IT,IT
30744,1699664940,1699686300,21360,1325,37834,FR,DE
116611,1700689380,1700713500,24120,1342,132191,DE,BG
163340,1699891260,1699927440,36180,69278,178476,MX,MX
22930,1699668360,1699700640,32280,70774,158212,TR,TR
185143,1700793780,1700818440,24660,100296,95458,BR,BR
142894,1699252920,1699282920,30000,120646,113587,TR,TR
156577,1698946620,1698976020,29400,166731,174109,TR,TR
39374,1700659860,1700684640,24780,144161,63021,DE,GB
179511,1699383720,1699416660,32940,188140,761,TR,TR
166491,1699740060,1699743660,3600,27205,89993,GB,GB
129576,1700530860,1700545320,14460,193996,30662,US,US
197749,1700673660,1700707140,33480,169012,81036,TR,TR
86008,1699276740,1699307580,30840,82787,177099,TR,TR
139640,1699911600,1699945680,34080,56326,83504,TR,TR
27701,1700320920,1700334060,13140,133391,41334,PT,PT
66146,1699003800,1699011060,7260,146845,23788,FI,EE
31571,1699309800,1699320720,10920,189926,153357,IT,IT
18417,1699348020,1699360740,12720,42639,107431,US,US
92012,1700637720,1700668320,30600,127359,70502,TR,TR
154749,1699118700,1699149780,31080,113645,29787,TR,TR
131025,1698833760,1698844920,11160,152546,31160,US,US
87318,1700002980,1700018880,15900,26584,21832,FR,IT
98009,1700568780,1700581560,12780,46133,5554,AT,BG
179166,1700404680,1700420040,15360,8568,149515,SE,SE
115541,1699742940,1699777320,34380,79422,45698,TR,TR
50499,1699208040,1699216140,8100,151286,127637,EE,EE
178513,1699795620,1699807440,11820,88174,100564,HR,HR
28262,1699472640,1699479300,6660,13063,47087,GB,GB
156056,1700526060,1700533680,7620,165072,175834,ES,ES
35950,1699431360,1699434960,3600,108987,114085,GB,GB
92695,1700552100,1700585520,33420,102199,16563,TR,TR
140467,1700009700,1700046480,36780,137543,181722,MX,MX
41239,1700507940,1700521860,13920,17944,13498,US,US
1898,1699163040,1699197240,34200,42856,151377,TR,TR
16251,1699328760,1699363920,35160,48597,107547,TR,TR
62976,1699144620,1699160100,15480,100373,91034,RS,RS
129154,1699659720,1699663320,3600,164450,115870,GB,GB
10109,1699389120,1699405800,16680,119973,33123,BE,NL
175320,1699626480,1699638840,12360,136347,21402,IT,FR
135516,1700681400,1700696220,14820,86837,193213,FR,FR
57388,1700433900,1700448840,14940,76592,55729,US,US
151091,1700689620,1700719440,29820,97665,45397,TR,TR
39708,1698874260,1698880440,6180,141082,97933,GB,GB
71994,1699812180,1699820640,8460,81054,15892,ES,ES
34735,1700170140,1700199180,29040,179137,6122,TR,TR
173178,1699902120,1699906260,4140,161081,3259,GB,GB
33246,1700520900,1700532720,11820,161574,2876,IT,IT
101323,1699992180,1700022420,30240,153909,190713,TR,TR
168009,1700820540,1700850480,29940,79512,153667,TR,TR
177541,1699825680,1699863120,37440,95599,137909,MX,MX
173602,1698941640,1698971820,30180,184869,175891,TR,TR
10017,1699434660,1699469220,34560,25204,154472,TR,TR
43163,1700520180,1700542740,22560,191903,132964,PL,DE
120240,1699167900,1699171500,3600,49928,56144,GB,GB
144789,1698921060,1698942900,21840,57873,35202,DE,DE
41549,1699289880,1699320060,30180,181513,162199,TR,TR
155370,1699656180,1699673040,16860,112505,148257,FR,NL
52205,1699177980,1699194780,16800,68568,65681,AT,AT
118577,1699986360,1700019480,33120,58728,52208,TR,TR
145772,1700632080,1700647140,15060,183887,82537,US,US
161146,1698981900,1698990420,8520,7143,20749,HR,HR
93058,1699823340,1699855680,32340,34201,57366,TR,TR
77125,1699440240,1699449240,9000,98157,12835,HR,HR
87956,1699369320,1699385280,15960,28667,164551,US,US
173625,1698982680,1698991200,8520,190750,198895,PT,PT
190433,1699385880,1699411680,25800,111600,16083,DE,BG
7600,1700574960,1700606100,31140,140578,111736,TR,TR
131754,1700276520,1700292900,16380,81987,149162,FR,FR
97572,1699364700,1699398900,34200,109789,57223,TR,TR
102413,1699092480,1699101780,9300,6741,120824,PT,PT
26430,1699778880,1699802280,23400,81980,29743,DE,AT
85821,1699853040,1699885620,32580,1423,11068,TR,TR
116162,1700699760,1700731140,31380,131901,51590,TR,TR
132979,1700409360,1700423940,14580,91300,31882,US,US
10759,1699575780,1699607520,31740,81692,194818,TR,TR
75795,1700417520,1700434080,16560,5229,48331,AT,AT
105215,1698882960,1698912840,29880,106529,115150,TR,TR
77832,1699913520,1699944420,30900,22094,103880,TR,TR
77853,1698888300,1698915000,26700,14803,86662,ME,HR
130837,1700718660,1700751780,33120,78517,61198,TR,TR
36225,1700530740,1700547480,16740,128968,98214,AT,AT
72306,1699522200,1699553340,31140,30179,139268,TR,TR
132738,1700559300,1700566560,7260,4967,142843,IT,IT
122874,1700726400,1700741340,14940,176033,187134,FR,FR
6478,1699321680,1699356060,34380,98097,49631,MX,MX
199636,1699909380,1699942500,33120,61664,75658,TR,TR
183393,1700342520,1700377740,35220,196620,50242,TR,TR
195715,1699620180,1699632660,12480,86282,136441,IT,IT
160848,1698924480,1698928080,3600,17139,25334,NL,BE
61704,1699496340,1699499940,3600,6647,178693,NL,NL
22507,1699136820,1699162500,25680,147414,109771,BR,BR
7733,1699437060,1699469520,32460,73797,14936,TR,TR
73416,1698824220,1698854520,30300,73321,139806,TR,TR
185831,1699584120,1699614240,30120,19917,47656,TR,TR
1589,1700646600,1700662740,16140,3650,22664,RS,RS
158280,1699948920,1699954800,5880,15445,142585,NL,NL
2098,1700583720,1700619060,35340,120050,7986,TR,TR
50555,1700378820,1700413080,34260,100765,172484,MX,MX
93163,1699453860,1699464900,11040,64700,43409,AT,AT
72007,1699052940,1699084620,31680,162084,130585,TR,TR
3583,1699641540,1699677360,35820,62352,167185,TR,TR
184075,1698851400,1698865860,14460,6956,149116,FR,FR
43448,1699715760,1699748460,32700,46875,59778,TR,TR
73979,1698926100,1698956520,30420,184256,99855,TR,TR
165800,1698855060,1698858660,3600,69365,176482,NL,NL
153829,1700050200,1700085180,34980,68473,130312,TR,TR
163069,1699064820,1699096920,32100,52361,19480,TR,TR
194029,1700344200,1700369460,25260,121988,182222,PL,PL
31473,1699458000,1699466340,8340,63081,170835,IT,IT
45230,1699130340,1699165800,35460,168822,36948,TR,TR
41067,1699313580,1699346520,32940,86964,164879,TR,TR
69351,1700831520,1700836560,5040,63354,109255,GB,GB
61604,1699458900,1699489560,30660,16626,126965,TR,TR
110058,1700679240,1700682840,3600,195063,90548,GB,GB
178615,1699099500,1699117260,17760,54972,136437,FR,NL
125747,1700460660,1700492880,32220,149445,63891,TR,TR
67986,1700836500,1700870220,33720,148036,18045,TR,TR
100337,1699154580,1699168140,13560,111842,146625,HR,HR
162817,1699565400,1699579740,14340,75582,96420,US,US
92758,1699126020,1699137360,11340,136125,130804,US,US
148951,1700299140,1700330460,31320,92018,138580,TR,TR
27858,1699851960,1699909260,57300,61014,191966,BG,TR
34543,1699665480,1699692480,27000,195406,125779,PL,PL
7880,1698794940,1698803760,8820,69839,36802,HR,HR
102648,1700088540,1700101200,12660,49863,90049,PT,PT
197719,1699755180,1699789560,34380,9851,116459,TR,TR
177522,1700273220,1700305740,32520,161315,1907,MX,MX
185096,1699907100,1699916460,9360,165906,198771,IT,IT
195278,1700674260,1700695500,21240,126238,15302,AL,BA
194100,1700639520,1700650620,11100,15575,94840,US,US
134100,1699781220,1699795620,14400,33805,154373,US,US
109548,1700594640,1700609520,14880,21453,11976,US,US
3287,1699727220,1699759140,31920,107551,4323,TR,TR
16789,1699208880,1699217280,8400,39730,142340,IT,IT
171967,1700866740,1700893860,27120,6428,16035,DE,DK
62760,1700322780,1700326380,3600,146570,73180,NL,NL
26565,1699622460,1699632360,9900,20594,161055,EE,EE
165060,1699576560,1699594380,17820,134949,167972,US,US
180641,1698814020,1698846300,32280,134830,63078,TR,TR
96377,1699315380,1699332780,17400,31219,100773,US,US
33691,1699579920,1699608300,28380,36394,22227,DE,HU
140196,1699209060,1699214580,5520,61221,153870,GB,GB
153905,1699018260,1699045980,27720,150494,19034,DE,BA
43958,1699683960,1699695180,11220,107005,71731,US,US
28821,1700217180,1700227140,9960,35077,177640,ES,ES
60819,1699240020,1699248360,8340,168229,160624,IT,IT
102837,1699239720,1699243320,3600,23715,35478,GB,GB
138241,1699481280,1699508220,26940,94341,4770,BR,BR
59876,1699001220,1699035060,33840,116030,120670,MX,MX
161698,1699193760,1699197360,3600,141163,65685,NL,NL
7177,1698978960,1698993900,14940,167174,48349,AT,SK
28743,1700446980,1700450580,3600,161318,197787,NL,NL
32895,1698932160,1698963780,31620,142409,152227,TR,TR
2005,1700565120,1700573220,8100,160026,134135,IT,IT
199253,1699300620,1699312560,11940,26953,100155,US,US
120207,1698853740,1698857340,3600,199209,180604,GB,GB
98362,1700264580,1700268180,3600,23467,20881,NL,AT
83586,1700831280,1700839200,7920,66382,125628,HR,HR
157463,1699964820,1699973760,8940,30321,143917,CL,CL
1972,1699407960,1699411560,3600,45162,131016,NL,NL
74472,1699611180,1699614960,3780,178333,188365,GB,GB
39926,1700483460,1700487060,3600,131944,155047,NL,NL
1432,1699523100,1699527780,4680,156389,194124,GB,GB
122117,1699022520,1699052040,29520,67221,3510,TR,TR
46709,1699122300,1699148160,25860,160262,90978,DE,DE
173901,1699911120,1699920360,9240,75382,150130,IT,IT
54213,1698901800,1698937140,35340,166788,189181,TR,TR
132314,1700719800,1700723400,3600,12472,155318,GB,GB
144928,1700318460,1700334900,16440,29560,41967,US,US
31508,1700450280,1700476800,26520,56,1976,BA,HR
98332,1700407380,1700443320,35940,42603,124365,TR,TR
128056,1699192140,1699223040,30900,60880,69072,TR,TR
151203,1699177560,1699191960,14400,102191,168796,US,US
96616,1699941840,1699974840,33000,51252,189566,TR,TR
144883,1699550520,1699585980,35460,116302,98920,TR,TR
79562,1698987900,1699001340,13440,65911,45538,US,US
8899,1700654820,1700666460,11640,183307,8859,IT,IT
96335,1699110900,1699144140,33240,126158,113110,TR,TR
178337,1699461360,1699465560,4200,77599,92259,GB,GB
180933,1699454460,1699467780,13320,48416,132042,IT,IT
99578,1700555400,1700570460,15060,171932,100238,FR,DE
175739,1700204940,1700235240,30300,29828,111091,TR,TR
15224,1699742520,1699753980,11460,155001,82350,US,US
149123,1700222580,1700234280,11700,184042,161093,HR,HR
4736,1699535820,1699561740,25920,111539,76245,BR,BR
36703,1700836260,1700849940,13680,135059,18892,IT,IT
189111,1699959060,1699970760,11700,106262,83626,AT,HU
152583,1699109040,1699133280,24240,4671,35878,DE,FR
94191,1700864160,1700883900,19740,42718,129813,BE,NL
15489,1700041080,1700053680,12600,63539,72504,SK,AT
173250,1698866820,1698874560,7740,138914,99224,IT,IT
57541,1698992100,1699021860,29760,193051,109913,TR,TR
41464,1699869180,1699906380,37200,5602,107514,MX,MX
168777,1699367280,1699399380,32100,5116,26247,TR,TR
56316,1699068960,1699072560,3600,11734,182611,GB,GB
115007,1700245020,1700250600,5580,115848,49194,NL,NL
95362,1699179540,1699183140,3600,189578,33228,GB,GB
190019,1700285520,1700308380,22860,57921,99788,BR,BR
9664,1700727720,1700752980,25260,81395,175573,PL,FR
95564,1698964440,1698976860,12420,175316,8747,HR,DE
59744,1700396880,1700402940,6060,17309,67391,NL,NL
107983,1699470360,1699496040,25680,168819,179518,PL,PL
68379,1700044680,1700061060,16380,125412,17844,FR,FR
133944,1699265160,1699284900,19740,27096,156647,FR,FR
8766,1700318340,1700351580,33240,14003,156935,TR,TR
89729,1700742420,1700777880,35460,55295,164390,TR,TR
61256,1699813740,1699818780,5040,182557,106147,CL,CL
88020,1699318920,1699350780,31860,92720,33256,TR,TR
196260,1700761800,1700776380,14580,44995,45389,FR,FR
140585,1700422980,1700438460,15480,143712,156754,FR,FR
40244,1700189100,1700215380,26280,162514,127086,DE,AT
77577,1699546020,1699583880,37860,81804,51575,MX,MX
56853,1698935220,1698948240,13020,43762,83465,US,US
133367,1699130400,1699144620,14220,101858,120440,US,US
60550,1700217480,1700244120,26640,167060,13783,DE,PL
195066,1699925760,1699947000,21240,174226,55833,FR,FR
43805,1700831520,1700846580,15060,152502,190228,US,US
12704,1700464500,1700493600,29100,86592,133247,TR,TR
166251,1700015700,1700052780,37080,73370,80551,MX,MX
101294,1700309580,1700332620,23040,87143,54444,DE,DE
78390,1699387200,1699417680,30480,190381,123024,TR,TR
40538,1699622940,1699651020,28080,125614,132703,RO,RO
179020,1700569920,1700599140,29220,64165,76670,TR,TR
77906,1699797840,1699803720,5880,170370,66941,GB,GB
161675,1699261860,1699293420,31560,192729,487,TR,TR
49741,1700469000,1700480280,11280,190699,10689,IT,IT
50246,1700241720,1700272680,30960,30058,83088,TR,TR
138467,1700116080,1700123820,7740,63304,44452,IT,IT
12172,1700607480,1700643300,35820,1087,113846,TR,TR
22289,1699720680,1699754640,33960,9201,135865,TR,TR
98804,1700513460,1700526780,13320,110674,59743,US,US
89367,1699153140,1699156740,3600,88887,94562,GB,GB
133522,1700175720,1700189820,14100,26890,82446,US,US
114882,1700557080,1700586000,28920,142847,147018,TR,TR
69930,1699997700,1700008680,10980,122621,136099,HR,HR
45693,1699058100,1699092540,34440,63095,195285,TR,TR
131313,1699123860,1699151580,27720,33536,101415,DE,AT
73391,1699096140,1699108080,11940,23429,145349,US,US
174009,1700150820,1700180640,29820,174919,123107,TR,TR
121001,1700087580,1700096700,9120,134000,181210,IT,IT
38096,1700704560,1700708160,3600,123383,25072,NL,NL
179040,1699949700,1699981140,31440,15562,28443,TR,TR
194714,1698876720,1698891240,14520,135753,75827,US,US
89488,1700619720,1700623320,3600,187802,60271,GB,GB
137804,1698887040,1698903720,16680,119780,189075,US,US
132352,1698893880,1698907140,13260,115722,82049,IT,IT
152863,1700704440,1700710320,5880,31695,123310,GB,GB
34614,1700248560,1700283780,35220,17446,120903,TR,TR
106875,1700158620,1700181060,22440,20717,51274,ME,HR
168094,1699911660,1699917600,5940,142565,94087,NL,NL
140556,1699755840,1699759440,3600,127777,142622,GB,GB
74792,1699247880,1699277040,29160,164633,14819,TR,TR
97895,1699430040,1699447860,17820,20375,77905,US,US
189873,1700773560,1700807940,34380,138157,13546,TR,TR
67937,1700693640,1700697240,3600,129218,85785,GB,GB
146300,1699499280,1699530900,31620,107651,115055,TR,TR
137792,1700637660,1700671620,33960,104211,26528,TR,TR
33227,1700475120,1700491860,16740,155489,28138,US,US
108901,1700859600,1700883600,24000,68908,191890,SI,RS
95257,1700137860,1700173260,35400,151223,17759,TR,TR
199527,1700144160,1700156700,12540,159637,134101,US,US
10812,1699437900,1699470060,32160,559,76729,TR,TR
167676,1700160960,1700175960,15000,110561,15972,US,US
142149,1700291580,1700322360,30780,77816,186664,TR,TR
37074,1699971540,1699996020,24480,148850,130947,DK,DK
187761,1700490060,1700506380,16320,100936,119593,FR,FR
65588,1699332840,1699365600,32760,115015,171459,TR,TR
71319,1699173240,1699207140,33900,44096,199312,TR,TR
78290,1699213440,1699248780,35340,149987,6299,TR,TR
82598,1700360940,1700376180,15240,89047,20980,US,US
135655,1700855940,1700876280,20340,129951,181586,DK,DK
111685,1699026240,1699029840,3600,63863,48446,GB,GB
130818,1699395060,1699412760,17700,88816,108193,US,US
66787,1699864140,1699899540,35400,149912,148904,MX,MX
171895,1699429680,1699433280,3600,111020,169165,NL,NL
150441,1699447320,1699477920,30600,92423,5105,TR,TR
186375,1698985260,1699017060,31800,162844,127996,TR,TR
101713,1699669500,1699674660,5160,54918,18211,NL,NL
137092,1699723560,1699750500,26940,112972,138837,DE,DE
108538,1699561200,1699596660,35460,86491,187949,TR,TR
78686,1699572000,1699604040,32040,169948,25029,TR,TR
178147,1699663080,1699670940,7860,193262,126121,PT,PT
128197,1700244180,1700247780,3600,8236,131989,GB,GB
37732,1698930360,1698956040,25680,128239,140323,DE,UA
163068,1698806040,1698817620,11580,121291,26442,ES,ES
95693,1699570320,1699573920,3600,98408,82483,GB,GB
60851,1700510100,1700519580,9480,56089,117718,IT,IT
83135,1700583120,1700634660,51540,32264,10211,BG,DE
111097,1699448820,1699463160,14340,131915,158116,IT,IT
12680,1700565540,1700581680,16140,80072,62038,US,US
123176,1699128180,1699161600,33420,22344,29969,TR,TR
94339,1699209840,1699238340,28500,71695,137900,PL,NL
100276,1700306580,1700338740,32160,6150,60393,TR,TR
163716,1699434060,1699448340,14280,75638,48236,IT,IT
14395,1700247840,1700260380,12540,43416,101452,US,US
140442,1699059540,1699083660,24120,141241,130411,BR,BR
133210,1700749200,1700776140,26940,180914,62781,PL,PL
34226,1698801780,1698840840,39060,85806,113025,LV,AT
102686,1699840980,1699870740,29760,151142,192561,TR,TR
49589,1700442840,1700474460,31620,122128,129185,TR,TR
33665,1700471760,1700488740,16980,56397,155148,US,US
115613,1700665860,1700700300,34440,58982,132258,TR,TR
59013,1698869700,1698895860,26160,33166,133048,PL,CZ
95120,1700318400,1700348940,30540,89776,199122,TR,TR
121279,1699616880,1699651380,34500,118049,152089,TR,TR
61040,1700808360,1700825280,16920,132260,106284,AT,HU
17441,1700016600,1700048940,32340,109487,72918,TR,TR
6942,1699162320,1699170840,8520,106032,127646,PT,PT
110285,1700024820,1700057940,33120,121906,159762,TR,TR
199052,1698878400,1698912000,33600,123255,91024,TR,TR
41039,1699036920,1699063200,26280,189439,2634,DE,DE
120467,1700064960,1700068560,3600,23987,169687,NL,NL
107921,1699477920,1699484220,6300,189942,20247,GB,GB
110523,1700201760,1700225460,23700,144245,47769,CH,DE
154167,1700512260,1700543100,30840,87723,19190,TR,TR
188962,1700862120,1700876640,14520,184960,3774,US,US
118335,1700432160,1700465100,32940,47672,177165,TR,TR
154976,1700526180,1700542440,16260,181988,100508,US,US
140259,1700704860,1700720760,15900,62181,38740,US,US
35989,1699672080,1699695600,23520,82130,185156,DE,DE
771,1700259300,1700290860,31560,134171,21437,TR,TR
56758,1699672740,1699681080,8340,129741,101029,AD,ES
161153,1700151300,1700157600,6300,120047,146862,NL,NL
127483,1699738800,1699752660,13860,161420,51305,RS,RS
151010,1699114740,1699143900,29160,180745,8822,TR,TR
157916,1699953120,1699980780,27660,177542,79671,DE,SK
68211,1698918120,1698951720,33600,155859,60511,TR,TR
184012,1699615200,1699652400,37200,75936,113820,MX,MX
107186,1700689200,1700715600,26400,7916,80629,BR,BR
111682,1699462020,1699465620,3600,92929,116453,GB,GB
30296,1699635120,1699646580,11460,192022,152584,US,US
155944,1698932460,1698962580,30120,148805,115227,TR,TR
42265,1700760420,1700764020,3600,173357,63204,GB,GB
199158,1699997460,1700029140,31680,150139,117977,TR,TR
47225,1700215740,1700268540,52800,151700,152977,BG,DE
80959,1699283580,1699318680,35100,34761,155752,TR,TR
116928,1698908100,1698916500,8400,151231,4341,SK,SK
174356,1700748540,1700763900,15360,99183,195407,US,US
31501,1700316060,1700330820,14760,173137,58946,US,US
85647,1699034940,1699041720,6780,183498,91052,AD,FR
42310,1699656900,1699668420,11520,175526,46475,AT,AT
136405,1699646040,1699649640,3600,25276,147925,NL,NL
144682,1699436520,1699470060,33540,146662,125409,TR,TR
115107,1700341140,1700357880,16740,179612,171528,US,US
1223,1700667840,1700680740,12900,138468,92728,CZ,CZ
69218,1700014980,1700048460,33480,167460,94032,TR,TR
130634,1699550160,1699553760,3600,64737,76434,NL,NL
186146,1700397900,1700432400,34500,47636,39774,TR,TR
5814,1699924260,1699931160,6900,8798,133896,GB,GB
186096,1700087580,1700091180,3600,34253,176533,GB,GB
48438,1700606580,1700618280,11700,130108,21596,IT,IT
118796,1699734000,1699745100,11100,110035,119592,AT,BG
181933,1699948620,1699952220,3600,60988,26945,NL,PL
172010,1700062440,1700095980,33540,106604,184880,TR,TR
91275,1699908360,1699919760,11400,119892,113857,CZ,CZ
6731,1699498260,1699513440,15180,76680,51005,RS,IT
136430,1698939960,1698967380,27420,146365,30355,RO,RO
87470,1699001280,1699018320,17040,109466,866,US,US
164594,1699775340,1699797540,22200,167445,197881,PL,PL
833,1699884480,1699919160,34680,99903,114774,TR,TR
15010,1700436240,1700467500,31260,68525,8297,TR,TR
184976,1699955220,1699977540,22320,49134,25045,ME,RS
79377,1699638060,1699647960,9900,1451,175966,SK,AT
51025,1700120160,1700153940,33780,21482,57899,TR,TR
95350,1700325420,1700360940,35520,194428,28477,TR,TR
13989,1699060800,1699087560,26760,94659,123291,PL,UA
117750,1699289220,1699300380,11160,78551,184872,US,US
58511,1700542200,1700552760,10560,95903,151309,HR,HR
82273,1700764080,1700799900,35820,150454,12587,TR,TR
69440,1699702980,1699706580,3600,145887,81783,GB,GB
145940,1700846940,1700862420,15480,103324,129958,US,US
129732,1699308180,1699343880,35700,41819,82361,TR,TR
117541,1700730960,1700745480,14520,129449,187199,US,US
147874,1700153640,1700167560,13920,41138,74858,US,US
94910,1699607040,1699619100,12060,95843,42959,US,US
170147,1700700300,1700710620,10320,150699,34401,IT,IT
178509,1699122300,1699131660,9360,96471,110308,IT,IT
151256,1699960320,1699997460,37140,52469,176481,MX,MX
86858,1700517900,1700548800,30900,139986,191924,TR,TR
99799,1700134560,1700138160,3600,106819,71077,GB,GB
39733,1700206620,1700226120,19500,103036,23362,FR,FR
103066,1699491300,1699522860,31560,115292,156261,TR,TR
7263,1700271120,1700276160,5040,111270,27231,GB,GB
105490,1699327980,1699331760,3780,55655,28868,NL,NL
161067,1699303800,1699316460,12660,175716,193923,IT,IT
125967,1700615520,1700627460,11940,118054,86208,US,US
146461,1700405520,1700436300,30780,54333,57527,TR,TR
118812,1700399880,1700421540,21660,156608,98230,DE,NL
26316,1700252400,1700258220,5820,139547,59025,NL,NL
102257,1700167980,1700198340,30360,47697,111127,TR,TR
118620,1698954000,1698958740,4740,61064,77498,GB,FR
125988,1700349780,1700360820,11040,196348,16607,US,US
127339,1698981960,1698991380,9420,67184,179856,HR,HR
63960,1700476320,1700488200,11880,77033,17951,US,US
26004,1699059660,1699075740,16080,163081,31799,US,US
40233,1700344140,1700372400,28260,135347,182583,DE,NL
191093,1700202540,1700210280,7740,182915,124324,IT,IT
188938,1700578320,1700595240,16920,26933,174326,US,US
78310,1698847800,1698883620,35820,39996,196929,TR,TR
33623,1700579220,1700613540,34320,144784,17717,TR,TR
4458,1698916620,1698950040,33420,12038,9305,TR,TR
103625,1699665420,1699669980,4560,188206,121069,NL,NL
160449,1699474200,1699504320,30120,55630,7328,TR,TR
77851,1698888120,1698921840,33720,154094,25311,TR,TR
106575,1699793760,1699807620,13860,33683,18715,IT,IT
163087,1699640880,1699654380,13500,115369,98568,US,US
166957,1700499660,1700513880,14220,16729,88352,IT,IT
83959,1700611440,1700623920,12480,158840,30868,US,US
165649,1699803420,1699833600,30180,118918,6997,TR,TR
71415,1698935040,1698970200,35160,157528,130995,TR,TR
89358,1700306940,1700338320,31380,68373,22416,TR,TR
188911,1699800600,1699813860,13260,49328,177903,IT,IT
64147,1700591220,1700600940,9720,166710,175166,IT,BG
167400,1700784060,1700797980,13920,190679,168368,AT,AT
157345,1700822220,1700851020,28800,177914,183929,TR,TR
16452,1699220700,1699224960,4260,54215,106181,NL,NL
23932,1700654340,1700657940,3600,23062,150535,NL,NL
125516,1699179000,1699191180,12180,176780,175330,US,US
155042,1700308560,1700343180,34620,189351,47147,TR,TR
100585,1699825680,1699850040,24360,125575,76240,SI,BA
20965,1700397960,1700413800,15840,76829,126587,RS,HU
154414,1700503140,1700514660,11520,53722,62291,US,US
58490,1700520900,1700528700,7800,171368,88600,SK,SK
158145,1699170240,1699205220,34980,188050,138919,MX,MX
128611,1700088840,1700121720,32880,18552,60557,TR,TR
60585,1699385160,1699397700,12540,157616,173190,HR,HR
133911,1699417500,1699452960,35460,90003,24526,TR,TR
167886,1699107600,1699111980,4380,161817,29305,GB,GB
96407,1699748220,1699784820,36600,129830,46872,MX,MX
54635,1699793160,1699806780,13620,126993,45989,US,US
187580,1698828420,1698862980,34560,135372,169532,TR,TR
122694,1700649540,1700660760,11220,191967,31957,HR,HR
38081,1700016120,1700028060,11940,154909,66222,US,US
87360,1699411080,1699449060,37980,63805,37260,MX,MX
177736,1700569980,1700583120,13140,186639,92939,IT,IT
113408,1699056480,1699071480,15000,94545,139721,AT,AT
60957,1699397640,1699403340,5700,11918,155255,GB,GB
104049,1699847940,1699855920,7980,51465,17619,IT,IT
104914,1699719240,1699748640,29400,50404,118259,TR,TR
15011,1699220580,1699252620,32040,139823,54696,TR,TR
82718,1700640180,1700662020,21840,184707,34906,DE,DE
71748,1699434060,1699447980,13920,148958,165926,PT,PT
68933,1700177640,1700181240,3600,134248,16219,GB,GB
130609,1700766420,1700779440,13020,48466,175098,IT,IT
134300,1699070280,1699086660,16380,114808,117374,US,US
4574,1699113840,1699123320,9480,177097,15665,IT,IT
141800,1699738380,1699752120,13740,133848,175213,AT,AT
54498,1698927420,1698946920,19500,115106,34181,FR,FR
176973,1700686080,1700699400,13320,168177,164129,US,US
77467,1700349420,1700362260,12840,35331,164212,US,US
8463,1700346360,1700357940,11580,159017,156788,HR,HR
149860,1699891920,1699903260,11340,14822,71178,AT,CZ
29697,1699007160,1699035240,28080,36846,83778,PL,DE
32395,1698844860,1698857760,12900,146979,159716,US,US
99702,1699597440,1699633380,35940,106548,158604,TR,TR
180472,1699085160,1699118820,33660,188211,98697,TR,TR
46698,1699079460,1699112100,32640,122039,157624,TR,TR
68818,1699459320,1699473000,13680,88505,71614,IT,IT
129275,1699197060,1699217220,20160,87491,66074,FR,ES
177467,1700061480,1700085180,23700,86755,159857,PL,PL
162838,1699506120,1699522320,16200,147198,65605,US,US
193810,1698935160,1698968820,33660,183052,155352,TR,TR
126116,1699353000,1699367340,14340,167503,94647,IT,IT
145816,1699115400,1699144740,29340,97554,87489,TR,TR
122015,1699140300,1699152000,11700,21045,169918,US,US
72709,1699180560,1699215060,34500,173275,61240,TR,TR
60725,1699748160,1699755840,7680,42436,10187,IT,IT
124147,1698909840,1698945420,35580,93230,55936,TR,TR
80696,1698886320,1698889980,3660,175427,132302,NL,LU
2783,1699616520,1699631760,15240,29460,110571,US,US
65098,1699956540,1699960140,3600,141786,33978,GB,GB
41607,1700128680,1700132280,3600,41124,135810,GB,GB
83943,1699268520,1699298760,30240,180113,31444,TR,TR
46893,1700578500,1700582100,3600,1253,137431,GB,GB
149442,1698965940,1698999660,33720,27761,134412,TR,TR
122313,1699165200,1699198260,33060,155648,71150,MX,US
17015,1698870660,1698874260,3600,151730,57127,GB,GB
116917,1699235220,1699249080,13860,98329,3605,SK,SK
99152,1699583820,1699589100,5280,14725,160065,NL,NL
142279,1699099440,1699129140,29700,76150,26625,TR,TR
123429,1700638680,1700667480,28800,168453,61967,TR,TR
40525,1700346120,1700361600,15480,193031,68736,AT,AT
22927,1699216800,1699252680,35880,158393,55871,TR,TR
115879,1699770540,1699783500,12960,39146,69663,HR,HR
113228,1699950600,1699984560,33960,45802,102953,TR,TR
94652,1698943680,1698975000,31320,139712,165596,TR,TR
119223,1700457060,1700462100,5040,107735,8296,GB,GB
58735,1699129560,1699134900,5340,5357,89232,NL,NL
184553,1698834060,1698845640,11580,62893,84123,PT,PT
58139,1699434240,1699463160,28920,71110,76015,TR,TR
22599,1700496420,1700530020,33600,138668,135797,TR,TR
109545,1700190780,1700201460,10680,56114,194081,IT,IT
126179,1700302500,1700313840,11340,21197,22006,US,US
4864,1699256460,1699288320,31860,100799,37857,TR,TR
74893,1699950000,1699965540,15540,150711,161969,BE,NL
110155,1700688420,1700721240,32820,46677,2260,TR,TR
103304,1700000100,1700035020,34920,154200,189248,TR,TR
162370,1699528800,1699540380,11580,119820,91596,SK,SK
72290,1700473020,1700487600,14580,165301,111146,US,US
118481,1699697460,1699727640,30180,101123,127653,TR,TR
180906,1700269740,1700299620,29880,158665,14607,TR,TR
195933,1700518320,1700547240,28920,4149,136823,TR,TR
37368,1699932600,1699958220,25620,136126,59648,BR,BR
166727,1700585220,1700597040,11820,113682,148026,CZ,DE
1300,1698999720,1699017060,17340,133446,156122,CZ,CZ
34746,1700005080,1700041020,35940,10375,139067,TR,TR
179893,1699367340,1699388820,21480,99013,127836,FR,FR
137041,1700254740,1700279400,24660,144904,177291,DE,RS
169127,1700253900,1700259540,5640,147079,6133,AD,ES
35843,1700354400,1700367180,12780,184589,26993,US,US
166239,1700408460,1700439480,31020,30783,156860,TR,TR
12437,1699893720,1699920720,27000,23475,101883,PL,PL
49183,1699315560,1699345440,29880,157686,14184,TR,TR
103801,1698796260,1698804180,7920,64687,135962,EE,LT
41061,1700001660,1700034900,33240,35505,83967,TR,TR
75957,1699944660,1699956480,11820,39999,71252,HR,HR
127270,1699176780,1699205940,29160,9461,32263,TR,TR
71968,1699559820,1699575840,16020,157573,197628,US,US
82737,1700242800,1700275680,32880,7875,122723,TR,TR
128316,1699239660,1699273140,33480,154109,197063,TR,TR
168657,1700188320,1700225340,37020,3897,165794,MX,MX
170044,1699293480,1699300320,6840,142464,107549,GB,GB
11490,1698814920,1698823320,8400,196082,133606,IT,IT
85452,1698954780,1698966360,11580,185444,174466,US,US
148688,1700647500,1700673900,26400,187502,127545,ME,RS
70247,1699251180,1699278900,27720,78269,35906,BR,BR
157108,1700479980,1700489580,9600,72180,152542,PT,PT
122013,1699036140,1699054740,18600,24808,124920,FR,FR
187970,1699225080,1699259100,34020,105826,122877,TR,TR
196236,1699956660,1699974900,18240,120509,10180,FR,FR
161773,1700675520,1700709600,34080,151523,60940,TR,TR
64775,1698832800,1698849840,17040,160904,53199,SE,SE
125332,1699217640,1699233720,16080,97352,46436,US,US
21593,1699010880,1699019400,8520,83916,192291,HR,PL
13709,1699827660,1699835940,8280,187133,161693,EE,FI
19134,1699202460,1699216440,13980,7358,151554,ES,ES
108992,1699242420,1699255440,13020,32196,29578,IT,IT
72077,1699680360,1699710840,30480,186868,118360,TR,TR
57266,1700399520,1700428800,29280,192977,172639,TR,TR
166048,1699091160,1699094760,3600,167329,37334,NL,NL
121557,1700832960,1700853180,20220,115773,142156,FR,ES
36002,1698848880,1698856560,7680,125354,113184,IT,FR
102622,1700473200,1700483580,10380,158757,121451,EE,FI
198240,1699651920,1699661760,9840,95633,83851,PT,PT
34564,1699962240,1699977120,14880,30935,96203,US,US
136092,1698966540,1698970140,3600,71948,55240,NL,NL
43787,1699160940,1699190460,29520,6714,87632,TR,TR
163989,1699900200,1699933320,33120,68200,55176,TR,TR
115664,1699914540,1699925100,10560,82609,170087,PT,PT
61793,1700568000,1700571600,3600,17869,177941,NL,NL
190175,1699791300,1699813560,22260,167767,192607,RO,RO
30887,1700184000,1700197740,13740,103823,70843,US,US
99888,1700028060,1700040300,12240,121555,57779,AT,SK
172343,1700142660,1700147700,5040,130453,60751,NL,NL
115892,1700484000,1700506080,22080,179088,133704,PL,DE
85447,1699195080,1699212300,17220,51741,85843,RS,RS
195187,1699521840,1699556460,34620,97164,107956,TR,TR
143797,1700492280,1700523900,31620,49543,23910,TR,TR
91440,1699246140,1699280940,34800,160494,97374,TR,TR
30766,1700390280,1700426220,35940,194612,162167,TR,TR
124047,1699992720,1700026980,34260,14111,52004,TR,TR
145264,1699405740,1699439460,33720,57860,4279,TR,TR
34355,1700619120,1700651160,32040,129105,17868,TR,TR
126891,1699007040,1699042380,35340,163023,197290,TR,TR
128534,1699995300,1700027940,32640,133616,144247,TR,TR
13502,1699876620,1699909740,33120,75743,11673,TR,TR
92215,1699766640,1699772520,5880,74977,69795,GB,GB
146352,1699846920,1699858560,11640,43695,165352,US,US
55924,1699109820,1699138800,28980,120908,177600,TR,TR
14760,1699033320,1699064160,30840,33325,108768,TR,TR
94068,1700682660,1700691840,9180,185110,100276,PT,PT
132210,1699618680,1699637700,19020,38421,31450,FR,DE
182179,1700125560,1700140560,15000,132147,3215,US,US
114026,1700461620,1700472780,11160,62512,16977,US,US
199629,1698815160,1698818760,3600,145383,64737,GB,GB
106900,1700764980,1700794500,29520,12190,36619,TR,TR
103475,1698963420,1698993780,30360,175346,25051,TR,TR
182061,1699913400,1699948860,35460,103020,105032,TR,TR
157379,1700245080,1700276640,31560,158772,60528,TR,TR
126273,1700548200,1700551800,3600,86981,185767,GB,GB
10528,1699666620,1699700220,33600,134344,120085,TR,TR
135674,1700269260,1700302680,33420,55007,143961,TR,TR
114850,1700714820,1700722560,7740,41120,99322,IT,IT
145516,1700352360,1700384520,32160,132354,15800,TR,TR
183929,1700088840,1700120760,31920,53314,116886,TR,TR
28933,1700732280,1700758020,25740,26425,134391,RO,RO
127913,1700361960,1700394060,32100,93431,96151,TR,TR
170316,1699301280,1699319640,18360,4723,150601,BE,NL
7299,1700211360,1700222340,10980,21916,87555,HR,HR
94721,1698904320,1698935760,31440,47201,197350,TR,TR
136804,1699147080,1699152300,5220,74780,117452,GB,GB
111698,1700521020,1700535840,14820,79537,173936,US,US
90723,1698960120,1698977100,16980,193887,67903,US,US
102891,1698944700,1698974580,29880,67323,42614,TR,TR
25213,1699588500,1699594560,6060,39525,40639,GB,GB
167547,1700226960,1700239560,12600,85529,116978,IT,IT
71187,1698856080,1698868020,11940,121082,8758,US,US
76148,1699642500,1699676520,34020,8592,192390,TR,TR
95079,1700149620,1700171880,22260,71516,186068,DE,BG
48678,1699075080,1699088820,13740,41255,198495,US,US
148642,1700353080,1700364900,11820,177987,168914,US,US
86563,1699905960,1699909560,3600,117301,79142,GB,GB
167543,1699512060,1699515660,3600,132461,138380,GB,GB
68228,1698909420,1698918840,9420,39597,21985,IT,IT
57054,1699374960,1699404600,29640,22928,32038,TR,TR
182112,1699489800,1699525200,35400,187471,159368,TR,TR
17876,1700203980,1700210220,6240,184067,25322,NL,BE
25760,1700352900,1700357400,4500,179323,21455,NL,NL
178518,1700333220,1700346300,13080,83270,112131,PT,PT
154655,1699257360,1699292040,34680,83551,43878,TR,TR
74838,1700812560,1700836260,23700,142264,186618,DE,BG
43603,1700397660,1700404800,7140,4937,64400,NL,DE
118609,1699698240,1699731840,33600,153068,85853,TR,TR
147654,1699646160,1699675920,29760,8103,5982,TR,TR
59308,1700117160,1700146020,28860,62762,173138,TR,TR
103173,1699972260,1699989900,17640,150943,98943,AT,AT
190841,1699970820,1700006100,35280,14314,171084,TR,TR
126561,1699603380,1699632720,29340,32689,72946,TR,TR
52230,1698961200,1698971160,9960,180811,188792,PT,PT
169924,1699716480,1699724640,8160,94489,75890,IT,IT
36890,1699569060,1699581060,12000,190881,170432,IT,IT
7208,1699698540,1699710480,11940,105033,25723,PT,PT
16814,1699653060,1699661100,8040,187504,133206,IT,IT
71211,1699811400,1699825560,14160,84586,168864,IT,IT
146886,1699265460,1699276980,11520,159651,191986,IT,IT
78365,1699847520,1699876980,29460,186351,100810,TR,TR
161102,1699130640,1699144440,13800,167722,125705,IT,IT
30253,1699200720,1699234920,34200,35804,908,TR,TR
15546,1700090340,1700095980,5640,86262,58677,GB,GB
109697,1699558860,1699594080,35220,145652,129423,TR,TR
34465,1700313420,1700317440,4020,14838,79501,NL,NL
153506,1700796060,1700810640,14580,197771,87712,US,US
56072,1698863520,1698867420,3900,10351,20707,GB,GB
15091,1699109160,1699147080,37920,18835,65737,MX,MX
171001,1700637180,1700651820,14640,69353,73147,BE,NL
176503,1698967560,1698978420,10860,173899,106230,IT,IT
129995,1700690940,1700723880,32940,177041,144307,TR,TR
84776,1699822620,1699829280,6660,113666,71224,GB,GB
114014,1699997340,1700028660,31320,172076,181206,TR,TR
191893,1700492940,1700523420,30480,6641,30218,TR,TR
5551,1700586240,1700620260,34020,43668,24824,TR,TR
39480,1699704360,1699713960,9600,77020,179843,SK,SK
175355,1700825400,1700829000,3600,56438,63058,GB,GB
181989,1700123520,1700148960,25440,3647,67037,PL,LV
17815,1699995420,1700009580,14160,166712,189185,US,US
58379,1699277580,1699290480,12900,125087,17944,US,US
90001,1699287420,1699303500,16080,75713,89506,AT,DE
160211,1699185000,1699212480,27480,112494,38668,RO,RO
118375,1700778300,1700808840,30540,126194,25655,TR,TR
47810,1699539060,1699574040,34980,128373,73919,TR,TR
79781,1699608720,1699615980,7260,158997,190323,IT,IT
131745,1700807100,1700842920,35820,173547,125640,TR,TR
83852,1699890360,1699925580,35220,22754,837,TR,TR
85522,1698838500,1698872460,33960,54596,142872,TR,TR
135077,1700669040,1700679060,10020,178714,39252,ES,ES
12279,1700468700,1700503140,34440,199178,106066,TR,TR
15314,1700346060,1700378460,32400,8275,93735,TR,TR
66623,1699208820,1699212420,3600,158210,169904,GB,GB
109837,1699617540,1699621140,3600,45598,113817,NL,NL
140910,1699454280,1699466280,12000,11944,160552,IT,IT
46721,1699927800,1699934760,6960,37750,59087,GB,GB
107649,1699240800,1699274880,34080,187183,74125,TR,TR
162248,1699822800,1699858200,35400,31981,131748,TR,TR
195021,1700094360,1700107140,12780,194876,27028,CZ,SK
180469,1700675700,1700680260,4560,40082,150368,NL,NL
21303,1699361160,1699370520,9360,2199,40124,HR,HR
151265,1699400400,1699404000,3600,179549,190990,GB,GB
33594,1700298600,1700315520,16920,188042,136998,US,US
139377,1698893400,1698897000,3600,31213,33985,NL,NL
9924,1699026120,1699054200,28080,33234,85413,DE,DE
128901,1700688420,1700704080,15660,164670,92553,RS,RS
103954,1700713680,1700730420,16740,2590,40027,CZ,DE
41723,1699004880,1699022700,17820,153709,81532,US,US
185557,1700122080,1700161020,38940,76894,68021,MX,MX
97096,1699575360,1699590720,15360,57420,87079,US,US
95090,1699181040,1699210980,29940,162395,32765,TR,TR
62304,1700726520,1700737440,10920,52096,3039,US,US
98110,1699000500,1699004100,3600,154352,100737,NL,NL
90257,1698809640,1698843300,33660,116940,97344,TR,TR
145652,1699145880,1699172700,26820,166963,171766,BR,BR
134516,1699128540,1699132140,3600,27037,91426,GB,GB
18290,1699136820,1699158360,21540,191752,78504,AL,MK
15254,1699039020,1699052580,13560,4235,144663,IT,IT
171525,1699682700,1699693080,10380,88687,196103,IT,IT
157006,1700838240,1700847840,9600,85229,131179,IT,IT
178964,1700575500,1700580120,4620,113764,28610,GB,GB
106838,1699254180,1699286820,32640,26272,151876,TR,TR
97503,1700544300,1700558640,14340,155433,94642,AT,DE
59021,1700679000,1700684040,5040,132439,194633,NL,NL
32346,1699660080,1699690320,30240,139688,117507,TR,TR
32654,1698946320,1698981240,34920,114873,11959,TR,TR
131551,1700555460,1700566320,10860,51599,55104,CZ,CZ
1134,1699093320,1699107120,13800,76429,114084,IT,IT
145460,1700324940,1700328540,3600,18928,74734,NL,NL
85865,1699099620,1699132140,32520,181721,11802,TR,TR
29293,1699738320,1699751700,13380,23096,35649,IT,IT
150456,1700202840,1700218860,16020,184926,83370,RS,RS
75989,1700851020,1700865060,14040,48761,116760,IT,IT
81127,1700622180,1700642760,20580,3536,119771,FR,ES
134386,1700001060,1700018100,17040,10405,191328,RS,RS
80224,1699163580,1699176660,13080,35736,76980,US,US
88673,1700365020,1700381280,16260,132080,152653,SE,SE
67598,1700454660,1700467440,12780,33650,38445,US,US
112799,1700049660,1700074500,24840,186096,151953,DE,DE
140114,1699722360,1699761540,39180,140559,31350,MX,MX
174465,1699588320,1699620720,32400,1758,80260,TR,TR
37807,1700134260,1700144220,9960,187494,179899,IT,IT
89258,1700403660,1700424120,20460,38396,145384,FR,BE
31232,1699055700,1699068960,13260,175247,162635,ES,ES
148084,1699203720,1699215540,11820,100880,152163,PT,PT
116561,1699235820,1699266900,31080,68942,65718,TR,TR
76328,1698997140,1699023120,25980,15276,78672,RO,RO
172647,1698947280,1698954360,7080,195310,197813,GB,GB
177513,1699874700,1699909920,35220,184028,198196,TR,TR
51668,1700832960,1700861940,28980,95092,158369,TR,TR
78666,1700607660,1700616060,8400,167676,14012,IT,IT
123103,1699128660,1699143000,14340,91422,148492,US,US
186230,1698948240,1698953280,5040,157234,121314,FI,EE
118336,1700678280,1700693880,15600,51827,10929,US,US
53784,1699065600,1699097280,31680,23053,130939,TR,TR
166976,1700135460,1700150340,14880,147609,93008,SE,RO
138240,1700175780,1700206980,31200,162589,95348,TR,TR
127179,1699491780,1699521780,30000,35149,143232,TR,TR
199672,1699354560,1699359180,4620,6804,71074,NL,NL
179136,1700321160,1700351460,30300,166493,9717,TR,TR
121591,1700280600,1700284200,3600,6851,132119,GB,GB
92531,1698799260,1698821700,22440,131095,128272,HU,CZ
26736,1700121300,1700147160,25860,92470,59683,PL,PL
88979,1699213800,1699232460,18660,47728,20823,DK,DE
156750,1699277520,1699284360,6840,92991,124461,NL,DE
147862,1700394300,1700397900,3600,175490,124927,NL,NL
77029,1700332860,1700346060,13200,145776,193734,HR,BA
191196,1700451960,1700487300,35340,92325,18877,TR,TR
3300,1698992460,1699011720,19260,169548,197558,LT,EE
199327,1700242680,1700271900,29220,141695,135061,TR,TR
75585,1700590440,1700599200,8760,182129,88510,ES,FR
17779,1699769100,1699797660,28560,36210,142859,DE,AT
164811,1699140720,1699146900,6180,120748,62681,GB,GB
70257,1699258380,1699273440,15060,167775,35465,AT,SK
3550,1699572780,1699606140,33360,145551,62352,TR,TR
134310,1699501980,1699513920,11940,141164,4602,US,US
153305,1699302720,1699316760,14040,169612,74760,IT,IT
150382,1700541120,1700551380,10260,110967,159229,PT,PT
54129,1700107020,1700110620,3600,42019,175137,GB,GB
21761,1699935420,1699947060,11640,12361,9620,US,US
32189,1700387460,1700402100,14640,39099,51614,US,US
83565,1700448180,1700451960,3780,66068,6844,GB,GB
22769,1699564140,1699575120,10980,114370,159640,US,US
72314,1699036920,1699045080,8160,140073,182426,IT,IT
102170,1700132760,1700163060,30300,137330,72166,TR,TR
29753,1700385120,1700398260,13140,81016,163983,IT,IT
133758,1699980300,1699983900,3600,98380,47333,GB,GB
196979,1699200180,1699216080,15900,105386,159832,US,US
96539,1699430760,1699436460,5700,50356,13260,GB,GB
168033,1699357860,1699390920,33060,164454,13430,TR,TR
131196,1700393640,1700429100,35460,3567,176274,TR,TR
97540,1700112960,1700130540,17580,1140,75746,AT,PL
100878,1698816000,1698821400,5400,67766,111652,GB,GB
15967,1700090280,1700122980,32700,29214,19001,TR,TR
3217,1698937080,1698940740,3660,2954,95250,NL,NL
19823,1700700000,1700731200,31200,94420,32348,TR,TR
36889,1700793660,1700806740,13080,59339,119320,US,US
98233,1700443020,1700475420,32400,30101,52962,TR,TR
181468,1700097720,1700101320,3600,148431,146631,GB,GB
190972,1700816640,1700821920,5280,86424,85014,NL,NL
62699,1700087220,1700118720,31500,101018,141754,TR,TR
14364,1699290600,1699324200,33600,152206,35929,TR,TR
124293,1699895160,1699906260,11100,102487,171951,IT,IT
114696,1700814060,1700827380,13320,197140,162893,AT,AT
142232,1699696260,1699728240,31980,32376,76957,TR,TR
28726,1700615100,1700629020,13920,155668,112510,US,US
129844,1699727400,1699756200,28800,139219,57420,TR,TR
197520,1700196780,1700227020,30240,87898,154132,TR,TR
23690,1699716360,1699728240,11880,647,158063,HR,AT
83429,1700677440,1700703720,26280,164999,16569,BR,BR
8835,1699801920,1699816740,14820,109012,194570,AT,AT
199720,1700416620,1700445720,29100,46490,65460,TR,TR
129453,1699190400,1699202880,12480,120613,151952,US,US
131953,1700783340,1700797380,14040,142260,14909,IT,IT
120644,1698879120,1698892680,13560,153226,85328,HR,HR
88338,1699730040,1699733640,3600,45577,78723,GB,GB
165330,1700856000,1700866620,10620,191300,138033,EE,DE
127172,1699306980,1699335840,28860,82919,161620,TR,TR
143858,1699472100,1699475700,3600,152695,62725,NL,NL
144302,1699505520,1699517040,11520,63311,38224,US,US
66420,1698829200,1698832920,3720,134867,65629,NL,NL
158184,1700527920,1700545260,17340,135471,150625,CZ,CZ
134675,1699450920,1699480140,29220,7575,141024,TR,TR
154228,1700313300,1700346840,33540,18741,87978,TR,TR
68316,1700314740,1700346240,31500,48373,122217,TR,TR
3516,1700067600,1700073840,6240,186232,102514,NL,NL
54759,1698877140,1698883260,6120,8464,192079,GB,GB
172736,1698825540,1698861300,35760,120810,110545,TR,TR
86317,1699840920,1699846140,5220,127402,176875,NL,NL
52097,1700135580,1700140080,4500,25674,19297,NL,NL
27577,1700414520,1700444700,30180,62714,97741,TR,TR
175671,1699046640,1699072440,25800,112922,95975,DE,FR
189970,1700151180,1700181660,30480,132753,148624,BA,HR
100677,1699159740,1699170780,11040,73308,54649,IT,IT
117761,1700445240,1700478060,32820,105879,81231,TR,TR
72585,1698998460,1699032420,33960,197759,43624,TR,TR
762,1700264580,1700298420,33840,6506,170601,TR,TR
183131,1698901920,1698933300,31380,146172,37119,TR,TR
166057,1699529280,1699542360,13080,114846,167265,IT,IT
117065,1699221960,1699235400,13440,35817,35747,IT,IT
109253,1699137060,1699141680,4620,102709,87504,NL,NL
100603,1698930480,1698934080,3600,187108,108257,GB,GB
171576,1700117520,1700152860,35340,148867,106844,TR,TR
28546,1699281480,1699295220,13740,59875,164350,IT,IT
35359,1698986940,1698990540,3600,159868,176357,GB,GB
95858,1700739900,1700774040,34140,60149,164588,TR,TR
156633,1700629500,1700633100,3600,45827,90821,NL,NL
42351,1699480920,1699510680,29760,172085,151271,TR,TR
124813,1700430360,1700465820,35460,53724,45511,TR,TR
20055,1699066140,1699073160,7020,164045,133602,NL,NL
105961,1698910800,1698914400,3600,66510,124650,GB,GB
160205,1698987720,1699001460,13740,52549,1257,US,US
86187,1699181760,1699211040,29280,139743,73736,TR,TR
197647,1699262220,1699297020,34800,137473,83121,MX,MX
98597,1699295040,1699298640,3600,9874,20685,NL,NL
188409,1698839880,1698870300,30420,173651,18774,TR,TR
65550,1699289580,1699296000,6420,143206,39217,FI,EE
3666,1700608080,1700637900,29820,126551,11944,TR,TR
33533,1698855240,1698868680,13440,75921,113437,US,US
191682,1700129520,1700133120,3600,130270,68292,GB,GB
179501,1699434360,1699443720,9360,165490,187979,IT,IT
193475,1698849300,1698884580,35280,137977,179964,TR,TR
16655,1699242540,1699246140,3600,192055,117578,GB,GB
46728,1700757960,1700787060,29100,96645,18897,TR,TR
119584,1700507700,1700536740,29040,24690,104160,TR,TR
36582,1699301640,1699326960,25320,197661,129460,PL,PL
119263,1698981780,1699013160,31380,191869,125191,TR,TR
102718,1699338780,1699367280,28500,188896,79543,CH,FR
28681,1700299140,1700333580,34440,133083,99199,TR,TR
143931,1699768560,1699775460,6900,20521,131939,NL,NL
81765,1698869460,1698873540,4080,172926,76076,NL,NL
166139,1699873140,1699906860,33720,49045,130198,TR,TR
59269,1700745180,1700772960,27780,161954,181347,DE,DE
156845,1699740840,1699770120,29280,145634,54968,TR,TR
154887,1699093500,1699122720,29220,78810,14525,TR,TR
113400,1700643420,1700673000,29580,196767,2949,TR,TR
174676,1700337660,1700369280,31620,83766,58507,TR,TR
134976,1699800420,1699804020,3600,60742,106472,GB,GB
145634,1700519340,1700552100,32760,82439,97390,TR,TR
23183,1699761600,1699790520,28920,147728,15791,TR,TR
107345,1699280520,1699292160,11640,109747,140072,US,US
197608,1700838060,1700869260,31200,60941,65008,TR,TR
118118,1699013760,1699045560,31800,151465,70520,TR,TR
96774,1700389560,1700406660,17100,137192,78447,US,US
173413,1699081800,1699107660,25860,27126,38011,PL,DE
80706,1699797240,1699812420,15180,133328,49302,US,US
91087,1700830440,1700865060,34620,55478,148672,TR,TR
57069,1698911820,1698915540,3720,177607,64021,AD,ES
96357,1699984800,1699998840,14040,75635,14970,AT,AT
92990,1700309700,1700332440,22740,31747,4970,DK,NO
18931,1700262300,1700291160,28860,146702,161787,TR,TR
112418,1700347920,1700365140,17220,33132,116568,US,US
62042,1700784360,1700817900,33540,57591,148583,TR,TR
51064,1699376880,1699407840,30960,106365,162788,TR,TR
119984,1699992240,1700002260,10020,147497,170834,ES,AD
29829,1700222760,1700255640,32880,100440,78221,TR,TR
157335,1700125860,1700132040,6180,93267,81335,NL,NL
56113,1698893340,1698917400,24060,135738,43141,HU,RS
56014,1700607120,1700622000,14880,73786,141311,US,US
63400,1699737360,1699749360,12000,33020,30621,US,US
134874,1700803860,1700837880,34020,95748,151344,TR,TR
112388,1700671320,1700675280,3960,1203,130736,GB,GB
101177,1700535120,1700552640,17520,36517,42314,US,US
74331,1699585620,1699615320,29700,93682,158207,TR,TR
18464,1699487760,1699493520,5760,57281,9248,NL,NL
12084,1699249440,1699279740,30300,152347,28826,TR,TR
162635,1699103700,1699116300,12600,137557,175157,US,US
4253,1699382160,1699414920,32760,187643,176453,TR,TR
170989,1700398320,1700431800,33480,160585,116975,TR,TR
36651,1699029000,1699062900,33900,19860,104221,TR,TR
177439,1699088640,1699100640,12000,92962,71,US,US
32242,1698838920,1698870420,31500,65968,172362,TR,TR
29927,1700291400,1700324100,32700,128139,116202,TR,TR
142801,1699798500,1699832700,34200,192000,50941,TR,TR
105549,1700856060,1700868240,12180,86369,98631,IT,IT
81354,1700208720,1700213040,4320,153723,108828,GB,GB
115364,1699401660,1699427040,25380,136084,51386,DE,PL
194839,1699375200,1699409580,34380,42572,19341,MX,MX
86813,1699798260,1699828620,30360,194116,122155,TR,RO
137650,1699214280,1699230780,16500,105965,189507,US,US
144777,1700317260,1700320860,3600,77493,62168,GB,GB
16901,1700767920,1700782380,14460,190744,162907,US,US
110300,1700505480,1700541420,35940,42001,59474,TR,TR
96884,1699740720,1699750440,9720,151743,144760,PT,PT
179133,1699052580,1699081560,28980,82240,193093,TR,TR
120243,1699282860,1699298160,15300,148719,69634,US,US
181858,1699964280,1699967880,3600,190923,1515,GB,GB
75986,1699818600,1699849680,31080,33803,50318,TR,TR
99718,1700611260,1700619720,8460,39179,35704,IT,IT
83358,1698973020,1699006140,33120,61066,102143,TR,TR
178652,1699374240,1699387200,12960,115207,180451,US,US
198668,1700422740,1700458020,35280,167376,138768,TR,TR
61885,1700630040,1700648760,18720,40859,48582,FR,FR
63041,1700514900,1700548500,33600,105917,68770,TR,TR
8742,1700397720,1700414040,16320,190518,174784,FR,FR
3110,1700279400,1700332080,52680,30773,54202,BG,AT
82278,1700218860,1700228160,9300,34265,98169,IT,DE
99802,1700335800,1700350380,14580,61937,55624,US,US
37820,1700597160,1700604600,7440,123358,169116,HR,HR
182162,1699247160,1699277460,30300,88993,182039,TR,TR
39722,1699218840,1699248120,29280,67426,98411,TR,TR
161302,1699001820,1699035180,33360,87014,58719,TR,TR
83003,1698972060,1699005900,33840,138309,42945,TR,TR
140542,1699161900,1699175640,13740,197476,23533,AT,AT
174739,1700282640,1700315040,32400,103296,149831,MX,MX
8740,1698940740,1698969180,28440,144771,64283,CH,FR
174427,1700575680,1700611260,35580,189573,125498,TR,TR
98311,1699914360,1699918860,4500,87895,172309,GB,GB
172953,1700539680,1700565600,25920,128489,39158,DE,FR
87008,1700515740,1700545620,29880,181082,64191,TR,TR
142510,1698938280,1698953760,15480,82712,147020,US,US
32863,1699013880,1699044420,30540,13844,93672,TR,TR
185528,1700044320,1700051940,7620,2491,153488,PT,PT
174394,1700647980,1700658720,10740,98910,117489,IT,IT
107486,1699834440,1699842480,8040,851,33834,ES,ES
5882,1700486760,1700522640,35880,190787,142184,TR,TR
134609,1698913800,1698933300,19500,29054,159998,FR,FR
160648,1698838560,1698853440,14880,74562,73578,FR,FR
24007,1700603100,1700616960,13860,148245,120290,ES,AD
28979,1699406700,1699438620,31920,152891,80981,TR,TR
92177,1699386960,1699390560,3600,151968,142145,GB,GB
143675,1700491620,1700522820,31200,72341,158935,TR,TR
157252,1700354820,1700385180,30360,70448,157664,TR,TR
50660,1699212960,1699248540,35580,19051,94391,TR,TR
26948,1699611180,1699627380,16200,83412,55228,US,US
60672,1698950160,1698962580,12420,117166,30401,IT,IT
38163,1699853760,1699870860,17100,120998,125127,US,US
129069,1699366560,1699370160,3600,33276,169370,NL,NL
106051,1698953460,1698969180,15720,5249,35293,US,US
145366,1700050800,1700083560,32760,193713,87608,TR,TR
110603,1699491840,1699505280,13440,41430,128069,CA,CA
169653,1699758000,1699790940,32940,176797,108194,MX,MX
32923,1700038140,1700067480,29340,149698,164090,TR,TR
4883,1699410240,1699441620,31380,160047,177462,TR,TR
82556,1700759340,1700785260,25920,165931,100177,DE,FR
21503,1699722120,1699726980,4860,26736,59580,GB,GB
81367,1700810700,1700826060,15360,171607,35600,US,US
188177,1700335860,1700352060,16200,139940,85870,FR,FR
37960,1699966320,1699999560,33240,13347,115282,TR,TR
181705,1700245080,1700261040,15960,152958,129238,US,US
188074,1698982140,1699019580,37440,97507,3391,MX,MX
100763,1699986420,1699997040,10620,954,12017,ES,ES
105646,1700013600,1700043720,30120,98335,31782,TR,TR
98427,1698919080,1698952440,33360,48168,136482,TR,TR
100659,1699814700,1699821420,6720,181432,148680,NL,NL
59151,1700839620,1700843220,3600,40073,33641,GB,GB
28842,1699790580,1699806840,16260,164619,114833,RS,MK
162663,1699623660,1699657680,34020,121716,125378,TR,TR
56812,1699616820,1699622280,5460,132355,62620,GB,GB
160879,1699654020,1699687320,33300,172781,195900,TR,TR
132951,1699176120,1699188060,11940,12799,109480,PT,DE
129082,1699909560,1699913160,3600,27604,178712,GB,GB
163261,1700092800,1700096400,3600,3756,192846,GB,GB
189197,1699543380,1699560480,17100,113597,76430,US,US
90657,1699597860,1699626960,29100,121848,11171,TR,TR
28487,1699543800,1699560960,17160,195463,116251,US,US
7029,1699417680,1699446780,29100,166676,158700,TR,TR
151717,1700451180,1700475000,23820,131025,54375,RO,MD
146053,1700304840,1700310360,5520,181674,180202,GB,GB
182005,1700349360,1700364720,15360,143561,88145,BE,FR
22722,1700079900,1700087280,7380,50227,89775,IT,IT
141714,1700673000,1700707800,34800,80540,66494,TR,TR
51060,1699163760,1699196880,33120,176881,78930,TR,TR
169982,1699803840,1699833120,29280,30269,16086,TR,TR
85596,1700751600,1700757000,5400,89174,62111,GB,GB
149468,1699910160,1699941720,31560,34629,115868,TR,TR
139766,1699433700,1699456620,22920,69157,163322,PL,PL
3279,1698899580,1698909420,9840,95772,19967,ES,FR
45659,1699259460,1699289760,30300,193251,176348,TR,TR
172910,1700027700,1700036220,8520,116333,39245,IT,IT
50222,1699073160,1699105560,32400,40165,117607,TR,TR
24121,1700677800,1700681400,3600,76488,186419,GB,GB
65469,1699119180,1699152840,33660,13061,18798,MX,MX
93456,1699534800,1699564620,29820,57748,87699,TR,TR
190194,1700670420,1700690040,19620,537,42562,FR,AD
190978,1700478720,1700482320,3600,150764,134087,GB,GB
131069,1698925920,1698940200,14280,84389,171811,US,US
138404,1699153260,1699188660,35400,53644,90072,TR,TR
184118,1699133400,1699140060,6660,4069,17820,GB,GB
115665,1700373300,1700376900,3600,128162,78483,GB,GB
99323,1699154520,1699160700,6180,48835,4237,NL,NL
64667,1700065980,1700096520,30540,23350,113240,TR,TR
101451,1700072460,1700107020,34560,59243,94643,TR,TR
109821,1699069860,1699073460,3600,99591,56089,GB,GB
122104,1699238340,1699241940,3600,24231,7149,NL,NL
138941,1700132040,1700136000,3960,3373,131605,NL,NL
197115,1699025640,1699058580,32940,51539,53428,TR,TR
59332,1698914640,1698941400,26760,115203,189419,BR,BR
187746,1699899240,1699902840,3600,29260,103090,NL,NL
150256,1700405220,1700439360,34140,175483,12456,TR,TR
18668,1700614140,1700648220,34080,183082,35001,TR,TR
190342,1700294640,1700302500,7860,185407,56614,HR,HR
35452,1699587600,1699599360,11760,4687,115941,RS,RS
60863,1700036160,1700040720,4560,74467,90846,NL,NL
81329,1699881720,1699893660,11940,33609,113254,ES,ES
39411,1698813420,1698835980,22560,162551,69439,BR,BR
16610,1699121160,1699133400,12240,187717,77182,SK,AT
110144,1700750100,1700757840,7740,90212,151137,IT,CH
28495,1698835260,1698847500,12240,191054,105332,US,US
136048,1699664040,1699691700,27660,164918,50954,RO,RO
59593,1699856820,1699873920,17100,194147,131154,RS,RS
186952,1699935420,1699939020,3600,49581,91860,NL,FR
124878,1698980520,1698991980,11460,3173,81401,IT,IT
197070,1700441040,1700455080,14040,65822,117204,US,US
78958,1700738640,1700773140,34500,188266,72404,TR,TR
40187,1699140960,1699156140,15180,68938,4245,FR,IT
72242,1700806200,1700812440,6240,8189,67126,GB,GB
37768,1699710060,1699740420,30360,42120,183763,TR,TR
26409,1698928740,1698961860,33120,25028,118719,TR,TR
174486,1700389320,1700423700,34380,167375,159531,TR,TR
152830,1699889340,1699892940,3600,180837,194087,GB,GB
15829,1699570440,1699601940,31500,123238,13189,TR,TR
4589,1699320960,1699354140,33180,143898,116889,TR,TR
23061,1700717160,1700726940,9780,107306,18231,IT,IT
196042,1699031760,1699056000,24240,79767,38758,RO,RO
102732,1700542440,1700546040,3600,63741,15748,GB,GB
100383,1699100160,1699112760,12600,86926,174704,AT,AT
58992,1699366320,1699369920,3600,151427,87373,GB,GB
155693,1700141820,1700176260,34440,191677,120163,TR,TR
126317,1700092020,1700115840,23820,151533,106376,PL,DE
82787,1700130900,1700165940,35040,2043,180792,TR,TR
117980,1699873980,1699878480,4500,48261,90282,GB,GB
191837,1700251980,1700286540,34560,186928,32906,MX,MX
18044,1699254060,1699286340,32280,160111,42186,TR,TR
90180,1700523240,1700526840,3600,123439,132279,NL,NL
149025,1699222860,1699226460,3600,47905,46714,GB,GB
24142,1699380120,1699395360,15240,175939,35861,US,US
51231,1699588740,1699621140,32400,137710,69118,TR,TR
27357,1699171680,1699187460,15780,74868,136014,US,US
147051,1700655240,1700669340,14100,130064,14796,US,US
87295,1699010580,1699040340,29760,48381,168643,TR,TR
174476,1699791960,1699820280,28320,131842,163019,PL,PL
18817,1700309580,1700326980,17400,52293,36069,US,US
172296,1700247600,1700283000,35400,184958,16389,TR,TR
186005,1699751220,1699786620,35400,155975,56656,TR,TR
61677,1699723920,1699755780,31860,135005,83726,TR,TR
118014,1700371740,1700404020,32280,134316,29224,TR,TR
198536,1698813660,1698849480,35820,141416,14981,TR,TR
139663,1699661700,1699665300,3600,157140,122626,GB,GB
127662,1699238220,1699251420,13200,86698,110355,PT,PT
172094,1699784580,1699812840,28260,723,43096,BR,BR
15932,1700611020,1700621820,10800,68270,51987,IT,CH
114821,1698817260,1698851940,34680,134210,174929,TR,TR
22297,1699008180,1699011780,3600,160295,5642,NL,NL
61026,1699117620,1699134780,17160,74739,165525,US,US
108743,1700712120,1700746020,33900,181731,114056,TR,TR
49163,1700733480,1700744340,10860,123257,165070,HR,HR
131333,1699570620,1699583640,13020,18948,140366,US,US
10080,1700190420,1700194680,4260,109842,109411,GB,GB
134681,1699400220,1699407120,6900,174746,56635,NL,NL
176072,1699740720,1699773600,32880,18547,75989,TR,TR
148367,1699621680,1699657260,35580,51325,115943,TR,TR
61755,1698810240,1698822300,12060,117088,112,US,US
56192,1700328480,1700358960,30480,23559,142031,TR,TR
123181,1698880740,1698884340,3600,3182,92902,GB,GB
69767,1700161500,1700176680,15180,135193,94473,AT,AT
57651,1700214600,1700233320,18720,118080,136933,SE,DK
80874,1700303880,1700328660,24780,60483,171169,DE,DE
146861,1699245000,1699271220,26220,178543,167878,DE,DE
103813,1698970860,1698999240,28380,117521,167274,CH,FR
115394,1698874080,1698902040,27960,72109,85205,RO,RO
56467,1699681980,1699693740,11760,199276,140084,ES,ES
179129,1700755020,1700788800,33780,199953,148809,TR,TR
112430,1699152000,1699186080,34080,175934,142784,TR,TR
112961,1700708580,1700718060,9480,188230,53837,IT,DE
2044,1699314840,1699328220,13380,104115,109284,HR,BA
193999,1700172480,1700207760,35280,124528,26720,TR,TR
24762,1699432500,1699456080,23580,11369,197400,DE,FR
73462,1699294320,1699308720,14400,20233,103935,US,US
145436,1700163840,1700181240,17400,123546,177172,US,US
30867,1698881280,1698913620,32340,164811,23607,TR,TR
146579,1700324760,1700337420,12660,72347,120547,IT,IT
77342,1698816240,1698824640,8400,19302,71357,IT,IT
180392,1700092200,1700126100,33900,52927,155378,TR,TR
77085,1699935180,1699964280,29100,171511,31622,TR,TR
145222,1700818080,1700849640,31560,122873,66802,TR,TR
155675,1700094900,1700098500,3600,27302,72861,NL,NL
183161,1698942180,1698948300,6120,157865,140962,CL,CL
163231,1699689720,1699700880,11160,6166,144990,US,US
80431,1700829300,1700846760,17460,31579,191269,US,US
35893,1699686240,1699689840,3600,82293,188869,NL,NL
141208,1698821640,1698830040,8400,153320,189751,IT,IT
141895,1700642760,1700674740,31980,84368,22979,TR,TR
40243,1700008500,1700039040,30540,167145,54741,TR,TR
102779,1699075200,1699107840,32640,11123,40719,TR,TR
83386,1699037940,1699053240,15300,55997,81024,FR,RO
79539,1699376220,1699390740,14520,163471,118369,US,US
133515,1698797820,1698812880,15060,183931,33474,US,US
102393,1699473660,1699489620,15960,52257,110058,SE,SE
44572,1699808040,1699838160,30120,106742,64069,TR,TR
165629,1700423940,1700455320,31380,194118,136046,BA,AT
144594,1699116780,1699128000,11220,165698,185801,US,US
196511,1699813860,1699828440,14580,17784,124753,US,US
112952,1700034840,1700068740,33900,71957,70989,TR,TR
99959,1699141680,1699145280,3600,178157,83889,GB,GB
57253,1700791560,1700827500,35940,179095,14842,TR,TR
117108,1699637520,1699672260,34740,76138,159612,TR,TR
190641,1700521620,1700536800,15180,91400,81268,US,US
52208,1699651920,1699658520,6600,193947,55804,GB,GB
98187,1699397640,1699427400,29760,75320,43287,TR,TR
8790,1700319720,1700330880,11160,128025,120688,US,US
73382,1700547840,1700562780,14940,37858,41932,CA,CA
102448,1699069560,1699102260,32700,101481,100083,TR,TR
57073,1700358720,1700385180,26460,63765,48219,BA,DE
47649,1700547060,1700562840,15780,3293,42284,US,US
17151,1699620480,1699636560,16080,178468,160873,US,US
40615,1700777580,1700787480,9900,173662,153737,IT,DE
189709,1700588040,1700591640,3600,196286,192765,GB,GB
171143,1699720920,1699733580,12660,116489,59047,RS,DE
107507,1699026360,1699040040,13680,26944,34624,US,US
99123,1699432680,1699465980,33300,160443,87588,TR,TR
93030,1700032620,1700047920,15300,166049,146935,US,US
135075,1699686060,1699719720,33660,93880,143104,TR,TR
141137,1699371540,1699384200,12660,29952,67871,IT,IT
117218,1699919580,1699929180,9600,2622,84680,IT,IT
178929,1699624380,1699636200,11820,11332,149070,US,US
163500,1699966920,1699980480,13560,131383,133779,CZ,HU
164805,1700185980,1700219220,33240,6691,137403,TR,TR
63199,1699755600,1699761240,5640,130140,54695,NL,NL
139991,1700815680,1700849940,34260,192339,65966,TR,TR
47129,1700366220,1700371320,5100,154833,107964,NL,NL
142059,1699033440,1699044900,11460,189582,126061,US,CA
38861,1699085580,1699118520,32940,86971,26488,TR,TR
12338,1699773900,1699780260,6360,49707,50583,GB,GB
127753,1700610960,1700621220,10260,126465,164149,IT,IT
1731,1699916640,1699927500,10860,128982,33538,IT,IT
158387,1699889400,1699922100,32700,27256,6973,MX,MX
59967,1700240400,1700266920,26520,60578,159579,DE,RS
75849,1699627140,1699630800,3660,118478,79877,NL,NL
131984,1699251420,1699281840,30420,79665,173477,TR,TR
122352,1700784300,1700815860,31560,152223,32644,BA,HR
101573,1700325780,1700361720,35940,146186,177963,TR,TR
151049,1700506320,1700515140,8820,26756,174651,IT,IT
55574,1700600640,1700604240,3600,35825,56240,NL,NL
81603,1699058640,1699076400,17760,67482,5318,US,US
149486,1700643360,1700663160,19800,22215,141349,FR,FR
181412,1700840280,1700872920,32640,165260,94655,TR,TR
159061,1698818580,1698822180,3600,32673,143662,NL,NL
85188,1699081260,1699096560,15300,45242,33710,US,US
106640,1700752140,1700768160,16020,14956,141556,AT,SK
117095,1700114580,1700124960,10380,19340,181083,HR,BA
43346,1699651500,1699668180,16680,115478,25182,US,US
178753,1700866320,1700881620,15300,182803,53138,SE,DE
160919,1700394480,1700407500,13020,189096,14199,US,US
119234,1699094040,1699106100,12060,140484,141780,US,US
157524,1699064400,1699093080,28680,97796,137068,RO,MD
105855,1699758240,1699766160,7920,25408,135685,IT,IT
4874,1700693280,1700705880,12600,129834,179417,US,US
191274,1699374060,1699383360,9300,84214,28935,ES,ES
84737,1699743300,1699774560,31260,58493,86894,TR,TR
116014,1699997460,1700030700,33240,5849,39911,TR,TR
86542,1700570640,1700582340,11700,51463,68314,US,US
100526,1699206360,1699224060,17700,31717,119611,US,US
101091,1699485480,1699499880,14400,193553,8990,AT,AT
53693,1699824720,1699856280,31560,78183,45310,TR,TR
24040,1699040580,1699053900,13320,95552,71012,PT,PT
185155,1700705580,1700722560,16980,8127,33477,CZ,CZ
132067,1700725740,1700749260,23520,12352,162926,DK,DK
180404,1699654800,1699662780,7980,13006,73766,ES,ES
188184,1700688120,1700717400,29280,184207,190947,TR,TR
141969,1699861740,1699897620,35880,181776,5237,TR,TR
164725,1698854940,1698869640,14700,171831,133210,BE,NL
195267,1700472180,1700505180,33000,3541,118373,TR,TR
178370,1699239780,1699244460,4680,27089,102526,GB,GB
158143,1700741580,1700745180,3600,28925,122414,GB,GB
125109,1699924740,1699955760,31020,71747,192996,TR,TR
84418,1700709900,1700743260,33360,107823,118990,TR,TR
134742,1700012520,1700029380,16860,21989,121282,US,US
31133,1700028360,1700033340,4980,179279,158006,AD,ES
1860,1700241240,1700271060,29820,101943,93585,TR,TR
89086,1699316700,1699327740,11040,169112,191969,US,US
26783,1700283480,1700309640,26160,142223,199697,PL,NL
172831,1699371660,1699403880,32220,112023,138162,TR,TR
125594,1700036580,1700041740,5160,34740,1120,GB,GB
146745,1700733300,1700744220,10920,36034,26542,IT,IT
101931,1699569480,1699599900,30420,110077,5352,TR,TR
23695,1699061400,1699097040,35640,99541,75489,TR,TR
24067,1700864220,1700894460,30240,165896,138023,TR,TR
2489,1699689000,1699700940,11940,60139,76874,US,US
141831,1700709780,1700741220,31440,21088,100531,TR,TR
19419,1699354380,1699378260,23880,198702,26726,BR,BR
167195,1700044440,1700048040,3600,193615,52152,GB,GB
185571,1698795300,1698827820,32520,112120,38450,TR,TR
132864,1699383780,1699416300,32520,159222,74387,TR,TR
128647,1699272360,1699305060,32700,177267,9126,TR,TR
126228,1699395240,1699399620,4380,96666,54652,GB,GB
53392,1700370120,1700382660,12540,105690,162160,IT,IT
27049,1699008840,1699024860,16020,128935,182223,AT,AT
148519,1700402580,1700408820,6240,199224,90183,NL,NL
103311,1700462100,1700471340,9240,173508,46736,HR,HR
43846,1700082120,1700088180,6060,71216,136408,GB,GB
36423,1700766300,1700771580,5280,156681,11117,NL,NL
44549,1699479960,1699512120,32160,102799,83922,TR,TR
53029,1700060520,1700086680,26160,137002,122499,DE,BA
187495,1700616120,1700646840,30720,124314,80238,TR,TR
149107,1700111280,1700114880,3600,101753,89297,GB,GB
4333,1698994500,1698998100,3600,64135,168957,NL,NL
65898,1700734800,1700738400,3600,102888,190296,NL,NL
168585,1700212080,1700218440,6360,81640,140907,EE,EE
176068,1700172480,1700206080,33600,197767,101661,TR,TR
99516,1699659300,1699694520,35220,52677,109262,TR,TR
109677,1699245840,1699258440,12600,54905,115688,US,US
2060,1699548180,1699579200,31020,176236,148214,TR,TR
112597,1698818880,1698850260,31380,62863,81381,TR,TR
166873,1700395800,1700421180,25380,42229,189137,DE,NL
172858,1699226220,1699239480,13260,152397,34280,US,US
146540,1699536360,1699549620,13260,126454,93159,IT,IT
13086,1700309820,1700337780,27960,196321,172190,PL,PL
29623,1698978900,1698990000,11100,116466,124257,IT,IT
8445,1699237980,1699269000,31020,186593,112365,TR,TR
135584,1700816280,1700822580,6300,90353,104532,NL,NL
143657,1698873420,1698889500,16080,77636,128830,US,MX
89886,1699998840,1700002740,3900,110566,46782,GB,GB
5165,1700388600,1700393700,5100,81069,161844,NL,NL
60093,1700520060,1700546880,26820,34385,113896,BR,BR
21641,1700393760,1700430060,36300,61738,47851,MX,MX
90748,1699645380,1699678200,32820,174166,168701,TR,TR
122880,1699873020,1699876620,3600,181742,113408,NL,NL
136511,1698801180,1698804780,3600,26244,74151,GB,GB
124317,1700149200,1700171340,22140,26324,24751,DE,DE
15176,1699939740,1699970280,30540,94858,110618,TR,TR
108457,1699738080,1699752960,14880,64291,118834,US,US
14618,1700199840,1700203440,3600,195392,138890,GB,GB
130990,1700031180,1700059020,27840,165603,108304,DE,DE
85482,1699721760,1699754640,32880,53210,79008,TR,TR
138744,1699754400,1699786020,31620,151071,188294,TR,TR
119610,1700283180,1700294580,11400,72254,146541,HR,HR
148970,1699675260,1699687740,12480,62825,147554,HR,RS
17510,1700011380,1700014980,3600,194329,170757,NL,NL
97621,1700837160,1700875620,38460,79271,67592,MX,US
142318,1700040000,1700063160,23160,77629,68658,DE,FR
95998,1699213740,1699231200,17460,182016,28964,US,US
180740,1699035780,1699065600,29820,156246,57589,TR,TR
196750,1699249920,1699284300,34380,144600,170448,TR,TR
19293,1700728860,1700732700,3840,178670,85808,NL,NL
26933,1699063740,1699078500,14760,86480,163117,US,US
44303,1699061820,1699076400,14580,76500,173544,AT,HU
164806,1698923460,1698955440,31980,127156,157766,TR,TR
151986,1699455360,1699490760,35400,17832,170335,TR,TR
15168,1699118160,1699131480,13320,12899,100362,US,US
88405,1699302600,1699313640,11040,39863,5147,ES,FR
110825,1698881040,1698894360,13320,98158,121371,IT,IT
176618,1700833080,1700862780,29700,159261,103767,TR,TR
49391,1698826380,1698831480,5100,132567,47841,GB,GB
183505,1699874100,1699877700,3600,107660,65877,GB,GB
119383,1700000160,1700011440,11280,144536,12341,US,US
66077,1699420320,1699431060,10740,107257,88634,HR,HR
139795,1700257560,1700264520,6960,139431,13432,NL,NL
176817,1700259720,1700263320,3600,17642,155885,GB,GB
42443,1699931460,1699968660,37200,162548,157906,MX,MX
157333,1700169480,1700184660,15180,9407,82313,FR,FR
120505,1699303260,1699333740,30480,71245,48510,TR,TR
197071,1700281920,1700314860,32940,83794,159763,TR,TR
136370,1698873000,1698876600,3600,122778,84617,GB,GB
163203,1699287480,1699314540,27060,57422,62081,BR,BR
90913,1699794540,1699811760,17220,93612,20279,US,US
22240,1699512780,1699518600,5820,48563,43539,GB,GB
82613,1700259540,1700270100,10560,91168,192991,IT,IT
117207,1700646780,1700650380,3600,176433,33120,NL,NL
90984,1699201680,1699210740,9060,88382,149077,IT,IT
45993,1700819880,1700829600,9720,129962,107620,IT,IT
101547,1699936980,1699947060,10080,25610,18187,HR,ME
52975,1700626500,1700660700,34200,84593,199920,TR,TR
141430,1700071620,1700102100,30480,51636,112723,TR,TR
85371,1699040340,1699074060,33720,23521,74765,TR,TR
153697,1700312400,1700337120,24720,71161,171869,DE,PL
175575,1699104120,1699113000,8880,175538,191223,ES,ES
101165,1700655480,1700690580,35100,128637,63416,TR,TR
149979,1700389140,1700395200,6060,7466,51053,GB,GB
143720,1700488080,1700499900,11820,50457,84909,AT,AT
115841,1699737240,1699740840,3600,47790,168126,GB,GB
127650,1700302260,1700312280,10020,42820,170621,IT,IT
139435,1699867080,1699902780,35700,56840,94186,TR,TR
128801,1698887040,1698895200,8160,19342,34224,PT,PT
163260,1700855340,1700888280,32940,147398,167467,TR,TR
105126,1700641560,1700651160,9600,192434,123702,ES,ES
68983,1699187820,1699192680,4860,80908,32021,GB,GB
104089,1698987360,1699016760,29400,18459,27069,TR,TR
176274,1700095740,1700151120,55380,21113,28003,UA,PL
160891,1699503960,1699512720,8760,91680,46010,IT,IT
30834,1700306160,1700309760,3600,151318,85286,GB,GB
182785,1699532040,1699543440,11400,84950,178582,HR,HR
14166,1700672880,1700702220,29340,81683,187085,TR,TR
65154,1699572120,1699584900,12780,81599,40169,PT,PT
84496,1699835460,1699841040,5580,17880,89947,NL,NL
69467,1699458660,1699462260,3600,5752,115327,NL,NL
173628,1700137560,1700147700,10140,134915,122346,IT,IT
137978,1700704920,1700712120,7200,189150,178357,PT,PT
77917,1699421640,1699452780,31140,82239,140952,TR,TR
190153,1698961920,1698995820,33900,17633,92768,TR,TR
96742,1700461560,1700474640,13080,9067,95432,IT,IT
73556,1700114040,1700130900,16860,168744,150032,US,US
125839,1699159260,1699172880,13620,77155,65811,US,CA
102569,1698851400,1698864000,12600,129538,41634,CA,US
174556,1700087220,1700114160,26940,89109,170036,DE,CZ
178556,1699909020,1699920900,11880,187683,133357,IT,IT
26996,1699659240,1699662840,3600,134312,55628,NL,NL
29255,1699616100,1699632300,16200,38668,171475,FR,FR
112955,1699427040,1699439880,12840,158310,62010,HR,HR
154651,1700197440,1700229840,32400,109128,95599,TR,TR
95411,1698857700,1698879540,21840,158896,3994,PL,PL
159350,1700063520,1700097960,34440,17796,35463,TR,TR
163102,1699750680,1699754280,3600,162079,14214,GB,GB
180496,1699900320,1699930260,29940,48624,147741,TR,TR
19066,1700109600,1700119740,10140,18221,188371,SK,SK
180823,1699643340,1699676580,33240,180848,90697,TR,TR
14401,1700254800,1700258400,3600,182825,103698,GB,GB
169637,1700293860,1700324700,30840,139324,84369,TR,TR
77174,1700454600,1700458200,3600,195700,123380,GB,GB
142738,1698914220,1698947100,32880,50210,169472,TR,TR
154131,1698801180,1698814440,13260,11003,74433,US,US
141886,1700055900,1700063340,7440,117272,30983,IT,IT
172881,1699141980,1699194780,52800,41163,189271,BG,BG
28280,1699694820,1699698420,3600,88212,158111,NL,NL
36439,1699280520,1699293240,12720,151783,60305,US,US
85693,1699835700,1699852620,16920,98044,8666,FR,FR
107907,1700830440,1700845740,15300,86399,143363,FR,FR
116767,1699581720,1699589040,7320,141123,65767,IT,IT
86461,1698983220,1699018680,35460,94409,185226,TR,TR
89043,1700690520,1700697960,7440,171544,61301,HR,AL
7774,1700723100,1700734320,11220,72795,78373,US,US
109660,1699471920,1699485840,13920,44951,3210,US,US
156260,1700448720,1700463000,14280,108682,89075,US,US
44183,1699874280,1699910100,35820,70923,65915,TR,TR
127534,1699408920,1699422960,14040,113930,34512,IT,IT
185520,1699704000,1699737300,33300,27357,31305,TR,TR
112502,1698968220,1698991260,23040,79830,52528,RO,RO
120101,1700050140,1700074680,24540,121767,15534,DE,BG
158539,1698919140,1698941400,22260,169471,106891,BR,BR
82764,1699401840,1699436220,34380,134079,17062,TR,TR
162230,1700397180,1700427360,30180,153056,87789,TR,TR
28289,1699226700,1699238040,11340,78586,27943,US,US
82846,1699374780,1699378380,3600,23324,65501,GB,GB
87142,1699957260,1699964220,6960,81112,39279,GB,GB
63429,1699437180,1699441560,4380,57292,108959,GB,GB
156578,1699958940,1699974660,15720,127101,47540,US,US
6825,1699515960,1699548960,33000,82522,7680,MX,MX
126708,1700277840,1700291820,13980,156712,2475,US,US
152732,1700386800,1700400240,13440,18576,59637,IT,IT
64733,1700329680,1700341080,11400,123346,18807,US,US
62473,1698889440,1698925260,35820,152441,130304,TR,TR
199138,1698987480,1698996900,9420,18266,140539,IT,IT
86554,1700640180,1700653560,13380,89313,100629,IT,IT
34190,1700696640,1700706840,10200,131646,87863,FI,EE
94685,1699485540,1699489140,3600,190392,172937,NL,NL
154503,1700033700,1700037300,3600,54002,148991,NL,NL
136479,1699714860,1699745100,30240,153790,85617,TR,TR
61123,1699628820,1699638900,10080,48922,133362,IT,IT
156768,1700784240,1700797860,13620,150698,191861,AT,AT
178209,1699606860,1699614240,7380,162963,102082,IT,DE
151108,1699132080,1699165140,33060,46347,181092,TR,TR
148327,1699376520,1699390020,13500,97923,88926,AT,HU
35699,1699239960,1699274760,34800,104547,158463,TR,TR
95725,1699168920,1699184760,15840,97750,16495,US,US
26755,1699018140,1699030140,12000,19891,153409,US,US
78044,1698805200,1698814920,9720,118678,97335,HR,HR
156599,1699562460,1699567140,4680,184153,76332,AD,ES
143259,1699162860,1699177200,14340,81179,189352,US,US
79419,1700638440,1700644620,6180,49453,163563,NL,NL
112769,1699349700,1699360620,10920,19839,24122,IT,IT
181274,1699274700,1699305900,31200,62790,187413,TR,TR
82105,1700576280,1700612040,35760,199520,121528,TR,TR
88299,1700149380,1700160420,11040,47985,44709,US,US
103517,1699148160,1699162980,14820,18765,69554,US,US
69567,1699149180,1699179660,30480,134765,119300,TR,TR
128594,1699399800,1699416900,17100,186672,160159,US,US
76179,1698997200,1699008420,11220,126807,119509,IT,IT
51866,1699726140,1699749840,23700,197650,175578,DE,DE
86349,1698795060,1698826200,31140,84010,156049,TR,TR
143790,1700692200,1700723640,31440,167326,57967,TR,TR
11449,1699817280,1699849560,32280,68834,196198,TR,TR
156711,1699084020,1699114380,30360,176438,120674,TR,TR
317,1699341360,1699372560,31200,141992,124254,TR,TR
11868,1699999020,1700032140,33120,62458,170100,TR,TR
14200,1699779420,1699813440,34020,26491,112786,TR,TR
146400,1700829660,1700864220,34560,91412,21572,TR,TR
29384,1700863320,1700897460,34140,184815,145885,TR,TR
72269,1699832280,1699861920,29640,176159,158739,TR,TR
126272,1700801580,1700834220,32640,42778,143755,TR,TR
101298,1700773860,1700827500,53640,78822,13735,BG,DE
87646,1698988080,1698998820,10740,151290,143943,ES,ES
130283,1699847880,1699858740,10860,20091,175850,HR,HR
155505,1699650600,1699662420,11820,109394,138502,IT,IT
197128,1699116180,1699126980,10800,49499,103337,PT,PT
104183,1699775160,1699778760,3600,52785,1775,GB,GB
76723,1698847320,1698859200,11880,114128,117203,RS,RS
71797,1700780280,1700784780,4500,69872,80283,NL,NL
21331,1698894900,1698918240,23340,90598,187952,PL,PL
162933,1699503840,1699539240,35400,169410,30406,MX,MX
141148,1698999960,1699018980,19020,81899,166407,FR,FR
55013,1699269180,1699283340,14160,198341,36718,US,US
181992,1699888440,1699910460,22020,186781,3845,DE,PL
105027,1700311620,1700343420,31800,95730,84217,TR,TR
64495,1700295180,1700312940,17760,40560,195710,US,US
79826,1699464540,1699474380,9840,94765,189124,PT,PT
82004,1700482860,1700512260,29400,50517,184101,TR,TR
189627,1699948320,1699951920,3600,54488,185593,GB,GB
65192,1700496660,1700508000,11340,52245,66972,PT,IT
136740,1699803900,1699807500,3600,136783,16895,GB,GB
73395,1698814980,1698822120,7140,37467,155914,GB,GB
147446,1700858340,1700861940,3600,122611,8022,GB,GB
6786,1700788080,1700791680,3600,119237,175326,GB,GB
86075,1699702980,1699738440,35460,114651,146688,TR,TR
5383,1700559480,1700563080,3600,160270,45168,GB,GB
150563,1699804860,1699815120,10260,86142,2774,ES,ES
138,1699077660,1699095600,17940,185682,108765,SE,PL
167932,1700790000,1700824080,34080,148364,180141,TR,TR
185617,1700197500,1700213640,16140,5315,177209,CA,CA
145988,1699971060,1700001900,30840,113108,98435,TR,TR
56214,1699686540,1699718580,32040,103160,162620,TR,TR
12044,1700499360,1700516580,17220,157313,82935,US,US
85717,1699513140,1699520640,7500,172421,15888,IT,IT
90102,1699929000,1699959660,30660,99729,99456,TR,TR
30982,1699642680,1699652580,9900,65818,34349,PT,PT
109428,1699425540,1699439700,14160,92581,89639,US,US
106618,1699743240,1699750800,7560,180783,17343,IT,IT
164036,1700435700,1700453460,17760,113854,129578,US,US
3519,1700799540,1700811060,11520,45959,10692,PT,PT
35203,1700222760,1700234760,12000,94537,21939,AT,AT
108194,1700173620,1700194440,20820,105576,62766,FR,CZ
123819,1700718840,1700723220,4380,99608,72939,GB,GB
93789,1699707600,1699741320,33720,196306,20115,TR,TR
16797,1699058340,1699070100,11760,103259,34324,PT,PT
42404,1700732580,1700765100,32520,199753,190776,TR,TR
108326,1700626860,1700637660,10800,111914,186549,CZ,CZ
122928,1700171040,1700200380,29340,29991,188356,TR,TR
54948,1700421120,1700432400,11280,68779,159042,PT,PT
30091,1700041440,1700045040,3600,1015,162759,NL,NL
136542,1700203500,1700221200,17700,77883,86128,US,US
141426,1699555320,1699584780,29460,82389,110227,TR,TR
11869,1699231980,1699245540,13560,19025,199475,US,US
24545,1699300020,1699305060,5040,3765,24677,GB,GB
119303,1700817780,1700821380,3600,20275,109685,GB,GB
96386,1700794740,1700814060,19320,114422,26244,FR,FR
20512,1699850760,1699858200,7440,137830,81043,SK,CZ
160654,1699105260,1699138920,33660,99925,119109,MX,MX
76911,1700344980,1700380620,35640,152046,115109,TR,TR
25021,1700089620,1700093220,3600,140416,68092,NL,NL
106276,1700140260,1700172000,31740,90145,172171,TR,TR
16463,1700775840,1700809440,33600,104849,176375,TR,TR
10927,1699361280,1699392540,31260,171188,157079,TR,TR
105209,1699285440,1699303560,18120,142311,80245,FR,FR
195325,1700078400,1700095860,17460,127813,162829,FR,FR
89994,1699537380,1699554240,16860,52667,143329,US,US
128236,1700015460,1700019060,3600,92519,166478,GB,GB
125982,1699280760,1699284360,3600,3843,59738,GB,GB
107234,1699426560,1699462260,35700,195962,15398,TR,TR
189973,1700763060,1700798100,35040,75997,145014,TR,TR
77614,1700602500,1700636460,33960,142539,78958,TR,TR
50921,1699795560,1699827120,31560,106063,26636,TR,TR
169674,1699786440,1699797780,11340,141538,111620,US,US
109116,1699061880,1699065480,3600,20135,189837,GB,GB
73721,1699168680,1699179900,11220,33601,19304,IT,CH
102899,1700234940,1700265120,30180,81253,36086,TR,TR
12234,1700600700,1700629740,29040,150273,172700,TR,TR
26851,1700363760,1700372820,9060,141684,108409,IT,IT
133489,1700541000,1700573040,32040,124629,152317,TR,TR
161720,1699562280,1699590000,27720,77326,146022,CH,DE
154250,1700125800,1700143500,17700,146423,104906,CZ,NO
35908,1700366700,1700397840,31140,177689,1359,TR,TR
129793,1699699560,1699729380,29820,55747,173707,TR,TR
27055,1699704900,1699724040,19140,59398,172794,FR,FR
112105,1700003280,1700006880,3600,140427,118057,GB,GB
107119,1698868500,1698899940,31440,10188,18464,TR,TR
82592,1699731240,1699764240,33000,108329,39648,TR,TR
31650,1699773480,1699806420,32940,30662,188231,MX,MX
40822,1700845980,1700880960,34980,134582,26653,TR,TR
70505,1700344740,1700371440,26700,165829,137330,HU,PL
48196,1699807380,1699865820,58440,97042,6469,UA,DE
167387,1699917540,1699922280,4740,53318,90507,GB,GB
766,1700470380,1700473980,3600,27149,66152,GB,GB
131072,1700346360,1700374200,27840,146870,192737,PL,PL
22438,1700037240,1700066880,29640,157649,156948,TR,TR
133080,1699282440,1699299780,17340,1035,3450,US,US
131390,1700371500,1700385000,13500,82218,33786,US,US
182965,1700806080,1700840340,34260,158360,21640,TR,TR
157566,1700550360,1700584560,34200,32420,43953,TR,TR
24961,1699771320,1699776300,4980,183712,162490,GB,GB
67954,1699273260,1699302840,29580,184681,130701,TR,TR
186892,1700301060,1700336220,35160,48344,89239,TR,TR
35986,1699832580,1699861500,28920,168615,75764,TR,TR
47418,1699720860,1699749900,29040,175472,60651,TR,TR
198140,1700176800,1700233680,56880,72802,130507,BG,TR
85213,1699665240,1699698060,32820,28612,160849,TR,TR
33591,1699182900,1699186500,3600,186230,7774,GB,GB
16945,1698808920,1698839040,30120,199009,179532,TR,TR
169916,1698934380,1698946080,11700,99702,120243,US,US
191104,1699303980,1699307580,3600,73046,187595,NL,NL
174435,1699189920,1699198980,9060,171512,90274,EE,FI
156986,1700811480,1700842560,31080,101180,163722,TR,TR
159915,1699815060,1699849140,34080,196098,20191,TR,TR
49620,1700508120,1700522340,14220,105790,182818,ES,RO
125741,1700498220,1700501820,3600,22075,102913,GB,GB
121293,1699663560,1699683720,20160,159987,35095,FR,FR
183356,1699485600,1699489200,3600,46638,178894,GB,GB
38884,1700611320,1700645520,34200,147416,87444,TR,TR
155855,1700631180,1700662440,31260,60757,31374,TR,TR
95237,1699191240,1699207320,16080,11008,82657,US,US
311,1700660940,1700664540,3600,107202,110041,GB,GB
40960,1700808120,1700815920,7800,192786,134247,AD,ES
11355,1699499280,1699533720,34440,137916,124012,TR,TR
101591,1700562660,1700580060,17400,97249,83628,US,US
55325,1700138820,1700142420,3600,135097,7112,NL,NL
85048,1699621500,1699649040,27540,101902,13961,BR,BR
193918,1698965640,1698979380,13740,73653,10751,US,US
98940,1700398140,1700410680,12540,140215,24918,US,US
8180,1699369560,1699383540,13980,98243,173328,US,US
93424,1699887420,1699918200,30780,107207,46923,TR,TR
167056,1699916280,1699929120,12840,120345,30314,ES,ES
131484,1700363400,1700389740,26340,89610,17675,PL,DE
185253,1699015620,1699044960,29340,161216,55165,TR,TR
162435,1699411680,1699415280,3600,46001,192933,GB,GB
127331,1699907280,1699923240,15960,182028,170955,US,US
64127,1700775240,1700792820,17580,169477,50075,US,US
197655,1699770960,1699778040,7080,183375,61746,GB,GB
188050,1699499820,1699514340,14520,138825,65513,BE,NL
18189,1699804860,1699819320,14460,50546,90619,US,US
118191,1699540500,1699554300,13800,198561,104936,IT,IT
176933,1700807100,1700858760,51660,97605,134698,BG,DE
174481,1699082520,1699114500,31980,115273,78664,TR,TR
8859,1699372860,1699427760,54900,159588,85803,BG,DE
13254,1699635540,1699639140,3600,147608,125058,NL,NL
86645,1700036940,1700047920,10980,175718,187471,IT,IT
87416,1700513340,1700572440,59100,165244,7215,UA,PL
63641,1699187160,1699198740,11580,34070,187492,US,MX
34618,1700530800,1700559660,28860,120322,114714,TR,TR
191746,1700213460,1700231820,18360,187928,29371,DK,DK
168712,1699285920,1699299060,13140,284,112152,US,US
144412,1699302420,1699306020,3600,19880,11361,GB,GB
115961,1699843260,1699860000,16740,36768,178751,BE,FR
47942,1699639380,1699672920,33540,65189,146105,TR,TR
82130,1700550420,1700580960,30540,48760,198194,TR,TR
64063,1699367640,1699396620,28980,90605,69408,TR,TR
161938,1700141940,1700151300,9360,124301,38604,IT,IT
105077,1699928040,1699941780,13740,6326,166537,US,US
111274,1699587060,1699618020,30960,170628,185563,TR,TR
147813,1699348140,1699399260,51120,12549,11294,BG,AT
23247,1699934220,1699946880,12660,124371,171073,IT,IT
145489,1699044720,1699048320,3600,18698,29869,NL,NL
127363,1700077500,1700081100,3600,138695,42668,GB,GB
122471,1699174080,1699207320,33240,6278,41698,TR,TR
171516,1699879320,1699894020,14700,65,41270,US,US
77587,1700590740,1700623860,33120,60962,89990,TR,TR
123666,1700627400,1700645340,17940,164396,102062,FR,NL
172404,1699135440,1699171200,35760,44343,177089,TR,TR
14937,1700094120,1700128320,34200,103900,196552,TR,TR
127148,1699867740,1699884540,16800,22073,186129,US,US
155738,1699551780,1699555380,3600,51936,122712,GB,GB
127234,1700470260,1700477280,7020,865,197762,GB,GB
107887,1699650360,1699666200,15840,685,91458,CZ,CZ
187561,1699731240,1699734840,3600,73594,175266,NL,NL
130000,1699484640,1699505940,21300,93730,181062,FR,FR
144931,1700332320,1700347500,15180,57895,32687,US,US
105133,1698811320,1698832020,20700,16419,171739,FR,FR
128276,1700631060,1700660460,29400,56467,79597,TR,TR
25969,1699373400,1699397280,23880,158945,17423,PL,DE
22662,1698919320,1698922920,3600,68869,56946,GB,GB
47495,1700538780,1700571780,33000,175386,122308,TR,TR
163038,1699592820,1699606860,14040,89785,65709,SK,SK
99635,1699086780,1699119660,32880,5379,13741,TR,TR
121691,1699930860,1699965060,34200,125892,63481,TR,TR
154507,1700292480,1700296080,3600,51342,184312,GB,GB
92816,1699693440,1699707420,13980,81543,92161,AT,AT
123432,1699124460,1699135560,11100,6489,190121,IT,IT
150618,1700303580,1700338320,34740,89558,11469,TR,TR
22271,1699006500,1699029840,23340,147012,152855,DE,HR
72337,1700417700,1700426700,9000,135567,176178,HR,HR
39056,1699380540,1699385220,4680,124512,2337,GB,GB
92639,1700359020,1700391420,32400,78925,160225,TR,TR
174899,1699101900,1699105500,3600,91390,169148,NL,NL
22759,1698832860,1698867180,34320,42226,179936,TR,TR
149474,1699190340,1699225020,34680,51809,111568,TR,TR
35802,1699261140,1699277280,16140,161506,199821,AT,HU
81813,1700028840,1700043240,14400,111124,116290,CZ,CZ
173463,1699892760,1699926240,33480,186401,127764,TR,TR
12809,1698819720,1698829440,9720,125384,142792,IT,IT
106259,1699135500,1699146480,10980,113337,57349,HR,HR
181837,1700442120,1700453460,11340,171043,198280,IT,IT
105519,1699669380,1699703760,34380,126852,133847,TR,TR
143327,1700284500,1700297580,13080,149332,43100,US,US
8347,1700023080,1700057520,34440,165070,87892,TR,TR
195868,1699160640,1699173480,12840,147763,103644,IT,IT
148467,1699747080,1699781640,34560,168376,104167,TR,TR
1068,1699310040,1699346280,36240,196545,185622,MX,MX
4270,1700576280,1700588700,12420,102929,23639,IT,IT
15753,1700059740,1700066160,6420,116562,81634,GB,GB
95441,1700583540,1700600100,16560,95073,157262,US,US
180032,1700509680,1700544360,34680,139465,69308,MX,MX
14998,1700407860,1700420580,12720,61341,94762,US,US
105665,1700572020,1700575620,3600,71902,82580,GB,GB
125550,1698979380,1698994140,14760,89111,156559,CZ,CZ
141251,1699058760,1699097940,39180,134228,97221,MX,MX
74859,1699847940,1699867020,19080,54678,20822,BE,NL
3622,1699040280,1699043880,3600,51281,130025,GB,GB
88135,1700229540,1700259120,29580,89594,19402,TR,TR
131548,1699388220,1699404120,15900,98195,66833,US,US
174221,1700554560,1700574480,19920,147126,13903,FR,FR
81885,1699680480,1699684260,3780,124603,60787,GB,GB
1785,1700504400,1700522220,17820,138292,20166,CA,US
124696,1699234800,1699238820,4020,178726,31560,GB,GB
157194,1698903180,1698917700,14520,164517,57477,US,US
37518,1699699680,1699724400,24720,195515,119974,DE,FR
69064,1699353180,1699359480,6300,116535,93559,GB,GB
164909,1699862580,1699866180,3600,21335,53198,GB,GB
196166,1699422660,1699432560,9900,9064,86293,EE,EE
119939,1699282800,1699294320,11520,175788,137428,IT,IT
21832,1699729620,1699744500,14880,21390,141900,AT,BG
143936,1700692560,1700696160,3600,39294,71272,NL,NL
71707,1699008480,1699014840,6360,130847,46172,NL,FR
1696,1700822520,1700848140,25620,12403,162264,DE,IT
86055,1698935700,1698971340,35640,120449,50057,MX,MX
35636,1698884100,1698890580,6480,44282,138829,NL,NL
144274,1700358720,1700370060,11340,76274,179765,AT,DE
124579,1700276160,1700287200,11040,62285,23680,US,US
136665,1699352160,1699388040,35880,167294,34006,TR,TR
183545,1700609640,1700637600,27960,112642,126686,DE,SE
30753,1700388840,1700401680,12840,36247,26995,US,US
136180,1699378560,1699395120,16560,12563,119115,RS,RS
192601,1700597460,1700629020,31560,15934,68539,TR,TR
85682,1700611980,1700643780,31800,167447,10065,TR,TR
44007,1698875940,1698881880,5940,60542,114857,GB,GB
158348,1699702560,1699706160,3600,75028,120612,GB,GB
178419,1699508400,1699519620,11220,146728,133827,PT,PT
110470,1698943440,1698963000,19560,89508,24604,BE,NL
73192,1700264160,1700299620,35460,170888,8972,TR,TR
165908,1700286720,1700297760,11040,99657,89011,AT,AT
71189,1699189860,1699225620,35760,67713,176668,TR,TR
197821,1699386180,1699399260,13080,45139,54501,US,US
106740,1698986760,1698990360,3600,62784,131943,NL,DE
127938,1699100340,1699131240,30900,113275,8582,TR,TR
147400,1699242600,1699246200,3600,62794,71239,GB,GB
110687,1700409960,1700413800,3840,24007,47440,GB,GB
127214,1700578740,1700614080,35340,121234,138682,TR,TR
80223,1700016540,1700051040,34500,79807,188004,TR,TR
75521,1700649780,1700685600,35820,92436,87005,TR,TR
193431,1699460640,1699490040,29400,86439,175804,TR,TR
64975,1699616940,1699620540,3600,159430,198302,NL,NL
105066,1700525400,1700531340,5940,78410,51920,NL,NL
29677,1699429800,1699440720,10920,138623,193650,IT,IT
34475,1699325400,1699329000,3600,168635,24812,NL,NL
65856,1700629620,1700663820,34200,92994,138870,TR,TR
140860,1700635800,1700669460,33660,72431,59036,MX,MX
24239,1700013180,1700044380,31200,165492,122443,TR,TR
83049,1699413000,1699437900,24900,13449,75432,DE,HR
12600,1698942660,1698954240,11580,46238,6908,AT,SK
30352,1700114940,1700120880,5940,141784,197858,GB,GB
94488,1700247120,1700269320,22200,178455,166690,BR,BR
103303,1699748100,1699772760,24660,160980,112342,DE,PL
162392,1699319580,1699354380,34800,29792,104535,MX,MX
191938,1698937920,1698968820,30900,10025,38562,TR,TR
83140,1700485620,1700520300,34680,122816,155917,TR,TR
179922,1698896100,1698904380,8280,15758,165772,IT,IT
171560,1699735920,1699739520,3600,35472,115104,GB,GB
130051,1700329020,1700385300,56280,15636,16215,UA,PL
45067,1698861060,1698879180,18120,137099,27831,FR,FR
173070,1700077020,1700110380,33360,69573,120931,TR,TR
146393,1700740740,1700775300,34560,17454,163020,TR,TR
167432,1699901280,1699905840,4560,194067,98852,NL,NL
104362,1699855440,1699887840,32400,103903,168316,TR,TR
192193,1700492880,1700521680,28800,58083,162165,TR,TR
102369,1699666020,1699681440,15420,123082,168940,US,US
111294,1700669160,1700672760,3600,2171,6291,GB,GB
77006,1699473360,1699485240,11880,44100,68195,AT,AT
61422,1699016640,1699044780,28140,197067,178920,CH,IT
106758,1699097940,1699129560,31620,141752,77782,TR,TR
53835,1699413720,1699417320,3600,50940,193671,NL,BE
75866,1700016840,1700027100,10260,73499,6530,IT,IT
89183,1699054380,1699086540,32160,35911,71225,TR,TR
49552,1700558160,1700592240,34080,120249,80316,TR,TR
55580,1700622060,1700656860,34800,199561,195572,TR,TR
161025,1699361340,1699396080,34740,97403,48847,TR,TR
158223,1699604160,1699610940,6780,73615,122328,GB,GB
115597,1700486160,1700498280,12120,173619,164452,US,US
94930,1700783820,1700815620,31800,148906,188347,TR,TR
60090,1699482720,1699506780,24060,82426,37851,PL,PL
127423,1700633340,1700637540,4200,193817,59258,GB,GB
35355,1699693800,1699706940,13140,129191,95928,US,US
91978,1699926960,1699938840,11880,113087,152948,IT,IT
80063,1699917300,1699929180,11880,154099,52934,IT,IT
174078,1699291080,1699321380,30300,76521,127820,TR,TR
51057,1699008420,1699044780,36360,47058,86821,MX,MX
71275,1699580280,1699613100,32820,57818,152188,TR,TR
88055,1699845480,1699851720,6240,99350,84586,FI,EE
130781,1699011540,1699043880,32340,31388,168464,TR,TR
56949,1699413240,1699425900,12660,47225,16442,IT,IT
106445,1700699820,1700732640,32820,126936,103499,TR,TR
68798,1699791660,1699827240,35580,109182,46182,TR,TR
86965,1700462160,1700479740,17580,188088,129683,US,US
38225,1699325820,1699332180,6360,149566,124636,NL,NL
185663,1700689620,1700707380,17760,55835,106434,US,US
133850,1698852120,1698856800,4680,88129,85546,NL,NL
190830,1698834480,1698863880,29400,33586,73914,TR,TR
174713,1700550060,1700553660,3600,141104,137689,GB,GB
169187,1699190100,1699206900,16800,74625,171480,US,US
173309,1700187720,1700214780,27060,51459,14253,DE,DE
10097,1699702800,1699736700,33900,143908,47955,TR,TR
158967,1699903800,1699925940,22140,68265,24152,DE,AT
75590,1699557420,1699561020,3600,195869,70876,NL,NL
105373,1699368120,1699381020,12900,63208,68079,IT,IT
144506,1698999240,1699034640,35400,196891,51426,TR,TR
172269,1700060520,1700087460,26940,122394,105792,DE,DE
137330,1699331940,1699340040,8100,23724,193433,IT,IT
82170,1699145940,1699150560,4620,113282,138192,GB,GB
1883,1700031240,1700060400,29160,72134,173221,TR,TR
73919,1700322480,1700331540,9060,32156,72293,IT,IT
191393,1700835060,1700859720,24660,3555,164527,DE,CZ
1398,1698876720,1698886260,9540,53408,53418,HR,HR
10265,1700667660,1700671260,3600,82901,156090,NL,NL
82831,1699984140,1700000700,16560,164373,58802,US,US
154026,1700262120,1700269620,7500,60102,98094,IT,IT
173434,1699557780,1699580220,22440,617,5014,BR,BR
124042,1699679640,1699683240,3600,172036,46734,NL,NL
164942,1700836560,1700848020,11460,62232,54794,IT,IT
4504,1699384140,1699416000,31860,27652,67312,TR,TR
22061,1699155900,1699160580,4680,194687,27173,GB,GB
43425,1698843660,1698876600,32940,181430,32204,MX,MX
144333,1699125180,1699159560,34380,28634,87024,TR,TR
92245,1700064660,1700070000,5340,83055,139698,GB,GB
136474,1699316880,1699320480,3600,174456,177785,NL,NL
125789,1699150500,1699156980,6480,189032,188025,GB,GB
178258,1699543320,1699569300,25980,46720,67001,PL,AT
147155,1700245920,1700275140,29220,85243,171993,TR,TR
15089,1700325840,1700336280,10440,74577,48230,IT,IT
23776,1699971060,1699977720,6660,15353,75360,GB,GB
110868,1700531160,1700542500,11340,161293,84292,RS,DE
143282,1699892100,1699895700,3600,91649,53399,GB,GB
8134,1699963440,1699977060,13620,44569,194452,US,US
129884,1700748240,1700764680,16440,72242,152718,US,US
88147,1700104860,1700113380,8520,154153,21838,ES,ES
101027,1699933140,1699968360,35220,125178,53519,TR,TR
84172,1698800580,1698816300,15720,62848,156813,FR,FR
66912,1699499280,1699534200,34920,133400,187211,TR,TR
131730,1700843160,1700852820,9660,67132,176377,IT,IT
56134,1699182240,1699187700,5460,115111,158853,GB,GB
18823,1700199000,1700212860,13860,147310,4592,US,US
120156,1698987780,1699003380,15600,82370,61093,FR,FR
143290,1698947340,1698978420,31080,179614,122615,TR,TR
83100,1699600800,1699614060,13260,2344,95493,AT,SK
117604,1700862720,1700892300,29580,2561,56098,TR,TR
63590,1700211720,1700225340,13620,89374,109679,US,US
57235,1700698740,1700713260,14520,89279,8202,US,CA
53353,1699186080,1699197780,11700,29936,45612,US,US
80517,1700507400,1700511120,3720,40726,125809,CL,CL
12452,1700305020,1700329200,24180,58037,49774,DE,PL
34065,1700463180,1700476500,13320,48737,37669,US,MX
118455,1700561460,1700591640,30180,9658,88866,TR,TR
139059,1700010000,1700020560,10560,63927,53250,IT,IT
100681,1699949520,1699953120,3600,12309,11426,GB,GB
174093,1699656300,1699666080,9780,189378,112620,IT,IT
97206,1699820820,1699833600,12780,160091,193040,IT,IT
86274,1700710740,1700740980,30240,107642,10407,TR,TR
136545,1699635360,1699664400,29040,133599,43529,TR,TR
130752,1699363860,1699373520,9660,13384,152592,IT,IT
32792,1700295180,1700326740,31560,91785,11051,TR,TR
175962,1699210740,1699214340,3600,59169,153043,GB,GB
142306,1699995240,1699999500,4260,130835,32017,NL,PL
193130,1700302500,1700332620,30120,4941,183185,TR,TR
25625,1699856640,1699863840,7200,79879,119920,HR,HR
173975,1698988440,1699014900,26460,173300,136709,DE,DE
76861,1699198320,1699215420,17100,153722,115436,CA,US
81286,1699798860,1699813200,14340,193178,87062,IT,IT
109505,1700231760,1700239680,7920,80609,78419,SK,SK
76635,1699351860,1699364700,12840,99651,160122,PT,PT
183300,1699110600,1699141920,31320,148005,117227,TR,TR
75832,1699107120,1699111440,4320,68948,172454,GB,GB
64805,1699449480,1699464120,14640,169591,51926,US,US
47622,1699376580,1699405020,28440,67668,126536,NO,PL
196754,1699531560,1699560840,29280,173921,122277,TR,TR
166804,1700791980,1700814900,22920,18024,88970,DE,FR
175344,1698876420,1698902340,25920,135768,22495,PL,PL
100767,1698801300,1698862320,61020,55669,147947,UA,PL
174587,1698815160,1698818760,3600,167484,156156,GB,GB
85667,1699039680,1699054620,14940,182170,114598,US,US
79340,1699598460,1699606560,8100,138946,197739,IT,IT
148187,1699676340,1699711200,34860,17950,18704,TR,TR
94078,1699410420,1699445760,35340,179162,190844,TR,TR
156021,1700220720,1700235480,14760,24423,153154,US,US
68627,1700824440,1700828040,3600,124842,3767,GB,GB
148158,1700372640,1700405160,32520,54433,15422,TR,TR
14199,1698818400,1698853440,35040,178633,71587,TR,TR
18400,1698970560,1699003380,32820,152760,24699,TR,TR
51953,1700017860,1700032440,14580,126387,95350,US,US
6219,1698866700,1698872640,5940,175897,75049,NL,NL
7124,1700665920,1700669520,3600,180552,112900,GB,GB
59398,1700735940,1700764740,28800,8577,112529,TR,TR
132261,1700771040,1700802000,30960,133995,119819,TR,TR
88999,1699995120,1700025660,30540,158983,19383,TR,TR
4821,1698988800,1699017420,28620,33412,33723,PL,PL
163473,1699416360,1699425300,8940,13601,139144,HR,HR
147058,1700766240,1700772720,6480,124706,192288,GB,GB
125236,1698910200,1698924000,13800,38848,17723,US,US
46326,1699056180,1699091400,35220,10771,102265,TR,TR
147398,1699606620,1699610220,3600,172177,151606,GB,GB
144756,1700200800,1700233560,32760,25465,6593,TR,TR
40520,1700113200,1700116800,3600,131921,21123,GB,GB
132462,1700334840,1700338500,3660,138542,112002,AD,ES
90937,1699611840,1699617420,5580,133097,149759,NL,NL
31513,1698898740,1698930060,31320,143166,111375,TR,TR
91488,1700655180,1700694420,39240,127001,161443,MX,MX
14095,1700014680,1700030700,16020,135132,187924,US,US
71322,1700467440,1700498760,31320,24739,64352,TR,TR
109857,1699515420,1699530060,14640,102997,41210,FR,FR
102571,1700376300,1700389080,12780,55971,185502,US,US
173562,1698900360,1698932520,32160,131738,67367,TR,TR
95980,1698976020,1699005300,29280,20029,147551,TR,TR
134917,1700565720,1700580720,15000,58727,107374,FR,ES
57664,1699349220,1699380000,30780,164072,51408,TR,TR
156969,1700028540,1700061720,33180,82022,94278,TR,TR
40629,1699033380,1699038000,4620,20152,165399,GB,GB
101935,1699674360,1699704780,30420,144598,98143,TR,TR
81413,1699802580,1699813500,10920,165496,145307,HR,HR
126897,1699689120,1699699500,10380,142605,149810,HR,HR
29914,1698874260,1698887400,13140,109961,163407,IT,IT
59306,1700288880,1700321340,32460,89942,150557,TR,TR
107073,1700343060,1700376660,33600,21380,28107,TR,TR
108444,1699579500,1699597320,17820,176368,117993,US,US
108875,1700498460,1700534280,35820,35024,126676,TR,TR
88360,1699927920,1699934160,6240,183692,150480,GB,GB
155468,1699893600,1699906020,12420,175435,133740,IT,IT
8377,1699695780,1699709700,13920,59941,94733,IT,IT
106274,1699519440,1699548540,29100,8405,168283,TR,TR
106045,1699997160,1700026380,29220,166105,151108,TR,TR
193425,1699165260,1699181160,15900,76869,194703,US,US
101598,1700771700,1700792160,20460,30721,19764,BE,NL
31082,1700154660,1700166840,12180,17073,149440,HR,DE
114895,1700619780,1700655240,35460,101378,192808,TR,TR
15258,1698940860,1698971340,30480,4748,40739,TR,TR
75274,1699215960,1699219560,3600,126857,11894,GB,GB
37356,1699071840,1699104600,32760,148642,82013,TR,TR
100781,1698873960,1698887880,13920,162147,65087,IT,IT
74894,1698967560,1698973920,6360,63233,75791,GB,GB
160921,1699100280,1699111800,11520,89205,139662,SK,SK
82609,1699665060,1699688400,23340,1925,72024,DE,DE
28909,1699460400,1699476000,15600,66920,64725,AT,BG
130374,1699944060,1699958640,14580,168665,192701,FR,ES
78302,1700331060,1700342520,11460,140936,157703,IT,IT
21247,1699055100,1699087320,32220,50829,151234,TR,TR
54187,1700687580,1700722080,34500,134199,148454,TR,TR
196344,1700145660,1700178660,33000,184913,52470,TR,TR
46900,1699796100,1699823940,27840,25766,38622,RO,RO
183364,1700262060,1700291040,28980,170755,160006,TR,TR
47963,1700762760,1700776200,13440,40026,26092,US,US
153074,1700201100,1700235180,34080,187385,198922,TR,TR
187399,1700194320,1700218800,24480,152413,100838,NO,SE
7350,1699485000,1699497000,12000,10360,146199,ES,ES
120270,1700181960,1700187540,5580,54743,19164,GB,GB
152216,1698957420,1698970980,13560,106923,155881,US,US
194535,1699686420,1699701720,15300,13732,89036,CZ,CZ
196271,1700491560,1700517960,26400,129985,194091,PL,PL
172712,1699077060,1699109460,32400,133864,7753,TR,TR
12952,1699324260,1699335240,10980,195497,138448,IT,IT
62777,1700036220,1700042460,6240,108429,142855,GB,GB
26020,1699416360,1699449480,33120,108734,194335,TR,TR
188348,1700807640,1700812200,4560,47452,29836,GB,GB
17020,1700104920,1700118540,13620,64178,111368,HR,HR
146830,1700260500,1700276400,15900,16858,113032,US,US
14936,1699976760,1700011500,34740,60918,101966,TR,TR
17281,1700115420,1700147160,31740,127102,40560,TR,TR
82533,1699354920,1699359960,5040,187790,21940,NL,NL
122860,1698961020,1698977340,16320,5816,128097,US,US
9332,1700510400,1700523780,13380,101366,21914,US,US
181753,1698801840,1698822540,20700,87274,129414,FR,FR
92602,1699408980,1699432380,23400,153122,146515,PL,PL
163644,1700437320,1700449380,12060,178190,78980,US,US
134984,1699459740,1699492740,33000,87835,40155,TR,TR
33601,1699822980,1699826580,3600,119951,182476,GB,GB
45772,1700662320,1700667360,5040,132747,176116,CL,CL
155583,1698834180,1698837780,3600,68930,39478,GB,GB
93389,1699130940,1699144200,13260,179063,25935,AT,AT
39072,1699558620,1699576080,17460,121340,170804,US,US
98141,1700407200,1700418300,11100,26197,63289,PT,PT
148801,1700245560,1700261160,15600,26179,96758,CZ,CZ
196719,1700682240,1700713080,30840,4055,144638,TR,TR
147763,1699578360,1699608660,30300,190019,16923,TR,TR
75599,1700253540,1700278560,25020,91286,157193,DE,DE
120986,1700196420,1700227020,30600,178513,18314,TR,TR
110190,1698867180,1698902760,35580,77204,54984,TR,TR
62640,1699833960,1699868160,34200,72207,160323,TR,TR
94360,1698931680,1698945960,14280,161598,181777,US,US
101668,1700051340,1700065320,13980,134489,124231,PT,PT
11223,1700141340,1700144940,3600,145352,6687,GB,GB
29453,1699883940,1699901640,17700,45707,45337,US,US
160105,1698827580,1698831180,3600,178545,103919,NL,NL
114590,1700250960,1700258220,7260,139881,60230,PT,PT
75325,1699415280,1699419900,4620,145501,14311,GB,GB
15574,1700849220,1700853120,3900,71000,37975,NL,NL
131344,1699478760,1699494720,15960,188092,123489,CA,US
151502,1699561200,1699595400,34200,104117,175595,TR,TR
7368,1700558340,1700568180,9840,180875,191780,SK,CZ
53241,1700202180,1700216940,14760,22556,82292,US,US
63727,1700675880,1700708580,32700,83054,93394,TR,TR
145152,1700220000,1700254380,34380,26055,101687,TR,TR
198609,1700186880,1700218860,31980,6890,64049,TR,TR
166738,1699465620,1699498440,32820,117727,191800,TR,TR
35616,1699969380,1700001360,31980,34671,195265,TR,TR
99544,1700452140,1700464500,12360,158413,11913,US,US
26154,1700204580,1700226300,21720,16030,58009,HU,DE
157208,1700277960,1700289240,11280,105710,127381,IT,IT
68948,1700159160,1700192460,33300,52051,153172,TR,TR
18047,1699443060,1699459680,16620,152132,1536,AT,BA
109202,1700008020,1700041620,33600,28502,25902,MX,MX
193615,1700288040,1700319660,31620,131291,8701,TR,TR
126682,1699712400,1699744260,31860,85202,180519,TR,TR
98406,1699106580,1699122840,16260,4716,104466,US,US
109367,1699514280,1699542480,28200,819,91923,DE,DE
175564,1699208280,1699211880,3600,138004,196243,GB,GB
133239,1699930680,1699961940,31260,66989,115702,TR,TR
154742,1698835920,1698846900,10980,114650,147246,IT,IT
62843,1698994980,1699019520,24540,138754,69708,ME,HR
85577,1699286820,1699291500,4680,3136,56529,NL,NL
40890,1698850320,1698883020,32700,87135,41389,TR,TR
103344,1699115100,1699130880,15780,166967,162707,FR,FR
95831,1699630380,1699662360,31980,100790,188600,TR,TR
165900,1699692720,1699707300,14580,11830,54174,US,US
38927,1699986900,1700011860,24960,37203,181911,DE,HR
161819,1699037280,1699044780,7500,111334,77633,ES,ES
55372,1700010840,1700023200,12360,167194,6306,US,US
91626,1700282880,1700315580,32700,137231,166027,TR,TR
196403,1699925280,1699928880,3600,182589,83111,NL,NL
167943,1699009980,1699031700,21720,41694,120482,ME,RS
175398,1699073340,1699107540,34200,170146,97017,TR,TR
118062,1699920900,1699954680,33780,39483,49117,MX,MX
117634,1698854220,1698859980,5760,150080,65949,NL,NL
160036,1699722240,1699747620,25380,35355,63019,HU,PL
13506,1700364720,1700403780,39060,11901,188935,MX,MX
159857,1700449680,1700478660,28980,147905,51113,TR,TR
54651,1700340060,1700374320,34260,144065,141287,TR,TR
37908,1698928680,1698956760,28080,22696,190210,DE,DE
8025,1699072620,1699081740,9120,20820,65239,PT,PT
148019,1699695900,1699729380,33480,88856,154904,TR,TR
121715,1700371320,1700386080,14760,32269,5306,FR,AD
81212,1699091940,1699106580,14640,153187,123920,CZ,CZ
87300,1699366200,1699397640,31440,171181,67580,TR,TR
25852,1699557780,1699592580,34800,55587,41969,TR,TR
25479,1699172460,1699176180,3720,180017,59606,EE,EE
96898,1699942020,1699953060,11040,164334,86397,PT,PT
135187,1699082880,1699093560,10680,15737,82514,HR,HR
148920,1699929240,1699962000,32760,163901,32008,TR,TR
22230,1699440660,1699475100,34440,26563,166244,TR,TR
88843,1700341920,1700371440,29520,9010,19543,TR,TR
36576,1698911940,1698926460,14520,31021,84748,CZ,CZ
71096,1699110840,1699129560,18720,29342,146613,FR,FR
99916,1699066320,1699069920,3600,104540,37311,NL,NL
138484,1698944580,1698948180,3600,47635,143106,GB,GB
94470,1700410020,1700421960,11940,37824,146917,SK,SK
30423,1699585500,1699621440,35940,96511,38791,TR,TR
108001,1700416380,1700451600,35220,105856,22614,TR,TR
97293,1699236900,1699254660,17760,111123,198131,US,US
132100,1699220820,1699230300,9480,43815,172331,ES,ES
21410,1700759940,1700788500,28560,37886,19125,DE,IT
25545,1699599840,1699603440,3600,12803,196099,GB,GB
68628,1700328480,1700358420,29940,48870,100660,TR,TR
16345,1700834820,1700844720,9900,57978,183514,IT,IT
130064,1699376040,1699387260,11220,183939,30383,US,US
183583,1699589340,1699622940,33600,196154,170167,TR,TR
102787,1699774200,1699780920,6720,82812,48438,NL,NL
164623,1700812320,1700823240,10920,5328,30710,ES,ES
4344,1698990420,1699018740,28320,25671,196301,PL,UA
62626,1699526220,1699529820,3600,173281,149465,GB,GB
862,1699917840,1699943160,25320,32138,57328,DE,DE
22303,1700300880,1700314920,14040,4140,41572,AT,DE
7920,1700859480,1700891760,32280,17963,86245,TR,TR
199545,1700554740,1700578080,23340,142276,140891,BR,BR
37064,1699034100,1699068120,34020,156860,115164,TR,TR
14695,1699562820,1699566420,3600,73772,536,GB,GB
183625,1699335060,1699365060,30000,175430,159829,TR,TR
126545,1700326080,1700351160,25080,175581,24814,CH,FR
176636,1700729520,1700746260,16740,196657,148668,RS,RS
105721,1699347420,1699351020,3600,73597,96551,GB,GB
69276,1699527180,1699560480,33300,64467,38213,TR,TR
114533,1699352640,1699380720,28080,189187,168403,RO,AT
180148,1699780860,1699791960,11100,155743,97496,PT,ES
168024,1699804200,1699812660,8460,23527,144864,IT,IT
65182,1700208540,1700243700,35160,23206,157061,TR,TR
28032,1699033260,1699050000,16740,127219,101627,US,US
23631,1700778780,1700814600,35820,165650,13567,TR,TR
25577,1700600640,1700604240,3600,136519,190297,NL,NL
43545,1699519380,1699522980,3600,149081,63948,GB,GB
137856,1699310160,1699313760,3600,83261,50731,GB,GB
124201,1699955700,1699989900,34200,63370,179651,TR,TR
81383,1699991820,1700026560,34740,3893,127160,MX,MX
179709,1700778300,1700781900,3600,176432,45621,NL,NL
63155,1700519880,1700524620,4740,196273,135707,GB,GB
91305,1699541460,1699574580,33120,15581,108149,TR,TR
186279,1700695740,1700707080,11340,164757,133984,HR,HR
28870,1699069560,1699073160,3600,128250,32782,GB,GB
57642,1699994100,1700021400,27300,15689,130227,BA,AT
46015,1700275920,1700287020,11100,178443,104491,IT,IT
118346,1700738400,1700742000,3600,66889,122076,GB,GB
84524,1699739340,1699743000,3660,44292,161956,GB,GB
84131,1699457880,1699492920,35040,106070,196397,TR,TR
52881,1699184160,1699202100,17940,123739,110615,US,US
2628,1699159200,1699191240,32040,178458,25225,TR,TR
197759,1698861780,1698894240,32460,195870,32844,TR,TR
19455,1699104360,1699131060,26700,78708,76983,DE,NL
68592,1699182420,1699194180,11760,77498,170115,PT,PT
43972,1700806980,1700837280,30300,7179,98798,TR,TR
116417,1700223900,1700235240,11340,99618,77806,IT,IT
130453,1699640160,1699647180,7020,175507,151688,GB,GB
50680,1700588640,1700621820,33180,5467,106263,TR,TR
183595,1700211480,1700215080,3600,29080,98462,GB,GB
91792,1699128360,1699152120,23760,73822,71801,DE,FR
102234,1700666640,1700678400,11760,86946,124600,AT,AT
20856,1700094420,1700115540,21120,100972,65415,DK,DK
128796,1700822820,1700826420,3600,13553,66521,GB,GB
59533,1699575000,1699608780,33780,6302,144430,TR,TR
118476,1699750140,1699765380,15240,190347,131296,US,CA
82247,1700163480,1700195640,32160,167385,38868,TR,TR
137219,1698939780,1698943380,3600,189257,160788,GB,GB
118585,1700591160,1700618700,27540,164898,188618,CH,DE
51262,1699186320,1699221060,34740,124008,153319,TR,TR
190585,1699938180,1699941780,3600,133594,14228,GB,GB
19307,1700142060,1700173860,31800,113463,123504,TR,TR
64639,1700589000,1700602140,13140,102505,121950,US,US
175214,1700761560,1700784360,22800,134543,96497,DE,HR
168537,1700034840,1700067300,32460,29336,136859,TR,TR
121083,1700418300,1700451840,33540,179532,6012,TR,TR
45441,1700292240,1700295840,3600,30699,62871,GB,GB
16047,1700805360,1700840460,35100,173297,191592,TR,TR
81613,1699844520,1699857060,12540,6850,19624,IT,IT
26131,1699503480,1699509360,5880,178394,166346,GB,GB
143340,1700317680,1700350800,33120,192065,66798,TR,TR
53521,1700855040,1700886420,31380,3489,99382,TR,TR
88427,1699040760,1699057320,16560,5204,161461,CZ,CZ
71891,1699500540,1699515180,14640,177398,69889,US,US
64590,1699135920,1699140420,4500,49369,62397,GB,GB
52692,1699727340,1699741260,13920,177681,18591,US,US
161892,1699254540,1699265040,10500,43423,142049,IT,IT
133970,1699064880,1699099380,34500,41340,22988,TR,TR
69562,1700053500,1700068080,14580,100624,126983,US,US
166496,1699520040,1699537320,17280,23940,178788,AT,AT
163509,1699148580,1699155420,6840,139959,68547,NL,NL
174519,1700283780,1700297280,13500,100588,72408,HR,HR
56112,1699336020,1699350600,14580,68789,139181,US,US
139595,1699840980,1699866900,25920,75647,67174,DE,LT
141143,1700277900,1700281500,3600,131395,94946,GB,GB
110955,1698809760,1698813360,3600,4721,56676,GB,GB
40205,1699414200,1699447980,33780,45511,65099,MX,MX
37418,1700161320,1700172420,11100,65806,110415,IT,HR
122876,1700757840,1700790180,32340,150995,7001,TR,TR
31526,1699995060,1700009160,14100,149069,118379,US,US
48302,1700201940,1700234220,32280,47039,170932,TR,TR
53116,1700278920,1700312040,33120,161176,160848,TR,TR
149644,1699656360,1699673220,16860,188234,145001,FR,FR
135555,1699513260,1699540380,27120,53304,100993,DE,DE
34197,1700545620,1700570160,24540,195710,69205,DE,HU
143679,1699055280,1699085040,29760,134160,3000,TR,TR
78999,1700396580,1700407680,11100,61464,186472,CZ,DE
176875,1699508160,1699525680,17520,85953,49937,US,US
175514,1700014980,1700022240,7260,24257,189685,SK,AT
153098,1699087680,1699099860,12180,137266,137805,US,US
62244,1700437680,1700441280,3600,69873,65464,GB,GB
121700,1699924320,1699942740,18420,1547,131860,DK,DK
78018,1700074500,1700078100,3600,97959,121123,NL,NL
13339,1699950480,1699979400,28920,161300,27163,TR,TR
81748,1699692600,1699700520,7920,76495,95857,SK,PL
98920,1700835600,1700850540,14940,166678,166681,US,US
92564,1698853920,1698886020,32100,102020,195902,TR,TR
83186,1699720320,1699728060,7740,66772,123034,ES,ES
2665,1700061240,1700069460,8220,171950,150189,IT,IT
104791,1699099440,1699116600,17160,23309,143687,AT,BG
167792,1698953760,1698958800,5040,6424,58096,NL,NL
55097,1699781100,1699796100,15000,86345,183734,FR,FR
167418,1700410500,1700421480,10980,151197,79958,US,US
127428,1700131140,1700161980,30840,10906,49573,TR,TR
102317,1698963240,1698991440,28200,121709,95148,DE,DE
162339,1700231820,1700267400,35580,40537,111211,TR,TR
161500,1700141220,1700153220,12000,192651,32276,US,US
96849,1699315680,1699338360,22680,131743,76731,PL,AT
95785,1700376960,1700411580,34620,5103,183125,TR,TR
136848,1700637720,1700647020,9300,90778,46912,PT,PT
85962,1700071800,1700102340,30540,127865,150448,TR,TR
179269,1699803180,1699827540,24360,3708,77314,DE,AT
91568,1700796600,1700827860,31260,10541,32403,TR,TR
131830,1700063460,1700091900,28440,159144,45435,RO,RO
147047,1700419680,1700426160,6480,56352,46383,NL,NL
158326,1700271180,1700288340,17160,166428,30646,US,US
20980,1700569740,1700580900,11160,179093,156868,IT,IT
67010,1700050260,1700072400,22140,148293,123757,PL,PL
156530,1699956720,1699960320,3600,107743,175843,GB,GB
41051,1699975380,1699988400,13020,123354,99276,HR,HR
109263,1700810820,1700814420,3600,166529,199655,GB,GB
53721,1698970560,1699002780,32220,26889,6129,TR,TR
160212,1699999320,1700029680,30360,84721,69042,TR,TR
179812,1699890840,1699920300,29460,194693,122716,TR,TR
168746,1700789760,1700823960,34200,120396,123340,TR,TR
132242,1699756860,1699768200,11340,26469,67568,PT,PT
118660,1700522220,1700559240,37020,163636,150272,MX,MX
29641,1700102280,1700111520,9240,130248,18341,IT,IT
133858,1698983340,1698995640,12300,92002,130321,US,US
82123,1700221380,1700252400,31020,94782,8146,TR,TR
123727,1700249400,1700274540,25140,172569,137271,DE,DE
196654,1699826940,1699861620,34680,126327,54181,TR,TR
61497,1699687260,1699720980,33720,120053,177483,TR,TR
25520,1700780280,1700787840,7560,155627,846,IT,IT
60040,1699302780,1699337520,34740,160757,15655,TR,TR
153446,1700141160,1700153460,12300,15956,69078,AT,AT
100088,1699950780,1699957020,6240,172856,115664,GB,GB
8787,1700607720,1700619960,12240,79521,70333,US,US
48001,1700302020,1700319720,17700,146350,187623,RS,SI
138233,1700258820,1700280120,21300,53843,12585,BE,NL
64600,1699102080,1699133040,30960,26901,43476,TR,TR
146132,1698955920,1698983280,27360,135297,154318,DE,FR
22892,1700783460,1700817420,33960,140746,14528,TR,TR
37334,1699390260,1699403640,13380,47774,35547,PT,PT
107132,1699540560,1699553880,13320,59907,143628,PT,PT
175706,1700256180,1700271300,15120,60627,97466,RS,DE
15680,1700112000,1700124600,12600,18770,64546,ES,ES
174355,1698920280,1698949980,29700,21300,50662,TR,TR
94194,1698905700,1698939240,33540,63105,55334,TR,TR
46206,1699851540,1699882260,30720,153496,21538,TR,TR
79645,1699366320,1699400160,33840,154299,112933,TR,TR
101019,1698858120,1698888660,30540,142384,186398,TR,TR
8694,1699595880,1699616040,20160,98085,29741,SI,BA
85932,1700686980,1700711760,24780,26624,24377,DE,RS
48857,1698815280,1698841440,26160,67528,184503,BR,BR
69700,1700349120,1700377080,27960,2154,106055,DE,DE
190854,1699110900,1699121820,10920,14501,94406,ES,ES
120449,1699773360,1699785960,12600,96207,116348,US,US
88910,1699089240,1699107120,17880,164693,191956,US,US
160996,1698845940,1698874260,28320,28514,66960,BA,SI
99508,1699874280,1699882260,7980,194590,153452,HR,HR
151350,1700267820,1700300820,33000,125086,81115,TR,TR
67478,1698943200,1698947280,4080,92608,170616,FI,EE
70082,1698950340,1698960720,10380,39117,150034,IT,IT
57021,1700185440,1700213400,27960,164312,66823,BR,BR
125011,1699955460,1699959060,3600,23934,55513,NL,NL
49399,1700761320,1700786520,25200,182546,97693,BR,BR
88355,1699739100,1699773840,34740,54380,89746,TR,TR
87461,1699882680,1699917960,35280,96074,177558,TR,TR
89229,1700527020,1700556240,29220,186442,71437,TR,TR
11430,1700639400,1700661600,22200,78733,180431,PL,DE
181910,1700619240,1700622840,3600,98512,186520,GB,GB
132315,1700071020,1700083500,12480,194150,109327,IT,IT
88790,1699810020,1699835220,25200,198307,135890,BR,BR
148003,1699603440,1699629780,26340,150642,98845,PL,PL
141761,1699051200,1699063500,12300,41817,47002,US,US
30109,1699204320,1699219800,15480,162739,73753,RS,RS
41905,1700041380,1700073120,31740,142099,73597,TR,TR
161138,1698866460,1698880980,14520,73880,123812,US,US
63136,1700085900,1700089500,3600,116978,56575,NL,NL
68461,1700828280,1700861100,32820,172450,7347,TR,TR
118357,1700400780,1700432700,31920,136831,12960,TR,TR
34335,1699619820,1699629720,9900,170817,135324,PT,PT
189225,1700489760,1700520780,31020,93015,25812,TR,TR
131851,1699681500,1699691160,9660,105304,33523,EE,EE
95260,1699434660,1699447140,12480,20994,60907,HR,SI
19755,1698869520,1698899220,29700,197064,193198,TR,TR
17215,1699621440,1699651800,30360,72526,162320,TR,TR
185979,1699305240,1699330740,25500,1593,178269,PL,PL
106037,1698980880,1698984480,3600,73581,74728,GB,GB
116506,1700302440,1700333040,30600,110288,9143,TR,TR
53727,1699582980,1699591500,8520,190082,178935,IT,IT
50690,1700786520,1700790120,3600,149774,77605,GB,GB
167019,1699813140,1699836720,23580,167390,127165,DE,AT
120107,1699642920,1699654860,11940,115591,77877,SK,SK
101408,1700245440,1700274000,28560,83179,190365,RO,RO
77827,1699945140,1699975080,29940,42390,169832,TR,TR
179248,1700564280,1700575560,11280,47067,78785,US,US
128230,1700451900,1700487480,35580,36157,96733,TR,TR
151574,1699698600,1699712160,13560,100154,71972,IT,IT
74360,1700146440,1700168700,22260,83244,124839,RO,RO
97019,1699922580,1699957440,34860,49958,104599,TR,TR
184270,1698844320,1698879420,35100,178177,7756,TR,TR
60504,1700027280,1700061540,34260,110431,87461,MX,MX
123657,1700294820,1700298420,3600,25055,26091,NL,NL
126585,1699893420,1699927380,33960,156152,12278,TR,TR
9931,1699009740,1699022220,12480,90304,76093,US,US
66943,1700839380,1700851500,12120,23684,124653,US,US
177433,1700140200,1700143800,3600,92653,137269,GB,GB
190705,1699433220,1699441320,8100,145795,97056,IT,IT
120206,1700346780,1700362020,15240,168878,4584,US,US
124137,1700067120,1700076600,9480,134587,144756,SK,SK
114510,1699083900,1699115640,31740,55799,37294,TR,TR
38668,1700763180,1700793420,30240,110502,107405,TR,TR
171750,1700783760,1700805000,21240,11937,74098,SI,RS
57062,1698903120,1698936480,33360,44909,190859,TR,TR
85356,1700827740,1700858760,31020,185827,27258,TR,TR
169474,1699087980,1699103700,15720,193093,32383,RS,ME
156467,1699851660,1699858920,7260,133206,60044,HR,HR
17033,1699243740,1699279080,35340,144595,112285,TR,TR
58578,1700395920,1700419800,23880,137179,151275,PL,PL
52158,1700727420,1700736180,8760,136559,122271,ES,ES
45297,1699446660,1699478880,32220,181279,180758,TR,TR
56591,1700669100,1700684640,15540,5837,171636,FR,BE
86179,1699212840,1699218720,5880,59267,154899,GB,GB
100131,1700071620,1700081160,9540,122247,190771,HR,HR
70282,1700436660,1700467500,30840,132561,158536,TR,TR
68031,1699834440,1699866660,32220,159713,39189,TR,TR
143145,1700367600,1700395680,28080,164537,145145,BR,BR
91878,1699030800,1699060500,29700,94501,91235,TR,TR
71463,1699774980,1699781520,6540,4552,114800,GB,GB
30553,1700761320,1700764920,3600,167436,7144,GB,GB
17255,1699916820,1699947960,31140,33455,83633,TR,TR
196986,1700371980,1700402820,30840,34684,14238,TR,TR
121962,1700045160,1700097960,52800,33086,161032,BG,AT
136296,1700550240,1700558040,7800,150647,197962,IT,IT
198687,1699943760,1699952160,8400,13274,68246,IT,IT
153561,1699488900,1699492500,3600,116422,66043,NL,NL
192650,1700813940,1700828220,14280,65328,50379,HR,HR
33257,1700637960,1700641560,3600,155770,67400,GB,GB
158228,1699846920,1699850520,3600,4482,157122,GB,GB
191739,1700117580,1700127600,10020,4284,182868,HR,HR
79905,1700617500,1700631840,14340,31928,40479,AT,AT
112713,1700606820,1700642220,35400,103265,3477,MX,MX
16605,1700784960,1700815860,30900,84174,80459,TR,TR
58411,1700350680,1700363460,12780,181508,169006,CZ,CZ
127493,1698935460,1698964620,29160,104455,30696,TR,TR
142978,1700616720,1700633040,16320,127709,26476,US,US
37987,1699067280,1699096500,29220,181935,174662,TR,TR
30133,1700610180,1700622780,12600,31877,151826,CZ,HR
158000,1700106720,1700116560,9840,71018,106647,IT,IT
75010,1698869280,1698898200,28920,119944,64083,TR,TR
79903,1699347540,1699353120,5580,148073,33250,GB,GB
104450,1699719120,1699749060,29940,466,192544,TR,TR
172725,1700222580,1700254140,31560,86681,189159,TR,TR
80442,1700475840,1700486040,10200,196937,14213,PT,PT
100910,1700031300,1700063400,32100,26232,16410,TR,TR
5792,1699266600,1699281840,15240,22173,70732,FR,FR
119910,1698918480,1698924660,6180,62568,135926,GB,GB
74037,1700065140,1700074980,9840,35976,139822,IT,DE
99617,1699705140,1699708740,3600,150921,70085,GB,GB
71025,1700738340,1700773740,35400,104403,192013,TR,TR
153567,1699034280,1699063680,29400,52363,124219,TR,TR
149966,1699472940,1699494960,22020,33406,92582,DE,AT
139252,1700857680,1700862960,5280,21762,26209,GB,GB
15374,1700350620,1700364180,13560,120547,42104,US,CA
192447,1700591640,1700623560,31920,64290,120663,TR,TR
57906,1699405740,1699411680,5940,141334,124767,GB,GB
146315,1700262360,1700272500,10140,61700,162375,IT,IT
126930,1699283640,1699307760,24120,14779,402,CH,PT
136459,1700630640,1700661180,30540,162922,139699,TR,TR
9431,1699539060,1699571700,32640,81658,142592,TR,TR
179013,1700821740,1700852340,30600,33384,195898,TR,TR
157720,1699384200,1699393560,9360,182015,186273,SK,PL
12783,1700718180,1700731860,13680,138273,19585,US,US
97725,1699758660,1699792320,33660,132817,51221,TR,TR
152497,1699542540,1699574700,32160,153394,180466,TR,TR
49369,1699588440,1699624200,35760,185786,50552,TR,TR
92399,1700136840,1700140440,3600,80419,117984,GB,GB
128124,1700696580,1700731320,34740,68748,163178,TR,TR
73954,1700133060,1700157240,24180,64709,94760,DE,AT
141944,1700754720,1700785020,30300,166837,82508,TR,TR
169528,1700371440,1700381760,10320,33691,160607,EE,DE
64908,1698971520,1698975120,3600,5659,167876,GB,GB
17280,1699490160,1699501080,10920,65176,8920,IT,IT
196114,1700069640,1700082000,12360,13949,966,IT,IT
86440,1699819800,1699837320,17520,64305,132842,RS,ME
60385,1700025000,1700040180,15180,109414,57803,US,US
45013,1699886460,1699919460,33000,149204,127863,TR,TR
132155,1699766040,1699772880,6840,65977,46954,NL,NL
62944,1698933300,1698965040,31740,29270,80172,TR,TR
150005,1699401240,1699408260,7020,27489,79900,NL,NL
15732,1700165700,1700222280,56580,133049,30619,BG,DE
68811,1700794320,1700818740,24420,26771,143591,DK,DE
191322,1699075020,1699091280,16260,136423,85208,US,US
51203,1699299960,1699321920,21960,121948,159791,PL,PL
139734,1698854760,1698886440,31680,111892,97728,TR,TR
119989,1699905120,1699923720,18600,161031,21030,SE,SE
117788,1699700400,1699735140,34740,190642,77820,MX,MX
138839,1699341960,1699376820,34860,76363,24527,TR,TR
144947,1698999060,1699004940,5880,82540,62278,GB,GB
88688,1699918380,1699929240,10860,35773,180432,US,US
12063,1698985620,1698989220,3600,144967,10116,GB,GB
15060,1700197200,1700214540,17340,8072,100816,US,US
144279,1699632540,1699650300,17760,18082,40430,US,US
190793,1700755500,1700772600,17100,64880,9687,FR,FR
111700,1700197020,1700208240,11220,30832,46212,IT,IT
67849,1700438340,1700449860,11520,135128,111869,IT,IT
75039,1699471920,1699507740,35820,18216,168075,MX,US
175976,1699294260,1699303920,9660,48742,187345,ES,ES
52614,1699450500,1699455060,4560,78003,7240,NL,NL
81375,1700124420,1700137560,13140,108506,186880,US,US
156991,1699005420,1699009020,3600,194520,196914,GB,GB
86897,1700384820,1700417820,33000,187253,45516,TR,TR
24977,1699410660,1699437600,26940,106059,116381,PL,PL
70952,1700413920,1700450580,36660,13188,141702,MX,MX
67610,1699316220,1699340880,24660,197921,5749,CH,IT
120070,1700825160,1700859780,34620,169134,184606,TR,TR
27861,1698958980,1698984540,25560,190516,171381,PL,DE
45248,1699979280,1700009520,30240,35559,42238,TR,TR
12975,1699920000,1699926300,6300,150802,85574,NL,NL
149790,1698904260,1698930720,26460,107694,68731,DE,RS
75406,1698906180,1698914580,8400,22548,99576,IT,IT
38403,1699860420,1699873080,12660,176981,91206,PT,PT
171992,1700167260,1700199540,32280,104477,64893,TR,TR
127549,1699522500,1699526100,3600,74191,47764,GB,GB
97454,1700641140,1700650860,9720,69243,134871,IT,IT
78489,1700580900,1700609280,28380,57151,134968,DE,AT
186116,1699444740,1699453260,8520,32840,819,HR,HR
95872,1700574060,1700582520,8460,169634,84534,IT,IT
50200,1700586180,1700589780,3600,26313,44688,GB,GB
55344,1700513280,1700548200,34920,114653,183413,TR,TR
10772,1698997980,1699001580,3600,199819,84735,NL,NL
134614,1700851260,1700873160,21900,75061,49797,DE,PL
105108,1700426700,1700435100,8400,164725,195145,CL,CL
52271,1700001600,1700037180,35580,29964,140676,TR,TR
107060,1699518840,1699556220,37380,63327,122525,MX,MX
158052,1700100480,1700115120,14640,65055,38500,FR,NL
84556,1700679180,1700713260,34080,96119,80375,TR,TR
76041,1700141820,1700146860,5040,49893,114359,NL,NL
164223,1700187480,1700222700,35220,42023,33251,TR,TR
28997,1699483860,1699509840,25980,189787,192506,BR,BR
121093,1700805960,1700809560,3600,138470,1424,GB,GB
121066,1699542060,1699556880,14820,183327,70630,FR,IT
174633,1699794180,1699809120,14940,195676,177779,US,US
170274,1700413500,1700425800,12300,170444,163776,US,MX
187208,1699541460,1699574880,33420,188041,101412,TR,TR
26041,1699579620,1699584000,4380,82679,48676,GB,GB
158487,1699107300,1699140420,33120,159878,50135,TR,TR
85883,1700327520,1700341620,14100,118227,66568,US,US
107902,1699058580,1699084380,25800,50986,143318,DE,DE
152835,1698822000,1698834900,12900,8152,144588,IT,IT
141330,1700357760,1700388600,30840,109501,173365,TR,TR
136913,1699755180,1699767000,11820,62385,86165,AT,BA
188345,1699551120,1699580100,28980,172770,54612,TR,TR
81816,1699991280,1700016720,25440,181581,36338,RO,RO
95765,1700707020,1700736840,29820,161950,55554,TR,TR
2270,1700236500,1700240100,3600,4590,19792,NL,NL
92407,1700664780,1700694060,29280,86116,192349,TR,TR
181843,1699067220,1699074000,6780,134810,192902,NL,NL
17147,1700603880,1700620140,16260,178943,116574,US,US
128492,1700783940,1700823120,39180,6797,52447,MX,MX
10320,1700154360,1700161920,7560,176381,194319,IT,IT
106483,1700701860,1700714400,12540,117764,15940,HR,HR
71192,1700131560,1700145780,14220,143844,85455,PT,PT
180076,1700280660,1700296560,15900,158634,167378,FR,FR
94691,1698905820,1698938040,32220,195916,178087,TR,TR
81307,1700672520,1700703000,30480,51699,161263,TR,TR
164756,1699225860,1699263420,37560,85461,191841,MX,MX
139592,1699533180,1699564320,31140,21976,162122,TR,TR
28883,1698910980,1698914580,3600,110762,129190,NL,NL
150327,1699154160,1699170060,15900,8898,28800,US,US
52447,1700306100,1700341620,35520,101596,118741,TR,TR
67828,1700632560,1700645040,12480,180937,92810,RS,RS
123021,1700007600,1700020260,12660,21500,192999,IT,IT
72089,1700054220,1700057820,3600,42886,80249,GB,GB
122237,1699335480,1699349940,14460,60261,106927,US,US
127427,1700616300,1700619900,3600,45619,140637,GB,GB
27735,1698799980,1698831660,31680,104157,115968,TR,TR
177370,1698847260,1698851880,4620,186102,74838,GB,GB
69939,1698961260,1698978660,17400,3950,168334,US,US
142022,1700805060,1700837760,32700,187515,180053,TR,TR
142941,1700661180,1700715240,54060,32760,166462,BG,DE
100167,1700732640,1700736240,3600,101515,157526,GB,GB
196837,1699667820,1699680960,13140,146019,181738,RS,RS
171225,1699711260,1699742220,30960,5105,35394,TR,TR
179531,1699770300,1699783560,13260,176807,99594,IT,IT
91181,1698968580,1698997440,28860,167217,101681,TR,TR
154851,1700274420,1700286240,11820,87218,44282,CZ,CZ
25910,1699219380,1699254660,35280,192889,153517,TR,TR
197373,1698914340,1698919200,4860,39003,151936,NL,NL
32639,1698825420,1698855480,30060,156144,43616,TR,TR
18026,1698922800,1698949500,26700,159821,105533,RO,RO
116116,1699252500,1699266720,14220,121377,192793,US,US
33020,1700055000,1700068500,13500,7127,101103,US,US
70268,1700296500,1700329800,33300,55458,58165,TR,TR
194583,1699491060,1699506180,15120,142703,107215,US,US
75424,1700462700,1700468880,6180,179887,13104,GB,GB
10952,1699826100,1699830840,4740,137826,75425,NL,NL
193224,1700371620,1700400720,29100,198435,188105,TR,TR
108546,1698944580,1698976560,31980,181637,40751,TR,TR
54833,1700363640,1700386260,22620,123783,110756,DE,CH
83172,1700007300,1700011020,3720,33184,124646,NL,NL
41906,1700024220,1700053260,29040,62469,139247,TR,TR
22862,1699354380,1699362000,7620,99174,199055,PT,PT
137479,1700050980,1700081160,30180,164060,151754,TR,TR
149713,1698830880,1698842820,11940,89440,41748,IT,IT
45239,1699886940,1699890540,3600,86941,198803,GB,GB
107856,1700608260,1700616540,8280,36304,118626,IT,CH
35341,1700673480,1700694420,20940,40180,155404,FR,FR
626,1699433160,1699436760,3600,181970,96189,GB,GB
45984,1700182740,1700203860,21120,113289,133729,AL,MK
180945,1700634960,1700668920,33960,34567,66032,TR,TR
45914,1699270920,1699302060,31140,11309,153099,TR,TR
9082,1698979020,1699011240,32220,109280,152838,TR,TR
11384,1700355180,1700390880,35700,35951,113094,TR,TR
35803,1700295600,1700331120,35520,132793,193998,TR,TR
156579,1699075020,1699107120,32100,18889,40285,TR,TR
88503,1698992640,1699020840,28200,49603,46218,BR,BR
134878,1700160480,1700164080,3600,166195,146895,NL,NL
163553,1700191920,1700223060,31140,153124,23962,TR,TR
87346,1699000920,1699006680,5760,68241,35473,GB,GB
108525,1699627260,1699640160,12900,90715,18992,AT,AT
133063,1699727520,1699731120,3600,86472,103128,GB,GB
198150,1699814100,1699837680,23580,132317,67868,DE,DE
76068,1700314260,1700326740,12480,28084,188535,IT,IT
145195,1699944600,1699982100,37500,191097,48382,MX,MX
77967,1699035120,1699066140,31020,61340,118338,TR,TR
38786,1699361400,1699394760,33360,124295,127211,TR,TR
42125,1700610600,1700631960,21360,2288,155750,FR,AD
6342,1700711700,1700739720,28020,157981,83638,RO,RO
15917,1700416260,1700442180,25920,133686,174302,DE,BG
18093,1699655040,1699671000,15960,148255,175580,FR,FR
69315,1699349640,1699379040,29400,119047,117670,TR,TR
113329,1699570320,1699577400,7080,78064,8365,NL,NL
55474,1699663020,1699693800,30780,182722,16711,TR,TR
165775,1698823680,1698840420,16740,186653,75322,US,US
107426,1699322400,1699345080,22680,166453,101699,DE,BG
55381,1700403180,1700406780,3600,122517,13311,NL,NL
102747,1699043460,1699072800,29340,170633,15431,TR,TR
193591,1699702200,1699723980,21780,174664,148121,PL,PL
48817,1699783140,1699788660,5520,82379,151693,NL,NL
88659,1700049540,1700084280,34740,179107,4363,TR,TR
53791,1699171500,1699189740,18240,32097,132297,FR,GB
180086,1700609640,1700630820,21180,68916,165813,BE,DE
67155,1698974700,1699006140,31440,91219,146559,TR,TR
76483,1700603880,1700637240,33360,40510,52019,TR,TR
105569,1700788080,1700821920,33840,113212,72458,TR,TR
40733,1700355360,1700372400,17040,169189,2394,US,US
51887,1700568600,1700572200,3600,153309,29326,GB,GB
199698,1699253160,1699284300,31140,126182,94718,TR,TR
49074,1699455660,1699488180,32520,160979,120303,TR,TR
156773,1700695140,1700705880,10740,52154,129317,PT,PT
134908,1700745360,1700748960,3600,85563,73425,NL,NL
136722,1700202240,1700209080,6840,180904,92561,GB,GB
195689,1699660860,1699690500,29640,120273,12024,TR,TR
128982,1699679880,1699714440,34560,15113,75589,TR,TR
72969,1700502180,1700515140,12960,193818,188835,CA,CA
90524,1700355720,1700372160,16440,168930,181968,US,US
109728,1700547060,1700569560,22500,122403,114555,BR,BR
124380,1699144620,1699163280,18660,136118,148168,DK,RO
126998,1699936860,1699961280,24420,49458,25172,ME,RS
123300,1699526100,1699558380,32280,104459,92555,TR,TR
85653,1700551500,1700583000,31500,13214,35321,TR,TR
163702,1700496180,1700506620,10440,68110,37497,IT,IT
122575,1698814740,1698829500,14760,173204,176410,US,US
68490,1700076180,1700089860,13680,121169,28812,ES,AD
55623,1700554380,1700583420,29040,89354,2869,TR,TR
85292,1698945660,1698956460,10800,195291,101586,RS,RS
14441,1698874560,1698878160,3600,114790,163366,NL,NL
126307,1699579680,1699592640,12960,26105,69,IT,IT
15505,1698970920,1698976320,5400,137070,199147,NL,NL
195276,1699695480,1699705320,9840,149355,41293,ES,ES
45990,1700027100,1700061060,33960,28458,150544,TR,TR
137814,1698804540,1698816780,12240,93496,198752,US,US
110790,1700145480,1700180160,34680,193965,16600,TR,TR
178002,1699383540,1699388340,4800,165422,67838,GB,GB
119701,1700179260,1700183160,3900,72366,141129,GB,GB
144476,1700647140,1700659320,12180,194028,152143,US,US
170074,1698869460,1698879840,10380,189598,108537,IT,IT
145476,1700723100,1700726700,3600,26915,102917,GB,GB
38566,1700304180,1700339160,34980,115574,39798,TR,TR
162886,1698951480,1698985200,33720,139902,65603,TR,TR
81559,1700005920,1700039640,33720,36160,170703,MX,MX
105044,1700779320,1700813580,34260,162917,190649,TR,TR
126345,1700687640,1700719560,31920,136184,103047,TR,TR
193850,1699943220,1699946820,3600,21259,111153,GB,GB
39204,1700613000,1700648460,35460,41759,198876,TR,TR
52839,1699719480,1699724100,4620,16276,139700,GB,GB
60690,1699016400,1699050900,34500,195712,86663,TR,TR
160363,1700113380,1700145420,32040,19394,7418,TR,TR
25784,1700162220,1700186220,24000,181924,105214,BR,BR
50309,1699070880,1699103340,32460,116437,95675,MX,MX
117886,1699843740,1699875660,31920,140283,19521,TR,TR
92558,1699136100,1699160160,24060,142511,78420,DE,RS
22088,1700202840,1700213640,10800,189978,177094,ES,FR
1038,1699179000,1699187160,8160,155437,43010,HR,HR
138857,1700196720,1700230080,33360,65715,174908,TR,TR
128861,1698984120,1699018980,34860,30017,119909,TR,TR
10932,1699938000,1699971720,33720,132356,17594,TR,TR
73262,1699272840,1699291020,18180,89638,92395,FR,FR
191397,1699551660,1699563840,12180,178822,68029,IT,IT
90099,1699572540,1699579140,6600,1559,172040,GB,GB
161269,1698858780,1698888960,30180,36733,57102,TR,TR
10467,1700173320,1700176920,3600,2819,166332,GB,GB
155493,1700468640,1700488920,20280,142743,67045,BE,DK
157284,1700247120,1700279940,32820,149904,40519,TR,TR
133031,1699498860,1699520640,21780,175008,183733,DE,BA
188917,1699037640,1699050480,12840,35667,172114,US,US
106944,1699490340,1699499460,9120,20346,114880,IT,IT
99207,1700019900,1700049720,29820,71604,592,TR,TR
103988,1700587020,1700619600,32580,18137,29313,TR,TR
61974,1700813340,1700825700,12360,179109,92752,AT,AT
4781,1700111460,1700118840,7380,66179,61712,EE,EE
96904,1700719380,1700722980,3600,106557,152975,GB,GB
150029,1699770240,1699782000,11760,16167,124182,ES,ES
34261,1700823600,1700857260,33660,68530,48595,TR,TR
28003,1700476680,1700491740,15060,43201,129227,US,US
51220,1698866280,1698869880,3600,21366,125986,GB,GB
165203,1699247700,1699302600,54900,170008,22795,BG,DE
85275,1699677600,1699692060,14460,30437,176905,CZ,CZ
67228,1698943560,1698954480,10920,173015,178156,US,US
92037,1700450280,1700454960,4680,31064,137532,GB,GB
160216,1698888420,1698912720,24300,43690,152286,BR,BR
98485,1700379300,1700393040,13740,35579,32319,US,US
162651,1699915680,1699947120,31440,62824,73605,TR,TR
70128,1699198500,1699259400,60900,101129,72556,UA,PL
44467,1699424580,1699454940,30360,121839,118517,TR,TR
54146,1699965420,1700002860,37440,185426,48870,MX,MX
165463,1700476080,1700487120,11040,53686,9312,US,US
46537,1699596720,1699625760,29040,147562,122819,TR,TR
34753,1699856220,1699868640,12420,97576,961,US,US
76342,1699582200,1699594260,12060,134262,129675,IT,IT
185123,1699874280,1699908120,33840,96944,142815,TR,TR
93899,1700190060,1700193660,3600,4155,117410,NL,NL
165369,1699729680,1699764180,34500,27427,50327,TR,TR
30122,1699239540,1699269360,29820,51932,94293,TR,TR
105603,1699909260,1699938900,29640,190173,148101,TR,TR
140687,1700723520,1700742600,19080,44887,93704,FR,FR
75692,1699992000,1700025180,33180,174851,95141,TR,TR
123059,1699506540,1699542300,35760,188842,92088,TR,TR
11532,1699254540,1699283880,29340,181162,174502,TR,TR
4373,1699150680,1699183860,33180,82816,33757,TR,TR
158003,1699455900,1699468620,12720,129970,64820,PT,PT
16807,1699634400,1699640640,6240,77263,52532,GB,GB
100085,1699226880,1699259760,32880,185403,4642,MX,MX
129917,1700317560,1700350920,33360,151709,154326,TR,TR
30875,1699414560,1699446240,31680,112284,164147,TR,TR
146501,1699756320,1699768260,11940,160666,71008,IT,IT
148275,1700670300,1700689500,19200,189121,96080,FR,FR
42013,1699834500,1699840020,5520,31820,138619,GB,GB
1404,1699406760,1699410360,3600,195579,130614,NL,NL
129274,1700577060,1700611260,34200,48332,176251,TR,TR
169545,1700356920,1700388180,31260,146367,171,TR,TR
129059,1700283900,1700298240,14340,1189,60291,US,US
30740,1700301300,1700332380,31080,126951,111665,TR,TR
102577,1700827560,1700858700,31140,126531,15479,TR,TR
87368,1700512380,1700522760,10380,40104,107258,IT,IT
34756,1700824740,1700828340,3600,101165,94612,NL,NL
173000,1700287920,1700296440,8520,138806,105722,IT,IT
126236,1700426040,1700443020,16980,9148,111677,AT,AT
177312,1699535880,1699575060,39180,74931,102770,MX,MX
30652,1699520700,1699535040,14340,142588,5278,HR,HR
138077,1699981980,1699993680,11700,131225,58705,IT,IT
172549,1699265520,1699283160,17640,108364,180663,CZ,SK
151972,1698985200,1699008960,23760,67280,159803,DK,PL
138165,1699260240,1699283580,23340,139962,82171,DE,DE
168051,1699053600,1699088820,35220,74084,146010,MX,MX
55035,1699200000,1699213860,13860,115965,191062,IT,IT
48517,1699169460,1699206960,37500,35442,19823,MX,US
103408,1699068180,1699079760,11580,155140,111385,SK,SK
64944,1700239260,1700254140,14880,85644,158652,FR,HU
149469,1698861300,1698874860,13560,23322,26558,US,US
65938,1699005300,1699008900,3600,148377,69458,GB,GB
181529,1699872900,1699880520,7620,103008,85823,IT,DE
116970,1699818540,1699851240,32700,32647,10502,TR,TR
21976,1700663940,1700667540,3600,49540,122048,GB,GB
166806,1699877280,1699911900,34620,135663,8642,TR,TR
94368,1700767860,1700780220,12360,7738,115260,IT,IT
56766,1700291880,1700321580,29700,111065,42123,TR,TR
92499,1699480620,1699497300,16680,38673,34948,US,US
153,1700735460,1700741940,6480,26686,154285,GB,GB
90230,1699590060,1699593660,3600,99697,83894,AD,FR
7593,1698801840,1698829020,27180,31833,80471,PL,PL
34346,1698826980,1698838080,11100,173102,177305,US,US
125972,1700306400,1700315520,9120,93981,71723,IT,IT
141372,1700008560,1700036640,28080,96280,154215,DE,RS
124654,1699462800,1699496100,33300,19397,57947,TR,TR
86312,1699626360,1699631520,5160,32359,29026,NL,NL
187214,1699279740,1699312200,32460,151578,31186,TR,TR
8267,1700238540,1700243040,4500,112896,199572,GB,GB
41986,1699753620,1699759560,5940,134914,28158,GB,GB
177105,1700648760,1700654100,5340,164391,133027,NL,NL
69259,1699315020,1699326300,11280,155038,7944,US,US
143764,1699367760,1699397760,30000,144136,45278,TR,TR
54683,1698892500,1698924480,31980,172592,62181,TR,TR
138522,1700404020,1700422440,18420,172484,12627,FR,FR
84002,1699072200,1699106940,34740,110621,143784,TR,TR
118700,1699867380,1699905060,37680,199908,165787,MX,MX
5738,1700171400,1700175000,3600,161543,33847,GB,GB
101921,1699622700,1699638420,15720,150514,95916,FR,FR
128794,1700521200,1700538780,17580,11973,123532,FR,IT
23127,1699363260,1699375260,12000,115656,102707,US,US
146591,1699346520,1699354500,7980,53551,48205,HR,HR
122178,1700129580,1700164440,34860,96230,197945,TR,TR
74771,1698996900,1699003200,6300,116924,28110,GB,GB
159236,1700787360,1700790960,3600,195442,106505,GB,GB
2149,1699482660,1699516500,33840,62623,135041,TR,TR
155178,1699703580,1699737420,33840,50177,166737,TR,TR
62891,1700133660,1700147580,13920,184187,161245,AT,HU
93481,1700317320,1700347020,29700,195320,186590,TR,TR
174916,1699120800,1699155960,35160,89787,99629,TR,TR
138763,1699627020,1699660980,33960,92061,12259,MX,US
131556,1700107980,1700141520,33540,129323,61900,TR,TR
100001,1699349160,1699353840,4680,35631,145156,NL,NL
199952,1698866940,1698875880,8940,145144,12439,PT,PT
45846,1699042980,1699078560,35580,56291,30900,TR,TR
82441,1700101980,1700113140,11160,104653,61501,US,US
168667,1699061880,1699065480,3600,180426,156195,GB,GB
28742,1699019820,1699049280,29460,199349,51807,TR,TR
11600,1699485180,1699517700,32520,196445,22492,TR,TR
77281,1700408160,1700439840,31680,10848,396,TR,TR
46341,1700167980,1700200140,32160,28286,83165,TR,TR
34175,1698971640,1699007460,35820,114454,81188,TR,TR
112916,1700098320,1700104080,5760,26854,131990,GB,GB
78234,1700302320,1700305920,3600,162845,126220,GB,GB
130678,1700659860,1700688780,28920,25425,22322,TR,TR
85255,1699212600,1699229340,16740,190912,84673,AT,AT
140948,1699693140,1699726500,33360,67582,54758,MX,MX
71152,1698871800,1698887100,15300,64851,10850,US,US
167458,1699904700,1699934400,29700,123059,132773,TR,TR
18298,1699517700,1699529220,11520,152946,173894,PT,IT
66216,1699202160,1699215420,13260,181625,58755,US,US
96265,1698872700,1698883560,10860,128064,24015,US,US
3156,1700108160,1700124420,16260,81868,136801,US,US
50264,1698842700,1698853440,10740,9651,110349,HR,HR
32969,1699254000,1699283820,29820,178057,50692,TR,TR
172109,1699193580,1699227600,34020,110525,124143,TR,TR
164006,1700106240,1700116200,9960,158710,61931,IT,IT
4067,1700095080,1700130720,35640,10005,55883,TR,TR
162153,1699025760,1699060140,34380,25154,87785,TR,TR
32450,1699994700,1700023140,28440,112485,173654,DE,DE
52911,1700362680,1700398560,35880,167790,166080,TR,TR
147629,1699896960,1699931640,34680,46316,156637,TR,TR
152467,1699941480,1699953540,12060,87368,55579,US,US
124111,1699971060,1699987500,16440,11471,186033,US,US
41309,1698849120,1698881520,32400,29837,101000,TR,TR
91205,1699502460,1699512780,10320,198970,149992,CL,CL
109297,1700603340,1700643840,40500,156153,98911,LV,PL
164933,1700498700,1700511300,12600,152827,156960,PT,PT
187512,1698824040,1698840600,16560,167480,7836,FR,DE
97595,1700308260,1700312640,4380,94710,71422,NL,NL
143028,1699261260,1699278300,17040,186383,198743,FR,IT
23252,1700055240,1700062740,7500,127266,83139,SK,SK
165139,1699959840,1699985940,26100,171229,103954,HU,PL
140667,1699799100,1699802700,3600,90620,79596,GB,GB
137449,1700654580,1700684760,30180,177771,13055,TR,TR
3240,1700378100,1700406300,28200,129989,24583,DE,BE
52985,1699159860,1699176660,16800,140697,46979,US,US
149235,1699044840,1699062120,17280,77219,162646,SE,SE
193225,1699021740,1699055040,33300,27459,44602,TR,TR
95840,1700199120,1700231640,32520,5878,6050,TR,TR
13382,1699260900,1699292880,31980,148309,177160,MK,AL
98002,1699215780,1699250100,34320,58618,195116,TR,TR
26820,1699744980,1699753560,8580,99370,169102,IT,IT
141516,1700412480,1700442600,30120,19400,142365,TR,TR
197597,1700799360,1700811480,12120,17863,72508,US,US
2695,1698949260,1698953700,4440,199862,115734,GB,GB
97342,1699552140,1699573800,21660,12109,20865,BR,BR
132241,1699207380,1699218240,10860,177495,183092,IT,IT
162237,1699054440,1699074840,20400,182158,38711,FR,NL
69720,1699978620,1700008320,29700,113420,32109,TR,TR
147095,1699847760,1699883280,35520,67479,153585,TR,TR
141726,1699463160,1699496400,33240,16723,19558,TR,TR
2028,1699541460,1699550400,8940,134370,42111,IT,IT
83328,1699703100,1699728300,25200,129184,58890,DE,BG
132678,1699007100,1699023240,16140,26338,189793,AT,DE
130345,1699393200,1699427040,33840,78244,45450,TR,TR
131216,1700728080,1700735880,7800,98956,127867,IT,IT
147775,1700046720,1700080440,33720,84970,69514,TR,TR
157148,1700001480,1700005080,3600,100017,7807,GB,GB
89299,1699496700,1699532520,35820,36766,32702,TR,TR
108541,1699841820,1699858740,16920,20174,27672,US,US
22965,1699503840,1699514640,10800,31343,122342,IT,IT
5553,1699967160,1700002440,35280,3544,177528,TR,TR
44875,1699207320,1699232520,25200,124041,144669,PL,NL
140731,1700816400,1700826420,10020,94192,181948,IT,IT
67159,1699093800,1699106640,12840,63832,5127,ES,FR
115370,1699830000,1699863840,33840,96442,68352,TR,TR
121051,1700746260,1700754600,8340,42022,151155,IT,IT
81671,1700126640,1700140680,14040,131402,53303,US,US
89224,1700745360,1700748960,3600,38819,146527,GB,GB
156873,1700049900,1700072640,22740,107265,22440,PL,PL
135124,1700825040,1700829540,4500,187396,150810,NL,NL
49511,1698798120,1698801720,3600,81685,34995,NL,NL
114069,1699927740,1699959840,32100,133155,194156,TR,TR
11062,1699252800,1699279680,26880,129835,117573,DE,DE
60118,1699953840,1699987020,33180,59739,14514,TR,TR
196614,1699022700,1699048260,25560,43705,1093,DE,DE
139049,1699936440,1699966560,30120,100681,186266,TR,TR
115120,1698890820,1698894420,3600,199897,19258,NL,NL
138652,1700006340,1700035620,29280,88540,70131,TR,TR
133507,1698986820,1699018260,31440,37732,80684,TR,TR
89752,1700552040,1700555640,3600,150734,152339,NL,NL
31717,1699955760,1699980060,24300,93683,14226,PL,PL
164722,1698823500,1698853440,29940,184966,181323,TR,TR
121948,1700459880,1700493300,33420,102178,6659,TR,TR
34166,1699249500,1699264020,14520,142227,186694,RS,RS
45581,1698872940,1698905280,32340,118005,174948,TR,TR
185701,1699891860,1699895460,3600,185133,146269,NL,BE
158118,1699777620,1699792140,14520,17567,160427,AT,AT
91340,1699950840,1699987860,37020,173047,39589,MX,MX
62540,1700430420,1700434020,3600,78867,41356,GB,GB
192981,1699931940,1699938960,7020,101953,52637,NL,NL
16042,1700146860,1700174700,27840,98281,10122,DE,BA
171828,1699246380,1699256580,10200,18051,87956,IT,IT
177104,1699986480,1700002920,16440,109640,19863,US,US
197238,1699220400,1699254420,34020,35711,131024,TR,TR
30245,1700081520,1700094660,13140,37127,189086,IT,IT
53776,1699414260,1699445940,31680,197231,93338,TR,TR
178286,1698975300,1699005540,30240,168456,72625,TR,TR
173080,1700165040,1700197440,32400,180793,108096,TR,TR
7862,1699104360,1699134000,29640,106720,116710,TR,TR
98237,1700327520,1700331120,3600,147219,126931,CL,CL
111870,1699800240,1699818120,17880,16738,50541,AT,BG
137171,1700577960,1700594280,16320,197669,19443,US,US
34265,1700537280,1700545500,8220,169074,183028,IT,IT
111679,1700461260,1700473260,12000,25305,98818,US,US
54621,1699932000,1699936860,4860,104508,185993,GB,GB
127499,1699362180,1699392360,30180,166370,195893,TR,TR
120938,1699370580,1699400340,29760,185305,64406,TR,TR
46937,1699875180,1699889400,14220,117091,53020,HR,HR
27150,1700583540,1700602020,18480,184649,109598,BE,FR
139597,1700733840,1700737440,3600,124241,49575,GB,GB
52251,1700815080,1700818680,3600,82708,123094,GB,GB
55132,1699251480,1699256640,5160,103353,20795,NL,NL
180487,1699656840,1699668660,11820,105745,102234,US,US
32785,1700204640,1700237760,33120,83170,187090,TR,TR
77456,1699092060,1699121040,28980,104587,95901,TR,TR
126830,1700472360,1700476200,3840,173182,109232,NL,BE
46956,1699740840,1699744440,3600,8536,195217,GB,GB
25301,1699370280,1699379700,9420,100794,41510,HR,HR
1415,1699647960,1699681020,33060,115944,185992,TR,TR
94860,1698854220,1698888480,34260,191184,29322,TR,TR
115483,1699441500,1699447620,6120,29483,30961,GB,GB
187650,1700770320,1700781540,11220,71642,58174,IT,RO
191681,1698812400,1698823860,11460,178619,106019,ES,ES
88315,1698862260,1698876780,14520,15168,97467,US,US
26689,1699060080,1699073820,13740,199554,180393,AT,AT
118028,1699460700,1699495020,34320,90570,26085,TR,TR
197938,1699737720,1699751040,13320,84871,198516,CZ,CZ
192227,1699808880,1699835640,26760,107144,526,DE,DE
196502,1699218840,1699226580,7740,72143,80792,IT,IT
89354,1700451600,1700457360,5760,183644,39613,NL,NL
72635,1700082180,1700095380,13200,95853,132623,AT,AT
18114,1700537460,1700567100,29640,48568,165066,TR,TR
177253,1699631460,1699635720,4260,111320,121932,EE,EE
159682,1699922820,1699954020,31200,30996,119036,TR,TR
678,1700544120,1700550000,5880,193226,76124,AD,ES
123122,1700140920,1700152680,11760,44307,8664,US,US
198324,1700832600,1700843640,11040,185823,47391,CA,US
25332,1700077020,1700086980,9960,97246,13025,IT,IT
35131,1700417040,1700436660,19620,1052,169384,FR,FR
135789,1699827960,1699857720,29760,142324,61669,TR,TR
50906,1700191440,1700208000,16560,79781,147170,US,US
117409,1700617440,1700621040,3600,73656,105973,GB,GB
188420,1700507160,1700514480,7320,48101,198065,IT,IT
44442,1700070060,1700099700,29640,153245,28896,TR,TR
63117,1699493400,1699506300,12900,136931,126713,US,US
77900,1699086720,1699121160,34440,125480,185261,TR,TR
131368,1698865200,1698868800,3600,133532,107177,GB,GB
54015,1699889160,1699919100,29940,25267,62187,TR,TR
103312,1699642320,1699666260,23940,31752,165891,DE,FR
102357,1700804460,1700815800,11340,63116,190510,HR,HR
138819,1698891900,1698904680,12780,8588,87219,IT,IT
91277,1700760540,1700798640,38100,7202,148738,MX,MX
82969,1700406000,1700440860,34860,77637,43682,TR,TR
65837,1699254360,1699276080,21720,64392,13531,RO,RO
12477,1699938840,1699970940,32100,61125,132092,TR,TR
92864,1700501700,1700512980,11280,119147,185942,ES,FR
48565,1700684760,1700712180,27420,179966,126305,DE,HU
66738,1699752180,1699777380,25200,179034,161603,BA,FR
36019,1699811280,1699820280,9000,60267,3650,SK,SK
185703,1698840360,1698873600,33240,150499,85957,TR,TR
63784,1699916160,1699929840,13680,86823,172227,US,US
132843,1699463760,1699495440,31680,4707,109975,TR,TR
45332,1700066040,1700105340,39300,163484,184484,MX,US
27665,1699412220,1699423980,11760,114310,154491,US,US
132897,1700719680,1700732220,12540,47232,161851,US,US
157546,1698832080,1698836760,4680,50669,133898,GB,GB
2805,1698898980,1698931140,32160,109196,174809,TR,TR
188907,1698814920,1698818520,3600,168066,119420,GB,GB
181781,1700653380,1700666700,13320,197713,162830,US,US
169381,1699089180,1699103880,14700,72353,38539,US,US
90088,1699634700,1699641840,7140,115594,29198,GB,GB
30730,1699195200,1699202400,7200,125637,87865,PT,PT
19620,1700174460,1700182500,8040,87782,125308,PT,PT
133552,1699386120,1699420080,33960,159654,5118,TR,TR
20275,1699983540,1699987140,3600,67003,106384,NL,NL
26440,1700392440,1700403780,11340,78927,67351,PT,PT
168828,1698928200,1698935340,7140,125146,78964,GB,GB
135987,1700700480,1700707380,6900,133034,109767,GB,GB
176920,1699882260,1699907760,25500,29835,14063,DE,IT
197393,1700477880,1700508240,30360,137402,100332,TR,TR
135969,1699575360,1699604340,28980,168847,41621,TR,TR
87047,1699486920,1699507200,20280,123140,143546,DK,DK
155987,1698927840,1698937740,9900,119803,102036,SK,AT
135244,1699486440,1699498560,12120,77801,113848,CZ,PL
165385,1699318380,1699347000,28620,196555,14896,DE,HR
183671,1700808480,1700816940,8460,64785,42649,HR,HR
60854,1699631880,1699667700,35820,80315,149086,TR,TR
119472,1700543220,1700573880,30660,187255,191607,TR,TR
179839,1700105880,1700109480,3600,138948,145965,NL,NL
122688,1699677360,1699714860,37500,170165,79800,MX,MX
149389,1698940140,1698951780,11640,1565,88321,US,US
52346,1699610820,1699625280,14460,142472,163408,US,US
34110,1699230240,1699263360,33120,174446,99664,TR,TR
69683,1700569680,1700604240,34560,130688,92514,TR,TR
149319,1700039400,1700068380,28980,16845,103813,TR,TR
27643,1699653780,1699663080,9300,166821,70223,IT,IT
103413,1699549440,1699578300,28860,195682,70719,TR,TR
58855,1699813740,1699827120,13380,99458,114608,IT,IT
12467,1700114700,1700118840,4140,17433,124201,GB,GB
35888,1700163420,1700174340,10920,182297,198718,PT,PT
133044,1700495040,1700508000,12960,135848,189090,IT,IT
142792,1699930860,1699962480,31620,79533,39604,TR,TR
3907,1699037640,1699055940,18300,129496,96253,SE,SE
18488,1699661760,1699674840,13080,108343,30562,US,US
188742,1700122440,1700151360,28920,45434,91404,TR,TR
167302,1699352340,1699364760,12420,95621,179784,US,CA
40902,1699913940,1699920000,6060,197606,2628,AD,ES
76286,1700785200,1700797800,12600,74269,34193,IT,IT
58428,1698918900,1698950700,31800,105284,34350,TR,TR
157956,1700306760,1700325480,18720,135032,4070,BE,NL
131582,1699272120,1699282560,10440,169964,32225,ES,ES
39279,1699498320,1699504740,6420,65752,189057,GB,GB
58355,1700690340,1700707680,17340,87458,112840,US,US
45930,1700839440,1700843280,3840,77844,41284,NL,NL
27692,1700825580,1700832120,6540,150305,129328,GB,GB
8188,1699903620,1699926360,22740,71154,108531,DE,DE
52178,1700426520,1700437260,10740,48531,33907,IT,IT
144467,1698923040,1698926640,3600,69419,131128,NL,NL
116803,1699045440,1699050840,5400,117096,30047,GB,GB
152462,1699050000,1699108200,58200,146671,13204,UA,DE
184620,1699993620,1700023080,29460,92982,160118,TR,TR
81758,1700522160,1700525760,3600,39131,153834,NL,NL
162552,1699559640,1699567320,7680,105403,185377,IT,IT
169875,1699227540,1699234200,6660,116514,42901,NL,NL
146477,1698906540,1698920160,13620,6023,44633,US,US
144524,1700802960,1700816100,13140,184086,92854,ES,ES
160908,1699167360,1699202520,35160,123212,4588,TR,TR
33481,1699259340,1699289160,29820,162491,131396,TR,TR
91970,1700494500,1700513700,19200,21042,55422,FR,DE
121283,1699497060,1699512900,15840,127692,5643,US,US
88394,1699330020,1699333620,3600,60068,122789,NL,NL
71922,1700304120,1700311860,7740,41970,89865,IT,IT
94656,1698831540,1698862860,31320,6149,121435,TR,TR
138104,1700656020,1700670120,14100,164939,192688,IT,IT
93931,1699899720,1699933260,33540,68861,125040,TR,TR
60505,1700056920,1700080500,23580,97583,130051,DE,HU
92312,1700334840,1700349000,14160,58869,120240,IT,IT
53258,1700509080,1700515020,5940,182554,120083,NL,NL
56471,1699041180,1699076220,35040,108368,85180,TR,TR
161723,1699799100,1699814160,15060,50273,25506,US,US
122523,1700829180,1700836800,7620,141857,39350,PT,PT
142507,1699248060,1699275780,27720,39421,177424,CH,IT
32336,1699398420,1699430520,32100,19467,57705,TR,TR
25142,1699647840,1699678320,30480,176301,94713,TR,TR
189617,1699239720,1699268520,28800,188506,91593,TR,TR
65752,1699693680,1699723380,29700,25178,148858,TR,TR
157440,1700452740,1700486760,34020,145792,23750,TR,TR
136515,1700178540,1700211240,32700,160963,132347,TR,TR
141832,1700860680,1700883600,22920,109673,160398,RO,RO
189156,1700214600,1700218200,3600,26835,105982,NL,NL
161220,1699203000,1699211160,8160,147717,192627,IT,IT
55767,1698867480,1698876720,9240,197118,29401,HR,HR
174076,1700725140,1700731440,6300,161447,126520,GB,GB
122214,1700575560,1700580240,4680,19280,156863,GB,GB
52683,1699134660,1699165500,30840,75889,157235,TR,TR
195848,1698982080,1699015920,33840,24301,195174,TR,TR
20916,1700011560,1700040600,29040,187296,195812,TR,TR
1662,1699136100,1699153020,16920,153452,96668,US,US
190753,1700456820,1700480520,23700,75752,189554,DE,NL
43599,1698912660,1698942420,29760,74567,40055,TR,TR
98837,1699543320,1699548180,4860,138932,139126,NL,NL
173318,1699302180,1699319040,16860,119703,23268,BE,NL
86193,1699817160,1699822920,5760,53364,167578,EE,EE
159582,1700120280,1700140440,20160,105677,171777,FR,FR
176437,1700305200,1700334000,28800,49998,115169,TR,TR
79438,1699669380,1699702560,33180,138329,51808,MX,MX
28740,1699778880,1699788420,9540,156947,49292,IT,IT
177614,1700366760,1700371800,5040,79573,149473,GB,GB
124602,1699850340,1699859400,9060,52244,109866,IT,IT
85453,1700046660,1700054820,8160,117873,189019,SK,SK
74456,1700517480,1700525160,7680,28851,32435,IT,IT
72480,1699989000,1700004660,15660,146191,57087,FR,FR
73086,1700712780,1700743920,31140,129946,86669,TR,TR
57096,1699972080,1699975680,3600,47537,92824,NL,NL
100441,1700522820,1700543880,21060,77257,124061,FR,FR
177109,1699575660,1699589580,13920,19451,198099,CZ,DE
187144,1699566240,1699574100,7860,182339,28434,AD,ES
91501,1698848100,1698855900,7800,74475,177909,HR,HR
142643,1700661900,1700678640,16740,121664,187160,FR,FR
49041,1700665440,1700684100,18660,150542,192918,FR,ES
30660,1699344720,1699358160,13440,64318,162395,US,US
24715,1698819120,1698836880,17760,24736,141389,US,US
142323,1698963660,1698994740,31080,156066,173115,BA,DE
62099,1700389620,1700423820,34200,51896,5034,TR,TR
23804,1699786980,1699822740,35760,43501,29677,TR,TR
125551,1700231520,1700238120,6600,122115,151690,GB,GB
111272,1699857420,1699889940,32520,43836,68625,TR,TR
71229,1699926780,1699941660,14880,74308,81203,US,US
175533,1699430340,1699459200,28860,138876,149015,TR,TR
97098,1698865560,1698900780,35220,21263,412,MX,MX
152346,1700283240,1700286840,3600,56299,150186,GB,GB
28383,1699300620,1699309560,8940,46158,178013,HR,HR
170910,1699614480,1699618080,3600,193539,21466,NL,NL
4235,1700025300,1700059320,34020,194695,77380,TR,TR
198755,1700655480,1700663400,7920,167118,69272,IT,IT
108536,1699516560,1699521960,5400,186023,116500,GB,GB
28764,1700848800,1700854440,5640,61069,98566,GB,GB
149580,1699393020,1699396620,3600,123918,74780,NL,NL
66698,1699029660,1699058700,29040,43482,163051,TR,TR
198401,1700156400,1700170560,14160,160435,58972,RS,RS
43029,1700230860,1700242140,11280,77848,54020,US,US
112905,1700786340,1700799360,13020,157627,75372,US,US
127385,1699056600,1699086300,29700,195076,105563,TR,TR
94735,1699955640,1699973100,17460,81026,133444,BE,DE
113450,1700381100,1700413080,31980,156803,44545,TR,TR
184482,1698947940,1698951540,3600,183365,134383,GB,GB
139242,1700374320,1700401620,27300,158951,43692,DE,IT
179942,1699622820,1699628820,6000,194050,141419,GB,GB
52470,1699028040,1699059000,30960,199506,131617,TR,TR
81265,1699492140,1699523460,31320,63547,147224,TR,TR
177386,1698809760,1698830460,20700,37015,37222,FR,IT
149701,1699207680,1699231680,24000,77860,119682,PL,PL
116161,1700402340,1700405940,3600,72990,190423,NL,NL
133450,1699303500,1699311480,7980,15547,139154,IT,IT
151605,1699294980,1699301460,6480,199993,103580,GB,GB
127577,1699798440,1699802040,3600,159392,48691,GB,GB
158296,1699685340,1699715340,30000,133420,23291,TR,TR
132728,1699243560,1699277160,33600,136100,179230,TR,TR
197244,1700689260,1700724300,35040,7069,162094,TR,TR
164629,1699656660,1699663440,6780,18419,42842,GB,GB
25009,1699903260,1699906860,3600,111833,97798,NL,NL
36036,1700115240,1700130000,14760,189190,29341,US,US
150086,1700267340,1700271300,3960,110400,29488,GB,GB
98778,1700548620,1700575080,26460,143751,177432,DE,DE
52817,1699379940,1699391820,11880,145743,127244,HR,RS
158705,1700004960,1700008560,3600,137964,151400,GB,GB
199469,1700217300,1700228880,11580,157288,8521,US,US
143456,1700399220,1700413620,14400,127443,88518,FR,IT
186842,1700152200,1700187240,35040,90311,198582,TR,TR
3349,1698910380,1698927360,16980,72286,66765,FR,FR
69118,1699972920,1699999440,26520,5996,189011,DE,DK
25421,1698995100,1699028340,33240,138588,18939,TR,TR
27104,1699985640,1700020560,34920,121091,23089,TR,TR
18976,1699397940,1699432560,34620,119548,46931,TR,TR
113424,1700565180,1700575620,10440,28840,23437,IT,IT
66979,1700212860,1700245740,32880,48196,142976,TR,TR
107280,1699894860,1699930200,35340,166274,45832,TR,TR
79057,1700307060,1700339760,32700,108164,114601,TR,TR
154118,1699735620,1699770780,35160,63581,34266,TR,TR
48622,1700330580,1700350980,20400,112757,178278,SE,NO
111138,1698923760,1698957540,33780,90044,16975,TR,TR
197101,1699187700,1699219500,31800,36399,142106,TR,TR
45111,1698835080,1698858180,23100,166151,30457,HU,PL
174913,1699614720,1699650960,36240,92502,58612,MX,MX
125169,1699857900,1699885920,28020,182116,50994,BA,DE
115377,1699037940,1699041540,3600,2991,71590,GB,GB
118665,1699750320,1699775160,24840,50577,141998,DE,FR
151187,1700067360,1700100540,33180,61907,24598,TR,TR
88017,1698862440,1698868620,6180,62945,154814,GB,GB
119359,1699189740,1699220340,30600,27609,7911,TR,TR
154071,1699703520,1699710720,7200,173900,743,SK,AT
62013,1699424520,1699432260,7740,99365,40860,IT,IT
94993,1699151880,1699169100,17220,46841,172978,US,US
40122,1699748940,1699752540,3600,84985,125137,GB,GB
42354,1700610060,1700630220,20160,55756,43104,FR,CZ
118175,1699133340,1699154580,21240,2439,1779,SE,DK
130220,1698940140,1698965100,24960,25548,85395,CH,CZ
198785,1700402460,1700431320,28860,56949,196753,TR,TR
126021,1699530480,1699544580,14100,12191,95291,US,US
105753,1699687680,1699701000,13320,198586,5116,US,US
141935,1699428960,1699439940,10980,65290,2903,US,US
147422,1700101020,1700116680,15660,85646,949,US,US
29711,1700476260,1700509740,33480,43648,170658,TR,TR
157428,1698801420,1698836820,35400,120822,125880,TR,TR
150529,1700271300,1700302380,31080,161358,127715,TR,TR
58315,1700735160,1700741580,6420,72465,180172,EE,EE
108609,1700376840,1700411340,34500,190229,98757,TR,TR
33228,1699730940,1699743540,12600,177341,12512,US,US
161149,1700643240,1700668020,24780,7496,161018,PL,DE
169111,1699797180,1699828800,31620,62155,133814,TR,TR
29810,1699765320,1699800060,34740,133048,59500,TR,TR
75526,1698922800,1698926400,3600,307,186277,GB,GB
56800,1700229180,1700259000,29820,185443,161640,TR,TR
20094,1699792140,1699823220,31080,14286,195609,TR,TR
102377,1700237580,1700249340,11760,130320,5552,US,US
164844,1698884760,1698888780,4020,43799,69515,GB,GB
152796,1699860060,1699869240,9180,40736,149593,EE,LT
182891,1700166720,1700200440,33720,28387,67036,TR,TR
101556,1700459700,1700479140,19440,143163,66866,FR,IT
50513,1699816140,1699848600,32460,31005,50096,TR,TR
44454,1698863400,1698876180,12780,153101,132984,IT,IT
23869,1699721880,1699743300,21420,17137,32799,FR,FR
153559,1700716740,1700745900,29160,166172,99640,TR,TR
83892,1699556280,1699589400,33120,87312,100389,TR,TR
176269,1700722080,1700726820,4740,48971,141545,GB,GB
43455,1698951420,1698985080,33660,99710,44553,TR,TR
82239,1699055160,1699065360,10200,10643,155210,PT,PT
86340,1699548480,1699564740,16260,89098,64864,US,US
125177,1699189380,1699193280,3900,186926,20465,GB,GB
39149,1700816220,1700828880,12660,160380,92785,IT,IT
175403,1699515960,1699527660,11700,2072,18335,US,US
70456,1700272680,1700302740,30060,24857,140213,TR,TR
134153,1699148820,1699152420,3600,30239,177466,GB,GB
28350,1699022400,1699026000,3600,91393,104538,NL,NL
31359,1700534580,1700551260,16680,45625,75724,AT,AT
7207,1700500980,1700516040,15060,69409,165478,US,US
116327,1699377840,1699407360,29520,33705,12077,TR,TR
173638,1698817620,1698821220,3600,73338,193922,NL,NL
145713,1699593600,1699632480,38880,26383,50260,MX,MX
72184,1699645320,1699660860,15540,59524,59724,BE,FR
68027,1700625000,1700638860,13860,61162,50365,ES,DE
176199,1699850820,1699863120,12300,162770,100050,US,US
48148,1699069980,1699102200,32220,94331,66179,TR,TR
180462,1700559180,1700594580,35400,16126,123685,TR,TR
55998,1700488320,1700501880,13560,171488,39466,CZ,CZ
31588,1699446480,1699478220,31740,65170,5815,TR,TR
23348,1699768920,1699801740,32820,174781,95969,TR,TR
23767,1699565880,1699601340,35460,151516,51990,TR,TR
99214,1699359960,1699394280,34320,178998,175424,TR,TR
162073,1699006620,1699014180,7560,7754,42792,IT,IT
101728,1699573380,1699582020,8640,23286,162012,IT,IT
103856,1698976320,1698993420,17100,144761,96038,FR,FR
113258,1700598180,1700613300,15120,146903,139223,US,US
79762,1699539900,1699557060,17160,183169,70410,US,US
156244,1699556640,1699584960,28320,154946,171701,DE,DE
188018,1698960840,1698973980,13140,193059,12712,IT,IT
5843,1698997020,1699031520,34500,143568,152212,TR,TR
4868,1699100880,1699104480,3600,74336,1427,GB,GB
153607,1699661400,1699692120,30720,162953,51706,TR,TR
154577,1698947520,1698976560,29040,34232,4165,TR,TR
104198,1700004240,1700009100,4860,139784,45456,GB,GB
33285,1700194440,1700209140,14700,110092,139258,CA,CA
160304,1699912140,1699915740,3600,123094,195549,NL,NL
7434,1700715480,1700725860,10380,85574,142627,PT,PT
55852,1699046820,1699081260,34440,92489,131352,TR,TR
128902,1700389260,1700416020,26760,76783,126586,BA,HR
197611,1700551500,1700555100,3600,39230,18183,GB,GB
15965,1699962960,1699968120,5160,188471,120693,GB,GB
158089,1699278300,1699296060,17760,128299,144136,FR,FR
160701,1700520660,1700526120,5460,49968,121221,GB,GB
46791,1699462920,1699496220,33300,74833,867,TR,TR
175069,1699853340,1699882200,28860,155043,16104,TR,TR
8946,1700289300,1700325420,36120,123754,128688,MX,MX
180019,1700120100,1700155200,35100,162451,186968,TR,TR
2842,1700325480,1700355120,29640,49907,83773,TR,TR
11962,1699961220,1699993560,32340,155044,188387,TR,TR
119327,1700371440,1700405760,34320,12911,35917,TR,TR
37143,1699096620,1699102620,6000,584,35015,NL,NL
149575,1700070120,1700073720,3600,170380,98248,NL,NL
100797,1698835560,1698845580,10020,163476,28015,EE,EE
60277,1700263260,1700266860,3600,90685,172149,NL,RO
165021,1699801380,1699817460,16080,98451,46805,US,US
53376,1700286900,1700319420,32520,144342,59422,TR,TR
46349,1699544280,1699578660,34380,22931,167036,TR,TR
13764,1699705200,1699736640,31440,57786,96024,TR,TR
165144,1698837480,1698868860,31380,156915,33158,TR,TR
185723,1699418160,1699448400,30240,90290,158433,TR,TR
64467,1700396640,1700429400,32760,106433,70578,TR,TR
150182,1700465400,1700482200,16800,47504,15090,AT,SK
187045,1700619780,1700623800,4020,147689,194424,NL,NL
130557,1699241400,1699269900,28500,103799,165769,DE,DE
177578,1700311560,1700316420,4860,32964,145895,GB,GB
25467,1700141160,1700172120,30960,72961,89409,TR,TR
117596,1700175600,1700207580,31980,92044,47658,TR,TR
144269,1700634240,1700644620,10380,190081,176236,IT,IT
185515,1698821040,1698831060,10020,108705,181227,IT,IT
48955,1699848360,1699876560,28200,123781,10750,PL,PL
167476,1699065120,1699099860,34740,197621,79783,TR,TR
59825,1700172960,1700176560,3600,40176,41035,NL,NL
188987,1699872540,1699884360,11820,121562,5906,IT,IT
47173,1700358660,1700388240,29580,58689,90631,TR,TR
122229,1700706900,1700757900,51000,85500,117929,BG,RS
173662,1700187960,1700220600,32640,114343,5112,TR,TR
25762,1700089680,1700103540,13860,20392,54394,HR,BA
14248,1700345700,1700368860,23160,180119,122200,DE,DE
51012,1700169360,1700200980,31620,108469,30214,TR,TR
69788,1699238160,1699250580,12420,142776,28649,AT,AT
94405,1700003820,1700016900,13080,179285,105103,PT,PT
123501,1699166760,1699189140,22380,15625,163503,DE,DE
13904,1699088220,1699104000,15780,38913,84933,RS,HR
106994,1700146440,1700162460,16020,122643,159216,FR,IT
34622,1700504700,1700508300,3600,93203,5833,GB,GB
79421,1700806740,1700841120,34380,117322,100798,TR,TR
5384,1699698600,1699710420,11820,24965,98948,IT,SK
43566,1699602540,1699631580,29040,92721,35111,TR,TR
121780,1700285100,1700293320,8220,181873,56349,IT,IT
1768,1699957320,1699988880,31560,19739,19458,TR,TR
34169,1699957740,1699991340,33600,112678,94207,TR,TR
72541,1699090440,1699101000,10560,572,18627,PT,PT
28185,1698922020,1698946560,24540,183336,3735,RO,RO
160486,1699645080,1699666740,21660,120641,17771,RO,RO
76165,1699705800,1699728780,22980,13819,72780,DE,DE
42744,1700722380,1700739900,17520,150245,15873,US,US
120548,1700467320,1700477220,9900,66042,16079,IT,IT
163202,1699070760,1699087440,16680,94038,60179,RS,HR
125182,1699571220,1699587840,16620,191899,69244,US,US
40481,1698908280,1698911880,3600,23751,153552,NL,NL
38800,1699754580,1699783500,28920,72631,49020,TR,TR
23404,1699880640,1699902720,22080,97344,10054,PL,PL
165818,1699113120,1699142700,29580,56558,73114,TR,TR
96543,1700781540,1700812860,31320,137764,32272,TR,TR
183241,1700079000,1700087160,8160,73690,53396,IT,IT
75761,1699751460,1699761780,10320,45060,97766,IT,IT
118445,1699696260,1699730700,34440,46226,159337,TR,TR
198650,1700508660,1700528340,19680,12551,152440,FR,FR
21803,1699018920,1699033140,14220,105289,188081,US,US
191898,1699187460,1699219440,31980,187516,179866,TR,TR
48900,1699673100,1699687080,13980,137200,129649,CZ,DE
143752,1700634060,1700639220,5160,163681,151031,NL,NL
192870,1699864860,1699894980,30120,71633,197903,TR,TR
14010,1700554560,1700586600,32040,36520,66051,TR,TR
197400,1699971480,1699985160,13680,4736,125283,ES,FR
125581,1700098020,1700109960,11940,78409,104051,IT,FR
18070,1699121220,1699124820,3600,150079,6157,NL,NL
184176,1699581540,1699604220,22680,139038,161287,PL,CZ
51644,1699382700,1699415100,32400,158589,125581,TR,TR
12444,1699295820,1699317780,21960,34495,51251,PL,PL
30143,1699472880,1699477680,4800,125960,151042,GB,GB
44301,1700568060,1700601900,33840,181664,61603,TR,TR
195385,1699012560,1699048500,35940,45863,155733,TR,TR
148754,1698902520,1698909060,6540,23035,154643,NL,NL
66696,1699206180,1699232700,26520,100663,60121,BA,SI
151234,1699723380,1699759620,36240,146775,58569,MX,US
115259,1700142780,1700175720,32940,177865,26386,TR,TR
43916,1700835960,1700850780,14820,147722,47508,US,US
17256,1699651500,1699664940,13440,64349,110068,US,US
90898,1700319180,1700353200,34020,13620,86609,TR,TR
152654,1699659840,1699677060,17220,41894,3366,AT,AT
96965,1699486680,1699499760,13080,102508,181805,AT,AT
147941,1699010460,1699028280,17820,118078,123524,US,US
33281,1699227600,1699261320,33720,3631,151504,TR,TR
184161,1698809160,1698823920,14760,177872,98665,US,US
10660,1699478340,1699512960,34620,12325,112458,TR,TR
194868,1700403240,1700406840,3600,61387,6484,GB,GB
176609,1700189880,1700194860,4980,159520,109133,GB,GB
16270,1699066860,1699071420,4560,113238,170358,GB,GB
145552,1700486880,1700512440,25560,186064,25563,DE,RS
53108,1700570700,1700574300,3600,78533,96088,GB,GB
137636,1699672320,1699689120,16800,112884,61755,AT,AT
1470,1699227720,1699243860,16140,68527,175535,AT,DE
15124,1699549800,1699579020,29220,4692,155592,TR,TR
142267,1699714140,1699725360,11220,109237,196100,IT,IT
127984,1699767240,1699799040,31800,238,150305,TR,TR
162397,1699318920,1699351920,33000,160847,58418,TR,TR
124241,1699645560,1699678920,33360,5934,159526,TR,TR
93328,1700308620,1700337660,29040,198440,9166,TR,TR
88142,1700619480,1700646660,27180,30491,118569,DE,AT
183515,1700048280,1700051880,3600,50136,196797,GB,GB
186242,1698889500,1698903240,13740,116518,17733,US,US
31521,1698840420,1698844980,4560,95148,193430,GB,GB
81351,1700322960,1700330040,7080,123840,35437,NL,NL
185461,1699340400,1699370280,29880,166623,133439,TR,TR
90037,1700518740,1700551200,32460,125548,16506,TR,TR
141238,1700488800,1700504760,15960,95497,125999,US,US
142633,1700492100,1700504880,12780,192702,145139,IT,IT
112682,1700025540,1700029140,3600,144876,134111,NL,BE
64581,1700050500,1700083080,32580,75063,161098,TR,TR
89577,1698842280,1698856560,14280,56585,139617,US,US
192301,1700539680,1700548560,8880,144210,197627,IT,IT
78464,1699782540,1699793820,11280,129907,17992,US,US
93859,1700410200,1700423640,13440,184799,45161,US,US
70788,1700472600,1700507220,34620,42062,32489,TR,TR
11873,1700446560,1700482020,35460,64530,18533,TR,TR
106776,1700480640,1700505960,25320,31237,13571,PL,PL
73907,1699872000,1699876620,4620,64742,126738,NL,NL
191970,1700735880,1700741940,6060,10593,64418,GB,GB
90679,1699287420,1699293360,5940,137737,80541,GB,GB
163520,1700192820,1700210520,17700,175033,111850,RS,RS
189823,1700116680,1700130720,14040,150405,191973,CZ,CZ
21458,1700056440,1700073660,17220,25581,66185,US,US
87447,1699049340,1699074300,24960,164731,177562,PL,PL
78122,1699403100,1699437840,34740,40160,38775,TR,TR
139155,1700388720,1700400240,11520,138240,192826,IT,IT
72959,1700384820,1700402580,17760,165389,158870,US,US
101528,1700437320,1700471220,33900,197489,137050,TR,TR
193895,1699261020,1699288260,27240,110720,120652,BR,BR
189805,1700348820,1700362560,13740,70202,94445,CA,US
82807,1700147400,1700178780,31380,44773,169213,TR,TR
186548,1699112280,1699118640,6360,29096,64815,NL,NL
101176,1699452900,1699456740,3840,23227,183405,NL,NL
32249,1700173080,1700178780,5700,30795,121479,NL,NL
6129,1699890900,1699920120,29220,157292,107315,TR,TR
67701,1699709640,1699743120,33480,82147,6107,TR,TR
52254,1699687080,1699712160,25080,21688,91695,PL,PL
189927,1698876780,1698881040,4260,176931,54890,GB,GB
170545,1700546040,1700572860,26820,32539,84490,RO,RO
59462,1700401620,1700429820,28200,40740,148278,PL,PL
47152,1700352900,1700364720,11820,182569,56075,IT,IT
146192,1700150460,1700181840,31380,143523,136583,TR,TR
17819,1699837860,1699868820,30960,54335,18594,TR,TR
84690,1700001060,1700043360,42300,139487,71990,LV,PL
170892,1699135440,1699149240,13800,103533,88182,US,US
138164,1699366080,1699381380,15300,102457,108261,US,US
98682,1699275000,1699278600,3600,54355,148637,NL,NL
2602,1700145000,1700156340,11340,102874,172850,US,US
86709,1700091540,1700095140,3600,45392,196770,GB,GB
131725,1700678340,1700692860,14520,152406,115041,FR,FR
49718,1699041540,1699056060,14520,188486,84171,FR,ES
163013,1698825780,1698834660,8880,125994,183896,IT,IT
198026,1699731600,1699747020,15420,190095,110972,US,US
136458,1699975260,1699990980,15720,66940,174919,US,US
12824,1699389240,1699423860,34620,17684,191665,TR,TR
150468,1699946100,1699971360,25260,193708,80619,DE,AT
16108,1699656360,1699688100,31740,169153,99946,TR,TR
50239,1698947880,1698982200,34320,163852,67382,TR,TR
108499,1699149480,1699184580,35100,97130,68344,TR,TR
171154,1699227960,1699231560,3600,25437,92022,NL,NL
8964,1699994520,1700028480,33960,187849,158178,TR,TR
167903,1699384320,1699416780,32460,102186,82029,TR,TR
91549,1699016040,1699041300,25260,163699,148435,HU,DE
91629,1699728900,1699732500,3600,164788,64763,GB,GB
21823,1700203200,1700216340,13140,2389,4256,PT,PT
64644,1699554480,1699558080,3600,188328,18844,NL,NL
186144,1699396680,1699400280,3600,45443,34251,NL,PL
197087,1699458060,1699486980,28920,52287,159754,TR,TR
5560,1699503300,1699519320,16020,113870,65687,US,US
101994,1698868980,1698881100,12120,129343,73009,US,US
147060,1699889040,1699892640,3600,157705,25933,GB,GB
26056,1700802960,1700834640,31680,97377,115118,TR,TR
51515,1699356300,1699390680,34380,169159,135156,TR,TR
36304,1700655780,1700690640,34860,96859,193950,TR,TR
187883,1698843060,1698868680,25620,51282,186626,DE,CH
71238,1700501280,1700536440,35160,96265,120184,TR,TR
54679,1699016880,1699025640,8760,144947,123347,IT,FR
22024,1700848860,1700862060,13200,176379,162020,ES,ES
6779,1700071800,1700107680,35880,133172,141030,TR,TR
56344,1699892160,1699921740,29580,132593,188380,TR,TR
172706,1700161080,1700192580,31500,26123,78997,TR,TR
30338,1698992400,1698997260,4860,152537,107210,NL,NL
92924,1699826580,1699834200,7620,56845,8030,IT,IT
67327,1700524380,1700555400,31020,183147,169497,TR,TR
38452,1700312700,1700342400,29700,157929,65559,TR,TR
92648,1699036740,1699048080,11340,82906,100131,US,US
98096,1699083240,1699088280,5040,147399,103760,GB,GB
159565,1700567580,1700582880,15300,49747,60385,CZ,CZ
171870,1698860700,1698894240,33540,36486,65734,TR,TR
134846,1699291860,1699313460,21600,156626,121652,DE,DE
126487,1700434140,1700465040,30900,38699,28687,TR,TR
164807,1700232360,1700265180,32820,17170,39445,TR,TR
187384,1699438200,1699449780,11580,14249,193289,AT,BG
175271,1700514060,1700530200,16140,81004,27518,US,US
76218,1699436700,1699440300,3600,149640,189095,NL,NL
154103,1698930600,1698942180,11580,140778,70022,IT,IT
197515,1700830620,1700845500,14880,91692,172760,US,US
49994,1699223880,1699257060,33180,8803,15111,MX,US
132192,1699811040,1699840020,28980,180906,44326,TR,TR
25683,1698964740,1698993060,28320,158473,10233,PL,HU
99732,1700853120,1700863920,10800,61245,176849,PT,PT
147489,1700210760,1700228880,18120,196198,142647,FR,BE
82274,1699918740,1699939260,20520,30258,56934,FR,DE
8677,1699983300,1699986900,3600,140535,7299,GB,GB
138521,1699854900,1699887120,32220,15207,57291,TR,TR
139645,1699745100,1699780920,35820,132268,18829,TR,TR
162039,1699526520,1699543500,16980,102387,143957,US,US
196273,1700795400,1700805480,10080,134203,179031,IT,IT
35520,1700676120,1700691360,15240,87418,7915,US,US
56417,1700309880,1700339880,30000,10313,24181,TR,TR
180810,1700157060,1700191080,34020,81508,107463,MX,MX
61866,1698953940,1698969900,15960,66553,162081,US,US
65858,1700715000,1700718660,3660,72253,11856,GB,GB
22110,1699951440,1699957560,6120,25790,199266,GB,GB
3695,1699695480,1699712940,17460,154999,2833,US,US
66662,1699751700,1699787100,35400,43212,31663,TR,TR
48014,1700610600,1700614200,3600,186204,151170,GB,GB
7610,1700197020,1700206260,9240,187676,175548,PT,PT
118625,1700534820,1700568600,33780,169375,130899,TR,TR
60596,1698937500,1698971460,33960,20317,73399,TR,TR
60108,1699416840,1699452420,35580,41547,115031,TR,TR
128015,1698863340,1698875400,12060,48765,145924,HR,HR
53139,1699352100,1699366200,14100,118175,126490,HR,HR
36295,1700444880,1700448480,3600,104064,107192,GB,GB
75053,1700857860,1700868180,10320,17528,82518,PT,PT
175793,1700767020,1700797800,30780,27600,19362,TR,TR
39292,1698976200,1698991020,14820,157503,50601,FR,FR
178770,1699228320,1699241460,13140,174164,147244,IT,FR
68300,1699132980,1699167780,34800,6578,20675,TR,TR
196873,1700042880,1700077200,34320,21476,119017,TR,TR
57107,1700255700,1700271780,16080,31365,155218,BE,HR
68529,1699075560,1699093380,17820,109439,177584,US,US
192790,1700267880,1700305380,37500,49288,134813,MX,US
17653,1698973440,1698979800,6360,113280,159536,GB,GB
23202,1700603340,1700612040,8700,195465,79164,IT,IT
113399,1700805780,1700822340,16560,85209,46655,FR,IT
73140,1700384100,1700399340,15240,58109,185598,US,US
102948,1700026740,1700044500,17760,181237,63545,US,US
127161,1699456500,1699471260,14760,164634,58664,US,US
107536,1700685060,1700696820,11760,56108,131235,US,US
20457,1700336040,1700367120,31080,115020,134598,TR,TR
150358,1700241780,1700257020,15240,104827,146180,US,US
142470,1700861100,1700874840,13740,17654,43086,US,US
165635,1699710900,1699727280,16380,75891,15007,FR,IT
13961,1699330740,1699354500,23760,30979,29096,DE,DE
187277,1700084460,1700122440,37980,142901,83378,MX,US
132651,1699127820,1699139820,12000,156255,83647,HR,HR
26629,1698957600,1698969540,11940,15226,24771,US,US
70457,1698980640,1698991740,11100,190214,34373,US,US
141443,1699168860,1699182840,13980,21123,137585,IT,IT
135701,1700404080,1700413740,9660,74257,156933,ES,ES
76958,1700275200,1700309940,34740,150226,180788,TR,TR
142980,1699203300,1699215660,12360,144966,41931,US,US
126757,1700397240,1700411160,13920,140517,41101,IT,IT
197614,1700080440,1700105580,25140,163177,755,DE,NL
125064,1700833140,1700836740,3600,192629,98208,GB,GB
50286,1699906320,1699935960,29640,143317,149638,TR,TR
3368,1699088700,1699105320,16620,81632,132786,US,US
25234,1699549920,1699560780,10860,89587,174554,US,US
172160,1700604780,1700608380,3600,76816,158446,NL,NL
69060,1699047660,1699054380,6720,8695,160744,NL,NL
59582,1699365000,1699399140,34140,170365,160016,TR,TR
37077,1699588620,1699602420,13800,141291,92225,IT,IT
119032,1700120220,1700135640,15420,10782,128934,BE,PL
181943,1700232720,1700262060,29340,134611,69396,TR,TR
19445,1699992480,1700004180,11700,128004,62439,CZ,CH
28745,1700350980,1700354580,3600,157987,131706,GB,GB
590,1699662120,1699679700,17580,119722,21097,FR,FR
35404,1699537200,1699566660,29460,178024,140921,TR,TR
16293,1700196120,1700211180,15060,30403,181067,US,MX
12213,1700271540,1700281500,9960,93547,17614,IT,IT
20715,1699009140,1699034940,25800,16540,191740,PL,DE
42743,1699174740,1699188660,13920,7050,29041,CA,CA
19165,1699004400,1699039020,34620,191356,113576,TR,TR
57895,1700453820,1700486880,33060,103968,137310,TR,TR
74559,1700583000,1700617920,34920,186689,106781,TR,TR
10146,1699385100,1699418820,33720,37188,70946,TR,TR
62005,1700422200,1700433900,11700,167973,21269,HR,HR
195809,1699717320,1699751700,34380,83313,85059,TR,TR
90139,1700324160,1700356500,32340,157275,137307,TR,TR
140164,1699031460,1699040520,9060,115230,151207,SK,SK
13701,1700020440,1700052420,31980,72226,30564,TR,TR
85106,1698843600,1698847200,3600,10145,151676,NL,NL
156793,1700383620,1700397540,13920,175248,49998,CZ,CZ
33349,1700056140,1700091600,35460,114686,16333,TR,TR
34295,1699210440,1699243860,33420,106028,161148,TR,TR
176195,1699820280,1699836060,15780,157302,96356,US,US
3253,1699697700,1699733460,35760,30355,46249,TR,TR
198305,1700216580,1700233320,16740,4964,188561,FR,FR
36365,1699239540,1699273260,33720,83844,107478,TR,TR
132872,1700118360,1700157480,39120,99295,93128,MX,US
79982,1700674620,1700691360,16740,113382,127000,RS,HR
173142,1699846380,1699876860,30480,176242,121331,TR,TR
28973,1698978480,1698990000,11520,10390,84213,IT,IT
77088,1699317720,1699343940,26220,157923,65399,DE,DE
167521,1700774700,1700809860,35160,86173,19227,TR,TR
181739,1699437600,1699467060,29460,118495,78138,TR,TR
70696,1698907800,1698939360,31560,177802,45506,BA,AT
117381,1699425060,1699428660,3600,185647,6027,NL,NL
10128,1700270940,1700283180,12240,147776,85552,US,US
5685,1699375260,1699389300,14040,117387,124514,HR,HR
141845,1699827540,1699856820,29280,190758,165923,TR,TR
177379,1700134680,1700151240,16560,16923,193409,US,US
122558,1699702440,1699715280,12840,7989,169810,IT,CH
54847,1700752800,1700769480,16680,80631,62311,US,US
93004,1699443300,1699452900,9600,77268,98871,SK,CZ
106775,1699408260,1699422540,14280,14858,113567,HR,AT
150357,1699381680,1699412940,31260,154435,56981,TR,TR
152310,1699589760,1699604580,14820,166928,69068,US,US
169350,1700362500,1700375700,13200,93937,28436,PT,PT
199532,1698798060,1698802980,4920,179910,67986,GB,GB
174591,1699146660,1699178220,31560,168505,181109,TR,TR
9256,1700548260,1700564280,16020,93294,102216,US,US
55832,1699205700,1699222560,16860,11855,121202,AT,DE
118702,1699962240,1699994820,32580,56280,197089,TR,TR
51142,1699672980,1699702320,29340,141683,158091,TR,TR
163526,1700622060,1700625780,3720,33496,11466,GB,GB
2505,1700039100,1700064900,25800,68790,101660,DE,IT
110161,1699858380,1699867800,9420,10491,18534,ES,PT
83636,1700729220,1700741760,12540,157305,96976,US,US
51149,1698837900,1698873420,35520,68929,107755,TR,TR
24695,1700344920,1700358420,13500,12958,2121,US,US
8506,1700772780,1700785680,12900,180672,87454,US,US
149722,1700408640,1700440200,31560,36557,75692,TR,TR
67092,1700542740,1700549580,6840,68402,82187,NL,NL
62851,1699737060,1699745520,8460,180215,63282,IT,IT
118500,1699423680,1699452780,29100,48642,64985,TR,TR
68736,1699538820,1699555020,16200,91448,197156,AT,AT
125676,1699805880,1699809480,3600,156551,128548,GB,GB
1561,1699300740,1699304820,4080,174860,89358,AD,ES
181215,1699436280,1699448820,12540,34139,53492,US,US
142308,1699783500,1699794660,11160,162804,134971,SK,AT
182285,1698805320,1698820500,15180,65814,156078,FR,FR
2229,1700254560,1700290020,35460,188192,126253,TR,TR
177970,1698971880,1698983520,11640,75108,42974,US,US
172088,1700309460,1700339160,29700,43269,172726,TR,TR
116168,1700554560,1700568360,13800,8990,93812,US,US
109873,1699058820,1699093860,35040,17345,198031,TR,TR
46816,1700121180,1700126160,4980,164289,141518,GB,GB
169286,1699251480,1699267620,16140,96611,18201,US,US
59678,1699889340,1699900920,11580,161496,2325,IT,IT
180365,1699158000,1699169580,11580,82256,8503,PT,ES
7670,1700168100,1700177940,9840,170678,175487,IT,IT
43176,1700506140,1700541000,34860,172927,28171,TR,TR
97254,1700429940,1700448420,18480,184977,142036,DK,DK
151655,1699167060,1699202160,35100,130286,35951,TR,TR
18887,1700574300,1700588220,13920,188278,33171,PT,PT
89422,1699622460,1699655700,33240,35545,162968,TR,TR
88795,1700755980,1700759580,3600,69376,54454,NL,NL
13519,1700430420,1700438640,8220,175271,37756,IT,IT
127613,1700682120,1700694360,12240,15633,72035,US,US
44173,1699592220,1699616040,23820,158275,13037,RO,RO
67325,1698913500,1698926100,12600,138518,76747,HR,HR
123233,1699077780,1699101120,23340,108317,14125,DE,AT
189309,1700421060,1700426280,5220,164593,128178,GB,GB
169645,1699794480,1699799580,5100,113283,78472,NL,NL
170149,1700373180,1700403240,30060,140929,36955,TR,TR
83243,1700746020,1700751420,5400,198996,13152,GB,GB
36870,1699956420,1699960020,3600,100813,89477,GB,GB
137357,1700287920,1700304240,16320,178306,57251,US,US
1368,1700254800,1700264340,9540,142292,137314,IT,IT
175159,1699725180,1699749060,23880,137299,73088,DE,FR
199278,1700805900,1700839380,33480,192208,22144,TR,TR
154990,1700701080,1700723280,22200,12533,20129,BR,BR
77239,1699009740,1699029780,20040,81099,156015,FR,FR
9815,1700233680,1700249220,15540,126371,141725,US,US
107908,1700386380,1700398200,11820,188342,48303,US,US
157744,1700322480,1700358120,35640,130369,31796,TR,TR
123902,1699520100,1699531620,11520,85083,120499,US,US
25750,1698822360,1698857760,35400,105702,32897,TR,TR
17630,1698947160,1698959700,12540,169571,92240,PT,PT
163608,1699728600,1699752780,24180,176733,40065,CH,DE
125045,1699306140,1699310460,4320,6215,174871,GB,GB
166129,1700134620,1700160000,25380,131312,126740,RO,ES
26497,1699143240,1699179780,36540,36073,115559,MX,MX
145031,1700714880,1700727060,12180,147769,37312,US,US
150244,1700791620,1700798640,7020,42774,3632,NL,NL
148162,1700621460,1700625060,3600,136318,145612,NL,NL
14657,1699302180,1699305780,3600,33061,78857,NL,NL
112441,1700454960,1700489820,34860,75812,162427,TR,TR
92032,1699502820,1699534260,31440,117784,186852,TR,TR
115563,1700281620,1700317380,35760,60580,13841,TR,TR
107236,1698867840,1698881400,13560,144489,179400,PT,ES
75156,1699166280,1699172880,6600,14302,198730,GB,GB
100835,1700681880,1700696280,14400,37419,63492,US,US
109096,1698930420,1698941820,11400,69748,75985,US,US
145811,1698984360,1698997320,12960,35343,23784,US,US
194088,1699379340,1699411380,32040,192337,108552,TR,TR
30644,1700550840,1700580420,29580,176231,23184,TR,TR
11022,1699432800,1699462020,29220,87033,54187,TR,TR
142161,1699389240,1699401540,12300,154595,152285,CZ,CZ
25529,1700758560,1700793660,35100,33214,177187,TR,TR
35651,1700687460,1700691060,3600,125206,193774,GB,GB
90474,1700332440,1700354280,21840,58574,126635,PL,DE
190241,1699372020,1699395720,23700,78511,80493,DK,DK
69352,1700448360,1700461200,12840,52600,59810,HR,HR
102187,1699547460,1699572180,24720,88783,71808,PL,DE
145253,1700073420,1700086800,13380,193146,167928,US,US
120675,1700021160,1700051160,30000,193794,66010,TR,TR
67767,1700031960,1700066160,34200,106572,100214,TR,TR
124647,1700436720,1700470020,33300,145898,139387,TR,TR
60077,1698850080,1698883320,33240,96941,80653,TR,TR
42941,1700798820,1700810040,11220,101694,160110,IT,IT
81382,1700307360,1700320500,13140,43644,31220,RS,RS
78966,1699361160,1699390260,29100,156123,196718,TR,TR
185154,1699660740,1699695780,35040,111250,148046,TR,TR
180789,1699036380,1699050120,13740,193781,170938,US,US
110204,1699885860,1699917540,31680,122920,33193,TR,TR
67693,1700227560,1700231160,3600,124704,80933,NL,NL
122183,1699872180,1699878600,6420,44774,3063,GB,GB
156414,1699713960,1699743960,30000,47740,3642,TR,TR
106677,1700606700,1700611260,4560,1316,64045,GB,GB
191708,1699334820,1699355580,20760,100492,14031,FR,FR
70773,1699611300,1699646160,34860,177858,133009,TR,TR
145623,1700041980,1700048820,6840,143528,7813,GB,GB
194962,1700566740,1700596500,29760,81548,194659,TR,TR
153987,1699296120,1699318500,22380,5836,176385,RO,RO
36456,1700643900,1700673300,29400,38384,124195,TR,TR
140470,1700142900,1700152500,9600,21808,180967,IT,IT
178769,1699701420,1699705980,4560,180890,179761,GB,GB
75758,1699631700,1699639200,7500,117639,191327,IT,IT
152255,1699365900,1699380540,14640,196301,161856,US,US
65257,1698824280,1698854880,30600,131734,34998,TR,TR
1607,1699288980,1699294800,5820,73795,36375,NL,NL
29404,1700577900,1700608080,30180,88152,102413,TR,TR
199831,1700088660,1700092260,3600,25135,125925,GB,GB
86713,1699699260,1699723140,23880,22666,18881,BR,BR
45497,1700416260,1700449260,33000,173992,31905,TR,TR
161768,1700205180,1700219040,13860,184955,126006,CZ,DE
45620,1699476420,1699490940,14520,137286,182374,US,US
112729,1698875700,1698889740,14040,186875,143701,ES,ES
37202,1699805760,1699839540,33780,95611,68204,TR,TR
163696,1699205940,1699222860,16920,140574,114011,AT,AT
95097,1699296060,1699313100,17040,149861,117681,US,US
191303,1699707180,1699718100,10920,9679,43725,IT,IT
54249,1698796020,1698826560,30540,110074,180186,TR,TR
120669,1698845460,1698881160,35700,198728,117479,TR,TR
69081,1700296260,1700326140,29880,151466,23776,TR,TR
169895,1700822760,1700856060,33300,25576,147951,TR,TR
74235,1700287620,1700316720,29100,152459,189010,TR,TR
18943,1699603320,1699612740,9420,76137,16383,IT,IT
114221,1699585320,1699617660,32340,162872,146234,TR,TR
174841,1700341140,1700367900,26760,156894,66543,BR,BR
101260,1699430640,1699441860,11220,117738,91728,IT,IT
82493,1699870140,1699896540,26400,113429,60446,HU,HR
33288,1700249220,1700255640,6420,31306,55270,GB,GB
190453,1700866500,1700883240,16740,46336,127195,US,US
33316,1699704120,1699734600,30480,78820,102818,TR,TR
196911,1699591320,1699641840,50520,134764,4761,BG,DE
17762,1699276620,1699280220,3600,39652,157160,GB,GB
127530,1699112940,1699123500,10560,89235,12766,HR,HR
56245,1700586780,1700619540,32760,79016,14291,TR,TR
197294,1699753860,1699760220,6360,131735,101604,GB,GB
172786,1699947240,1699968600,21360,171079,176561,DK,BE
10669,1700137440,1700160000,22560,8894,187286,DK,DK
181840,1699857900,1699873080,15180,167526,106347,FR,BE
85539,1699891260,1699917420,26160,86860,16467,HU,PL
1743,1699946940,1699963140,16200,142316,170399,US,US
175879,1699214100,1699243800,29700,37541,11583,TR,TR
104286,1699956240,1699985160,28920,149084,42464,TR,TR
190037,1700792340,1700795940,3600,105587,96026,GB,GB
73997,1699417800,1699451460,33660,92680,146495,TR,TR
78299,1700426340,1700459880,33540,29007,19033,MX,MX
9218,1700777340,1700806260,28920,123829,121258,TR,TR
77540,1698957900,1698972960,15060,159209,104665,RS,RS
73153,1700268600,1700295720,27120,150477,18649,BR,BR
9226,1699993320,1700002680,9360,140981,172055,PT,PT
48118,1699375620,1699396800,21180,81725,48213,FR,FR
112848,1700692560,1700728020,35460,65672,188918,TR,TR
174215,1700312400,1700316000,3600,117798,16986,GB,GB
66471,1699053480,1699089420,35940,71244,197528,TR,TR
120341,1700763720,1700787660,23940,52969,173557,DK,DK
15438,1699274580,1699288260,13680,194106,100984,HR,HR
149599,1700675820,1700690100,14280,147857,79557,US,US
94737,1699323420,1699328580,5160,122504,26106,GB,GB
42834,1700704680,1700739480,34800,134986,35179,TR,TR
83388,1699341240,1699374540,33300,11827,87334,TR,TR
183072,1700388000,1700399460,11460,56893,89686,US,US
82064,1699390680,1699419780,29100,3545,57485,TR,TR
60474,1700134020,1700163060,29040,22097,94982,TR,TR
86219,1699163700,1699199340,35640,172520,67740,TR,TR
54189,1699053360,1699059720,6360,79967,182907,NL,NL
49959,1699631940,1699645440,13500,17204,184736,IT,IT
105465,1698987540,1698991140,3600,17657,18776,GB,GB
24358,1699748580,1699770600,22020,198129,26742,HU,AT
95442,1700637840,1700672280,34440,114995,131524,TR,TR
24026,1699103040,1699129560,26520,5260,29116,PL,PL
35363,1699477740,1699482480,4740,184438,30861,GB,GB
78724,1699763520,1699786860,23340,60205,103098,DK,NO
29073,1699864020,1699898040,34020,151057,99798,TR,TR
126415,1700765700,1700779380,13680,59703,187557,AT,SK
157816,1699554420,1699585860,31440,94212,152012,TR,TR
11138,1699315080,1699344240,29160,94670,116751,TR,TR
185161,1699789980,1699817820,27840,30153,176086,DE,NL
135958,1700225940,1700238360,12420,29535,170783,US,US
188825,1699411320,1699426320,15000,1157,101621,US,US
48413,1699131480,1699138080,6600,8055,82793,FI,EE
170276,1700012460,1700044200,31740,148419,44601,TR,TR
32070,1699066980,1699097400,30420,199002,89268,TR,TR
59534,1699514760,1699549320,34560,64393,40843,TR,TR
3620,1699228680,1699232280,3600,173752,156566,NL,AT
89982,1700368500,1700399880,31380,13817,172874,TR,TR
170722,1700099760,1700112900,13140,16981,139581,US,US
139388,1699477740,1699510500,32760,108900,32031,TR,TR
56786,1699411080,1699436940,25860,3156,98153,DE,UA
50721,1700010720,1700016840,6120,57364,100674,NL,NL
2243,1700275800,1700309580,33780,180037,45518,TR,TR
114177,1699294200,1699305900,11700,168532,142761,IT,IT
91806,1699622760,1699626360,3600,33504,150916,GB,GB
37440,1700808240,1700823720,15480,19237,166285,FR,GB
176925,1700046120,1700058600,12480,79504,220,RS,RS
177581,1700801640,1700837520,35880,197397,196275,TR,TR
146462,1699905360,1699938600,33240,56099,63781,MX,MX
117338,1699742220,1699749540,7320,121623,75579,ES,ES
48069,1699948980,1699970700,21720,128130,82043,PL,PL
77566,1699292460,1699321260,28800,178335,170877,TR,TR
122835,1700029140,1700045160,16020,146287,55121,US,US
74783,1698986160,1699018620,32460,127094,104887,TR,TR
148135,1700548080,1700560800,12720,31975,14414,HR,HR
117813,1699588800,1699598280,9480,13424,13191,IT,IT
141069,1700042640,1700054640,12000,88261,193401,IT,IT
85515,1700347620,1700362260,14640,81185,29555,US,US
44785,1700146140,1700149740,3600,125089,86358,NL,NL
123731,1699885380,1699917240,31860,16918,44801,TR,TR
41754,1699506780,1699527480,20700,56028,167462,IN,IN
27699,1700591640,1700605560,13920,198420,40987,IT,IT
106652,1700584380,1700596260,11880,198537,151025,AT,SK
49977,1699725720,1699738560,12840,155109,11025,RS,RS
118347,1698995940,1699024860,28920,191056,157435,TR,TR
119614,1699177080,1699211520,34440,12129,94772,TR,TR
12825,1699743780,1699760220,16440,63344,146367,RS,HR
103352,1699808040,1699840020,31980,191125,59210,TR,TR
197108,1700797440,1700828520,31080,10582,197681,TR,TR
18842,1700747580,1700776620,29040,185128,60262,TR,TR
137169,1700748540,1700777160,28620,5560,131657,DE,CZ
178003,1699698000,1699704240,6240,182984,151934,NL,NL
87178,1699096260,1699129920,33660,63055,161767,TR,TR
21246,1700078580,1700108820,30240,4632,199962,TR,TR
123011,1699569120,1699575120,6000,97100,62675,NL,NL
89368,1699323720,1699336380,12660,27643,91532,US,US
166074,1699607460,1699616460,9000,23863,169741,ES,ES
110992,1699781520,1699810140,28620,33239,129720,BA,BA
33884,1700567400,1700603100,35700,4931,118620,TR,TR
180286,1699202640,1699219200,16560,69520,121535,US,US
40190,1700334000,1700363100,29100,198822,162356,TR,TR
120992,1699334520,1699339740,5220,47038,85900,GB,GB
119148,1700163660,1700178360,14700,171052,9703,US,CA
155203,1699608060,1699611660,3600,3195,2812,GB,GB
74170,1699325820,1699357620,31800,101725,157405,TR,TR
75687,1700646000,1700677020,31020,184094,127680,TR,TR
2077,1699567380,1699585740,18360,129092,136369,IN,IN
104664,1700593440,1700604780,11340,41522,28530,US,US
97086,1699430400,1699463460,33060,19115,165758,MX,MX
38683,1699059000,1699076760,17760,76695,59625,US,CA
108693,1699173120,1699186500,13380,87233,181799,IT,IT
154709,1699939980,1699943580,3600,83582,109120,NL,NL
199458,1698943980,1698950760,6780,185106,86196,GB,GB
180770,1699837080,1699850100,13020,90591,77450,US,US
17584,1699677720,1699691580,13860,17826,135310,IT,IT
121040,1699346880,1699350540,3660,51606,144338,GB,GB
117539,1700494140,1700526660,32520,58370,170074,TR,TR
90204,1700079300,1700111640,32340,30822,157148,TR,TR
148781,1699223580,1699256880,33300,94588,94174,TR,TR
79921,1699212600,1699241820,29220,16264,9700,TR,TR
91766,1700794440,1700798520,4080,194232,57375,GB,GB
37441,1700660760,1700694540,33780,30326,196814,TR,TR
3212,1698933960,1698939240,5280,39174,159917,NL,NL
64141,1698991680,1699021920,30240,92173,62050,TR,TR
111120,1700641200,1700664180,22980,21298,128495,RO,RO
97041,1700213940,1700238660,24720,94397,144681,HU,AT
197978,1699598820,1699616040,17220,86487,27892,US,US
159341,1699077840,1699088100,10260,170257,75644,IT,IT
189412,1700272620,1700302260,29640,95295,24719,TR,TR
181183,1700666040,1700683020,16980,40659,2476,FR,FR
96908,1700003700,1700040780,37080,110303,95282,MX,MX
170354,1700858400,1700891700,33300,22699,104952,TR,TR
88435,1700856060,1700891820,35760,138452,198928,TR,TR
22716,1699571940,1699605420,33480,135607,197948,TR,TR
188311,1700347320,1700379240,31920,169290,161006,TR,TR
158690,1699371420,1699405740,34320,132431,21048,TR,TR
197660,1699672440,1699676040,3600,50271,159775,GB,GB
43157,1699505520,1699538100,32580,123623,65465,TR,TR
199336,1700862840,1700893620,30780,159154,177399,TR,TR
5162,1700295540,1700330820,35280,31066,144456,TR,TR
53624,1698860820,1698872580,11760,149621,113484,US,US
145661,1698977220,1698980820,3600,45366,184358,GB,GB
14800,1700339760,1700369520,29760,180792,117331,TR,TR
11942,1699499340,1699510620,11280,169899,191767,US,US
107993,1698950160,1698953760,3600,4469,173041,GB,GB
36866,1700267400,1700282640,15240,51125,45420,US,US
105227,1699883640,1699938240,54600,185220,149043,BG,DE
131424,1699819860,1699855200,35340,195306,164289,TR,TR
5849,1700533440,1700559780,26340,25171,63050,BR,BR
183355,1700059200,1700062920,3720,76762,16943,GB,GB
129867,1699674480,1699678080,3600,107854,88574,NL,DE
2448,1699092480,1699102860,10380,168714,13715,IT,IT
80361,1699731060,1699754400,23340,135968,173280,PL,PL
60051,1700173260,1700199900,26640,13683,150826,RO,RO
27825,1699735260,1699766700,31440,2294,124716,TR,TR
42218,1699526880,1699540920,14040,183731,99033,CZ,CZ
114003,1700176020,1700180640,4620,2416,184538,GB,GB
73004,1700098860,1700115780,16920,25612,118082,AT,AT
188452,1700617920,1700622180,4260,159921,39847,NL,NL
52314,1698810180,1698827940,17760,107438,149812,US,US
65962,1699765020,1699798560,33540,53147,140941,TR,TR
135609,1699944240,1699978200,33960,186080,190870,TR,TR
113554,1698832380,1698842280,9900,146957,151966,HR,HR
121626,1700100120,1700117640,17520,134377,160452,US,US
101289,1700173740,1700206080,32340,142498,130673,TR,TR
78273,1699934400,1699943400,9000,88017,82683,ES,ES
51066,1699811160,1699814760,3600,171789,136814,NL,NL
143902,1700800560,1700833020,32460,147768,165142,TR,TR
64640,1699251180,1699280580,29400,72445,187320,TR,TR
91955,1700507760,1700516160,8400,139440,107346,PT,ES
144752,1700362260,1700398020,35760,148816,144225,TR,TR
88740,1700802120,1700827680,25560,44397,167730,RO,MD
194676,1698946500,1698981300,34800,188912,130161,TR,TR
168660,1699513260,1699548540,35280,12260,173507,TR,TR
95406,1699666380,1699697400,31020,147620,151712,TR,TR
143577,1699264920,1699269900,4980,159297,190247,NL,NL
116911,1699618680,1699637640,18960,107264,174774,FR,DE
86885,1700328240,1700340300,12060,47396,11461,US,US
10979,1699350480,1699385940,35460,58131,61810,TR,TR
161206,1700521380,1700529360,7980,100419,78405,IT,IT
130174,1700367240,1700377140,9900,105534,80,IT,IT
18514,1698949200,1698954780,5580,143973,46155,GB,GB
132255,1700432220,1700456040,23820,18601,1693,HU,DE
73150,1699690380,1699719300,28920,175147,183541,TR,TR
186472,1700549700,1700578920,29220,134131,49834,TR,TR
57026,1699690440,1699721400,30960,93504,9441,TR,TR
176765,1700607060,1700635380,28320,52248,110856,BR,BR
66344,1699649880,1699653480,3600,14347,98218,GB,GB
122153,1699459620,1699491240,31620,145126,29465,TR,TR
70658,1700087640,1700099040,11400,142788,148549,US,US
94013,1700159580,1700163180,3600,121159,134536,GB,GB
145355,1700730600,1700764980,34380,121305,63979,TR,TR
183185,1700238240,1700245980,7740,37636,61204,IT,IT
126176,1699682820,1699713120,30300,3291,158017,TR,TR
187225,1700705880,1700739900,34020,15665,95308,TR,TR
120307,1700413080,1700442360,29280,179541,33906,TR,TR
8391,1700683320,1700704980,21660,136772,10581,PL,DE
105733,1700625180,1700632740,7560,154525,119573,IT,FR
21082,1699353420,1699385340,31920,109497,130919,TR,TR
68427,1699695780,1699712520,16740,35424,2240,US,US
55565,1699773960,1699779060,5100,112592,176002,GB,GB
76983,1700159220,1700170680,11460,96183,167697,IT,IT
122004,1699380300,1699394760,14460,629,147790,FR,FR
622,1699208940,1699212540,3600,107239,163149,NL,NL
8124,1698988620,1699005960,17340,37568,166764,US,US
153870,1700255580,1700287920,32340,56219,15296,TR,TR
87037,1699798260,1699832160,33900,28345,56648,TR,TR
188303,1699109940,1699120980,11040,62020,97111,HR,HR
171657,1700343180,1700352420,9240,194633,40328,SK,SK
101864,1699221900,1699235880,13980,65708,136666,PT,PT
137751,1699432980,1699468440,35460,64264,148232,TR,TR
9377,1700015880,1700031720,15840,195963,67208,US,US
76385,1699134840,1699170480,35640,196366,94879,TR,TR
91508,1699450380,1699455060,4680,28418,89325,GB,GB
176909,1699040400,1699054320,13920,36878,181060,ES,FR
16070,1700545560,1700549160,3600,194079,88116,GB,GB
108628,1699284900,1699317180,32280,168385,40936,TR,TR
187373,1700281800,1700296680,14880,7303,64359,FR,ES
140384,1700110440,1700132820,22380,20795,136257,DE,DE
141750,1699523100,1699536960,13860,179393,151193,AT,DE
9860,1699114500,1699143060,28560,107967,116093,DE,AT
120809,1699238820,1699243800,4980,157749,111485,NL,NL
9054,1700024760,1700077440,52680,199981,68187,BG,BG
66472,1699888200,1699914000,25800,56319,177837,BA,HR
47039,1699027440,1699051020,23580,26684,58456,DE,FR
175817,1700675160,1700687520,12360,154550,10958,AT,AT
96339,1699419300,1699451880,32580,16020,114654,TR,TR
148138,1699309140,1699323480,14340,14685,110767,RS,RS
22667,1700045940,1700062380,16440,27967,92819,US,US
96885,1699079160,1699082760,3600,77754,2148,NL,NL
183691,1700339160,1700367960,28800,85662,88100,TR,TR
131311,1699391640,1699426980,35340,30651,174751,TR,TR
50696,1700122500,1700139060,16560,168327,178655,SE,SE
163134,1700506020,1700531520,25500,53807,771,BR,BR
110213,1699876560,1699891140,14580,115531,123258,US,US
189026,1700141580,1700156160,14580,24340,38188,US,US
69461,1699517460,1699551240,33780,118328,12205,TR,TR
67686,1699658220,1699675860,17640,153587,141893,CA,CA
24982,1699968720,1699994580,25860,72960,22846,RO,RO
102789,1700600700,1700611080,10380,22320,11028,PT,PT
115450,1699978680,1700007720,29040,51766,70383,TR,TR
126279,1700839560,1700872680,33120,10524,191541,TR,TR
130089,1699397640,1699435860,38220,37789,105678,MX,MX
192088,1699041600,1699053120,11520,139852,139950,US,US
29396,1700696580,1700714280,17700,22401,154307,AT,AT
46390,1699102800,1699110900,8100,176617,59381,IT,IT
36748,1699659660,1699673340,13680,12769,176191,PT,PT
153141,1700614260,1700647980,33720,155503,154095,TR,TR
49191,1699413420,1699444620,31200,12600,124517,TR,TR
54541,1700818260,1700832840,14580,111968,182267,US,US
133862,1699065060,1699093920,28860,63127,8094,TR,TR
111753,1700666880,1700696160,29280,160168,151284,TR,TR
72042,1698794520,1698826320,31800,87774,122988,TR,TR
127872,1700335620,1700362320,26700,78636,111703,DE,DE
129672,1699605300,1699618680,13380,69312,44594,US,US
71494,1700042520,1700071620,29100,17632,144764,TR,TR
143176,1700150100,1700157600,7500,72661,183714,EE,FI
18742,1700371560,1700406540,34980,45649,88882,TR,TR
183587,1700195700,1700209500,13800,183537,108196,IT,IT
156852,1699387680,1699416480,28800,94399,27659,TR,TR
72943,1700174580,1700185860,11280,58757,186571,US,US
80200,1700694480,1700748360,53880,36027,29597,BG,TR
102107,1700391120,1700417940,26820,119140,140796,PL,NL
190089,1699354260,1699368960,14700,116660,131787,FR,FR
159049,1699792560,1699808280,15720,32345,101016,FR,FR
196735,1699085640,1699097520,11880,195831,173458,IT,IT
169923,1700249280,1700252880,3600,61822,31932,GB,GB
181557,1699600440,1699613700,13260,23807,113345,HR,HR
148118,1699311120,1699314720,3600,129433,37882,NL,NL
142854,1698906960,1698927960,21000,71005,152731,BE,FR
86789,1699284300,1699295640,11340,10272,102285,US,US
196357,1700693100,1700706360,13260,50504,36189,IT,IT
109182,1699256700,1699268460,11760,186872,46535,US,US
95420,1700833380,1700836980,3600,194199,172194,NL,NL
13257,1699277400,1699281000,3600,77846,157484,NL,NL
11570,1700544540,1700576760,32220,99138,146167,TR,TR
72873,1700187720,1700192760,5040,16251,143868,NL,NL
8031,1699184760,1699188360,3600,149174,26970,GB,GB
155882,1700412720,1700445000,32280,176715,189380,BA,RS
81849,1699101120,1699123200,22080,16697,124096,DE,CH
141463,1700012760,1700024040,11280,1159,164311,US,US
141022,1699645500,1699677360,31860,112782,18833,TR,TR
102786,1699217760,1699224300,6540,127340,4749,NL,NL
38931,1700152260,1700188200,35940,197969,180603,TR,TR
27038,1700740740,1700744400,3660,161754,156173,NL,NL
3765,1699612440,1699617420,4980,186658,151281,GB,GB
138731,1700426880,1700462640,35760,78556,128816,TR,TR
137788,1700389860,1700422680,32820,72927,87788,TR,TR
87180,1699759440,1699783680,24240,71789,4137,AL,MK
171683,1699907520,1699938660,31140,17921,128585,TR,TR
15537,1699827120,1699844340,17220,86362,143195,FR,FR
122404,1699964220,1699987260,23040,51442,13276,DE,HU
132734,1699703940,1699712580,8640,46340,127216,IT,IT
26968,1699992780,1700007060,14280,133358,67124,RS,BA
144214,1700355840,1700369340,13500,90174,102459,US,US
69036,1700116620,1700147520,30900,2266,191347,TR,TR
84599,1699784700,1699801920,17220,62308,164009,FR,FR
109250,1699603800,1699635960,32160,146686,190026,TR,TR
199589,1700438700,1700454120,15420,48762,178372,US,US
86459,1700491560,1700495160,3600,72785,153058,NL,NL
124158,1700487720,1700508600,20880,20411,59584,FR,FR
106153,1698991320,1699000380,9060,193800,184889,HR,HR
122841,1700643420,1700673120,29700,47266,130715,TR,TR
4902,1700608980,1700625360,16380,102967,77322,US,US
163298,1699785840,1699816440,30600,38719,179419,TR,TR
80649,1700145120,1700157840,12720,187302,183117,RS,RS
129277,1700457420,1700468940,11520,126898,142265,AT,AT
50926,1699159380,1699162980,3600,55018,125645,GB,GB
172363,1699879500,1699899540,20040,155284,163809,FR,FR
54677,1699422300,1699434900,12600,41278,165129,HR,HR
115568,1700844300,1700876100,31800,37596,136212,TR,TR
166319,1700453700,1700492520,38820,199085,2570,MX,MX
41971,1700552940,1700585520,32580,49631,130260,TR,TR
137183,1700449500,1700455860,6360,138222,74100,NL,NL
169959,1698976800,1699012680,35880,35642,157931,TR,TR
18071,1699042620,1699048860,6240,80494,165209,GB,GB
154965,1699584240,1699618680,34440,78009,81058,TR,TR
182521,1700249280,1700280720,31440,97947,122867,TR,TR
139130,1700196300,1700199900,3600,5617,44429,NL,NL
192338,1699090200,1699096980,6780,123984,157781,NL,NL
197816,1699118820,1699128480,9660,176065,20712,IT,IT
178969,1699909380,1699926180,16800,87867,136299,AT,AT
120635,1700758200,1700763240,5040,85945,145718,NL,NL
102607,1699900560,1699904160,3600,124559,138885,NL,NL
131039,1699159260,1699194420,35160,75019,76850,TR,TR
121235,1700693400,1700697000,3600,2860,150087,NL,NL
9543,1699758120,1699771740,13620,195794,47280,US,US
104191,1698937080,1698962940,25860,39152,159457,BR,BR
137081,1699100280,1699105980,5700,167562,146266,NL,NL
52628,1699376760,1699395660,18900,48604,37666,FR,CH
121196,1699693920,1699723920,30000,80796,173978,TR,TR
34330,1699995300,1700013180,17880,130628,77730,RS,RS
13995,1698934200,1698968880,34680,33781,49992,TR,TR
177895,1699181400,1699185240,3840,167138,179250,NL,NL
54338,1699229340,1699247940,18600,101896,73002,FR,FR
2870,1699255500,1699269480,13980,197258,142481,IT,IT
50981,1700310600,1700335800,25200,194357,15420,DE,AT
142693,1700685780,1700703300,17520,28720,50113,US,US
147978,1700826480,1700841120,14640,47088,81567,SE,SE
27293,1699768680,1699772280,3600,50488,156471,NL,NL
45197,1699077120,1699109940,32820,13118,78568,TR,TR
72055,1699352760,1699383900,31140,142551,152037,TR,TR
23015,1700756820,1700762100,5280,85184,137061,NL,GB
107201,1698806880,1698819300,12420,180298,187420,IT,IT
21251,1699698720,1699709520,10800,111301,158250,AT,AT
94821,1699463880,1699467480,3600,5606,160518,GB,GB
80029,1699751460,1699763880,12420,45782,165001,US,US
62609,1700472360,1700498460,26100,178213,137810,DE,DE
36142,1700050560,1700066340,15780,89225,188678,US,US
59915,1700403000,1700432040,29040,192898,28797,TR,TR
185170,1699377840,1699404480,26640,114521,82847,PL,PL
59939,1699466640,1699500900,34260,51865,127054,TR,TR
127466,1700862780,1700898540,35760,188946,142861,TR,TR
138093,1698972600,1698987480,14880,2282,142539,US,US
86068,1700389740,1700400180,10440,129615,122878,HR,HR
74445,1699229580,1699284780,55200,79511,151519,UA,CZ
11299,1699542360,1699577100,34740,144868,33039,TR,TR
106145,1699252560,1699284900,32340,28504,152813,TR,TR
48478,1699179660,1699210980,31320,76117,33795,TR,TR
88648,1699590060,1699593660,3600,4444,60053,GB,GB
145258,1699731840,1699739040,7200,183308,77016,IT,CH
598,1699882500,1699912800,30300,54964,176898,TR,TR
58686,1700172120,1700203860,31740,199287,17841,TR,TR
194840,1699638360,1699670700,32340,155239,146640,TR,TR
177567,1698819900,1698830700,10800,120565,9471,IT,IT
18930,1699667820,1699682040,14220,196549,31359,HR,HR
87287,1699470660,1699501800,31140,17904,103676,TR,TR
196783,1699921500,1699936500,15000,69585,119767,US,US
69175,1700326140,1700356980,30840,128458,24586,TR,TR
184171,1700524020,1700557320,33300,48540,121012,MX,MX
74225,1699830060,1699841820,11760,40334,113643,CA,US
182102,1699039680,1699045380,5700,110285,174804,GB,GB
73405,1698884880,1698888480,3600,37772,50614,NL,NL
97864,1698968100,1699002960,34860,73208,93645,TR,TR
22691,1700345520,1700352240,6720,127811,135162,NL,NL
126623,1699933800,1699937400,3600,157367,166784,GB,GB
130720,1698964920,1698985260,20340,35580,137974,BE,FR
193576,1699917000,1699949460,32460,172134,110172,TR,TR
601,1699974480,1700003760,29280,97893,53558,TR,TR
63729,1698957600,1698971340,13740,105560,74881,IT,BG
82704,1700275680,1700293080,17400,66593,138551,US,US
15836,1699011060,1699041720,30660,58047,112693,TR,TR
7201,1698897900,1698927300,29400,84944,131101,TR,TR
28563,1698883320,1698898800,15480,116618,12509,US,US
192319,1700412420,1700433180,20760,4118,8843,SE,SE
146839,1700106780,1700118480,11700,39302,91282,CZ,CZ
151810,1700618580,1700650500,31920,159500,165147,TR,TR
75158,1699474860,1699486860,12000,3116,25954,IT,IT
168140,1698914640,1698931620,16980,195722,55264,FR,FR
187827,1699225380,1699240020,14640,65849,171736,FR,NL
114975,1698899760,1698908760,9000,5462,196270,IT,IT
169091,1699649220,1699670640,21420,3138,112798,SE,NO
83893,1699750440,1699768440,18000,151228,176461,BE,NL
112066,1700603760,1700614800,11040,4208,149918,HR,HR
89852,1700641320,1700674620,33300,17732,182492,TR,TR
158473,1699539480,1699545120,5640,102244,120401,GB,GB
135009,1700787180,1700815740,28560,26991,77356,RO,RO
197804,1698933480,1698966960,33480,15120,66623,TR,TR
31274,1700806980,1700836920,29940,13588,97824,TR,TR
64601,1699773600,1699789920,16320,28664,107318,RS,RS
11226,1699953120,1699960860,7740,97156,7895,PT,PT
141821,1700740260,1700770380,30120,92111,182292,TR,TR
98260,1700367180,1700401920,34740,152340,135304,TR,TR
158606,1700362500,1700380260,17760,161625,98608,SE,SE
86628,1700303700,1700323680,19980,111725,56762,BE,FR
34006,1700771460,1700802840,31380,27380,157665,TR,TR
90954,1699408260,1699441560,33300,125839,41038,TR,TR
10024,1699977420,1700008200,30780,42991,126403,TR,TR
4206,1698919140,1698922740,3600,32408,51262,GB,GB
111102,1698970080,1698995580,25500,127455,172945,BA,HR
160863,1700124660,1700137260,12600,148756,44292,US,US
1676,1698891540,1698897900,6360,54583,21471,NL,NL
4311,1700818500,1700840940,22440,122960,137682,PL,PL
29846,1698959220,1698976800,17580,170362,46013,CZ,CZ
74819,1699079280,1699082880,3600,118221,14318,GB,GB
126903,1699353600,1699388820,35220,73173,163293,TR,TR
158140,1699419000,1699422600,3600,118136,107331,GB,GB
171578,1700776200,1700789340,13140,37346,9937,IT,IT
123975,1699961160,1700014800,53640,137378,140422,BG,DE
5063,1699389300,1699400880,11580,112031,175863,US,US
6086,1698969720,1698986040,16320,23231,106834,US,US
179502,1699547160,1699561140,13980,179519,195842,IT,IT
125787,1700298660,1700317140,18480,153612,181706,FR,FR
99596,1700798700,1700802300,3600,68123,162139,GB,GB
173301,1699040340,1699054860,14520,163733,196523,US,US
106437,1700488500,1700526180,37680,152943,58875,MX,MX
34649,1700146320,1700179140,32820,177644,132419,TR,TR
107396,1700340120,1700373420,33300,178953,178691,TR,TR
50562,1700813100,1700848560,35460,45889,186942,TR,TR
61488,1699347180,1699361820,14640,6388,169923,BE,FR
137940,1699715940,1699719540,3600,98696,53139,GB,GB
134206,1699831080,1699834680,3600,146576,140734,NL,NL
115002,1699837920,1699850580,12660,161109,155798,US,US
80714,1700100420,1700104020,3600,143691,57449,GB,GB
63096,1699697280,1699713720,16440,83651,168694,US,US
71130,1699103280,1699130040,26760,29435,66790,DE,NL
2170,1700375880,1700389500,13620,33299,162456,IT,IT
85127,1699537800,1699573260,35460,144364,172182,TR,TR
160618,1700369460,1700401260,31800,37232,83453,TR,TR
197340,1699924620,1699936740,12120,168680,147883,US,US
167707,1699460640,1699494600,33960,196493,7647,TR,TR
17448,1700226600,1700245200,18600,3046,71348,FR,FR
147882,1698991200,1698994800,3600,53818,140421,NL,NL
164970,1699449480,1699461420,11940,135395,136903,US,US
127456,1699860540,1699867200,6660,22640,140689,GB,GB
85633,1700455020,1700472600,17580,60005,161893,US,US
160402,1699883880,1699887600,3720,61376,197175,GB,GB
132006,1698895320,1698898920,3600,92691,125774,NL,NL
113957,1699046220,1699053060,6840,195424,60343,GB,GB
22530,1699939020,1699942620,3600,190736,68777,GB,GB
104038,1700135100,1700169060,33960,54647,28294,TR,TR
143244,1698816720,1698834420,17700,167327,15945,US,US
80407,1700338380,1700373540,35160,63824,88847,TR,TR
18863,1699297320,1699331820,34500,40523,6163,TR,TR
47264,1700722500,1700731980,9480,195440,148977,HR,HR
40589,1700800860,1700829360,28500,63960,25950,BR,BR
5211,1700077080,1700109120,32040,133488,73006,TR,TR
168749,1699993320,1700006160,12840,49746,14207,IT,IT
180378,1699420380,1699424040,3660,197471,141766,GB,GB
199246,1700399100,1700432760,33660,69837,10573,TR,TR
34837,1699617720,1699637460,19740,12929,114109,FR,ES
117769,1700841540,1700846700,5160,85700,142383,NL,NL
147020,1698847680,1698859320,11640,23656,37271,PT,PT
175313,1699980780,1699998000,17220,171119,125797,US,US
9825,1699280100,1699287600,7500,114629,116862,HR,HR
39895,1699601700,1699634640,32940,187519,67189,TR,TR
190270,1699191840,1699224540,32700,98876,14797,TR,TR
35338,1699723140,1699736460,13320,77507,16717,HR,HR
107023,1699773600,1699809240,35640,44772,131503,TR,TR
25174,1699119240,1699154400,35160,139812,189736,MX,MX
32598,1699065840,1699092420,26580,23654,121254,DE,DE
22428,1699303380,1699321020,17640,44926,79827,US,US
82222,1699497780,1699506540,8760,104573,12736,HR,HR
140237,1700709660,1700727840,18180,89575,97446,BE,NL
161426,1699588200,1699608660,20460,61997,42570,LT,EE
159297,1699318560,1699345140,26580,66021,114427,PL,PL
196740,1700061600,1700081940,20340,65918,167354,FR,BE
30359,1699681920,1699696200,14280,154554,25627,ES,PT
108227,1699453620,1699486980,33360,86924,1743,TR,TR
5878,1699533780,1699545540,11760,22268,186534,AT,AT
112663,1700260080,1700273580,13500,71572,43910,US,US
44522,1700754000,1700788440,34440,168148,143987,TR,TR
152,1698946620,1698950700,4080,40102,17748,GB,GB
148740,1700471700,1700475300,3600,64200,130122,NL,NL
69296,1700218680,1700245380,26700,86133,63651,DE,BG
25600,1700192580,1700197680,5100,12227,100992,GB,GB
150960,1699066380,1699099920,33540,191689,43240,TR,TR
22205,1699151580,1699164300,12720,136662,140341,AT,AT
56670,1699201620,1699228140,26520,124440,29696,DE,HU
6549,1700149380,1700158620,9240,50980,96040,IT,IT
85195,1700648460,1700652180,3720,116321,2134,GB,GB
56600,1699012020,1699046400,34380,129754,170154,MX,MX
172919,1700740800,1700754120,13320,151839,78143,CZ,DE
53362,1699017960,1699051080,33120,123297,106396,TR,TR
121200,1699421520,1699430280,8760,142024,140192,ES,ES
109971,1699902420,1699913700,11280,169827,61000,ES,ES
83818,1699647720,1699682760,35040,108471,86906,TR,TR
25128,1699750800,1699765140,14340,31238,199401,US,US
53803,1698963480,1698995100,31620,54524,71174,TR,TR
168499,1699579260,1699582860,3600,92403,86775,GB,GB
38496,1698917940,1698942360,24420,73922,114169,CH,NL
158557,1699571700,1699586100,14400,197855,135786,US,US
80508,1699909860,1699944420,34560,92666,122290,TR,TR
121603,1700332140,1700347680,15540,19793,117665,RS,RS
64747,1700267400,1700293320,25920,67466,30122,BA,HR
120102,1698963000,1698979800,16800,3355,106758,US,US
85561,1699816380,1699846500,30120,74961,7090,TR,TR
31520,1699881060,1699891200,10140,88125,31244,IT,IT
62262,1699645320,1699657800,12480,32423,143955,IT,IT
186616,1700122860,1700136240,13380,171415,143852,CA,US
864,1700284020,1700298660,14640,97963,90801,US,US
123301,1698989580,1698993180,3600,156999,84928,GB,GB
3071,1699926900,1699949280,22380,133850,177910,HU,DE
94777,1699455540,1699463640,8100,74027,37621,PT,PT
5732,1700706540,1700737080,30540,178507,182413,TR,TR
102372,1699085160,1699120380,35220,99893,70703,TR,TR
110084,1700119800,1700132940,13140,194057,8436,HR,CZ
133843,1699662780,1699687560,24780,107214,145991,RO,RO
113202,1700734080,1700764740,30660,174256,119439,TR,TR
22880,1700715480,1700753880,38400,80398,98308,MX,MX
20862,1699276380,1699299900,23520,109970,37245,RO,MD
156680,1699979700,1700014680,34980,73008,151003,TR,TR
74997,1700698560,1700702820,4260,75516,157017,GB,GB
74847,1700696460,1700708520,12060,148520,83049,CZ,DE
55608,1700797140,1700812200,15060,4982,164600,FR,PL
194717,1700342820,1700355240,12420,103278,47516,US,US
163789,1699537200,1699548120,10920,114779,143138,AT,AT
179034,1700574240,1700591520,17280,20130,36282,US,US
66603,1699611540,1699625820,14280,7080,97038,IT,IT
3293,1700312580,1700348160,35580,33473,138122,TR,TR
185575,1700210520,1700220660,10140,54395,157469,PT,PT
4224,1699643280,1699678020,34740,69640,42140,TR,TR
196279,1700355720,1700384520,28800,133811,154906,TR,TR
188614,1699348320,1699377180,28860,138043,51924,TR,TR
51632,1699147080,1699150680,3600,93825,31039,GB,GB
171065,1700501340,1700536860,35520,99098,66319,TR,TR
123551,1699523400,1699553640,30240,164710,96183,TR,TR
180821,1700480340,1700518200,37860,116222,26652,MX,MX
123290,1699301520,1699332780,31260,165448,101642,TR,BG
120490,1700682660,1700686260,3600,147985,189667,GB,GB
97225,1699638960,1699654920,15960,197098,21040,US,US
16602,1700257020,1700307660,50640,198854,14328,BG,DE
25455,1700005020,1700019540,14520,147761,8831,RS,RS
107713,1699355640,1699388100,32460,178199,20423,TR,TR
133009,1699741020,1699776600,35580,179451,138216,TR,TR
25884,1699743240,1699757160,13920,34724,199555,IT,IT
24676,1698899340,1698911400,12060,6567,165869,HR,HR
123135,1700087820,1700099940,12120,26408,101800,US,US
131247,1700382420,1700414460,32040,37160,105592,TR,TR
37529,1699295760,1699309080,13320,87786,191198,AT,AT
73223,1700715720,1700728140,12420,123356,90835,US,US
124716,1699593480,1699625880,32400,188906,159830,MX,MX
152113,1699295100,1699325460,30360,170781,102032,TR,TR
70155,1699266720,1699301700,34980,174509,150348,TR,TR
178357,1699440900,1699456320,15420,134432,103748,AT,AT
89313,1700639400,1700645400,6000,128156,152418,NL,NL
145070,1698817440,1698828840,11400,72974,17855,CZ,PL
90917,1699849080,1699882800,33720,72467,98239,TR,TR
77551,1700511360,1700542860,31500,150172,175786,TR,TR
7582,1700280900,1700302560,21660,41116,129070,DE,RS
59063,1698900240,1698903840,3600,134855,151709,NL,NL
191343,1699248360,1699253940,5580,54042,46667,NL,NL
168845,1700775840,1700800380,24540,8416,132625,DE,BA
114644,1699502400,1699515900,13500,150312,33002,IT,IT
185407,1700493060,1700526960,33900,24401,30525,TR,TR
68364,1699450140,1699480560,30420,151688,151599,TR,TR
113551,1700622720,1700651820,29100,22583,144620,TR,TR
16685,1699506540,1699531560,25020,65873,4734,RO,RO
99033,1699511040,1699518720,7680,63203,141937,EE,FI
193078,1700205420,1700209020,3600,75735,69753,GB,GB
168786,1699530000,1699542300,12300,50073,39813,US,US
163580,1698821460,1698836700,15240,152446,3872,US,US
107000,1698802380,1698820740,18360,87325,77466,FR,CH
178867,1700617500,1700650200,32700,65784,3616,MX,MX
180164,1700400480,1700429520,29040,194806,75178,TR,TR
21853,1700329980,1700341320,11340,148121,128294,US,US
4217,1700055840,1700067180,11340,199943,104733,US,CA
82022,1699052700,1699056720,4020,108495,118996,GB,GB
24885,1700193180,1700224140,30960,199939,21864,TR,TR
155491,1700405520,1700409120,3600,157747,90220,NL,NL
164570,1698911520,1698917760,6240,5316,162142,NL,NL
73540,1699417740,1699452420,34680,119624,112026,TR,TR
40657,1699169280,1699198320,29040,70725,134310,TR,TR
178008,1700393580,1700406780,13200,3982,11010,PT,ES
93348,1699924200,1699962240,38040,45157,158903,MX,MX
138810,1699091100,1699122720,31620,25714,114166,TR,TR
778,1700063400,1700074620,11220,99182,120716,IT,IT
176494,1699387020,1699390620,3600,132377,130078,GB,GB
169315,1699041000,1699054140,13140,20334,59,IT,IT
127260,1699768560,1699782600,14040,60385,4364,PT,PT
135105,1699930320,1699933920,3600,59652,3192,GB,GB
64521,1700216160,1700241480,25320,54014,12116,BA,HR
58349,1699396980,1699418100,21120,190168,139325,FR,NL
138066,1698981180,1699014000,32820,1636,29425,TR,TR
189024,1700749800,1700764200,14400,108954,176340,US,US
119599,1699460400,1699480860,20460,103249,185054,FR,BE
69851,1700353020,1700387820,34800,183093,162521,TR,TR
198048,1700746440,1700780940,34500,183614,168648,TR,TR
32485,1699490100,1699493700,3600,22838,48664,NL,NL
27280,1700487000,1700502180,15180,132333,169413,AT,AT
113629,1700105220,1700135640,30420,118423,69010,TR,TR
8165,1699635360,1699666140,30780,162271,112299,TR,TR
97154,1700703600,1700708820,5220,2827,110979,GB,GB
14120,1698801060,1698836940,35880,97949,83740,TR,TR
14243,1699561380,1699574460,13080,33305,111516,US,US
174735,1699081680,1699093200,11520,137594,11237,HR,HR
148692,1699906440,1699914840,8400,74279,93068,IT,IT
122224,1699369860,1699382760,12900,139322,149027,AT,AT
14990,1700583960,1700592660,8700,41704,66190,HR,HR
37894,1700586600,1700604000,17400,110106,81930,US,US
195002,1699071420,1699085040,13620,197334,71036,IT,IT
165788,1699168980,1699172580,3600,71466,107730,GB,GB
68087,1699214760,1699245240,30480,30213,170746,TR,TR
150206,1699275420,1699304280,28860,22717,195843,TR,TR
184467,1699840620,1699844220,3600,183057,3103,GB,GB
175650,1700122440,1700139180,16740,198711,116363,FR,FR
14894,1699071900,1699080600,8700,61365,79455,IT,IT
15350,1700090100,1700093700,3600,78051,9599,NL,NL
195119,1700244300,1700272200,27900,87394,484,DE,SK
158247,1700159280,1700162880,3600,34842,47378,NL,NL
20135,1698802920,1698834780,31860,58568,143571,TR,TR
168829,1699495680,1699514760,19080,129806,115590,FR,FR
56988,1699907100,1699942140,35040,110690,16298,MX,US
75434,1699802520,1699806120,3600,82383,47993,GB,GB
151915,1700733960,1700762040,28080,101501,78481,DE,RS
29752,1699265100,1699294860,29760,46810,181775,TR,TR
10189,1700327820,1700355180,27360,156825,76876,HU,FR
140012,1699203120,1699214520,11400,9173,99517,US,US
78738,1700754360,1700786400,32040,20856,183787,TR,TR
174534,1700705340,1700718720,13380,110245,74363,US,US
194121,1700435400,1700465700,30300,87799,131186,TR,TR
153542,1699829940,1699845720,15780,44218,148498,US,US
175665,1700567700,1700599800,32100,165703,117211,TR,TR
45723,1700593320,1700622900,29580,23418,148074,TR,TR
26510,1700776740,1700812200,35460,20939,29339,TR,TR
191204,1700693760,1700697360,3600,172563,154947,NL,NL
38338,1699855200,1699882920,27720,78858,82198,DE,FR
198935,1700030340,1700033940,3600,52608,141646,NL,BE
196100,1700410920,1700437620,26700,108146,79087,BR,BR
105913,1699114320,1699149960,35640,142715,22681,TR,TR
111836,1699576860,1699610700,33840,75777,125723,TR,TR
5044,1700761140,1700772360,11220,81277,55626,IT,IT
126210,1698796080,1698827520,31440,161261,86832,TR,TR
75437,1700631480,1700660580,29100,118763,158358,TR,TR
151901,1698943260,1698958200,14940,94970,35562,US,US
192761,1699071300,1699101480,30180,92596,130910,TR,TR
175537,1700632860,1700666340,33480,196978,63408,TR,TR
75459,1699960920,1699976280,15360,191499,177366,US,US
188826,1699328520,1699339380,10860,62867,133628,IT,IT
80055,1700237400,1700249100,11700,167101,165437,IT,IT
185280,1699930860,1699965900,35040,98883,194128,TR,TR
86329,1700594760,1700607900,13140,43883,11332,IT,IT
129969,1700103060,1700106660,3600,159923,61426,GB,GB
49378,1699770960,1699799940,28980,1261,66061,TR,TR
143794,1699980240,1700003580,23340,112914,130521,DE,FR
66324,1700525640,1700560020,34380,46179,105444,TR,TR
157643,1699590780,1699607580,16800,89128,37748,US,US
36717,1699582140,1699605900,23760,135726,6664,DE,AT
132719,1700301000,1700330400,29400,45505,147179,TR,TR
39835,1698882480,1698889800,7320,154436,114093,IT,IT
128669,1699180860,1699191840,10980,13283,179665,AT,AT
127009,1699463880,1699496640,32760,52612,187114,TR,TR
168415,1699358880,1699371060,12180,51059,40159,US,US
54646,1700410140,1700438940,28800,141619,111350,TR,TR
50329,1699413120,1699417620,4500,192441,133383,NL,NL
15308,1699385400,1699415520,30120,56905,115232,TR,TR
47698,1699183560,1699215360,31800,131608,108074,TR,TR
151913,1699805280,1699830840,25560,60047,120855,DE,DE
199824,1700092320,1700103840,11520,33906,124259,PT,PT
95936,1700418960,1700452860,33900,29245,50407,TR,TR
36118,1700424420,1700435220,10800,26877,126718,US,US
14283,1700812740,1700817540,4800,194385,182298,GB,GB
4837,1699221840,1699233960,12120,138608,20883,CZ,CZ
51547,1699882080,1699913760,31680,151163,181030,TR,TR
156001,1699595400,1699599180,3780,79452,173881,GB,GB
81944,1699684740,1699697760,13020,113474,104806,IT,IT
33241,1700710080,1700722320,12240,24975,70807,IT,IT
199146,1700353200,1700370840,17640,10719,27558,US,US
45699,1698922380,1698954840,32460,87976,56864,TR,TR
63470,1700040780,1700071500,30720,45265,78663,TR,TR
136847,1700351220,1700362920,11700,112437,48603,US,US
42445,1699577160,1699597200,20040,37748,113894,LT,DE
87608,1700851500,1700883900,32400,172899,42972,MX,MX
191900,1699749960,1699763880,13920,65270,110228,US,US
196891,1699006860,1699021560,14700,63046,73947,SE,SE
114128,1699686660,1699697220,10560,97524,61653,HR,HR
119396,1699622400,1699639080,16680,76340,129591,US,US
37326,1700632500,1700665500,33000,176029,165600,TR,TR
68238,1699010100,1699021020,10920,70204,45997,IT,IT
97943,1700541660,1700573580,31920,197447,105101,TR,TR
154926,1699431660,1699459620,27960,76945,194358,BR,BR
9419,1699137480,1699143720,6240,5977,144017,GB,GB
94200,1700167620,1700171220,3600,6510,167760,NL,NL
181213,1699040160,1699069800,29640,116153,152784,TR,TR
41432,1699004760,1699036260,31500,7730,37115,TR,TR
188534,1699726500,1699730100,3600,68493,95707,GB,GB
164846,1698917760,1698933960,16200,40054,153668,FR,FR
83448,1699429140,1699443660,14520,178374,166768,FR,BE
76200,1699652700,1699681500,28800,982,196661,TR,TR
117428,1699575300,1699578900,3600,91464,75780,GB,GB
56881,1699810320,1699845540,35220,93011,125948,TR,TR
53799,1699159740,1699169160,9420,102547,27608,ES,ES
173202,1700674140,1700706900,32760,96237,159276,TR,TR
189531,1700812080,1700820180,8100,174911,72811,PT,PT
107749,1700370960,1700383980,13020,193400,98788,IT,IT
79880,1699558680,1699593780,35100,34155,199800,TR,TR
100723,1700374020,1700381700,7680,196165,110895,HR,HR
2663,1700659500,1700668020,8520,30688,34975,ES,ES
20975,1699127040,1699144440,17400,113819,47124,AT,AT
39950,1700510040,1700521860,11820,98970,4066,AT,DE
124276,1700627100,1700633100,6000,179389,168008,GB,GB
10738,1699643280,1699649700,6420,114463,139833,GB,GB
66235,1698920880,1698938640,17760,118489,38456,SE,NO
157152,1700054280,1700057880,3600,18643,6471,GB,GB
93957,1699067340,1699074480,7140,53909,169465,GB,GB
10196,1700623140,1700656080,32940,103268,138471,TR,TR
103478,1699920420,1699927080,6660,131143,93958,NL,NL
46819,1700637240,1700668860,31620,49661,134397,TR,TR
32471,1698992160,1698995760,3600,177017,48013,NL,NL
46311,1698798360,1698815580,17220,76594,31200,US,US
157093,1699785900,1699789500,3600,126844,154168,NL,NL
31123,1699427820,1699452780,24960,29464,8324,DE,IT
43985,1700107860,1700141580,33720,32795,494,TR,TR
178123,1700162340,1700197080,34740,134209,11015,TR,TR
132828,1699096500,1699115160,18660,182771,134018,LT,DE
58720,1700746140,1700780280,34140,92136,186299,TR,TR
29282,1699100220,1699113420,13200,150238,162257,ES,ES
46641,1698905040,1698927660,22620,26327,27916,DE,DE
160716,1699119840,1699130700,10860,166313,74610,PT,FR
85091,1700510160,1700523300,13140,173777,42049,HR,HR
190917,1700439360,1700456160,16800,119510,90399,US,US
131879,1700056140,1700086500,30360,146035,26303,TR,TR
148759,1700235120,1700238720,3600,22665,198120,NL,NL
41237,1700812380,1700821380,9000,124879,56720,HR,AT
8155,1699443660,1699451460,7800,106145,43404,PT,PT
185293,1699273620,1699307580,33960,145574,108254,TR,TR
52039,1699528680,1699548720,20040,119868,860,SE,SE
133868,1699704420,1699724100,19680,67851,69379,FR,FR
94165,1700653500,1700667120,13620,45005,35564,IT,IT
60714,1700636160,1700641740,5580,164830,69017,NL,NL
22602,1700615640,1700643540,27900,41578,156852,RO,IT
111578,1700754720,1700784660,29940,30086,175505,TR,TR
57879,1699743240,1699749060,5820,166107,78852,EE,EE
8678,1699866300,1699902600,36300,172156,182499,MX,MX
15988,1699342740,1699374660,31920,64304,37185,TR,TR
44191,1699010700,1699014300,3600,25912,130387,NL,NL
128344,1700223420,1700252880,29460,51989,54328,TR,TR
128605,1700533740,1700549940,16200,49919,172981,AT,AT
117040,1700106300,1700140560,34260,170416,114025,MX,MX
188860,1699507620,1699523760,16140,19401,52352,RS,HU
121169,1699807920,1699838340,30420,108327,45228,TR,TR
142091,1699400880,1699435920,35040,134052,161304,TR,TR
6245,1698992880,1699027380,34500,68626,29484,MX,MX
64471,1699033620,1699037220,3600,140033,104653,GB,GB
162897,1700800740,1700808600,7860,106769,39686,IT,IT
12435,1699933620,1699944360,10740,191494,180160,CL,CL
99337,1698805380,1698812520,7140,8145,47611,NL,NL
93735,1699451340,1699458720,7380,51333,11657,HR,HR
34710,1700091060,1700104560,13500,74663,81476,US,US
133510,1698862560,1698893640,31080,54167,51185,TR,TR
156394,1698910620,1698943500,32880,42944,92610,TR,TR
86544,1700175120,1700182500,7380,139593,166351,IT,IT
8482,1699482240,1699498200,15960,139774,106367,US,US
5954,1699312020,1699325100,13080,58429,142374,US,US
180417,1698967500,1698971940,4440,40633,180195,NL,NL
152178,1699346040,1699371660,25620,82222,57765,CH,FR
15695,1700297220,1700323080,25860,39757,77250,PL,PL
172616,1700770260,1700780160,9900,13758,27122,IT,IT
1579,1699862220,1699874880,12660,127144,165234,US,MX
131774,1699798620,1699829580,30960,19201,13941,TR,TR
21248,1698842880,1698862020,19140,90600,80769,FR,FR
135003,1700148180,1700165520,17340,96512,170472,FR,FR
180640,1699417980,1699455000,37020,191297,53684,MX,MX
136738,1700009160,1700021400,12240,180625,106597,SK,CZ
62201,1699869000,1699901520,32520,167842,29985,TR,TR
183495,1699464060,1699479720,15660,64326,38922,US,US
163680,1699985340,1700019360,34020,133689,118973,TR,TR
14691,1700133780,1700147520,13740,51273,191806,US,US
147201,1699996260,1700027700,31440,185008,22637,MK,AL
99995,1700858640,1700871060,12420,62645,119811,PT,PT
34452,1699246380,1699261620,15240,175620,26089,US,US
118854,1700174220,1700209080,34860,176057,41200,TR,TR
138357,1699364760,1699396200,31440,30228,52037,TR,TR
71617,1699323780,1699357740,33960,138198,51349,TR,TR
81711,1700683260,1700713920,30660,196308,197580,TR,TR
163683,1698948600,1698983940,35340,136944,61861,TR,TR
140268,1700807280,1700813160,5880,188920,35230,GB,GB
32872,1700640300,1700649060,8760,151691,69557,IT,IT
59604,1700824680,1700846340,21660,87845,180247,DE,CZ
167292,1699141020,1699174080,33060,27818,193684,TR,TR
103768,1698878520,1698891660,13140,30623,134525,US,US
186795,1700812020,1700827740,15720,86164,89568,US,US
23177,1699816320,1699819920,3600,128163,94259,NL,NL
47867,1699384920,1699415220,30300,124112,35151,TR,TR
187282,1700862180,1700900040,37860,172037,24554,MX,US
91005,1699663140,1699694520,31380,45936,181575,TR,TR
181175,1699869780,1699899000,29220,62618,69237,TR,TR
147849,1699489620,1699518900,29280,125315,47177,TR,TR
53992,1699171980,1699198380,26400,24293,187828,DE,DE
31102,1698920820,1698943380,22560,1748,45021,DE,PL
73346,1699100160,1699111260,11100,6590,58113,ES,ES
28505,1699013460,1699045860,32400,118605,39707,TR,TR
79989,1700855280,1700885460,30180,33446,77203,TR,TR
105466,1699058580,1699074120,15540,96064,60193,US,US
137570,1700503740,1700513940,10200,25005,129793,IT,IT
122024,1700483280,1700496600,13320,59127,149183,ES,BE
60056,1700513940,1700543760,29820,194110,159436,TR,TR
138757,1700846460,1700868300,21840,147487,152921,HU,CZ
676,1698858420,1698890220,31800,141238,83428,TR,TR
193147,1700198580,1700234460,35880,163268,117574,TR,TR
129208,1699388820,1699412400,23580,194402,89013,PL,DE
9772,1700639220,1700671620,32400,179424,113574,TR,TR
189594,1699455900,1699487760,31860,96390,135231,TR,TR
29748,1699597380,1699600980,3600,46738,106651,NL,NL
106925,1700005140,1700008740,3600,80730,34466,GB,GB
148253,1700044560,1700079960,35400,121358,185660,TR,TR
61850,1700579340,1700588460,9120,141303,95506,IT,IT
42904,1700652420,1700662320,9900,8196,28775,SK,DE
144024,1700126160,1700144640,18480,155575,6046,DK,DK
97664,1699702560,1699736640,34080,24959,96873,TR,TR
153988,1700777280,1700804580,27300,161730,70090,CH,IT
58400,1699783620,1699787220,3600,193841,85268,GB,GB
13346,1699502100,1699537920,35820,58780,172343,MX,MX
170036,1700146560,1700150160,3600,937,80764,GB,GB
113034,1699675200,1699710000,34800,86520,142095,TR,TR
98639,1700328360,1700359980,31620,196941,68107,TR,TR
154782,1700292120,1700322420,30300,80652,85654,TR,TR
126554,1699494840,1699525020,30180,104761,127328,TR,TR
139225,1699441440,1699451760,10320,78198,83392,IT,IT
90090,1699896720,1699926180,29460,154872,132920,TR,TR
148359,1699993920,1700023680,29760,156293,72571,TR,TR
167139,1700617200,1700628000,10800,24694,159169,IT,IT
161088,1699722360,1699734420,12060,59732,160931,US,US
107254,1699782960,1699814580,31620,19277,102363,TR,TR
151086,1699435920,1699467060,31140,87365,98934,TR,TR
159395,1699980540,1700010180,29640,71124,87887,TR,TR
24934,1700592480,1700626320,33840,85580,73427,TR,TR
172586,1699972860,1700004120,31260,176825,113646,TR,TR
145807,1700233020,1700267880,34860,182784,71786,TR,TR
44668,1699288680,1699304280,15600,84087,26161,US,US
60551,1700845260,1700862360,17100,42015,95873,US,US
126128,1699208700,1699235160,26460,120321,105266,DE,HR
50870,1700291880,1700327580,35700,22110,131043,TR,TR
93588,1699225440,1699251360,25920,15192,179645,RO,RO
107932,1699083960,1699117380,33420,123142,22830,MX,US
71739,1700571300,1700589540,18240,21960,33035,FR,FR
76576,1700234340,1700269680,35340,32944,181494,TR,TR
153769,1699814100,1699830720,16620,170775,114735,US,US
89931,1700425140,1700436780,11640,35919,67396,US,US
157681,1700187960,1700199960,12000,158889,105106,US,US
77106,1699590420,1699616760,26340,124179,122106,BR,BR
75579,1699080720,1699109640,28920,71848,139650,TR,TR
103545,1700176440,1700183820,7380,58549,102743,SK,SK
191621,1700853480,1700864880,11400,169128,172474,US,US
112296,1700436600,1700450280,13680,76709,121714,HR,HR
178345,1700363580,1700373660,10080,44675,81601,IT,IT
1515,1700505480,1700514960,9480,43638,102387,IT,IT
186961,1699645260,1699675380,30120,133639,189466,TR,TR
180567,1699697820,1699717260,19440,49593,23373,IN,IN
180997,1699600140,1699621860,21720,58497,19323,BR,BR
177487,1700396280,1700409840,13560,14227,143380,IT,IT
190362,1698991440,1698995280,3840,79513,188219,NL,NL
146189,1698928440,1698938280,9840,11203,57652,HR,HR
26737,1700387340,1700422440,35100,141517,26064,TR,TR
123024,1700781600,1700810760,29160,112919,173049,TR,TR
135539,1699653300,1699682700,29400,121256,32123,TR,TR
61183,1699724100,1699735680,11580,139457,134699,US,US
51969,1699619340,1699632960,13620,47731,135381,IT,IT
126983,1700820600,1700838300,17700,105399,195956,CZ,FR
167349,1700690820,1700719740,28920,122055,64379,TR,TR
105731,1700254080,1700284140,30060,140338,164253,TR,TR
56972,1699761240,1699774680,13440,198064,1787,PT,PT
67552,1699231740,1699235340,3600,89603,63550,GB,GB
1533,1699324980,1699358400,33420,70764,175444,MX,MX
31528,1699293240,1699319220,25980,158607,20212,BA,HR
153732,1699685280,1699698120,12840,72848,79938,US,US
58972,1700220600,1700237760,17160,58175,92177,BE,FR
33218,1699032360,1699045620,13260,124839,112277,HR,HR
182631,1699922460,1699958220,35760,16481,162,TR,TR
4669,1700345220,1700348820,3600,57052,57378,GB,GB
22860,1700646060,1700663700,17640,85265,124459,US,US
140313,1700425680,1700437920,12240,40239,177122,ES,ES
9555,1699703880,1699707480,3600,22710,164604,GB,GB
71643,1700105280,1700110980,5700,152354,14921,GB,GB
132583,1699137300,1699170540,33240,3858,170888,TR,TR
91962,1699348860,1699382040,33180,183839,189652,TR,TR
189408,1699277040,1699290180,13140,160906,52259,US,US
65186,1699706940,1699720320,13380,190060,67193,US,US
80353,1698975720,1698980940,5220,139489,88894,GB,GB
170983,1700140200,1700172120,31920,67536,77762,TR,BG
98567,1700369460,1700386740,17280,33248,177815,CZ,NL
8978,1699799400,1699820160,20760,120385,94986,BE,NL
39536,1699571220,1699603920,32700,103382,139180,TR,TR
66967,1700470500,1700495040,24540,150325,193470,DE,DE
161180,1699129440,1699164420,34980,115354,194064,TR,TR
156763,1700580420,1700585580,5160,104406,160514,GB,GB
38629,1698986940,1698999120,12180,155407,4434,US,US
85081,1699528080,1699546380,18300,30967,73948,FR,RS
112559,1700518860,1700550360,31500,56669,54925,TR,TR
45905,1699108080,1699138860,30780,151106,15013,TR,TR
68915,1698913260,1698931080,17820,41366,162962,FR,FR
144071,1700008740,1700037000,28260,81811,108037,DE,DE
184431,1699239660,1699253400,13740,33831,187430,PT,PT
138775,1699427820,1699437000,9180,68116,176694,ES,ES
74257,1699862220,1699865820,3600,192356,113302,GB,GB
121281,1700413020,1700442720,29700,66465,177002,TR,TR
169216,1700229180,1700264100,34920,187925,190989,TR,TR
92517,1699651200,1699659480,8280,94008,16941,IT,IT
71849,1699712880,1699743060,30180,95191,19750,TR,TR
196795,1700074740,1700101680,26940,144912,180566,BR,BR
158961,1699448400,1699457580,9180,110537,152052,IT,IT
191858,1699257960,1699271040,13080,170451,79220,AT,AT
156471,1700039400,1700073120,33720,41505,56677,MX,MX
147255,1700285040,1700316420,31380,183118,146542,TR,TR
116616,1699004040,1699034760,30720,14620,89913,TR,TR
98910,1699502220,1699506720,4500,131336,19648,GB,GB
40680,1700643300,1700655000,11700,21508,194882,US,US
171264,1699363140,1699398360,35220,168511,111879,TR,TR
177461,1699603020,1699615800,12780,177225,157256,US,US
171285,1699884420,1699888020,3600,163088,135002,GB,GB
109950,1699985640,1699997940,12300,174670,42014,IT,IT
182479,1700135700,1700163960,28260,181894,159047,DE,DE
75997,1699697220,1699727880,30660,179037,107644,BA,BA
116932,1700414640,1700448720,34080,140988,53571,TR,TR
48581,1699130220,1699133820,3600,117227,35315,GB,GB
22711,1699116360,1699123800,7440,184362,52967,PT,PT
29559,1700629200,1700642460,13260,130341,101052,US,US
73199,1700349720,1700365920,16200,59328,58081,CZ,CZ
83907,1699320180,1699356300,36120,141854,131142,MX,US
92075,1700515140,1700518740,3600,138909,57401,GB,GB
69726,1699295520,1699310760,15240,124664,198800,US,US
37971,1699672380,1699689480,17100,188718,189343,US,US
199116,1700110620,1700143560,32940,95124,147162,TR,TR
185224,1700744220,1700757420,13200,128010,100671,HR,HR
141474,1699845720,1699854360,8640,19620,23122,HR,HR
191877,1699732080,1699751040,18960,173259,91945,FR,AD
51197,1699584840,1699617180,32340,14819,35694,TR,TR
195083,1698937800,1698948840,11040,123488,117867,ES,AD
88464,1700538360,1700550600,12240,118462,127912,US,US
23532,1699861920,1699866900,4980,84324,27657,GB,GB
94528,1699626540,1699636020,9480,190286,108996,HR,HR
74767,1699191960,1699206660,14700,122281,78091,FR,GB
155572,1700543160,1700575560,32400,112518,177656,TR,TR
175171,1700556720,1700560320,3600,175857,72110,GB,GB
182712,1699260960,1699290900,29940,110308,167000,TR,TR
45478,1700627280,1700630880,3600,68222,37925,NL,NL
18862,1700629500,1700636040,6540,83915,162697,NL,NL
194307,1698882000,1698911760,29760,88391,110626,TR,TR
103563,1699832940,1699848840,15900,70728,145780,FR,FR
12210,1698931380,1698950400,19020,70288,77551,FR,NL
169573,1698850440,1698883500,33060,72940,82916,TR,TR
5450,1699773540,1699804980,31440,122370,144773,TR,TR
9214,1700460300,1700473380,13080,179513,59548,RS,RS
129046,1698900780,1698913320,12540,17169,156475,IT,IT
26329,1699152780,1699172040,19260,68130,27457,FR,BE
128163,1700573100,1700606640,33540,48965,67179,TR,TR
147484,1699734720,1699750020,15300,87389,22536,FR,HU
84403,1699081260,1699118400,37140,28684,56530,MX,MX
96121,1700458860,1700490060,31200,162002,187227,TR,TR
170559,1699378860,1699393020,14160,185328,128641,ES,ES
4162,1700048340,1700077680,29340,123722,147033,TR,TR
192944,1700384640,1700411460,26820,161511,195029,RO,RO
162519,1699857300,1699891320,34020,60575,184418,TR,TR
144437,1699795980,1699804200,8220,60855,127443,PT,PT
23479,1699762140,1699795680,33540,49833,57637,TR,TR
70106,1698838920,1698871020,32100,101088,166488,TR,TR
2694,1700616360,1700626320,9960,146578,128956,FI,EE
139987,1700355120,1700389440,34320,124135,27836,TR,TR
107872,1700839140,1700873280,34140,61553,133379,TR,TR
18380,1699692540,1699709580,17040,145577,17642,US,US
74665,1699855020,1699889400,34380,151321,18401,TR,TR
53884,1699959900,1699974120,14220,16053,132110,ES,ES
197942,1699163280,1699193760,30480,111584,72463,TR,TR
23203,1698974520,1699003680,29160,45506,146842,TR,TR
136421,1699797600,1699827900,30300,77693,49722,TR,TR
57256,1700763720,1700798760,35040,82699,193709,TR,TR
55805,1700205300,1700229180,23880,109738,29574,HU,AT
1566,1700000760,1700012040,11280,25995,74333,AT,AT
117051,1699137720,1699144200,6480,133950,171106,NL,NL
142545,1700483820,1700487420,3600,33955,138292,GB,GB
138222,1698882240,1698912720,30480,67402,76958,TR,TR
170630,1700366340,1700372220,5880,104752,12282,GB,GB
122824,1700629020,1700664840,35820,193628,183847,MX,US
178574,1700030100,1700033820,3720,88458,7869,GB,GB
50189,1698810120,1698833220,23100,114324,110487,DE,BG
187426,1698801720,1698805320,3600,194415,159361,GB,GB
144779,1700322600,1700354100,31500,86701,55569,TR,TR
176980,1698802200,1698834840,32640,6724,7468,TR,TR
66331,1700064000,1700069640,5640,521,75599,GB,GB
75680,1699518240,1699543080,24840,101439,170079,NO,DK
102512,1699131240,1699148400,17160,53524,132872,US,US
197628,1700247960,1700256960,9000,135117,84001,IT,IT
182950,1699067160,1699078800,11640,52399,93799,US,US
40635,1700055660,1700066040,10380,70239,88476,IT,IT
101626,1700846940,1700882760,35820,197029,119075,TR,TR
176968,1699071000,1699074660,3660,12192,16406,NL,NL
20526,1699778040,1699781640,3600,112442,66056,NL,NL
123164,1700135640,1700163840,28200,14761,89793,PL,PL
142675,1699393680,1699402740,9060,47120,163259,IT,IT
22475,1700070960,1700105700,34740,103910,143556,TR,TR
102946,1699959420,1699971540,12120,9538,83663,US,US
79748,1700604900,1700616540,11640,89304,178135,US,US
181504,1699365000,1699373160,8160,151340,54094,PT,PT
185437,1698810000,1698823260,13260,39643,111325,IT,IT
174634,1699038420,1699042020,3600,52309,190353,GB,GB
195450,1700404620,1700438760,34140,33642,175688,TR,TR
33616,1700112900,1700148840,35940,115753,88655,TR,TR
56792,1699267860,1699271460,3600,2016,4529,GB,GB
38287,1698980820,1699014000,33180,167384,137059,TR,TR
176155,1700468880,1700504760,35880,71358,190393,TR,TR
193420,1700446440,1700475240,28800,198101,167976,TR,TR
147565,1699990080,1699996440,6360,39638,73734,GB,GB
116300,1699919280,1699930620,11340,78212,66318,IT,IT
66199,1700756340,1700760060,3720,116232,124321,GB,GB
43565,1699721580,1699730580,9000,60634,76055,IT,IT
161399,1699902060,1699931580,29520,184341,8051,TR,TR
160495,1699127340,1699142040,14700,192654,10194,US,US
126529,1700017560,1700033520,15960,78178,57647,US,US
79703,1699398180,1699433220,35040,17214,12363,MX,MX
55311,1700793900,1700797500,3600,181635,82971,NL,PL
148979,1699118100,1699131060,12960,34584,160856,CZ,HU
55296,1700660820,1700694600,33780,122016,144097,TR,TR
183293,1699853400,1699871160,17760,37125,188784,RS,ME
42021,1698907200,1698920460,13260,1332,113415,IT,IT
69695,1700130480,1700139720,9240,25506,83261,IT,IT
45913,1700700780,1700730600,29820,163849,160892,TR,TR
175609,1700000340,1700014800,14460,23,106827,AT,AT
116744,1700821440,1700838180,16740,115791,196855,CA,US
18993,1700661300,1700670840,9540,117402,90398,HR,HR
182981,1700641800,1700672280,30480,128654,42065,TR,TR
136859,1699712280,1699740540,28260,123325,190152,DE,BA
19105,1700597220,1700629140,31920,117485,73847,TR,TR
60827,1699137120,1699171200,34080,69027,128985,TR,TR
24098,1698795660,1698813600,17940,40763,170466,AT,AT
161573,1700559120,1700575740,16620,185366,91600,US,US
122449,1699841520,1699872360,30840,156397,195797,TR,TR
144106,1700773260,1700776860,3600,91417,68885,NL,NL
28915,1700105880,1700137740,31860,169357,115051,TR,TR
60270,1700191320,1700222580,31260,80383,145721,TR,TR
120277,1698951600,1698964980,13380,103199,131856,PT,PT
140836,1699553400,1699588680,35280,192631,188823,TR,TR
68374,1700601120,1700612100,10980,85785,50079,AT,DE
72595,1700441520,1700450820,9300,23291,52587,ES,ES
58965,1699357140,1699366500,9360,123762,138447,HR,HR
73088,1699668660,1699701840,33180,122814,42808,TR,TR
72861,1698914220,1698945480,31260,107388,62900,TR,TR
63140,1700277180,1700286000,8820,188437,19703,ES,AD
175345,1700407380,1700438340,30960,148238,184003,TR,TR
50912,1699525020,1699532940,7920,19192,43548,HR,HR
52415,1700038740,1700074200,35460,54239,122175,TR,TR
38709,1700717700,1700734620,16920,82012,159171,US,US
168592,1698859200,1698871800,12600,187681,20850,HR,HR
95581,1699278420,1699282020,3600,125323,3136,GB,GB
163977,1699846380,1699880160,33780,104822,158620,TR,TR
71525,1699464600,1699474620,10020,10540,19766,PT,PT
158148,1700200620,1700233260,32640,189785,143706,TR,TR
190651,1700642880,1700665740,22860,152747,58082,DE,DE
178090,1700837520,1700867640,30120,53321,175659,TR,TR
81575,1699035120,1699065360,30240,96543,147342,TR,TR
12287,1700596500,1700629440,32940,47822,9337,TR,TR
33530,1698972060,1699009740,37680,120113,101022,MX,MX
83637,1700783340,1700813700,30360,6802,68341,TR,TR
109135,1698992820,1699025580,32760,116561,199720,TR,TR
118324,1699978380,1699985820,7440,15605,10366,HR,HR
186094,1699313700,1699336080,22380,140614,172186,PL,PL
177608,1699025220,1699040040,14820,27332,5501,US,US
31080,1700831940,1700845260,13320,130116,160378,US,US
89980,1699464060,1699498860,34800,52782,11708,TR,TR
101245,1698794400,1698826380,31980,164687,24581,TR,TR
155933,1699091760,1699125060,33300,22923,135151,TR,TR
156071,1700410980,1700414580,3600,120481,73329,GB,GB
170085,1699665780,1699695600,29820,104331,157584,TR,TR
126856,1700208060,1700243940,35880,19471,16409,TR,TR
130287,1699884840,1699893360,8520,62575,84274,ES,PT
119296,1699477920,1699498620,20700,42285,64774,BE,CH
70666,1698984540,1699012800,28260,190218,112432,DE,DE
56919,1698893040,1698905040,12000,139264,184105,IT,IT
87493,1699515780,1699533720,17940,176183,59084,RS,RS
107648,1698871500,1698882900,11400,224,92761,US,US
86721,1699583280,1699621800,38520,196689,87723,MX,MX
94618,1699870140,1699881180,11040,110937,174380,US,MX
8803,1699640280,1699652940,12660,55599,8935,IT,FR
16594,1700012940,1700017800,4860,198410,103097,GB,GB
97489,1699397220,1699429260,32040,45126,104085,TR,TR
33286,1700567520,1700580960,13440,65652,22498,IT,IT
109722,1699478280,1699502160,23880,67994,122742,DE,DE
137327,1699765620,1699776480,10860,159094,22455,HR,HR
25696,1700492460,1700510160,17700,84921,168975,FR,BE
154684,1700668020,1700675160,7140,6223,147330,GB,GB
84517,1699682040,1699699800,17760,110530,14876,US,US
190614,1700816700,1700830980,14280,78542,154609,US,US
54073,1699824360,1699830720,6360,4399,102967,GB,GB
39373,1700563740,1700576220,12480,12353,101490,AT,PL
86209,1700620440,1700655720,35280,64391,144149,TR,TR
191601,1699373820,1699404720,30900,10163,157134,TR,TR
170550,1700080260,1700099400,19140,20903,100959,FR,FR
69964,1699788060,1699811220,23160,170337,166503,PL,PL
171806,1700608080,1700642340,34260,122361,1616,MX,MX
7036,1700044200,1700068080,23880,99550,62036,PL,FR
47563,1698905640,1698922560,16920,96134,10073,US,US
128356,1700391900,1700414340,22440,21245,23245,DE,FR
53152,1699595340,1699609860,14520,151677,193127,US,US
185746,1700439660,1700473080,33420,96244,141793,TR,TR
21856,1700861220,1700891100,29880,138760,124621,TR,TR
76693,1699757580,1699789020,31440,35368,35656,TR,TR
165677,1700703780,1700736780,33000,78984,93014,TR,TR
125027,1699755180,1699767540,12360,198192,7290,PT,PT
39402,1699606200,1699636020,29820,46148,118169,TR,TR
152618,1700047500,1700059320,11820,48862,5038,IT,IT
117597,1699839660,1699843260,3600,179584,34685,GB,GB
35081,1699177320,1699204680,27360,149988,177019,HU,RS
184837,1700611740,1700628060,16320,101113,42280,US,US
55582,1698952020,1698965520,13500,189019,41173,CA,US
124369,1700473440,1700499900,26460,103207,143017,DE,HU
174239,1700622120,1700633640,11520,181169,40076,HR,HR
190985,1700396340,1700409960,13620,189847,113938,IT,IT
43345,1699340340,1699359300,18960,135722,12461,FR,CZ
6426,1698984600,1698989520,4920,86380,159753,GB,GB
18296,1699549800,1699553400,3600,138601,109601,GB,GB
178687,1700294940,1700298540,3600,108853,175083,GB,GB
21527,1699217340,1699234620,17280,196200,34063,US,US
133597,1699303200,1699306800,3600,190165,80104,GB,GB
94395,1699854480,1699866000,11520,124387,77441,US,US
168493,1699932600,1699967220,34620,126403,149291,TR,TR
98049,1699680360,1699683960,3600,133785,20021,GB,GB
155229,1699446840,1699482060,35220,11672,94974,TR,TR
87338,1700561460,1700591400,29940,41703,30725,TR,TR
11026,1699368300,1699377480,9180,91535,91097,IT,IT
59579,1700500020,1700535120,35100,17075,104287,TR,TR
106133,1700641380,1700662380,21000,71006,117982,FR,FR
134152,1699259520,1699291140,31620,58157,118049,TR,TR
64660,1698910200,1698929460,19260,1176,13910,MD,RO
112238,1699230840,1699265040,34200,65796,57641,TR,TR
102201,1699659960,1699672740,12780,61039,126996,PT,PT
16454,1699594080,1699597680,3600,55419,198997,NL,NL
21095,1699940880,1699968420,27540,97983,167618,DE,DE
103979,1699168080,1699197780,29700,12839,150682,TR,TR
15928,1699854840,1699879260,24420,104593,104053,HU,PL
50760,1699174860,1699182960,8100,60592,84931,IT,IT
147041,1700548500,1700573700,25200,101258,160500,RO,RO
10764,1699162800,1699180560,17760,109255,94911,US,US
189676,1699566660,1699589340,22680,175855,195897,BR,BR
5010,1698971400,1698975000,3600,1090,155911,GB,GB
134426,1700623560,1700637180,13620,12149,73511,HR,HR
143499,1699550100,1699562460,12360,53098,36315,CZ,CZ
22279,1699952640,1699983420,30780,177600,179081,TR,TR
196440,1699469940,1699523220,53280,7917,187441,BG,GR
164084,1700168400,1700200440,32040,70402,25517,TR,TR
123305,1699746000,1699759380,13380,98858,64929,ES,ES
28616,1700675220,1700704440,29220,83014,17100,TR,TR
60694,1700831160,1700862840,31680,10216,110223,TR,TR
30341,1698876660,1698890460,13800,84131,114603,IT,IT
112680,1700190960,1700197740,6780,120750,140492,GB,GB
28736,1699406160,1699420380,14220,65731,154575,RS,RS
101997,1699821660,1699825680,4020,70972,97810,NL,NL
45910,1699885920,1699918740,32820,32427,43941,TR,TR
82185,1698976860,1699008120,31260,54457,18836,TR,TR
181413,1700821260,1700855340,34080,79147,19880,TR,TR
155277,1699081080,1699086000,4920,195285,88784,GB,GB
35050,1700482440,1700500140,17700,44546,58973,US,US
24317,1700830920,1700844540,13620,7352,88944,PT,PT
30058,1698863160,1698893880,30720,32669,148245,TR,TR
135525,1700329860,1700339220,9360,122226,42198,IT,IT
52220,1700818860,1700851140,32280,109576,90888,TR,TR
35589,1699267080,1699302780,35700,35496,147744,TR,TR
169038,1699689120,1699719060,29940,186345,44663,TR,TR
125039,1699093320,1699120380,27060,26729,132114,DE,DE
106436,1700161140,1700196000,34860,77158,185479,MX,MX
16004,1700515080,1700518680,3600,137979,8491,GB,GB
192431,1699939800,1699955040,15240,78326,97046,US,US
145674,1699526880,1699530480,3600,99452,128810,GB,GB
189090,1700064660,1700096220,31560,149832,21581,TR,TR
38991,1700028840,1700064000,35160,184944,151034,TR,TR
290,1700351160,1700384940,33780,146276,28071,TR,TR
176073,1700250780,1700265540,14760,139377,130513,RS,RS
111500,1700728380,1700761080,32700,154248,151264,TR,TR
198407,1700684280,1700696460,12180,37599,63132,IT,IT
77490,1700171940,1700198880,26940,36582,107947,PL,PL
188589,1700404440,1700440260,35820,134869,69180,TR,TR
101161,1699823040,1699855920,32880,87961,52993,TR,TR
179965,1700051640,1700080800,29160,84530,95126,TR,TR
150676,1699468500,1699504080,35580,159655,158407,TR,TR
132578,1699993080,1700025840,32760,58710,10048,TR,TR
149536,1700657820,1700687580,29760,50880,107030,TR,TR
169966,1698971940,1698986340,14400,109377,95099,US,US
44358,1700827080,1700844300,17220,147207,168489,CZ,PL
95247,1700155380,1700185500,30120,19441,67572,TR,TR
88075,1700285580,1700289360,3780,107432,68907,NL,NL
86966,1700770500,1700783100,12600,181867,73691,AT,AT
82942,1699777980,1699791540,13560,107105,181651,IT,DE
169506,1698831900,1698864060,32160,39807,146469,TR,TR
64688,1700177820,1700188020,10200,149207,189208,IT,IT
191249,1700457960,1700488620,30660,30821,3208,TR,TR
105964,1699124520,1699156320,31800,126830,13548,TR,TR
190150,1699265520,1699282980,17460,42997,30411,US,US
163976,1698832500,1698858900,26400,87540,118918,DE,DE
105507,1700096700,1700129160,32460,185207,27556,TR,TR
196467,1700445540,1700460960,15420,11612,180003,US,US
111338,1699187280,1699203720,16440,97887,77375,FR,ES
185367,1700455620,1700490180,34560,52541,188085,TR,TR
25187,1699975440,1699997280,21840,28247,95280,DE,DE
74739,1698830940,1698836880,5940,96145,48011,GB,GB
64340,1700359440,1700387940,28500,183972,167518,DE,BG
63836,1699867680,1699881600,13920,44158,30251,US,US
138957,1699888800,1699906560,17760,28141,147410,RS,RS
192660,1700857440,1700869260,11820,181304,52692,US,US
84412,1699285080,1699299960,14880,59495,140596,RS,HU
16312,1700604060,1700615580,11520,20106,19753,US,US
6035,1699338540,1699357800,19260,33075,86463,FR,FR
74882,1699737780,1699788720,50940,182377,86318,BG,DE
30113,1699470060,1699479480,9420,29558,155556,HR,HR
28956,1699447740,1699455960,8220,37795,1170,IT,IT
47958,1700162040,1700175240,13200,145692,154785,US,US
35518,1699717920,1699729500,11580,171210,31330,IT,IT
103375,1699612560,1699642620,30060,100819,31595,TR,TR
59214,1699185960,1699194120,8160,149410,167540,IT,IT
35622,1699065960,1699100640,34680,140921,99860,TR,TR
171396,1700575680,1700590320,14640,77991,187097,US,US
56971,1700689680,1700700180,10500,54847,85476,IT,IT
196571,1700460300,1700474580,14280,58566,124950,US,US
74575,1700166540,1700195640,29100,73752,70018,TR,TR
140537,1700539920,1700543760,3840,161338,69710,GB,GB
138150,1700019300,1700030400,11100,108758,28105,IT,IT
156254,1700480460,1700494440,13980,108414,158667,SK,IT
38059,1700624220,1700631420,7200,1946,146289,IT,IT
52716,1700768580,1700801280,32700,141886,57200,TR,TR
4374,1700431320,1700438100,6780,9456,134574,GB,GB
58600,1699845060,1699873980,28920,46484,6011,TR,TR
150032,1699219920,1699234140,14220,129014,72462,US,US
129736,1699966920,1699984680,17760,106112,69440,FR,FR
119414,1700592420,1700627220,34800,89910,199794,TR,TR
124840,1699423320,1699432860,9540,98161,175361,SK,CZ
130861,1700115480,1700128920,13440,145237,73237,US,US
121755,1699557780,1699561980,4200,53649,25562,NL,NL
145197,1698865320,1698871380,6060,111602,172138,GB,GB
85435,1699987320,1700019600,32280,169187,71894,TR,TR
67487,1698810120,1698822420,12300,31970,109206,CZ,EE
157565,1700761260,1700789160,27900,165951,197188,BR,BR
107569,1700344380,1700373300,28920,107876,81636,TR,TR
81414,1699823280,1699852860,29580,2009,42043,TR,TR
28139,1700342040,1700369280,27240,107738,71866,DE,DE
122220,1699264920,1699293240,28320,66292,89856,ME,RS
141311,1700374920,1700410620,35700,13856,96136,TR,TR
8617,1699460400,1699471200,10800,120514,166659,RS,RS
70744,1700697540,1700729520,31980,98983,199394,TR,TR
122394,1699427280,1699457520,30240,12756,195015,TR,TR
105438,1698802680,1698824040,21360,106388,110386,AL,MK
184901,1700787720,1700791320,3600,113620,92398,NL,NL
177539,1698932880,1698960060,27180,150210,34593,DE,DE
104344,1700018580,1700048700,30120,183381,187948,TR,TR
72307,1700837340,1700853360,16020,173959,92122,RS,RS
109209,1699744020,1699756800,12780,146936,36478,IT,IT
197172,1700775420,1700806980,31560,125264,47187,TR,TR
131634,1700155620,1700161980,6360,128564,103906,GB,GB
18611,1700157360,1700189220,31860,1208,195997,TR,TR
8848,1699423560,1699445460,21900,87466,197238,PL,DE
35127,1699683600,1699713300,29700,138784,188611,TR,TR
59909,1698944520,1698951840,7320,122654,95489,HR,HR
162537,1700510280,1700533500,23220,52613,84000,DE,FR
193815,1700721480,1700731620,10140,57824,170704,IT,IT
101942,1699769820,1699804320,34500,184334,193331,TR,TR
138319,1699814760,1699837560,22800,88935,62070,PL,PL
56012,1700376120,1700381160,5040,103229,85875,GB,GB
28593,1699176180,1699207500,31320,132882,132837,TR,TR
108580,1699076100,1699107720,31620,111001,97426,TR,TR
99560,1699826220,1699880400,54180,104113,31459,BG,DE
114920,1698882300,1698912000,29700,46849,158702,TR,TR
59212,1700077980,1700108640,30660,114088,160863,TR,TR
123310,1699238460,1699244040,5580,38183,180811,AD,ES
78359,1699991700,1700026800,35100,130427,67191,TR,TR
130091,1699066560,1699080480,13920,182043,71844,US,US
73492,1699210320,1699220340,10020,132576,41491,HR,FR
18928,1700042880,1700059320,16440,39413,73743,FR,FR
104481,1699419180,1699448940,29760,124638,38972,TR,TR
25089,1699656480,1699663320,6840,91154,151517,GB,GB
140767,1699844460,1699873500,29040,71465,157801,TR,TR
161455,1699679400,1699694520,15120,126615,70894,US,US
175293,1699617600,1699639500,21900,116491,155730,RO,MD
156049,1699018620,1699036140,17520,116925,198807,US,US
156123,1699029000,1699063560,34560,45235,55893,TR,TR
196429,1699722420,1699754700,32280,187870,190544,TR,TR
33194,1700793360,1700823180,29820,179335,7481,TR,TR
47381,1699493220,1699504740,11520,134305,6706,IT,IT
17581,1699742160,1699776360,34200,58224,28516,TR,TR
29090,1700469480,1700474880,5400,172406,96706,GB,GB
169934,1700443620,1700456940,13320,120751,72169,IT,IT
198696,1699957200,1699989720,32520,196826,109324,TR,TR
105852,1698810900,1698819060,8160,166293,42877,IT,IT
68623,1699000620,1699034700,34080,164388,5648,TR,TR
31648,1699329720,1699333320,3600,85824,112174,GB,GB
149393,1700275800,1700290680,14880,57524,130594,US,US
150593,1699501320,1699533780,32460,50014,177701,TR,TR
25255,1698862920,1698895140,32220,76797,59538,TR,TR
155395,1699048800,1699059660,10860,166642,165960,IT,IT
23298,1699946460,1699966500,20040,17093,38709,FR,RO
101825,1699635900,1699660260,24360,183437,29511,AL,MK
109144,1700502360,1700516280,13920,20542,64766,IT,IT
4678,1699456560,1699463280,6720,79712,42569,GB,GB
25542,1699129620,1699164240,34620,88463,59130,TR,TR
100029,1698800160,1698807960,7800,97467,195772,HR,HR
157321,1699553820,1699559100,5280,129882,53663,GB,GB
79120,1699080060,1699094340,14280,43389,145091,US,US
102319,1699473480,1699477080,3600,80251,171715,GB,GB
33868,1699028160,1699040880,12720,57088,99764,US,US
123793,1700406240,1700434140,27900,167772,133569,DE,IT
26860,1698873000,1698904740,31740,94945,164155,TR,TR
109114,1700266860,1700283000,16140,82028,131028,US,US
16931,1698829620,1698849240,19620,66876,107262,FR,CH
199189,1699564440,1699578900,14460,42054,64594,RS,RS
30859,1700606940,1700610900,3960,132615,34946,CL,CL
159871,1699086420,1699090020,3600,121978,146967,GB,GB
80650,1700598660,1700620320,21660,156247,194517,DE,CZ
107554,1698924780,1698934680,9900,157495,27977,IT,IT
71837,1700110980,1700133540,22560,21308,105160,PL,DE
55457,1699040340,1699073760,33420,180349,3823,TR,TR
120509,1700130960,1700166180,35220,157428,95344,TR,TR
134219,1699809240,1699812840,3600,26034,27469,GB,GB
111076,1699710420,1699715700,5280,76805,150742,GB,GB
73915,1699393140,1699396740,3600,177836,129217,GB,GB
135806,1699910340,1699925520,15180,139378,88874,FR,FR
53094,1699145700,1699181220,35520,142524,156703,TR,TR
41632,1698959580,1698994320,34740,161735,161911,TR,TR
179431,1699570620,1699586760,16140,157379,187701,US,US
149710,1699837200,1699843080,5880,14941,147066,GB,GB
40235,1700415420,1700448600,33180,17995,182637,TR,TR
111018,1700437260,1700449020,11760,122410,16793,US,US
89518,1700187300,1700202900,15600,174796,106141,US,US
127327,1699128000,1699163100,35100,98469,25665,TR,TR
83325,1700763120,1700777820,14700,163756,56867,AT,AT
72047,1699075800,1699086600,10800,77116,128411,IT,IT
66930,1700581080,1700584800,3720,32486,61112,NL,NL
139313,1700155380,1700162280,6900,180944,174728,NL,NL
154836,1698922980,1698953100,30120,106644,69481,TR,TR
74585,1700443440,1700447040,3600,159215,130852,GB,GB
13353,1699667160,1699700340,33180,171107,54850,TR,TR
186639,1700528040,1700535480,7440,71664,106878,IT,IT
49501,1700673240,1700685780,12540,103536,41963,IT,IT
6914,1700049300,1700069940,20640,62628,146422,FR,PL
115834,1699839300,1699873200,33900,158866,19687,TR,TR
47898,1699878060,1699892940,14880,105719,99016,US,US
48939,1700517960,1700551260,33300,191352,173392,TR,TR
18925,1700549280,1700561520,12240,92296,124684,US,US
97826,1700648580,1700682480,33900,96732,228,TR,TR
155283,1699867380,1699901760,34380,160182,135866,TR,TR
187527,1700777460,1700781060,3600,181529,28198,NL,NL
42482,1700846400,1700876520,30120,26128,124089,TR,TR
157752,1699208520,1699212120,3600,182701,111623,NL,NL
151968,1700756040,1700790300,34260,2055,128623,TR,TR
86698,1700631000,1700644860,13860,70637,187654,HR,HR
188901,1699889820,1699904340,14520,169247,85435,BE,PL
12284,1699129200,1699148940,19740,68428,89504,BE,FR
47123,1699140600,1699153920,13320,99091,141843,IT,IT
191331,1700377200,1700407860,30660,54373,57613,TR,TR
65723,1698837780,1698845940,8160,85362,20973,ES,ES
71800,1700159760,1700163360,3600,12662,104813,NL,NL
31584,1699887660,1699927020,39360,193030,59910,MX,MX
146864,1699898340,1699912680,14340,21513,141976,US,US
110719,1700692020,1700703540,11520,64002,97786,US,US
96578,1700717760,1700752680,34920,15089,65354,TR,TR
21850,1699081980,1699085580,3600,165007,56606,GB,GB
138108,1698804180,1698807780,3600,195015,196216,GB,GB
177356,1700313540,1700317140,3600,186968,12158,NL,NL
39678,1699467120,1699473960,6840,101096,26999,NL,NL
12932,1699354260,1699386840,32580,109376,166024,MK,RS
119580,1699226040,1699257420,31380,92057,168013,TR,TR
112986,1699356660,1699360260,3600,46437,132696,NL,NL
128943,1700717760,1700729100,11340,160265,33719,US,MX
32457,1700728020,1700738460,10440,63053,88761,IT,IT
13991,1699325100,1699328700,3600,175920,107180,NL,NL
90469,1700126460,1700140020,13560,44521,8355,US,US
137014,1699943820,1699947420,3600,53188,28010,GB,GB
49247,1700475000,1700509620,34620,191640,199341,TR,TR
24634,1700627400,1700641560,14160,68382,2460,AT,CZ
163304,1700401620,1700439420,37800,99980,155670,MX,MX
2453,1699531380,1699542240,10860,110829,175375,US,MX
135378,1699487580,1699504740,17160,65132,181505,RS,RS
115757,1699558500,1699570740,12240,27840,177718,US,MX
99912,1699045140,1699069980,24840,178662,78694,RO,IT
20096,1698855360,1698868860,13500,99180,148143,US,US
12875,1699014720,1699028400,13680,4401,63270,PT,PT
16815,1700310780,1700338500,27720,120036,28354,DE,NL
81674,1699003200,1699035720,32520,107537,46870,MX,MX
185023,1699269900,1699279260,9360,77556,143937,IT,IT
87882,1700198160,1700212140,13980,63430,142949,US,US
88819,1699961940,1699992840,30900,73290,43298,TR,TR
45259,1699122780,1699128900,6120,2797,32326,NL,NL
5060,1700342040,1700371080,29040,194540,43091,TR,TR
197352,1699052700,1699067580,14880,13902,47102,US,US
165468,1699180200,1699209180,28980,121248,178221,TR,TR
162477,1699885740,1699899000,13260,34506,27691,CZ,CZ
106161,1700206980,1700234160,27180,24491,6954,RO,RO
168303,1699287780,1699311660,23880,62301,132916,PL,PL
184300,1699522740,1699526340,3600,112498,103260,GB,GB
8641,1700213940,1700246640,32700,156010,95169,TR,TR
79160,1699308240,1699322160,13920,62598,140145,IT,IT
129287,1699594020,1699628520,34500,88315,71270,TR,TR
177084,1699999980,1700035860,35880,171242,23412,TR,TR
103927,1699829460,1699857780,28320,126661,37432,DE,AT
85634,1699132740,1699165320,32580,179370,2127,TR,TR
7585,1699304340,1699315380,11040,190023,39149,US,US
102305,1700037900,1700052240,14340,135596,192372,US,US
172795,1700035200,1700049420,14220,47894,85868,IT,IT
65242,1699973400,1700003040,29640,102264,138716,TR,TR
6539,1700600460,1700624580,24120,82814,133199,RO,RO
186921,1700363220,1700378640,15420,72833,35964,AT,AT
107510,1698810180,1698816180,6000,121805,198558,EE,EE
138109,1700830620,1700841360,10740,173935,53203,IT,IT
106188,1699803300,1699817040,13740,106083,157865,IT,IT
10456,1700503920,1700537940,34020,2880,69317,MX,MX
60557,1699337940,1699372500,34560,80041,91855,TR,TR
120504,1699230600,1699264380,33780,11093,106690,TR,TR
119808,1699191840,1699195440,3600,188514,160926,GB,GB
90087,1699206480,1699223940,17460,7936,84415,US,US
78867,1699973340,1699986480,13140,84902,195492,CA,US
9620,1699090320,1699119360,29040,64516,143809,TR,TR
130140,1699866240,1699869840,3600,102925,89995,GB,GB
107848,1700116980,1700126100,9120,106802,97928,PT,PT
115614,1699335420,1699345680,10260,18087,157928,IT,IT
127841,1699563600,1699592220,28620,52784,151903,BA,DE
135577,1700073000,1700098920,25920,139281,120409,BR,BR
123130,1699795020,1699808940,13920,154127,698,IT,IT
106242,1700699040,1700711760,12720,59171,96312,IT,IT
28576,1699943700,1699978500,34800,95789,48578,MX,MX
179356,1699346400,1699350000,3600,17082,84849,NL,NL
148059,1699677420,1699693140,15720,196652,39525,US,US
155874,1699271880,1699290240,18360,42701,44703,IN,IN
38617,1699461180,1699478760,17580,101971,129072,US,US
134114,1700697360,1700707020,9660,193518,31105,IT,IT
132392,1699149780,1699178640,28860,105850,125959,TR,TR
46055,1699410480,1699442880,32400,192700,139997,TR,TR
167924,1700105160,1700113260,8100,105435,118292,PT,PT
196054,1700287740,1700313120,25380,148068,159653,DE,CZ
183480,1699496940,1699504320,7380,158414,136708,IT,CH
75903,1700490660,1700494260,3600,84706,13914,NL,NL
123982,1700174400,1700183040,8640,77548,20529,HR,HR
51867,1699793700,1699812840,19140,8264,26727,FR,FR
89480,1700741220,1700752800,11580,146187,101673,IT,IT
137005,1698992640,1699027200,34560,12409,8090,TR,TR
37140,1700850300,1700859000,8700,7810,106972,IT,IT
112948,1699000020,1699012020,12000,80776,25053,HR,HR
4885,1700329320,1700364180,34860,33598,107273,TR,TR
20475,1699367340,1699400520,33180,173759,142730,TR,TR
91712,1699148340,1699157880,9540,70528,188579,IT,IT
77026,1699029420,1699062900,33480,38603,122849,TR,TR
124888,1700155320,1700166120,10800,17063,26586,AT,AT
125907,1698794820,1698805560,10740,146573,75282,IT,IT
11602,1700754300,1700788200,33900,179981,92053,TR,TR
95272,1699741860,1699776780,34920,172865,128330,TR,TR
27341,1700358480,1700371680,13200,55912,64334,CZ,CZ
113283,1699399680,1699428900,29220,75530,12577,TR,TR
85635,1700533440,1700544300,10860,83777,40220,US,US
70173,1700733180,1700736780,3600,146613,177417,GB,GB
106798,1698970320,1698999660,29340,154668,54965,TR,TR
3910,1700656800,1700663700,6900,37416,194214,GB,GB
144336,1699890300,1699895460,5160,14149,66409,GB,GB
123073,1700406600,1700421480,14880,175546,196885,US,US
173724,1699051920,1699063380,11460,118874,190408,ES,ES
37226,1698904620,1698912480,7860,10322,51104,IT,IT
84830,1699343040,1699375020,31980,169040,150301,TR,TR
108712,1699565940,1699580640,14700,134530,69109,FR,IT
22062,1700112660,1700117880,5220,148734,172701,NL,NL
128219,1699605120,1699613880,8760,38662,46411,IT,CH
23217,1699968300,1699971900,3600,164063,1368,GB,GB
7590,1700084100,1700122680,38580,147834,6246,MX,US
35922,1699937940,1699969560,31620,100372,31896,TR,TR
129118,1698806340,1698839820,33480,187919,37515,TR,TR
7793,1700757840,1700766120,8280,72229,151353,IT,IT
28415,1700630280,1700660100,29820,175411,195963,TR,TR
173381,1700562840,1700576460,13620,10137,59493,US,US
29454,1700819400,1700833560,14160,141602,11319,HR,HR
161887,1699828740,1699851000,22260,135287,86276,CH,IT
189095,1699138920,1699155540,16620,73893,159394,US,US
99188,1699344120,1699347720,3600,50751,150784,NL,FR
190908,1700533860,1700567040,33180,158627,40129,TR,TR
51286,1700103540,1700115600,12060,187986,184217,US,US
182518,1700094720,1700115900,21180,120457,9007,FR,FR
17686,1699020660,1699050900,30240,18457,25251,TR,TR
137227,1700830380,1700868300,37920,129421,15607,MX,MX
43822,1699997340,1700030160,32820,183071,71971,TR,TR
198979,1698882480,1698913560,31080,185595,29706,TR,TR
114761,1699473960,1699485420,11460,112860,128936,IT,NL
76481,1700636280,1700655660,19380,57396,54378,BE,HR
45927,1699883340,1699913040,29700,94893,142468,TR,TR
171328,1699987920,1700020860,32940,161096,128515,TR,TR
112623,1699468800,1699481820,13020,37118,57318,IT,IT
27927,1700122380,1700138400,16020,193882,144461,US,US
94323,1699620480,1699653000,32520,152477,197169,TR,TR
23873,1700364720,1700400840,36120,97873,191442,MX,MX
170450,1698875040,1698930420,55380,25811,116343,BG,AT
113641,1699085520,1699089120,3600,82813,5148,NL,NL
156296,1698882720,1698914340,31620,190607,72842,TR,TR
59729,1699260120,1699291020,30900,886,109377,TR,TR
194790,1699495740,1699503780,8040,95877,161158,IT,IT
106098,1700799180,1700833380,34200,67286,20437,TR,TR
114031,1699968180,1700000580,32400,51095,86742,TR,TR
175341,1700828760,1700850540,21780,54084,166852,DE,DE
43903,1699839480,1699846500,7020,15081,188343,NL,NL
164543,1699793340,1699826700,33360,121076,30706,TR,TR
15842,1700689320,1700724780,35460,68338,150398,TR,TR
144148,1698907200,1698925440,18240,69672,174417,FR,IT
29744,1699094100,1699127640,33540,179974,146963,TR,TR
140553,1699690320,1699721280,30960,55033,169129,TR,TR
13284,1700651460,1700656320,4860,191366,97737,GB,GB
95357,1699991100,1700004180,13080,72746,24064,US,US
130058,1700395140,1700415720,20580,22985,118750,FR,FR
199888,1698810060,1698839220,29160,67287,186868,TR,TR
191768,1699950300,1699979400,29100,29665,1027,TR,TR
135132,1699944120,1699951860,7740,2063,46770,IT,IT
111439,1699842900,1699882320,39420,44372,30423,MX,MX
62110,1699505460,1699535100,29640,192057,109729,TR,TR
83219,1699866780,1699902180,35400,6437,98194,MX,MX
35017,1700335560,1700350860,15300,51518,19509,SE,SE
20321,1699130040,1699161600,31560,137804,72225,TR,TR
128114,1699520040,1699530960,10920,41108,115013,RS,RS
164018,1700093520,1700126520,33000,94299,45499,TR,TR
88388,1700478060,1700512980,34920,130278,85237,MX,US
91284,1700490000,1700517900,27900,181094,86178,HU,AT
121770,1700820360,1700824320,3960,91015,11699,GB,GB
163456,1700220660,1700229720,9060,130109,64610,ES,ES
156415,1699822320,1699855320,33000,73260,160304,TR,TR
43377,1699669680,1699673280,3600,52690,36392,GB,GB
128877,1700630880,1700647740,16860,143694,111525,FR,DE
32223,1700382420,1700417940,35520,140135,38860,TR,TR
104370,1699612560,1699629420,16860,161361,143439,US,US
123754,1700496780,1700513280,16500,81577,4183,FR,FR
105955,1699425960,1699431840,5880,194890,140453,GB,GB
42707,1700792520,1700799000,6480,43285,142743,NL,NL
10459,1699637700,1699643760,6060,176028,160952,GB,GB
72009,1700119800,1700128800,9000,1634,158544,IT,IT
68817,1700233440,1700268420,34980,111246,162116,TR,TR
198370,1699579680,1699590540,10860,24620,14082,IT,DE
144973,1700634600,1700670000,35400,89007,91280,TR,TR
70957,1699785240,1699788840,3600,166521,88632,GB,GB
152333,1699001340,1699012860,11520,39354,99970,AT,AT
23075,1700424540,1700454060,29520,1960,9196,TR,TR
191370,1700447340,1700469600,22260,177898,31724,DE,IT
38274,1700840160,1700854740,14580,123311,108021,RS,MK
106642,1698883860,1698887460,3600,127595,158720,NL,NL
12864,1699020600,1699047120,26520,123492,47171,BR,BR
20245,1699283280,1699318920,35640,14436,177550,TR,TR
62434,1700142120,1700165640,23520,60010,44098,DE,BA
36858,1700124720,1700155680,30960,186861,81457,TR,TR
67700,1699943460,1699976160,32700,41661,126162,TR,TR
21286,1699962060,1699971720,9660,156138,180168,EE,EE
120866,1700291520,1700327460,35940,108515,119128,TR,TR
2676,1699792560,1699796160,3600,179899,80501,NL,NL
81049,1699319760,1699349760,30000,55396,11932,TR,TR
24790,1700484480,1700512200,27720,175682,164993,DE,DE
36054,1700224140,1700258880,34740,62894,122459,TR,TR
48482,1700380800,1700415720,34920,138658,175916,TR,TR
198993,1699656480,1699660080,3600,28270,111572,NL,NL
178887,1698815940,1698822720,6780,767,192424,NL,FR
26990,1699634460,1699646520,12060,37042,72382,US,US
12576,1699724880,1699753200,28320,144355,132029,DE,DE
62816,1699136340,1699139940,3600,76359,46674,GB,GB
137019,1700474760,1700480100,5340,88677,119651,NL,NL
93759,1700285040,1700292000,6960,84456,79012,GB,GB
147091,1699905840,1699931340,25500,38341,38084,BA,DE
100036,1698861720,1698891300,29580,187531,86540,TR,TR
95436,1700815980,1700837460,21480,164414,20925,DK,DK
33104,1699386120,1699404960,18840,184435,25934,FR,FR
118958,1698881040,1698895440,14400,109629,10308,US,US
84483,1698969000,1699001520,32520,157473,42602,TR,TR
145938,1699456320,1699486560,30240,102833,174727,TR,TR
11603,1700580900,1700595120,14220,71420,169192,US,US
80630,1699048320,1699055640,7320,172477,80610,IT,IT
193161,1699674600,1699704360,29760,57302,90963,TR,TR
26962,1700561040,1700596440,35400,47927,88766,TR,TR
135838,1698916980,1698937200,20220,132311,60677,FR,FR
54372,1699511220,1699518120,6900,156948,124141,GB,GB
167804,1700242620,1700269560,26940,118411,188789,DE,PL
2840,1698965220,1698985500,20280,180437,139567,FR,FR
77956,1699434780,1699464240,29460,193217,60253,TR,TR
33696,1699294740,1699309140,14400,50436,87360,US,US
61337,1700796120,1700831280,35160,19778,69029,TR,TR
167473,1700639880,1700674320,34440,64109,58291,TR,TR
162443,1700857740,1700861400,3660,181913,194298,GB,GB
143440,1698898200,1698927360,29160,140390,60857,TR,TR
74261,1700331000,1700362020,31020,73602,82226,TR,TR
98931,1699380420,1699409280,28860,29588,163220,TR,TR
38070,1699231380,1699239780,8400,103206,191992,IT,IT
98337,1700325840,1700346420,20580,89260,47813,DK,DK
43920,1698999240,1699034400,35160,74510,34616,TR,TR
55290,1700819220,1700830620,11400,154051,50652,IT,IT
126911,1699737480,1699769460,31980,44760,87998,TR,TR
188543,1698835740,1698870480,34740,162940,102074,TR,TR
56426,1699613820,1699648620,34800,139447,160266,TR,TR
159050,1699905300,1699936620,31320,31171,192419,TR,TR
165450,1700281800,1700317380,35580,174379,89796,TR,TR
48479,1700223060,1700236860,13800,102792,105976,HR,BA
98276,1700234880,1700268180,33300,137041,155594,TR,TR
171857,1699998180,1700031180,33000,137141,199051,TR,TR
37408,1699775820,1699790160,14340,36819,184607,IT,DE
175608,1699714380,1699746480,32100,56333,146288,TR,TR
57527,1699352760,1699379580,26820,73219,168012,DE,GB
133240,1700848560,1700873520,24960,150091,33561,CH,IT
64004,1699877280,1699910880,33600,110256,60852,TR,TR
127146,1700768040,1700771640,3600,154332,57501,GB,GB
120707,1699060140,1699070820,10680,129088,66792,IT,IT
123273,1700620020,1700636640,16620,40635,75753,US,US
57023,1700254680,1700283360,28680,92062,154444,PL,BE
52913,1699793100,1699796700,3600,34297,922,NL,NL
122390,1699186260,1699221720,35460,152118,120254,MX,US
53462,1700143140,1700154420,11280,89244,135382,IT,IT
153982,1699227600,1699258980,31380,9005,191374,TR,TR
165845,1700544480,1700562180,17700,52271,140279,US,US
101297,1698804540,1698823500,18960,140766,191071,FR,PT
4065,1699397760,1699419720,21960,177899,13063,DE,BG
82021,1698959280,1698972480,13200,47419,46949,SK,SK
126174,1698996960,1699031340,34380,60310,71713,TR,TR
24996,1700607240,1700610840,3600,9610,161831,NL,NL
128535,1699569480,1699583940,14460,103565,86080,US,US
109102,1699338840,1699365960,27120,15646,548,NO,DK
30192,1699838040,1699870440,32400,46393,24789,TR,TR
75311,1699446360,1699462440,16080,173534,83449,US,US
141263,1698836280,1698868140,31860,84356,90211,TR,TR
149433,1699919760,1699953420,33660,182394,16439,TR,TR
130998,1699316520,1699322220,5700,127910,9919,GB,GB
68694,1699576680,1699588200,11520,61239,175826,HR,HU
76978,1699300860,1699331160,30300,175120,190937,TR,TR
103513,1700566200,1700595780,29580,190187,38166,TR,TR
125998,1699845120,1699861200,16080,131573,99495,FR,FR
65731,1699824600,1699830000,5400,147011,44557,GB,GB
168675,1700424120,1700434980,10860,89308,65621,HR,HR
73995,1699084740,1699095540,10800,126263,33938,AT,DE
108944,1699395240,1699427040,31800,138869,66707,TR,TR
75697,1700640840,1700675040,34200,134398,125103,TR,TR
141678,1699322820,1699337880,15060,16429,161199,AT,AT
39544,1700160840,1700166300,5460,65924,165386,NL,NL
143556,1699030740,1699055340,24600,2908,17603,HU,AT
85469,1698912000,1698927120,15120,108833,162096,US,US
154813,1699140180,1699171800,31620,178919,68232,TR,TR
32609,1700659620,1700692740,33120,96155,85503,TR,TR
133461,1700018880,1700053320,34440,59297,178318,TR,TR
152794,1700787720,1700804640,16920,23391,184957,FR,FR
76409,1698975360,1698989580,14220,153279,28189,US,US
38229,1699795560,1699828500,32940,165700,191431,TR,TR
31367,1699122900,1699133040,10140,161074,163486,ES,ES
71667,1698812640,1698842160,29520,131321,169233,TR,TR
179483,1698867780,1698871380,3600,6688,36009,GB,GB
125528,1700708820,1700724360,15540,141682,49039,CZ,CZ
101656,1699272300,1699305180,32880,103545,3754,TR,TR
95666,1700795880,1700831100,35220,183530,145218,TR,TR
163927,1700198220,1700223720,25500,104648,79279,RO,MD
172794,1699579800,1699617180,37380,95481,122368,MX,MX
196368,1700371620,1700410140,38520,118329,169147,MX,MX
40824,1698915180,1698947580,32400,165909,74260,TR,TR
5089,1699817280,1699820880,3600,70461,95595,NL,FR
191958,1699634460,1699638060,3600,73887,106281,GB,GB
193102,1700208900,1700240820,31920,194706,191144,TR,TR
162244,1698840840,1698869220,28380,196637,159647,PL,PL
15750,1700468160,1700499420,31260,179120,155188,TR,TR
196697,1700844360,1700875860,31500,139395,122727,TR,TR
50963,1700401080,1700410800,9720,145487,80216,IT,IT
9649,1699844760,1699848360,3600,183700,107151,NL,NL
146305,1699278540,1699293720,15180,130739,53594,FR,NL
142988,1699467000,1699502580,35580,49437,43845,TR,TR
73396,1699028160,1699062360,34200,74642,41154,TR,TR
74202,1699219920,1699254180,34260,32528,77407,TR,TR
72525,1700704320,1700715660,11340,14867,172337,HR,HU
179404,1700597340,1700608920,11580,67714,18664,US,US
113682,1700386200,1700400180,13980,187926,43101,AT,SK
7137,1700409120,1700416740,7620,79388,38143,IT,IT
81745,1699530600,1699542360,11760,481,189106,IT,IT
40888,1699389180,1699392780,3600,64655,86378,GB,GB
108993,1700557740,1700588700,30960,95227,64920,TR,TR
188689,1700012160,1700023800,11640,55672,79137,IT,IT
190353,1700259720,1700268480,8760,2714,54488,IT,IT
9065,1699172280,1699185900,13620,48609,154144,HR,HR
63198,1699990080,1699993680,3600,108566,103350,GB,GB
92422,1698881580,1698911940,30360,147173,174639,TR,TR
173725,1698798480,1698812220,13740,142353,93896,IT,DE
120966,1700515020,1700529240,14220,13093,193662,US,US
19431,1700839440,1700843040,3600,126020,139408,GB,GB
195269,1699137720,1699152720,15000,72060,179855,US,US
72750,1698876120,1698909840,33720,191786,49043,MX,US
112919,1700727660,1700763060,35400,196870,52205,TR,TR
92699,1700305380,1700314020,8640,129454,113181,IT,IT
93546,1699586460,1699617360,30900,148221,188669,TR,TR
198303,1699803900,1699820520,16620,36021,125919,FR,FR
66684,1699693140,1699726320,33180,43067,61690,MX,MX
144618,1699505160,1699521900,16740,61981,45209,US,US
106616,1700780880,1700793420,12540,154892,113070,PT,PT
143027,1699537380,1699540980,3600,172128,78721,NL,BE
35163,1699489620,1699502880,13260,24903,77415,ES,ES
10243,1698938040,1698941640,3600,103579,181468,GB,GB
116933,1699584840,1699602360,17520,53966,164933,RS,AT
44740,1699775340,1699788660,13320,52020,130783,IT,IT
104330,1698922860,1698954480,31620,90079,136182,TR,TR
67516,1699245300,1699254480,9180,174660,69393,ES,ES
97159,1699484280,1699519080,34800,157334,59899,TR,TR
190933,1699375980,1699385760,9780,40652,40752,IT,IT
198276,1700848740,1700864100,15360,186706,64412,AT,AT
106457,1700589000,1700617800,28800,174037,198465,TR,TR
128260,1700151480,1700182380,30900,183955,138160,TR,TR
15647,1699695240,1699709580,14340,84511,179776,CZ,CZ
87501,1699736820,1699765920,29100,165583,187537,TR,TR
43655,1700526780,1700553900,27120,60174,31500,DE,DE
28266,1699551060,1699575180,24120,90823,130555,DE,DE
124678,1700559000,1700594580,35580,194153,54190,TR,TR
143023,1700792220,1700820060,27840,134060,175687,PL,PL
75734,1699446300,1699478460,32160,135528,124033,BA,DE
104707,1699806540,1699841940,35400,37734,48072,TR,TR
107622,1699802340,1699827180,24840,119148,148546,DE,NL
133165,1698932640,1698965220,32580,4283,104230,TR,TR
89633,1699058100,1699075980,17880,33231,194749,US,US
37405,1699560240,1699567980,7740,157645,175811,IT,IT
176104,1699257780,1699262880,5100,98132,7635,NL,NL
84884,1699596360,1699629000,32640,78574,193639,TR,TR
78833,1699851960,1699855560,3600,78912,63297,GB,GB
98022,1700439840,1700474820,34980,18650,168045,TR,TR
7315,1700009880,1700040420,30540,140479,13069,BA,HR
114345,1700199180,1700209380,10200,11172,67544,HR,HR
119471,1699051620,1699073760,22140,158640,191781,DE,DE
22290,1700201520,1700211780,10260,176757,29422,HR,HR
184835,1700735040,1700769420,34380,79129,173377,TR,TR
192336,1700439060,1700446560,7500,137549,175451,AD,ES
44520,1699076880,1699081200,4320,18918,54841,GB,GB
195640,1699972440,1700006760,34320,4470,7993,MX,MX
1362,1699379400,1699398540,19140,97675,146356,FR,AD
172836,1698931500,1698940620,9120,187474,142271,ES,ES
100554,1699568280,1699579920,11640,197523,23396,ES,ES
155513,1700673060,1700705880,32820,158692,181177,TR,TR
98595,1699663860,1699667460,3600,129062,6167,GB,GB
33842,1699296960,1699308180,11220,54088,105030,CA,US
176029,1700526060,1700543880,17820,146664,17194,US,US
71422,1699147320,1699150920,3600,180435,6329,NL,NL
120118,1699001640,1699032720,31080,158728,102534,MK,GR
161441,1699222440,1699258020,35580,64424,13662,TR,TR
20424,1700541900,1700577540,35640,45411,80225,TR,TR
87917,1700193480,1700210280,16800,94217,112705,BE,NL
69508,1699741860,1699752780,10920,167824,128305,IT,IT
10715,1699006140,1699027980,21840,121016,88892,PL,PL
26728,1700533200,1700546520,13320,37566,46255,IT,IT
100019,1700044140,1700078340,34200,20642,171722,TR,TR
48327,1700255760,1700289840,34080,176810,196758,TR,TR
27908,1700740020,1700760300,20280,128426,192259,FR,FR
140027,1699292220,1699324080,31860,168273,157103,TR,TR
13935,1700252640,1700256240,3600,106313,118883,GB,GB
195811,1700714640,1700746020,31380,3379,42377,TR,TR
115950,1700229300,1700260320,31020,196677,145128,TR,TR
185827,1699581600,1699586460,4860,30272,53285,NL,NL
130552,1699091880,1699096200,4320,14816,29894,GB,GB
119514,1700070660,1700089860,19200,198183,155728,FR,IT
177306,1699710960,1699715220,4260,60090,122318,NL,NL
67682,1699336020,1699366980,30960,10149,69184,TR,TR
34514,1700123460,1700157960,34500,33971,155596,TR,TR
23434,1700790120,1700825940,35820,167001,118863,TR,TR
27128,1699984800,1699997760,12960,18429,103029,US,US
39959,1699283280,1699294620,11340,156743,113335,IT,IT
118847,1699912800,1699927380,14580,36260,184920,US,US
145298,1698819660,1698853560,33900,198734,87740,TR,TR
152568,1700036280,1700049300,13020,118363,169021,IT,IT
156326,1699278240,1699313880,35640,93890,104285,TR,TR
64910,1699797600,1699810620,13020,161000,197320,US,US
156856,1699108620,1699142520,33900,192849,106600,TR,TR
98632,1700702580,1700715300,12720,20836,113131,HR,HR
95843,1700212980,1700216580,3600,62222,73936,GB,GB
28895,1700285460,1700303700,18240,132259,156432,FR,FR
86997,1700315580,1700350200,34620,153473,150989,TR,TR
193340,1699743540,1699758240,14700,121951,104593,FR,FR
78578,1699855080,1699889940,34860,155618,7227,TR,TR
24106,1700297400,1700313540,16140,104852,27711,AT,AT
159420,1700021100,1700052180,31080,195457,103303,TR,TR
73745,1700370600,1700374200,3600,119365,194903,GB,GB
158913,1699415400,1699419000,3600,54385,96673,GB,GB
50484,1700294940,1700324460,29520,182531,125497,TR,TR
24522,1700012460,1700029500,17040,48375,29138,US,US
156839,1699959360,1699992900,33540,119957,149047,TR,TR
164067,1700124720,1700128320,3600,131034,131601,NL,FR
23740,1700866080,1700882280,16200,120196,60705,US,US
115111,1699449900,1699454400,4500,149282,204,GB,GB
199647,1699060980,1699064580,3600,163189,50161,NL,NL
117292,1699918680,1699949940,31260,171290,107416,TR,TR
186838,1699458120,1699471260,13140,180708,162811,US,US
64591,1700319000,1700353320,34320,72748,50669,TR,TR
8156,1698927480,1698983400,55920,199406,172123,UA,AT
17613,1700321160,1700338080,16920,118065,170032,US,US
98018,1700531880,1700544900,13020,44928,133999,IT,IT
159964,1700358780,1700368800,10020,94023,74284,ES,IT
154878,1699513500,1699517100,3600,195594,181517,NL,CZ
27663,1700233200,1700248680,15480,91141,96081,CZ,CZ
45656,1699920240,1699954740,34500,67143,16522,TR,TR
58804,1699328100,1699351500,23400,131604,4285,CH,IT
85137,1699327140,1699330740,3600,137341,179627,GB,GB
183071,1700480040,1700511120,31080,182327,29505,TR,TR
42734,1699645800,1699656480,10680,196185,184525,IT,IT
113607,1699820700,1699837140,16440,99323,181613,US,US
102480,1699714080,1699745700,31620,3286,88515,TR,TR
51639,1699460700,1699485180,24480,6508,192691,PL,HR
156449,1699777380,1699797120,19740,134766,8541,BE,NL
148297,1699934520,1699991220,56700,31078,8704,BG,AT
68041,1699387200,1699405740,18540,187344,51633,FR,FR
78033,1699764360,1699796340,31980,77060,52951,MK,AL
160020,1700225640,1700261340,35700,11682,61807,TR,TR
17336,1699726500,1699761240,34740,57573,47196,TR,TR
126674,1699141620,1699157640,16020,75261,67532,US,US
110802,1700151900,1700165760,13860,87577,198198,IT,IT
7366,1700231640,1700244060,12420,28759,164737,PT,PT
178900,1699212180,1699236900,24720,31211,61992,DE,FR
61348,1700481480,1700503440,21960,98640,190076,DE,FR
78105,1699606980,1699641240,34260,51399,39631,TR,TR
158226,1700792700,1700803320,10620,131825,85539,IT,IT
171208,1698897180,1698921060,23880,24220,120811,DE,UA
42532,1699188240,1699201020,12780,79816,17480,AT,CZ
136942,1698904560,1698940020,35460,199503,134835,TR,TR
57017,1699470960,1699505880,34920,26265,100580,TR,TR
153628,1700651160,1700664360,13200,13911,199467,CZ,AT
54179,1699198140,1699227060,28920,140268,85761,TR,TR
88698,1698969900,1698998880,28980,187049,17657,TR,TR
55026,1699618080,1699626360,8280,164218,187750,IT,IT
118047,1699152060,1699160520,8460,150229,64833,IT,IT
76445,1700251260,1700254860,3600,72506,62727,NL,NL
65001,1698908280,1698942480,34200,193980,146501,TR,TR
184024,1700079480,1700088060,8580,172996,134898,IT,IT
75348,1700062800,1700073540,10740,143131,71372,ES,ES
27898,1699242600,1699264920,22320,46765,176647,PL,NL
176626,1699065180,1699068780,3600,168922,96652,NL,NL
195691,1699245600,1699250880,5280,142484,160117,GB,GB
181448,1700114400,1700144460,30060,61772,6959,TR,TR
136616,1699157220,1699188120,30900,180762,181140,TR,TR
2291,1699322280,1699356600,34320,75625,58707,TR,TR
9563,1699186500,1699221720,35220,47069,104303,TR,TR
102411,1700111220,1700128380,17160,70817,88760,AT,AT
76751,1700820720,1700827680,6960,38119,132602,GB,GB
12382,1698994680,1699024140,29460,153679,31694,TR,TR
64345,1699585380,1699596120,10740,120081,181639,IT,IT
87891,1699762380,1699774740,12360,122587,99345,IT,IT
109109,1699308300,1699344300,36000,81566,118711,MX,MX
123963,1699214220,1699226280,12060,78398,123787,US,US
161625,1699745340,1699753200,7860,178586,76739,IT,IT
168766,1699023420,1699057500,34080,126795,57628,TR,TR
130323,1699683420,1699715160,31740,59649,145870,TR,TR
5977,1700146920,1700180220,33300,165674,35648,TR,TR
2666,1700723760,1700732760,9000,152307,8270,IT,IT
63662,1699823640,1699843680,20040,155185,143966,MD,RO
125231,1700077680,1700088540,10860,12543,26768,IT,IT
40550,1700072580,1700085300,12720,90223,198162,US,US
194317,1699781700,1699815420,33720,13096,190231,MX,MX
6634,1700128440,1700132040,3600,1851,47186,GB,GB
147989,1700803020,1700833560,30540,61626,68033,TR,TR
109298,1700076300,1700090640,14340,165973,187662,PT,PT
161998,1698817680,1698832020,14340,164166,81093,US,US
119275,1700291520,1700324580,33060,155842,39668,TR,TR
175389,1700569440,1700579520,10080,17897,26052,SK,AT
180484,1699777200,1699793160,15960,174818,4834,US,US
104621,1700344320,1700376600,32280,152543,92506,TR,TR
185948,1699752480,1699783740,31260,143821,36709,TR,TR
43625,1699407960,1699441680,33720,39414,23458,TR,TR
83266,1700412600,1700446620,34020,60389,42527,TR,TR
184951,1700832900,1700863140,30240,148444,163433,TR,TR
42211,1699189380,1699215360,25980,129247,90658,DE,DE
58728,1699305660,1699323540,17880,26259,6867,US,US
56144,1699271760,1699278180,6420,83544,81382,GB,GB
58015,1700422500,1700435940,13440,126715,47075,IT,IT
186246,1699662060,1699694160,32100,50820,74049,TR,TR
69975,1700206140,1700239800,33660,192935,76947,TR,TR
37038,1698846600,1698857460,10860,67665,21067,HR,HR
173450,1698941280,1698948360,7080,107872,133313,GB,GB
160217,1699447440,1699452540,5100,49485,43356,GB,GB
106486,1698844500,1698875340,30840,29855,162040,TR,TR
13275,1700828580,1700861160,32580,184457,179143,TR,TR
123856,1699439580,1699447320,7740,166180,94079,ES,ES
87147,1699942860,1699956600,13740,43685,91824,ES,AD
51844,1698820860,1698847980,27120,112077,12673,PL,PL
135598,1698931920,1698967860,35940,81285,153073,TR,TR
160480,1699603020,1699620600,17580,43449,182343,US,MX
87247,1699389480,1699405920,16440,100306,182059,RS,RS
198373,1700019120,1700024520,5400,61891,120399,GB,GB
1866,1699583340,1699597020,13680,133057,59383,US,US
175009,1698828840,1698834420,5580,11688,94845,GB,GB
177213,1699700280,1699727100,26820,145216,143174,BR,BR
89192,1700301000,1700318640,17640,71629,82790,US,US
26954,1699883340,1699889460,6120,106073,178777,GB,GB
194737,1700558280,1700591340,33060,58925,18808,TR,TR
179423,1699364340,1699393980,29640,5073,59623,TR,TR
48137,1699920660,1699933920,13260,55382,117013,US,US
132645,1699457400,1699492320,34920,133175,116789,TR,TR
163773,1700175240,1700178840,3600,40064,77259,GB,GB
105497,1699804560,1699817940,13380,191053,175283,IT,IT
41036,1700346780,1700380800,34020,118389,112339,TR,TR
163604,1699647300,1699677900,30600,185306,62063,TR,TR
142112,1700226600,1700242020,15420,71785,78201,AT,AT
17062,1700179380,1700212380,33000,131775,127659,TR,TR
176060,1699696380,1699701720,5340,127714,198626,NL,NL
14999,1700232420,1700260380,27960,14760,189303,RO,RO
64619,1700834340,1700837940,3600,103827,172396,GB,GB
177193,1699591140,1699595040,3900,102380,124719,GB,GB
115780,1698915000,1698918600,3600,138831,34325,NL,NL
26684,1699129320,1699136160,6840,105717,72123,NL,NL
199763,1700776740,1700810880,34140,156638,56213,TR,TR
101673,1699579800,1699592340,12540,42201,426,IT,IT
51241,1700444340,1700456340,12000,186977,171219,PT,PT
155104,1700649960,1700682720,32760,133266,97659,TR,TR
131959,1699072440,1699076040,3600,29830,48347,NL,NL
148033,1700409960,1700445360,35400,109169,193034,TR,TR
164157,1700778420,1700794860,16440,196765,109500,SE,SE
126892,1700852700,1700886540,33840,113937,127957,TR,TR
127180,1699889940,1699893540,3600,36872,62199,NL,DE
116375,1699918320,1699925940,7620,88843,176753,EE,EE
92468,1700853120,1700861940,8820,4562,34776,IT,IT
169873,1698879240,1698891300,12060,18281,40680,IT,IT
146787,1699379880,1699392720,12840,40103,132505,ES,PT
39748,1700322420,1700329380,6960,185124,105594,GB,GB
38278,1700010120,1700021940,11820,72551,91423,US,US
127705,1698828840,1698842280,13440,98008,73128,US,US
147168,1700355420,1700371740,16320,99735,75562,AT,AT
28635,1700233140,1700245800,12660,146425,83901,US,US
30370,1699373640,1699407720,34080,45319,7486,TR,TR
135410,1700709600,1700716020,6420,45503,52863,NL,NL
34415,1699201860,1699227180,25320,126178,151468,RO,RO
160837,1700116860,1700155080,38220,60058,49826,MX,MX
142582,1700718780,1700729280,10500,12540,50798,IT,IT
31969,1699274340,1699288440,14100,199284,88132,US,US
131166,1700535780,1700551140,15360,75626,114570,US,US
73851,1699023960,1699059420,35460,55316,154662,TR,TR
23980,1698942300,1698954600,12300,107637,46401,AT,AT
194847,1698911100,1698928980,17880,44169,15883,AT,AT
51185,1699665660,1699697940,32280,48916,56657,TR,TR
136449,1700066760,1700078040,11280,65037,181889,PT,PT
154719,1700748900,1700759760,10860,86979,16096,IT,IT
116758,1700519520,1700523120,3600,164496,52709,GB,GB
158806,1700863380,1700894460,31080,76021,179294,TR,TR
90766,1700826180,1700843940,17760,75194,7512,US,US
59990,1700829120,1700863080,33960,87330,39098,TR,TR
192402,1699859340,1699893300,33960,90242,156499,TR,TR
195780,1699249500,1699274640,25140,168033,67354,DE,DE
164515,1699597560,1699621920,24360,58535,19050,AL,MK
145729,1700184900,1700201100,16200,126121,69171,AT,HR
30071,1699046460,1699069980,23520,55821,2058,PL,PL
132977,1700304600,1700328660,24060,71905,58208,DE,DE
163944,1698924120,1698980880,56760,191242,84192,BG,AT
90209,1699179600,1699211040,31440,35991,97490,TR,TR
45848,1699746420,1699779420,33000,53059,5335,TR,TR
13060,1699779720,1699811100,31380,117144,179181,TR,TR
116028,1699408740,1699422720,13980,121374,173586,ES,ES
80803,1700831460,1700867280,35820,20967,95872,TR,TR
187014,1699239780,1699245300,5520,163934,112828,GB,GB
135974,1700502240,1700532660,30420,121153,9350,TR,TR
124159,1700420280,1700455800,35520,23975,121902,TR,TR
36908,1698953880,1698985200,31320,32836,133784,TR,TR
75729,1700088900,1700092500,3600,127041,71289,GB,GB
157311,1700634720,1700666040,31320,122015,59078,TR,TR
190739,1700333760,1700337360,3600,108977,152075,GB,GB
95313,1700726160,1700757300,31140,90829,6590,TR,TR
49582,1699982220,1700016420,34200,1711,113703,TR,TR
12422,1699734480,1699764120,29640,59766,157599,TR,TR
84663,1700574840,1700588640,13800,176174,12519,HR,HR
2006,1698976080,1698979680,3600,148892,171040,NL,FR
134696,1699739160,1699773360,34200,197123,13193,TR,TR
98577,1700662800,1700696820,34020,152868,162612,TR,TR
19826,1699049700,1699082220,32520,17418,15235,TR,TR
18577,1699540080,1699548180,8100,156196,1155,IT,IT
70317,1700637720,1700642820,5100,139333,135315,NL,NL
96220,1698860400,1698893460,33060,134597,157031,TR,TR
145693,1700351580,1700388120,36540,21431,36416,MX,MX
32156,1700288520,1700323860,35340,83935,164281,TR,TR
31104,1699771320,1699788420,17100,90238,177994,FR,FR
157223,1700130480,1700165880,35400,96872,137077,TR,TR
147840,1698815040,1698847320,32280,102176,159478,TR,TR
2015,1699353360,1699392420,39060,57653,80051,MX,MX
43231,1699160880,1699165260,4380,132191,15660,GB,GB
190098,1699767840,1699779480,11640,174647,123839,IT,IT
157320,1700298240,1700312520,14280,114197,125895,US,US
125909,1700238120,1700255220,17100,132210,61841,AT,DE
120360,1700634180,1700647080,12900,165654,185531,IT,DE
150831,1700623680,1700659200,35520,42177,156966,TR,TR
87212,1700692380,1700708400,16020,33076,122379,US,US
155819,1699681680,1699685280,3600,53007,145536,GB,GB
191381,1699301940,1699309620,7680,197808,146173,IT,IT
27678,1699752360,1699770000,17640,157324,72157,US,MX
181662,1700812380,1700817480,5100,131121,11686,NL,NL
125696,1699012140,1699019160,7020,195783,167862,GB,GB
145038,1699203660,1699227300,23640,137355,51908,PL,DE
69261,1700611680,1700615280,3600,84618,16238,NL,FR
93602,1698823740,1698859200,35460,13909,58555,TR,TR
84606,1699808280,1699838100,29820,116589,119469,TR,TR
14013,1698892920,1698928440,35520,78831,139775,MX,MX
46234,1699925640,1699959720,34080,124957,152950,TR,TR
19788,1699533660,1699537260,3600,184424,129324,NL,NL
129689,1699871580,1699905360,33780,12686,142439,TR,TR
44415,1699575960,1699613760,37800,147023,176031,MX,MX
41927,1700511360,1700539440,28080,124271,59669,DE,NL
97445,1699911960,1699940940,28980,196807,156528,TR,TR
65882,1699693440,1699728600,35160,169291,173981,TR,TR
170211,1699062120,1699095300,33180,43583,171940,TR,TR
119816,1700746560,1700752920,6360,29701,26596,NL,NL
13978,1700441160,1700454240,13080,39087,125531,IT,IT
36759,1698896580,1698930660,34080,121294,186959,TR,TR
82839,1699172460,1699202580,30120,36222,135119,TR,TR
187743,1699201920,1699230840,28920,46860,146205,TR,TR
129822,1700512620,1700547000,34380,192911,89245,TR,TR
186530,1699732260,1699735860,3600,88318,66174,GB,GB
153624,1700840100,1700871000,30900,186884,71149,TR,TR
189562,1699680300,1699695420,15120,65617,28864,US,US
96927,1700625120,1700659500,34380,128520,3458,TR,TR
171271,1700084760,1700088360,3600,149648,157583,NL,NL
175462,1699737960,1699770960,33000,188632,145846,TR,TR
93235,1699001460,1699020000,18540,483,100206,DK,DK
26261,1700407380,1700410980,3600,73967,152907,NL,NL
15151,1699968360,1699995660,27300,37834,101737,DE,DE
132581,1700119260,1700143800,24540,145579,104966,DE,AT
23625,1699847460,1699851240,3780,192877,51735,GB,GB
25602,1700523660,1700527260,3600,109851,184144,GB,GB
183064,1700264100,1700267700,3600,197673,115635,GB,GB
159123,1699060560,1699064460,3900,131046,190016,GB,GB
172509,1700859300,1700872500,13200,131467,137240,US,US
85563,1699542120,1699573560,31440,175713,141168,TR,TR
142729,1699169880,1699203300,33420,13137,66679,TR,TR
118155,1700196300,1700229660,33360,149404,112478,TR,TR
46312,1698795480,1698808440,12960,91631,106599,CZ,CZ
171463,1699150200,1699183140,32940,142794,71842,TR,TR
168547,1700394660,1700421300,26640,34651,36754,DE,DE
40308,1699157880,1699188420,30540,64126,114977,TR,TR
122202,1700063580,1700082360,18780,131502,62383,BE,SK
2223,1699761780,1699796460,34680,129997,142904,TR,TR
76493,1699307220,1699323480,16260,75021,55669,US,US
94026,1700001480,1700036760,35280,55098,134510,TR,TR
32599,1699260180,1699263780,3600,69896,46491,NL,FR
396,1700195640,1700199240,3600,70146,100254,GB,GB
135207,1699066800,1699078020,11220,38257,13905,IT,IT
69065,1700377620,1700407560,29940,60570,54876,TR,TR
81278,1698843480,1698849600,6120,26618,95732,GB,GB
76733,1699379340,1699409100,29760,139186,14793,TR,TR
181068,1700664300,1700700120,35820,151524,183993,MX,MX
37072,1698861840,1698865440,3600,86618,195904,GB,GB
76782,1699996740,1700026560,29820,189142,162842,TR,TR
14520,1699002660,1699016640,13980,78143,194391,RS,BG
10371,1700044680,1700057940,13260,88570,100932,US,US
36933,1699845300,1699855740,10440,138313,80997,IT,FR
187291,1699775280,1699787880,12600,102845,16191,US,US
118353,1699396740,1699431360,34620,137981,37113,TR,TR
8826,1700105820,1700109420,3600,27755,149574,GB,GB
179391,1699259280,1699292220,32940,13574,125479,TR,TR
177397,1699601100,1699604700,3600,115109,113441,NL,NL
47695,1699620600,1699656060,35460,110333,138355,TR,TR
41099,1700031240,1700042880,11640,159531,178009,PT,PT
140597,1699424520,1699459380,34860,169982,126940,TR,TR
4320,1699504200,1699537200,33000,98828,196497,TR,TR
24556,1700229900,1700234340,4440,127520,90823,GB,GB
191411,1699224600,1699228320,3720,49456,40917,EE,FI
183589,1700288220,1700300760,12540,69065,37248,US,US
90237,1700546820,1700585880,39060,167498,132926,MX,US
62698,1700544660,1700556180,11520,47081,37183,ES,ES
109404,1700831820,1700835420,3600,188551,21730,NL,NL
167773,1699200360,1699213440,13080,178210,169255,US,US
174758,1700122560,1700138580,16020,16658,109304,US,US
37635,1700813940,1700822940,9000,121876,5292,IT,IT
71798,1699616820,1699651920,35100,54897,191391,TR,TR
995,1700338860,1700368500,29640,47818,22735,TR,TR
156406,1700082540,1700096700,14160,154124,51977,US,US
158141,1700390940,1700406840,15900,84949,99484,US,US
43473,1699692840,1699696440,3600,184562,63953,NL,NL
96066,1699349940,1699358160,8220,175859,45466,HR,HR
158080,1699438800,1699442400,3600,195977,74425,GB,GB
33725,1700222700,1700254680,31980,42915,69053,TR,TR
20782,1699784940,1699797660,12720,52130,144819,US,US
77958,1699024800,1699032180,7380,88132,25400,SK,AT
97534,1698899400,1698931200,31800,151014,106463,TR,TR
115049,1699564440,1699599300,34860,186405,21351,TR,TR
68748,1700213700,1700245380,31680,41044,2683,TR,TR
113401,1699089240,1699113960,24720,43036,188738,PL,UA
197323,1699485120,1699518060,32940,126732,102980,TR,TR
30223,1699768560,1699775820,7260,166654,154014,IT,IT
162851,1700772660,1700805180,32520,13906,17881,TR,TR
67800,1698808980,1698843660,34680,19901,159804,TR,TR
188752,1699637340,1699640940,3600,154223,60176,NL,NL
113466,1699362540,1699375980,13440,74429,28722,IT,IT
12013,1699410660,1699437480,26820,188754,83240,DE,CH
79000,1700453820,1700457420,3600,36373,180991,GB,GB
195262,1698888420,1698901440,13020,77739,44802,US,US
86453,1699834680,1699838580,3900,79579,23886,EE,EE
85925,1699082460,1699086060,3600,73249,20312,GB,GB
157183,1699204620,1699236540,31920,5747,140663,TR,TR
176946,1699049640,1699081440,31800,83971,52945,TR,TR
169334,1699965900,1699999860,33960,7990,77268,TR,TR
196352,1698923160,1698947760,24600,49648,123840,RO,RO
12898,1699233540,1699267920,34380,182829,130787,MX,US
155795,1699236240,1699258920,22680,105407,187758,BR,BR
21785,1700428260,1700435940,7680,88546,197091,IT,IT
90742,1699445820,1699477800,31980,157468,18672,TR,TR
24501,1700445840,1700481540,35700,137328,110221,MX,MX
50198,1699094640,1699113420,18780,39973,40414,FR,FR
80142,1699708260,1699739580,31320,153941,175839,TR,TR
115698,1699202280,1699213380,11100,32680,37148,IT,IT
21397,1698994200,1699018080,23880,64282,187412,PL,NL
37437,1700454180,1700483280,29100,157406,104249,TR,TR
152510,1700495040,1700510700,15660,133592,40698,US,US
173017,1699974840,1700009760,34920,14241,147291,TR,TR
41635,1699057560,1699069140,11580,37102,133399,IT,IT
29362,1700317320,1700335560,18240,160335,123478,DK,DK
193973,1700202720,1700231700,28980,165736,40387,TR,TR
135698,1699198200,1699208700,10500,104439,42329,IT,DE
62039,1698990000,1698993600,3600,171167,145826,GB,GB
84742,1699615500,1699647000,31500,86608,12708,TR,TR
122122,1700103540,1700121660,18120,129180,170301,BE,FR
22908,1700666160,1700701440,35280,10741,17404,TR,TR
11148,1700044440,1700059440,15000,184851,71529,US,US
47078,1699672560,1699685820,13260,177310,61015,HR,HR
117989,1699708920,1699745640,36720,147237,20341,MX,MX
104855,1700391060,1700407020,15960,81777,113069,US,US
117948,1700219400,1700233800,14400,199117,132151,US,US
37973,1699829280,1699855260,25980,123273,169419,DE,MK
41096,1700424300,1700449200,24900,13094,2800,PL,EE
333,1700243280,1700263440,20160,15149,181131,FR,GB
38286,1699855080,1699863300,8220,2087,156819,IT,IT
192860,1699678380,1699692420,14040,36470,47990,US,US
192818,1699533480,1699556400,22920,8298,165330,BR,BR
191610,1700814300,1700829480,15180,196621,12789,US,US
95167,1700301720,1700361420,59700,620,167192,UA,AT
174588,1700790960,1700803800,12840,23117,178014,RS,RS
170110,1700494560,1700499600,5040,37391,69648,NL,NL
144237,1699891380,1699924740,33360,117230,123059,TR,TR
133831,1699699680,1699703280,3600,74359,130761,GB,GB
43922,1698959820,1698963420,3600,61263,23953,GB,GB
85691,1699568100,1699583940,15840,144710,104279,FR,FR
29724,1700370480,1700402580,32100,41241,29296,TR,TR
191106,1699380300,1699388220,7920,181482,51322,IT,IT
161467,1700196660,1700210640,13980,134491,175867,US,US
168108,1698894240,1698930180,35940,174171,130510,TR,TR
168475,1700577420,1700604360,26940,30534,14349,HU,AT
98869,1700043420,1700055540,12120,168823,92154,CZ,IT
58138,1700815920,1700831040,15120,148965,142652,CZ,CZ
81095,1700334540,1700339400,4860,46379,105443,NL,NL
18639,1700583600,1700617800,34200,133923,150212,TR,TR
117462,1699256100,1699267080,10980,81792,147597,US,US
138510,1700859000,1700874180,15180,21287,41527,FR,FR
132575,1699465200,1699484160,18960,94277,98029,FR,FR
51546,1700065560,1700070780,5220,1471,9357,NL,NL
123533,1700355180,1700388360,33180,12790,19923,TR,TR
163159,1699727040,1699736820,9780,62184,72161,IT,IT
100502,1700729040,1700764740,35700,186413,63227,TR,TR
121681,1700047800,1700064600,16800,79589,77397,US,US
40757,1699771740,1699807560,35820,32314,74401,TR,TR
95286,1700100780,1700104380,3600,139614,99587,GB,GB
173702,1700847780,1700883720,35940,119544,23361,TR,TR
173244,1699216500,1699273680,57180,104878,182441,BG,BG
32487,1698837120,1698866880,29760,29687,66580,TR,TR
190446,1700296080,1700327340,31260,162254,168582,TR,TR
5539,1699928760,1699941300,12540,98726,25995,IT,IT
53397,1700688360,1700712660,24300,199478,13946,DE,IT
54638,1700408100,1700430240,22140,46390,27602,DE,NL
136981,1699213080,1699244040,30960,166005,153627,TR,TR
107378,1699995060,1700012700,17640,75701,180531,CZ,UA
142334,1699487040,1699493760,6720,6330,39481,GB,GB
196257,1699545960,1699574820,28860,49211,80862,TR,TR
161810,1700772600,1700776440,3840,171408,113754,GB,GB
102926,1699424520,1699437060,12540,44361,159416,US,US
95660,1700256240,1700287320,31080,107806,127846,TR,TR
138772,1699400100,1699417860,17760,113644,84553,CZ,CZ
132950,1699374060,1699377840,3780,131050,36068,CL,CL
173090,1699148520,1699160820,12300,5330,90283,ES,AD
109179,1699151280,1699202280,51000,45648,80497,BG,AT
155763,1699073760,1699106880,33120,104299,130788,TR,TR
47754,1700698860,1700702460,3600,163423,37103,NL,NL
124984,1700164920,1700182620,17700,152326,176775,US,US
146573,1699839600,1699843200,3600,128709,32656,GB,GB
147936,1700539680,1700562900,23220,48340,99564,RO,RO
47578,1700434980,1700465580,30600,101051,70783,TR,TR
39359,1699596180,1699611480,15300,78497,84263,FR,BE
74786,1700097360,1700108880,11520,62097,199525,AT,AT
92433,1698923940,1698936660,12720,156676,20769,IT,IT
92188,1700063400,1700097960,34560,31054,68594,TR,TR
59586,1700370180,1700375220,5040,113782,31520,GB,GB
120673,1699928580,1699942500,13920,27626,149588,ES,FR
163019,1699189980,1699203120,13140,192914,17008,CZ,CZ
96175,1700040900,1700046300,5400,81636,11344,GB,GB
57907,1699550820,1699561740,10920,149417,42522,RS,NL
49444,1700487720,1700517180,29460,133790,115006,TR,TR
76674,1699676880,1699694820,17940,176894,33844,US,US
99980,1699255500,1699259100,3600,135007,122172,NL,NL
27800,1700018640,1700050320,31680,147982,181012,TR,TR
82851,1699115340,1699125900,10560,122544,76365,IT,IT
131248,1699918980,1699949880,30900,190831,45646,BA,HR
132863,1700232300,1700293380,61080,119527,23887,UA,CZ
118097,1699729560,1699744140,14580,110867,35142,FR,FR
21170,1699588200,1699600260,12060,68743,129909,AT,AT
86834,1699155540,1699176180,20640,9322,34653,FR,FR
116142,1699921620,1699956780,35160,120650,171205,TR,TR
138998,1699488060,1699521000,32940,194010,94516,TR,TR
102623,1699069440,1699103100,33660,122222,132537,TR,TR
182966,1699680300,1699685580,5280,155890,152981,GB,GB
105894,1699487100,1699505460,18360,343,133398,FR,DE
178904,1699873980,1699909920,35940,169829,15758,TR,TR
9739,1700650320,1700663520,13200,150706,68307,IT,IT
152084,1700026440,1700058300,31860,180130,98276,TR,TR
195185,1699179240,1699205220,25980,35827,68445,RO,ES
54615,1700115720,1700128620,12900,70056,63527,IT,IT
139885,1700426220,1700429880,3660,14774,190724,NL,FR
107259,1700286960,1700303460,16500,104146,152340,US,US
68453,1699777980,1699790040,12060,70132,95393,AT,AT
125699,1700028780,1700032380,3600,57192,128558,NL,NL
139108,1700690040,1700693940,3900,124403,119014,GB,GB
111582,1699818000,1699853580,35580,8083,75899,TR,TR
1137,1700447700,1700459100,11400,114217,87894,US,US
197770,1700786880,1700790480,3600,167086,16760,NL,NL
127199,1699612800,1699623300,10500,118108,105220,PT,PT
1509,1700531580,1700553540,21960,84845,132181,DE,DE
62625,1700065440,1700071440,6000,30602,65679,GB,GB
167402,1699706820,1699714020,7200,65510,26326,HR,HR
13868,1699582680,1699616040,33360,112792,71263,TR,TR
89742,1699062540,1699095240,32700,89189,158186,TR,TR
72174,1699186080,1699195320,9240,115925,96570,IT,IT
166735,1699755840,1699770480,14640,133444,105571,SE,SE
71660,1699196700,1699210380,13680,110760,54769,PT,PT
23455,1698870720,1698903540,32820,183436,102221,TR,TR
90891,1700550960,1700581680,30720,144541,33624,TR,TR
163033,1700528040,1700531640,3600,127211,83076,NL,NL
23959,1699736400,1699740000,3600,34446,13050,NL,NL
169976,1700817420,1700821020,3600,50951,106533,NL,NL
63596,1700550360,1700576820,26460,113045,179091,DE,DE
68458,1699342560,1699372620,30060,151164,105557,TR,TR
50032,1699684500,1699702440,17940,26777,4949,AT,AT
147303,1699155240,1699178640,23400,149959,109984,PL,PL
177546,1700463720,1700492760,29040,58385,68294,TR,TR
195258,1700637900,1700650140,12240,49204,30666,IT,IT
56888,1699600800,1699615260,14460,64319,193510,US,US
191368,1699411500,1699426260,14760,51830,21000,US,US
37263,1700645520,1700660820,15300,149189,81480,AT,HU
83060,1699908540,1699939260,30720,96084,186314,TR,TR
45048,1699386720,1699412520,25800,191553,36093,DE,DE
103583,1700838240,1700846700,8460,20460,24458,IT,IT
195422,1700388480,1700415240,26760,35802,41176,DE,FR
24432,1699410600,1699445460,34860,180265,84389,TR,TR
42617,1700855340,1700888220,32880,26737,174377,TR,TR
84643,1699535760,1699565820,30060,177597,102934,TR,TR
15402,1699941540,1699976280,34740,139600,176077,TR,TR
120189,1698960300,1698993240,32940,86041,160194,TR,TR
86694,1700823180,1700857500,34320,115907,183859,TR,TR
198911,1698880200,1698886920,6720,104581,197256,GB,GB
60387,1700843520,1700849400,5880,142643,11328,GB,GB
194205,1700087100,1700102160,15060,59498,64082,US,US
89897,1700211360,1700246340,34980,150978,152233,TR,TR
93147,1699495320,1699527840,32520,76608,56132,TR,TR
113088,1699519320,1699522920,3600,129052,70064,NL,DE
93143,1700416680,1700448840,32160,184205,58036,TR,TR
150116,1700744340,1700768820,24480,68312,64060,PL,UA
125005,1700064180,1700099820,35640,8597,93635,TR,TR
99108,1700136000,1700168220,32220,168851,114123,TR,TR
75865,1699422600,1699454880,32280,17695,34277,TR,TR
127307,1699491060,1699521180,30120,82273,39856,TR,TR
9711,1699274040,1699299960,25920,115022,61958,PL,UA
196856,1699848600,1699863420,14820,75588,4240,CZ,AT
80777,1699322280,1699356900,34620,186812,40354,MX,MX
23501,1699462020,1699490820,28800,164029,171079,TR,TR
21692,1700399640,1700419020,19380,4563,101474,FR,FR
75469,1699833720,1699866780,33060,192853,59035,MX,MX
17143,1700757300,1700763360,6060,178885,69421,GB,GB
142874,1699667580,1699676340,8760,17761,193037,PT,PT
199156,1699583340,1699586940,3600,191570,111513,GB,GB
191566,1699188240,1699214280,26040,8976,149434,DE,PL
90774,1698946020,1698953160,7140,94357,40854,GB,GB
85543,1699368660,1699401480,32820,3300,50052,MX,US
70995,1699368180,1699397100,28920,172411,196040,TR,TR
10340,1699685580,1699717260,31680,128948,142978,TR,TR
16484,1698949080,1698961920,12840,116382,27109,SK,PL
25342,1700746020,1700765700,19680,36814,31529,FR,IT
131456,1700791080,1700820120,29040,71463,152905,TR,TR
2559,1699420380,1699437120,16740,190666,52888,FR,AD
138452,1700383680,1700397600,13920,136512,106757,IT,IT
100689,1700465220,1700472540,7320,187,182797,IT,IT
97937,1700383920,1700392560,8640,100335,10223,IT,IT
121059,1699097880,1699106580,8700,19120,167242,HR,HR
79893,1698972900,1699001940,29040,95495,108116,TR,TR
116781,1700093400,1700127600,34200,33965,83858,TR,TR
70872,1699643580,1699650120,6540,116117,125773,GB,GB
125463,1700327340,1700339160,11820,182648,189139,IT,FR
83249,1700542680,1700558940,16260,182127,154853,RS,HR
145173,1699759740,1699788780,29040,109096,187054,TR,TR
177962,1700206440,1700245200,38760,107809,187779,MX,MX
86590,1699621980,1699639080,17100,29561,156821,RS,RS
120335,1699144080,1699173480,29400,102196,122140,TR,TR
113549,1699399260,1699415640,16380,181618,36030,FR,FR
72104,1700334540,1700367000,32460,107115,123242,TR,TR
123435,1699076340,1699101180,24840,40457,3258,BR,BR
32565,1700634660,1700691600,56940,128768,191850,BG,DE
160741,1700516100,1700548440,32340,123968,108143,TR,TR
135853,1700788920,1700796120,7200,64083,152914,IT,IT
161715,1699358940,1699394580,35640,2481,145472,TR,TR
30501,1699314300,1699321860,7560,110888,48426,IT,FR
77907,1700578200,1700590620,12420,167336,94779,US,US
160025,1700404140,1700420820,16680,147361,129777,FR,FR
43436,1699658520,1699690980,32460,142591,55696,TR,TR
85415,1699517640,1699521240,3600,12020,114294,NL,NL
142742,1700752080,1700768820,16740,106808,157319,US,US
118836,1700390880,1700398500,7620,189302,67987,ES,IT
33100,1698956460,1698989520,33060,103383,49308,TR,TR
125911,1698903780,1698937260,33480,134466,76804,TR,TR
80305,1699957380,1699981140,23760,103071,194957,HU,RS
179591,1699879860,1699903740,23880,122698,73998,DE,BA
70840,1700124540,1700132580,8040,142600,78117,IT,IT
162747,1699155540,1699168260,12720,93677,6841,US,US
10654,1699776720,1699790160,13440,102836,41413,PT,PT
159163,1700598120,1700611260,13140,197765,30055,ES,ES
63104,1699654980,1699684740,29760,150934,62714,TR,TR
188055,1698958800,1698989820,31020,170374,183211,TR,TR
130087,1698793740,1698805680,11940,162293,185999,AT,DE
11088,1700818920,1700822520,3600,75208,21407,GB,GB
40613,1699392300,1699428120,35820,52863,63560,TR,TR
25901,1699378920,1699382520,3600,29643,32957,GB,GB
195098,1698941280,1698946140,4860,145990,121502,GB,FR
170195,1700448600,1700482800,34200,36450,199252,TR,TR
190146,1699694220,1699716180,21960,71555,197259,DE,DE
119559,1700589240,1700605920,16680,192417,170720,US,US
84741,1700507760,1700520180,12420,142796,180966,US,US
134803,1700423700,1700441340,17640,173846,177906,RS,BG
49490,1699487820,1699517820,30000,117658,150905,TR,TR
179122,1700039280,1700066220,26940,97582,70380,HU,PL
48351,1699571220,1699601460,30240,142923,74860,TR,TR
163568,1699165380,1699187820,22440,129164,104775,DE,MK
35218,1700709840,1700724480,14640,116999,80842,US,US
29095,1700588400,1700592600,4200,5785,151634,GB,GB
95912,1699100040,1699122180,22140,93416,84636,DE,PL
13297,1700344680,1700352240,7560,10790,38109,HR,HR
19073,1699828320,1699841820,13500,120652,56380,HR,HR
24947,1700313600,1700318700,5100,167405,168080,GB,GB
115894,1699348500,1699360440,11940,23926,147084,HR,IT
76553,1700795820,1700829180,33360,19299,59831,TR,TR
127290,1698795300,1698821040,25740,81682,143512,DE,DE
149437,1699028220,1699054980,26760,15175,13281,PL,PL
9617,1699740960,1699757580,16620,9108,107808,FR,FR
48225,1700611740,1700615880,4140,189204,151045,GB,GB
87009,1700649480,1700683440,33960,161723,125843,TR,TR
104840,1699370340,1699378920,8580,143689,78597,IT,IT
186490,1699744200,1699752900,8700,63898,108248,SK,SK
55553,1700330580,1700335920,5340,38344,120079,NL,NL
188778,1699589580,1699625160,35580,193636,107682,TR,TR
54997,1699823580,1699854240,30660,29894,82870,TR,TR
141453,1699562340,1699619100,56760,69299,76153,BG,AT
168862,1700085720,1700096760,11040,38968,73239,US,US
30088,1699614960,1699645740,30780,79679,194890,TR,TR
85174,1700816700,1700842380,25680,71405,143742,BR,BR
161456,1699994400,1700006220,11820,99466,177413,US,US
170634,1699379700,1699383300,3600,199147,189746,GB,GB
165150,1699235580,1699267500,31920,27954,181455,TR,TR
182439,1699888860,1699921620,32760,103627,154512,TR,TR
28732,1700691720,1700702040,10320,196753,110755,IT,FR
48636,1700582520,1700587620,5100,181570,117871,GB,GB
4147,1700508600,1700537580,28980,28166,28251,TR,TR
112760,1700416080,1700434320,18240,117471,98973,FR,FR
137954,1700488440,1700504700,16260,5237,81684,CZ,CZ
101333,1699107960,1699121340,13380,183178,60435,IT,IT
181886,1700693640,1700703840,10200,176042,15347,SK,SK
51745,1699891860,1699926420,34560,29824,113353,TR,TR
106840,1700229240,1700259780,30540,153360,121231,TR,TR
197529,1700116080,1700123340,7260,79235,183217,ES,ES
28175,1699656000,1699690500,34500,9557,97856,MX,MX
98726,1700734860,1700742360,7500,153522,93620,ES,ES
180034,1699809540,1699820040,10500,48488,15002,HR,BA
101225,1700137440,1700171220,33780,199280,61418,TR,TR
46733,1698893700,1698900300,6600,128435,50793,GB,GB
39904,1700511840,1700529480,17640,148944,60076,FR,FR
145553,1699333380,1699337820,4440,87785,183522,GB,GB
39700,1700532000,1700548020,16020,53638,70653,US,US
29924,1699942260,1699955520,13260,129136,14216,PT,PT
51487,1700617800,1700647980,30180,38841,24267,TR,TR
41389,1700603220,1700636940,33720,113678,112638,TR,TR
112641,1700243400,1700256300,12900,122051,1371,IT,IT
113609,1700612040,1700618280,6240,127262,122536,EE,EE
182644,1700607840,1700612460,4620,182470,47018,GB,GB
56131,1700797020,1700827680,30660,16076,65502,TR,TR
39714,1700046180,1700076420,30240,26484,2078,TR,TR
167918,1699662120,1699697220,35100,151895,9500,TR,TR
179784,1699859100,1699883340,24240,130572,196745,BR,BR
13354,1699468920,1699475700,6780,137754,170960,GB,GB
2789,1700769060,1700772660,3600,175786,195523,GB,GB
77137,1700167020,1700175480,8460,77597,81776,ES,ES
50851,1700382240,1700410560,28320,55264,1516,PL,HU
33217,1698854340,1698868020,13680,84394,194551,IT,IT
45012,1699197180,1699225920,28740,154520,87758,DE,BG
45608,1700325960,1700335860,9900,113343,161622,IT,IT
186813,1700733540,1700769180,35640,124784,132682,TR,TR
194081,1699977840,1699988760,10920,141171,180482,IT,IT
97010,1699232880,1699238460,5580,101363,177811,NL,NL
168177,1699074360,1699094220,19860,99489,196710,BE,SK
39951,1700842560,1700856900,14340,88862,70647,US,US
34834,1699406400,1699433700,27300,137027,77302,DE,PL
5511,1698867900,1698902460,34560,16198,3165,TR,TR
131157,1699211940,1699219380,7440,91337,25473,IT,IT
181255,1699852740,1699857240,4500,65987,198353,EE,EE
83985,1700309100,1700312700,3600,188038,20435,GB,GB
38270,1699575720,1699606140,30420,93343,106920,TR,TR
20519,1700693160,1700710620,17460,35148,196640,US,US
45859,1699617480,1699640820,23340,108775,154308,DE,PL
160144,1699124940,1699154700,29760,34895,128858,TR,TR
126795,1700187300,1700205000,17700,108293,94503,FR,DE
49705,1700513760,1700545320,31560,76381,79936,TR,TR
168781,1699194540,1699200360,5820,105301,37034,EE,EE
158238,1699130820,1699145520,14700,80062,33066,AT,HR
58937,1700738220,1700741820,3600,97239,34937,GB,GB
183560,1699343400,1699372380,28980,182507,6055,TR,TR
125055,1700479500,1700512140,32640,128254,3149,TR,TR
68274,1699689420,1699724760,35340,54810,140452,MX,MX
184097,1699555680,1699559280,3600,122081,99160,GB,GB
134738,1700272620,1700279280,6660,93786,190237,GB,GB
78019,1699339440,1699373940,34500,176228,29929,TR,TR
101286,1699275480,1699287720,12240,35873,186216,IT,IT
132151,1700853600,1700862480,8880,149755,54424,IT,IT
56487,1699094640,1699098240,3600,185131,105356,GB,GB
87677,1699711020,1699714620,3600,134461,109309,NL,NL
25923,1700012700,1700045280,32580,19017,29357,TR,TR
100348,1699069500,1699101540,32040,4615,154366,TR,TR
117192,1699066260,1699099860,33600,37830,191473,TR,TR
5502,1699120080,1699123680,3600,159993,169812,GB,GB
130743,1699980660,1699984440,3780,117800,81965,NL,NL
174283,1700760900,1700783580,22680,190215,91099,RO,RO
20907,1699866960,1699898820,31860,60737,14944,TR,TR
20391,1699217940,1699242840,24900,39057,178293,PL,DE
152136,1700556960,1700566500,9540,170904,189765,HR,CZ
83074,1700772240,1700804880,32640,55970,119497,TR,TR
140582,1700642340,1700678280,35940,22176,66771,TR,TR
110262,1699550100,1699566180,16080,17934,135042,AT,AT
53147,1699362780,1699396140,33360,26833,98678,TR,TR
187278,1700700600,1700736480,35880,57551,77974,TR,TR
21945,1700698560,1700721060,22500,19387,97713,DE,PL
186915,1699900260,1699932360,32100,171759,29328,TR,TR
149848,1699176900,1699211520,34620,31167,46926,MX,MX
48042,1699251480,1699266180,14700,22894,117354,US,US
973,1700093280,1700110440,17160,98963,163016,US,US
76566,1699369260,1699405020,35760,81628,158050,TR,TR
20606,1700031960,1700066700,34740,95147,141944,TR,TR
31939,1698922500,1698927840,5340,150996,41732,GB,GB
86477,1700242080,1700275260,33180,61980,70428,TR,TR
189593,1699687320,1699711020,23700,101217,20270,RO,RO
44786,1699651260,1699666200,14940,33038,145634,US,US
146508,1700541060,1700560980,19920,141530,50675,FR,FR
196935,1700468760,1700503080,34320,48046,162898,TR,TR
59561,1699021080,1699040220,19140,104398,39722,SE,SE
168109,1700057100,1700092800,35700,128040,87133,TR,TR
152031,1699189080,1699194960,5880,133343,55360,NL,NL
187323,1699342860,1699357740,14880,185103,35121,CA,CA
122441,1700028600,1700056680,28080,172884,10734,DE,DE
179747,1700149560,1700154060,4500,92417,75081,NL,NL
190163,1699484580,1699498260,13680,6154,74331,US,US
23409,1700436120,1700459880,23760,338,155688,DE,DE
5432,1699374180,1699404600,30420,69265,136102,TR,TR
21369,1699118520,1699122120,3600,97663,54451,NL,NL
86168,1700696640,1700753220,56580,4871,28137,BG,DE
197200,1700822220,1700849580,27360,94388,90701,DE,DE
70858,1700758920,1700766180,7260,19143,148015,IT,IT
41790,1699232040,1699249980,17940,97381,166197,US,US
169547,1699046280,1699101600,55320,133363,154174,BG,AT
119759,1700043660,1700074860,31200,115169,149472,TR,TR
4095,1700259120,1700273460,14340,6701,115519,AT,MK
107282,1699446840,1699462320,15480,157580,147746,US,CA
31502,1699887420,1699921380,33960,175123,196111,TR,TR
145591,1699516920,1699533840,16920,190623,113466,US,US
85107,1698955920,1698959940,4020,150622,177428,NL,NL
189755,1700851800,1700860020,8220,158716,64679,PT,PT
97590,1700636280,1700641380,5100,138735,17156,GB,GB
71093,1699715640,1699723500,7860,3094,57903,PT,PT
113359,1699563960,1699577580,13620,44041,110774,US,US
183949,1700845020,1700870640,25620,145619,59431,PL,CZ
8108,1700720040,1700755260,35220,65958,100903,MX,MX
17236,1700400660,1700431800,31140,23225,69470,TR,TR
106468,1699657560,1699687260,29700,67888,15499,TR,TR
10108,1699379760,1699411500,31740,10301,166093,TR,TR
172461,1699118100,1699147080,28980,58781,18982,TR,TR
170764,1699406880,1699424220,17340,143479,89862,US,US
124839,1698912240,1698920460,8220,82470,4362,HR,HR
123356,1699276080,1699286700,10620,151888,66704,PT,PT
82901,1700614620,1700618220,3600,63865,56912,NL,NL
14664,1699909740,1699920360,10620,158438,43686,IT,DE
189245,1700544420,1700578560,34140,174085,12288,TR,TR
127845,1699369440,1699375200,5760,11996,157710,GB,GB
120513,1699676400,1699687440,11040,1867,121263,IT,IT
83957,1699846380,1699870680,24300,59966,159183,DE,DE
141,1700182080,1700197200,15120,79866,1977,RS,SI
13181,1699354680,1699364700,10020,170332,52776,IT,IT
88378,1699119180,1699154700,35520,137400,105492,TR,TR
162000,1700449680,1700478900,29220,74644,14055,TR,TR
166793,1699071060,1699081560,10500,88147,175027,HR,HR
199721,1699075140,1699105860,30720,128341,3611,TR,TR
180435,1699589820,1699625700,35880,177142,26075,TR,TR
167849,1699405140,1699417200,12060,127368,156343,US,US
106388,1699024920,1699056540,31620,125719,174447,TR,TR
161046,1698920340,1698953640,33300,29729,68013,TR,TR
124764,1699284420,1699312380,27960,89808,28969,BR,BR
52597,1700651280,1700660460,9180,188008,33397,IT,IT
95376,1700035440,1700039040,3600,188021,185955,GB,GB
181065,1698988020,1699022040,34020,19196,6992,TR,TR
80428,1699127700,1699158120,30420,100205,11850,BA,DE
12060,1699308480,1699343100,34620,70424,7413,TR,TR
58722,1698979860,1699011720,31860,174724,190181,TR,TR
169838,1700615580,1700629200,13620,112523,43746,AT,AT
176166,1699348740,1699356780,8040,36734,102915,IT,IT
152359,1699394940,1699425420,30480,181672,32667,TR,TR
804,1699642020,1699674600,32580,108844,93895,TR,TR
135943,1699596480,1699608240,11760,146545,87647,HR,DE
184700,1699780800,1699789200,8400,15704,162415,IT,DE
29401,1700627220,1700630820,3600,47746,48779,GB,GB
196519,1699637460,1699675080,37620,29922,141512,MX,MX
89598,1699534860,1699550340,15480,77323,154852,US,US
29253,1699104420,1699139640,35220,116649,117428,TR,TR
120421,1699015560,1699031580,16020,138641,118836,US,US
13207,1700166000,1700195280,29280,177712,142205,TR,TR
107008,1700236560,1700254380,17820,155200,17222,US,US
122945,1699643820,1699659420,15600,85335,41197,RS,NL
114080,1698996180,1699030200,34020,46033,126590,TR,TR
45473,1698984480,1699008780,24300,141315,111013,DE,DE
166632,1700608080,1700622360,14280,80199,38639,US,US
27700,1699225620,1699237020,11400,73375,27509,AT,DE
34715,1700000220,1700034180,33960,95514,75173,TR,TR
78540,1700018460,1700053800,35340,66766,153261,TR,TR
165528,1700257680,1700267280,9600,121613,64770,ES,ES
24414,1700633580,1700646180,12600,98635,128765,IT,IT
102361,1700441040,1700463660,22620,190375,173582,DE,FR
89287,1699825320,1699828920,3600,128310,101594,GB,GB
152579,1699432560,1699440180,7620,60824,180772,IT,IT
170950,1699800660,1699815780,15120,137395,38018,US,US
59317,1699125060,1699132920,7860,142217,89490,PT,PT
129367,1699082700,1699094040,11340,163007,70970,AT,AT
94327,1699723200,1699726800,3600,115011,188655,GB,GB
24818,1699516140,1699551360,35220,55787,130635,TR,TR
82893,1699054920,1699084140,29220,60435,102922,TR,TR
175418,1699638540,1699674060,35520,10875,136162,TR,TR
120252,1700527920,1700543400,15480,137233,88448,CA,US
155125,1700317080,1700351340,34260,66581,88627,TR,TR
117076,1699477260,1699507680,30420,77522,97919,TR,TR
95880,1699579860,1699610340,30480,102212,194821,TR,TR
57047,1698830100,1698833700,3600,81178,135497,GB,GB
146851,1699377900,1699413480,35580,166033,6558,TR,TR
102236,1700129460,1700135640,6180,124341,160539,GB,GB
167179,1700637480,1700655720,18240,124071,23609,FR,DE
53165,1699904520,1699929960,25440,53997,135323,DE,NL
16315,1700234520,1700263620,29100,94073,62847,TR,TR
20947,1700379300,1700411100,31800,31443,185069,TR,TR
120399,1699443300,1699463580,20280,106535,30658,DK,DK
146075,1699901940,1699937040,35100,92647,131003,TR,TR
6095,1699671840,1699704720,32880,65007,118157,TR,TR
6044,1698918120,1698930720,12600,187359,192048,IT,IT
47599,1699369500,1699388040,18540,53906,10632,LT,PL
162926,1700383560,1700387160,3600,58250,97987,GB,GB
6419,1699859580,1699871880,12300,9030,35097,US,US
197160,1699633080,1699661940,28860,180019,36748,TR,TR
53890,1700200200,1700207940,7740,133236,150828,HR,BA
71812,1700375340,1700401680,26340,54523,54584,DE,PL
8405,1699831380,1699866780,35400,20737,176091,TR,TR
123512,1700277780,1700289000,11220,136279,76085,IT,IT
115055,1699769700,1699803360,33660,76922,177692,TR,TR
4803,1699674180,1699690080,15900,47855,124756,CZ,CZ
170769,1700047920,1700051520,3600,6431,52169,GB,GB
174101,1700306400,1700311980,5580,31917,1195,GB,GB
46357,1700212980,1700224860,11880,35128,33592,US,US
70214,1700020500,1700076720,56220,84646,36248,BG,AT
3899,1699525980,1699539480,13500,158875,100202,HR,HR
118499,1700561400,1700566380,4980,101166,30438,GB,NL
35062,1699800000,1699834620,34620,196097,18086,TR,TR
134474,1699312620,1699320120,7500,125008,121457,HR,HR
141837,1699517940,1699529580,11640,104147,89926,ES,BE
37354,1698890340,1698920460,30120,1112,179597,TR,TR
135616,1700586960,1700597700,10740,49036,57394,PT,PT
87691,1699857060,1699889880,32820,56806,50013,TR,TR
190992,1699106820,1699111200,4380,164470,88077,GB,GB
64460,1700359200,1700371620,12420,174948,51802,US,US
77007,1699548480,1699560840,12360,2280,6254,HR,RS
78628,1700774580,1700788740,14160,41599,148147,US,US
140859,1700386020,1700399580,13560,40694,97282,US,US
13082,1699508760,1699533840,25080,183602,38007,HU,AT
55271,1700741040,1700772600,31560,182662,120137,MK,AL
107349,1700481720,1700516940,35220,185416,132301,TR,TR
184508,1699082520,1699114500,31980,117673,96240,TR,TR
13748,1699948980,1699956000,7020,166813,89461,GB,GB
21928,1698862320,1698878340,16020,170868,59850,US,US
363,1700355840,1700387520,31680,93325,96771,TR,TR
173020,1698940920,1698953460,12540,30332,189098,IT,IT
58876,1699939740,1699974720,34980,162697,54113,TR,TR
10682,1699384740,1699397700,12960,7400,186182,IT,IT
61862,1700739000,1700768640,29640,113982,133536,TR,TR
181533,1700460300,1700489460,29160,178869,133408,TR,TR
39169,1700524020,1700536440,12420,96755,168710,IT,IT
63132,1700359380,1700375760,16380,158913,10232,US,US
190694,1699805040,1699808640,3600,91983,29764,GB,GB
165721,1699764720,1699768320,3600,112805,110627,GB,GB
133707,1699388520,1699392120,3600,3212,119717,GB,GB
74114,1699631700,1699667160,35460,78103,80726,TR,TR
172864,1700312460,1700320740,8280,165042,144617,IT,IT
153185,1699735620,1699757520,21900,119586,92541,PL,PL
198884,1700273220,1700281260,8040,193070,156727,IT,IT
84712,1699066440,1699072620,6180,184714,117172,GB,GB
4495,1699887060,1699911420,24360,88877,105993,DE,DE
76903,1699019040,1699048920,29880,158633,2027,TR,TR
9471,1700353260,1700382060,28800,150061,197157,TR,TR
70427,1700433060,1700462400,29340,129033,35954,TR,TR
190560,1699002000,1699034640,32640,185082,16643,TR,TR
131697,1700083020,1700103060,20040,148877,144767,FR,FR
95320,1699632000,1699653840,21840,190146,127935,DE,PL
54632,1700163540,1700167140,3600,182519,137228,GB,GB
18148,1699009500,1699021380,11880,183152,155042,ES,ES
116738,1700431440,1700461740,30300,172052,179890,TR,TR
72178,1699059120,1699069440,10320,128008,179800,HR,HR
1514,1699504260,1699537380,33120,73360,15332,TR,TR
21749,1698848220,1698864600,16380,2254,139446,FR,FR
117684,1699247400,1699258560,11160,30944,192661,US,US
125824,1700851680,1700881980,30300,162735,27699,TR,TR
39710,1698910320,1698941400,31080,95121,50355,TR,TR
68018,1698939480,1698967920,28440,127091,168897,PL,PL
180139,1699277280,1699312560,35280,146329,146182,TR,TR
145262,1700796600,1700812200,15600,160885,131167,RS,RS
150997,1699634460,1699657200,22740,8801,56561,DK,DK
35575,1699880700,1699892520,11820,42646,107323,IT,IT
45217,1700463900,1700496480,32580,68719,25553,TR,TR
171158,1699145700,1699159560,13860,81263,99138,US,US
168362,1699651200,1699660320,9120,117751,76310,HR,HR
55964,1699446960,1699450560,3600,185274,91436,GB,GB
92567,1698918960,1698929940,10980,36335,11628,IT,IT
178488,1700010480,1700044680,34200,124700,754,TR,TR
30819,1699420740,1699424340,3600,13748,13261,NL,NL
136527,1699689360,1699704300,14940,78284,159984,FR,DE
25873,1700007240,1700024760,17520,96946,63061,RS,RS
61663,1698938040,1698972900,34860,52136,10854,TR,TR
145960,1700177520,1700193780,16260,110129,187918,AT,SK
165322,1699871520,1699883400,11880,161984,171999,PT,PT
2564,1699342620,1699376820,34200,62322,79807,TR,TR
158402,1699424700,1699428300,3600,56364,40842,GB,GB
190787,1700549340,1700582580,33240,149521,27773,TR,TR
174341,1700681340,1700716920,35580,129040,90040,TR,TR
125214,1698853380,1698857520,4140,84147,145591,NL,NL
14111,1699308000,1699325280,17280,118324,80423,US,US
46833,1699045740,1699059900,14160,192879,49873,US,US
160721,1700828880,1700842740,13860,167271,167481,IT,IT
126136,1699160760,1699174560,13800,54725,53642,US,US
107857,1699972380,1699987140,14760,197299,85177,FR,FR
79592,1700189760,1700228400,38640,17520,159294,MX,MX
194262,1700119920,1700130660,10740,94583,189033,IT,IT
93281,1699265160,1699276860,11700,100996,91505,US,MX
161223,1700445420,1700479860,34440,3190,191523,TR,TR
115786,1700480940,1700515680,34740,176331,31559,TR,TR
8376,1699767660,1699797480,29820,129764,79252,TR,TR
79523,1700846280,1700879280,33000,145525,45280,TR,TR
137272,1699694040,1699729740,35700,27950,8001,TR,TR
11712,1700443620,1700447220,3600,74505,184987,GB,GB
58238,1700094840,1700109900,15060,61726,22086,US,US
170678,1699993020,1700025120,32100,34325,174670,TR,TR
178083,1698913740,1698944220,30480,70905,180890,TR,TR
160633,1698886440,1698917220,30780,11156,16775,TR,TR
108436,1700539320,1700572080,32760,183853,142371,TR,TR
56725,1700072220,1700087280,15060,152189,1479,AT,IT
128710,1700365380,1700394480,29100,160041,99910,TR,TR
28856,1699502760,1699530960,28200,159109,156931,DE,DE
81377,1699510500,1699526400,15900,130641,80175,AT,AT
198611,1699319160,1699348980,29820,167006,180810,TR,TR
41401,1698807600,1698819600,12000,187364,72018,IT,IT
33569,1699214640,1699236960,22320,81697,3645,BR,BR
30506,1699693260,1699712460,19200,145798,153817,BE,NL
175255,1699272660,1699299300,26640,23665,125363,DE,DE
115362,1699477980,1699511820,33840,69,187756,TR,TR
111895,1698990540,1699020600,30060,147667,96494,TR,TR
163648,1700665680,1700698680,33000,41004,162599,TR,TR
26351,1700815440,1700835480,20040,99759,9320,SE,NO
152299,1700726700,1700760180,33480,111258,9440,MX,US
153514,1698881940,1698916680,34740,16619,171793,TR,TR
82531,1700722920,1700752680,29760,168654,148447,TR,TR
90408,1698907500,1698920760,13260,101951,168645,US,US
10674,1699745520,1699777320,31800,94102,191145,TR,TR
57088,1700274960,1700307000,32040,82854,120720,TR,TR
9878,1700631720,1700637840,6120,168196,152676,GB,GB
96271,1699120860,1699156620,35760,86749,136340,TR,TR
171194,1699212240,1699247940,35700,101864,176872,TR,TR
179728,1699571280,1699602420,31140,1816,32287,TR,TR
159829,1699008600,1699012200,3600,153331,44774,GB,GB
116241,1699439520,1699452180,12660,146321,43105,US,US
84267,1700573940,1700609280,35340,151392,67389,TR,TR
170232,1699525440,1699553760,28320,135467,154080,BR,BR
5021,1699329960,1699342080,12120,176060,46100,IT,IT
182652,1700377260,1700392140,14880,112618,88347,US,US
87930,1699959360,1699989180,29820,131916,121348,TR,TR
50727,1698959520,1698963120,3600,58530,195458,GB,GB
38705,1700697540,1700708520,10980,146018,152541,HR,HR
79939,1699498440,1699533480,35040,177632,47704,TR,TR
114190,1699928160,1699947060,18900,197234,135363,FR,NL
29137,1700830620,1700835300,4680,22761,75723,GB,GB
184929,1699516200,1699537980,21780,99002,127881,PL,PL
122056,1700189040,1700202300,13260,46342,125916,PT,PT
134937,1700849820,1700862180,12360,128836,193927,HR,HR
147311,1699051140,1699061880,10740,144734,33289,IT,IT
182342,1700610000,1700632920,22920,18412,195403,ME,RS
94320,1699150980,1699185540,34560,30142,19389,TR,TR
134819,1698810540,1698843420,32880,185353,161971,TR,TR
44455,1699548600,1699580940,32340,125855,194303,TR,TR
70088,1698957900,1698992400,34500,73558,118993,MX,MX
64623,1700529660,1700556840,27180,178738,2997,RO,RO
188850,1700228700,1700253060,24360,128939,85793,DE,DE
85409,1700671440,1700700360,28920,28374,197674,TR,TR
151242,1699030140,1699062300,32160,53223,50162,TR,TR
186800,1699190880,1699204080,13200,147643,93798,IT,IT
91988,1698819840,1698823440,3600,152075,93239,GB,GB
102739,1699908300,1699964400,56100,20069,134441,BG,DE
155919,1699083600,1699113300,29700,39937,119231,TR,TR
186236,1699247160,1699253220,6060,194390,89052,NL,NL
97551,1699358700,1699383480,24780,45765,20138,BR,BR
107164,1700398980,1700432940,33960,149654,184015,TR,TR
55755,1699440960,1699444860,3900,179243,91618,GB,GB
147117,1699797540,1699810500,12960,195490,75630,IT,IT
31950,1700082600,1700094720,12120,153637,137534,US,US
26530,1699731480,1699741260,9780,26567,99244,IT,IT
19341,1700442000,1700481060,39060,148652,157529,MX,MX
164495,1700081580,1700119020,37440,79319,160584,MX,US
186792,1699709340,1699740120,30780,179606,67768,TR,TR
180603,1699601460,1699618200,16740,136764,15890,FR,FR
133820,1700227920,1700248020,20100,99774,55899,FR,FR
127021,1700810940,1700820240,9300,140661,8367,HR,BA
172512,1700437620,1700441220,3600,169729,55353,NL,NL
130975,1700063340,1700075580,12240,189410,89122,US,US
22613,1700726280,1700750100,23820,110579,17223,RO,RO
19018,1699423740,1699427340,3600,41453,121209,GB,GB
68605,1700004540,1700020140,15600,100878,197709,US,US
63278,1699622520,1699654680,32160,161,188888,TR,TR
168701,1700158320,1700161920,3600,2523,43136,NL,NL
126259,1699352700,1699360320,7620,153644,116505,HR,HR
48081,1698947700,1698978300,30600,165807,72483,TR,TR
9526,1699132020,1699161720,29700,91861,58383,TR,TR
147287,1699179000,1699192500,13500,18739,100645,US,US
95728,1699989720,1700016000,26280,196957,11836,DE,DE
135571,1700248440,1700282940,34500,94902,40161,TR,TR
46118,1698804060,1698836460,32400,95064,45266,TR,TR
82208,1699089300,1699122300,33000,58715,57249,TR,TR
122614,1698897600,1698903480,5880,80937,150979,NL,NL
110582,1700367900,1700383440,15540,137874,233,US,US
2586,1698975480,1698992760,17280,116006,174756,US,US
18733,1700718660,1700726640,7980,121118,616,IT,IT
64739,1699261980,1699278720,16740,12050,198915,BE,FR
16146,1699164660,1699199520,34860,152954,162271,TR,TR
57319,1699714500,1699727580,13080,31187,87240,US,US
187738,1700409000,1700414640,5640,42880,138415,GB,GB
57583,1699075800,1699082280,6480,171170,108979,GB,GB
169272,1699422300,1699434420,12120,169508,116597,IT,IT
198151,1699032360,1699049400,17040,182973,37024,US,US
150314,1699938480,1699952220,13740,44732,138190,ES,AD
16956,1700111220,1700114820,3600,39029,67293,GB,NL
108808,1698950880,1698963120,12240,64606,153779,PT,PT
120783,1698986400,1698991140,4740,14452,72843,GB,GB
28833,1700647500,1700683020,35520,83706,189987,TR,TR
34119,1700769000,1700772600,3600,50514,26210,GB,GB
95950,1700593020,1700597460,4440,171169,65119,AD,ES
106853,1700464260,1700476200,11940,152054,55575,CZ,DE
151558,1699344300,1699376580,32280,153253,19484,TR,TR
137186,1699469520,1699481100,11580,18834,149519,IT,IT
26300,1699399320,1699412040,12720,144548,94362,US,MX
85854,1699019940,1699030200,10260,118864,73157,PT,PT
117104,1700838540,1700842140,3600,190830,106130,GB,GB
27973,1699340220,1699372020,31800,89153,110998,TR,TR
134889,1699140840,1699154760,13920,172705,130473,US,US
24005,1700784240,1700813940,29700,155322,108459,TR,TR
130380,1699798740,1699802340,3600,45689,134201,GB,GB
78700,1700232960,1700265600,32640,124313,53513,TR,TR
81357,1699152840,1699188360,35520,99892,71299,TR,TR
99216,1698876660,1698898260,21600,135668,138802,HU,CZ
83217,1699744800,1699748400,3600,114145,190509,NL,NL
71804,1698806940,1698841440,34500,108964,176169,TR,TR
86641,1699900560,1699904160,3600,127699,155054,NL,NL
82763,1699600140,1699612320,12180,41641,143752,US,US
147208,1700068440,1700085720,17280,73844,24060,US,US
88726,1700014860,1700022240,7380,71844,172602,IT,IT
49246,1700231400,1700244660,13260,20179,110841,US,US
166208,1699588680,1699603500,14820,130375,121199,US,US
62827,1700148300,1700162100,13800,44996,71770,RS,RS
55136,1698811020,1698837000,25980,191918,193673,DE,DE
169467,1700203020,1700234940,31920,37801,56129,TR,TR
60499,1700689380,1700700600,11220,129076,176662,US,US
140659,1699132680,1699139100,6420,8610,722,GB,GB
129660,1699515300,1699518900,3600,110192,107208,GB,GB
50764,1700519100,1700539320,20220,80553,26265,FR,NL
153124,1700298960,1700334480,35520,1678,95762,TR,TR
192312,1699874700,1699887960,13260,63770,69441,CZ,AT
166215,1700308320,1700339220,30900,183756,117420,TR,TR
64758,1699143300,1699173540,30240,139124,192712,TR,TR
29660,1699504560,1699532040,27480,36866,192674,RO,RO
19685,1700392260,1700427120,34860,198531,5295,TR,TR
185370,1700811780,1700846040,34260,9092,4438,MX,MX
2213,1700820420,1700846640,26220,14396,129726,ME,RS
79132,1699260060,1699276260,16200,70831,175398,US,US
21107,1700406960,1700441640,34680,145517,64792,TR,TR
177323,1700025480,1700062440,36960,55739,128072,MX,MX
199457,1700161080,1700175120,14040,133349,102278,IT,IT
133565,1700291940,1700306820,14880,138258,46675,AT,BG
48142,1700574480,1700605560,31080,89492,146370,TR,TR
198658,1699056000,1699087620,31620,96670,90075,TR,TR
89636,1699636200,1699664760,28560,184789,33347,DE,DE
160043,1700536800,1700570580,33780,91094,33027,TR,TR
68381,1699083120,1699097700,14580,13873,49089,US,US
144474,1699067520,1699101360,33840,161374,182167,TR,TR
12154,1700253600,1700258940,5340,129309,103992,GB,GB
75275,1700569080,1700583060,13980,117755,133282,US,US
32810,1700173380,1700183340,9960,33257,4232,ES,ES
156877,1700562060,1700571180,9120,127123,178592,HR,HR
8070,1700161800,1700192820,31020,177722,99476,TR,TR
191335,1700374200,1700403240,29040,119439,43608,TR,TR
71868,1699537560,1699544400,6840,114887,124580,GB,GB
152244,1699270620,1699300740,30120,5989,98822,TR,TR
56130,1699349700,1699379100,29400,98378,194868,TR,TR
69963,1699353420,1699388880,35460,138849,51681,TR,TR
189898,1700031120,1700035500,4380,138555,110671,NL,NL
161250,1699190040,1699223640,33600,118233,165132,TR,TR
72739,1700386680,1700412600,25920,116393,183948,RO,IT
50514,1699478460,1699491360,12900,37570,161932,US,US
134701,1699839540,1699845240,5700,8856,35740,NL,NL
153633,1699529580,1699546860,17280,51938,4635,FR,FR
171066,1699288740,1699299780,11040,73001,7879,ES,FR
131663,1700401260,1700418660,17400,196584,64233,BE,FR
27261,1698926460,1698930060,3600,175779,31029,GB,GB
90582,1698857460,1698867120,9660,145976,22331,IT,IT
171800,1699493040,1699509000,15960,10212,126405,FR,FR
120388,1699220880,1699252920,32040,154893,169664,TR,TR
192721,1698984360,1698996840,12480,6247,127950,HR,HR
27349,1700239740,1700243340,3600,195550,140174,GB,GB
27574,1700200140,1700232000,31860,179223,72624,TR,TR
63553,1699661580,1699697400,35820,18820,120093,TR,TR
120622,1699109580,1699141860,32280,188529,98565,TR,TR
21204,1699727280,1699756140,28860,95648,257,TR,TR
182999,1700477340,1700500140,22800,32807,111751,DE,BA
188493,1700434740,1700446440,11700,74064,165808,US,US
6586,1700835120,1700841600,6480,161878,39151,GB,GB
102774,1699936500,1699970640,34140,52224,62006,TR,TR
177,1700235960,1700269380,33420,40398,62599,TR,TR
95971,1700265540,1700280900,15360,17527,84607,FR,FR
5991,1699572180,1699599120,26940,52059,96464,PL,PL
195216,1699163040,1699175400,12360,157896,144311,AT,CZ
116873,1700564460,1700586720,22260,195502,170047,DE,DE
167283,1700151060,1700186100,35040,134077,183263,TR,TR
164272,1699391580,1699409340,17760,55026,191707,CZ,HU
109415,1700336040,1700344260,8220,52910,97652,HR,PL
111431,1700634780,1700638380,3600,78494,139747,GB,GB
78876,1700639700,1700643300,3600,73936,93242,GB,GB
84169,1700625420,1700659620,34200,85170,154673,TR,TR
195072,1698817500,1698848100,30600,148627,148611,TR,TR
166702,1699386240,1699399980,13740,119528,116104,IT,IT
37630,1699730580,1699741800,11220,122086,175576,US,US
91345,1699489800,1699520940,31140,152487,136634,TR,TR
9819,1700442420,1700446980,4560,164368,123896,GB,GB
178583,1700372700,1700384820,12120,139033,68367,AT,HU
40515,1699413600,1699420260,6660,197176,1375,CL,CL
175027,1700142480,1700161320,18840,796,96516,FR,NL
188704,1699300020,1699314780,14760,4946,24031,US,US
152400,1700076780,1700110140,33360,127995,159430,TR,TR
17789,1699819320,1699829760,10440,89723,199389,SK,SK
58682,1700056920,1700060520,3600,150628,33684,GB,GB
90103,1699433760,1699444620,10860,187407,66616,PT,PT
199753,1700162880,1700170680,7800,78288,37458,IT,IT
199758,1699983600,1699995720,12120,23388,127648,US,US
95216,1700566980,1700598060,31080,55498,135286,TR,TR
2457,1698877800,1698894720,16920,53038,10274,US,US
116916,1699280880,1699294080,13200,68699,113389,IT,IT
155969,1700666940,1700682960,16020,123551,190341,US,US
147022,1699137000,1699140600,3600,24044,11421,GB,GB
93616,1698805680,1698834660,28980,33066,177936,TR,TR
115123,1699873380,1699897920,24540,117370,109657,DE,DE
110844,1700011800,1700019600,7800,166528,59411,IT,IT
41143,1699957740,1699970520,12780,11808,42420,IT,FR
169641,1699532820,1699555740,22920,153054,63027,ME,BA
83859,1699683780,1699698060,14280,13129,49883,IT,IT
191942,1699104120,1699118520,14400,112132,104068,US,US
118737,1700590020,1700595060,5040,170395,42696,GB,GB
95963,1699000560,1699017120,16560,114939,187773,US,US
188416,1700535540,1700539140,3600,96383,120635,GB,GB
181982,1700312700,1700343180,30480,16003,129747,TR,TR
179852,1699844160,1699857840,13680,94385,98979,US,US
82315,1700139120,1700143680,4560,59361,74200,NL,NL
32917,1700593440,1700628000,34560,175634,95714,TR,TR
65632,1700168580,1700200080,31500,57589,42883,TR,TR
22574,1699755900,1699761540,5640,8031,75051,GB,GB
63780,1700464320,1700493180,28860,75275,155159,TR,TR
5433,1699714140,1699747200,33060,156523,54282,TR,TR
140230,1698957360,1698991200,33840,79944,105706,MX,MX
165605,1700769600,1700795820,26220,12859,72151,DE,DE
45153,1700746200,1700772480,26280,50097,26080,BR,BR
20293,1699300980,1699334580,33600,149520,166513,TR,TR
122568,1700440260,1700455800,15540,106303,121566,US,US
7082,1700287680,1700317800,30120,40621,111066,TR,TR
152735,1699096740,1699100340,3600,95316,157597,GB,GB
30242,1698995100,1699027200,32100,101164,184489,TR,TR
21609,1700818260,1700850000,31740,26214,14405,TR,TR
25677,1700185680,1700199120,13440,83237,15135,IT,IT
82776,1700208780,1700240640,31860,150431,6075,BA,HR
162634,1699084080,1699092840,8760,195439,63143,PT,PT
144093,1699263240,1699274400,11160,15503,78871,US,US
46510,1699545180,1699574280,29100,40891,46372,TR,TR
17337,1700098800,1700110020,11220,177686,93193,US,US
55501,1699756140,1699791300,35160,54349,142460,TR,TR
49284,1699385640,1699400880,15240,20037,155633,AT,AT
150574,1699309140,1699341000,31860,111077,58454,TR,TR
11675,1699429020,1699461180,32160,146904,48746,TR,TR
103890,1700649180,1700682120,32940,11840,90573,TR,TR
81898,1699609620,1699645380,35760,92860,57305,TR,TR
144408,1700050560,1700082660,32100,142258,136793,TR,TR
104585,1700486700,1700491860,5160,91434,66493,GB,GB
146829,1700428560,1700432160,3600,182827,163331,NL,NL
166005,1700563680,1700592720,29040,170623,58228,TR,TR
103984,1699667820,1699684500,16680,23253,150408,US,US
158730,1699318800,1699322400,3600,132604,137142,GB,GB
188071,1700705100,1700733780,28680,74951,96148,BR,BR
14343,1699779300,1699791540,12240,48535,28777,US,US
32741,1698827580,1698835020,7440,24859,118561,IT,IT
56993,1699867740,1699871340,3600,155974,166981,GB,GB
150752,1700729100,1700735400,6300,127104,131507,GB,GB
61886,1699678020,1699690740,12720,150618,84321,IT,IT
71388,1700419500,1700454720,35220,142056,24420,TR,TR
199679,1699098120,1699137120,39000,117441,114029,MX,MX
94815,1700444940,1700474760,29820,23867,187017,TR,TR
38844,1699303560,1699307160,3600,170067,162209,NL,NL
54102,1699802700,1699833840,31140,127504,150581,TR,TR
49930,1699338240,1699370040,31800,122891,50592,TR,TR
60845,1700800920,1700804520,3600,106519,44294,GB,GB
154331,1699966680,1699971420,4740,93455,176720,NL,NL
163290,1698797700,1698801300,3600,148868,123817,GB,GB
176680,1699742520,1699774680,32160,49697,20509,TR,TR
128950,1700244000,1700251200,7200,139087,145581,PT,PT
75725,1699884780,1699896840,12060,197856,129766,US,US
42840,1700641320,1700650020,8700,18872,174831,HR,HR
129548,1699217340,1699227360,10020,70612,139496,IT,IT
178248,1700628060,1700660280,32220,119097,23173,TR,TR
180095,1700689140,1700719860,30720,78210,32760,TR,TR
145846,1699678980,1699738980,60000,51471,13953,UA,HU
81158,1699388160,1699395420,7260,86374,156130,IT,IT
22921,1699526400,1699560840,34440,178508,46702,TR,TR
34873,1699707660,1699736460,28800,107036,111181,TR,TR
121042,1699404000,1699414980,10980,42405,41202,AT,BG
112298,1698997800,1699005960,8160,66841,110357,IT,IT
174552,1699147440,1699151040,3600,70201,190037,GB,GB
2305,1698963000,1698967380,4380,71093,33197,GB,GB
11221,1700733420,1700749260,15840,104723,39272,CA,CA
193713,1699848120,1699882200,34080,111507,106024,TR,TR
64037,1700592540,1700608800,16260,160564,113722,US,US
193217,1700716020,1700745480,29460,123978,115641,TR,TR
71252,1699565340,1699599960,34620,20604,170871,TR,TR
4397,1700219220,1700232480,13260,9879,186870,RS,RS
101759,1699852980,1699873980,21000,62211,163630,DK,DE
78646,1699864980,1699877220,12240,191431,162448,US,US
178086,1699402860,1699434420,31560,131561,192438,TR,TR
91863,1700052600,1700084460,31860,44866,16990,TR,TR
121912,1700295240,1700321280,26040,100407,95637,RO,RO
34314,1699735560,1699749360,13800,23049,187993,PT,PT
127616,1700191680,1700226900,35220,67661,70540,TR,TR
171159,1699765200,1699778280,13080,176259,183011,IT,IT
184860,1700148540,1700165640,17100,183461,157747,US,US
157313,1700495340,1700520480,25140,6061,29609,DE,NL
27238,1699537380,1699540980,3600,8941,149750,NL,NL
16530,1700757480,1700770380,12900,90843,41895,IT,IT
189470,1700125680,1700154960,29280,93001,186788,TR,TR
21380,1699135500,1699166820,31320,98479,66879,TR,TR
151468,1699871400,1699901100,29700,41244,179838,TR,TR
66423,1698952320,1698955920,3600,69754,56011,NL,NL
71029,1699910700,1699945980,35280,145664,72288,TR,TR
13551,1699797180,1699821960,24780,113447,40162,DE,FR
173743,1700454120,1700463780,9660,190276,124807,IT,IT
38971,1698858180,1698861780,3600,66221,166317,GB,GB
69922,1700043240,1700057820,14580,163319,125336,US,US
6572,1700813220,1700847120,33900,107728,86312,TR,TR
65598,1700806680,1700819700,13020,4928,151428,US,US
154771,1699294920,1699306680,11760,45073,32954,AT,AT
157535,1699587180,1699606260,19080,103603,182363,FR,DE
24140,1699288380,1699292640,4260,178020,154493,NL,NL
115143,1700083800,1700087820,4020,92989,126229,GB,GB
32377,1700702820,1700729640,26820,139309,55824,DE,BE
68083,1700754960,1700780640,25680,71088,159141,DE,DE
175054,1699677360,1699697940,20580,186053,90041,FR,DE
82057,1699859220,1699874580,15360,190552,114669,CZ,PL
180555,1700227980,1700246280,18300,37401,11721,BE,FR
76646,1700241540,1700249520,7980,119104,192631,IT,IT
134289,1699066020,1699087500,21480,79864,136164,BE,HR
160616,1699981860,1699998540,16680,162450,49401,FR,BE
126141,1700469240,1700507280,38040,163536,53665,MX,MX
28768,1699872960,1699876560,3600,79320,144901,GB,GB
154534,1700607960,1700640120,32160,121849,151029,TR,TR
106273,1700456340,1700459940,3600,32498,85164,GB,GB
3206,1699136640,1699147740,11100,98124,14561,US,US
91849,1698860760,1698864360,3600,130791,166150,GB,GB
49469,1700296080,1700299680,3600,110919,199484,GB,GB
85428,1699534980,1699548240,13260,190360,86995,US,US
40624,1698883440,1698887040,3600,46263,179067,GB,GB
173991,1699012140,1699041120,28980,175119,105364,BA,DE
146876,1699639500,1699643760,4260,13227,160639,GB,GB
99393,1698894300,1698897900,3600,143204,58412,NL,NL
135950,1699638840,1699643400,4560,82877,180548,GB,GB
188652,1699757040,1699769520,12480,22622,27902,IT,IT
81710,1700454360,1700486760,32400,162929,88235,TR,TR
53026,1700389740,1700398500,8760,171478,32719,PT,PT
101278,1699497240,1699507560,10320,39837,99835,IT,IT
62957,1700717340,1700741220,23880,69862,135201,DE,DE
176801,1699365360,1699372980,7620,150975,131530,HR,HR
150183,1699143960,1699161900,17940,41680,49906,FR,FR
42721,1700449560,1700453160,3600,37152,28709,GB,GB
72766,1698993300,1699029120,35820,59613,125937,TR,TR
111930,1700386980,1700405760,18780,98301,4008,FR,FR
36344,1700077740,1700109540,31800,111662,149714,TR,TR
157863,1699873260,1699908420,35160,78695,122112,MX,MX
113769,1698883320,1698887640,4320,180963,99411,NL,NL
90450,1699489560,1699494240,4680,34732,17049,EE,EE
171818,1699694460,1699726920,32460,55508,80760,TR,TR
86722,1700352840,1700359380,6540,138169,141859,FI,EE
118971,1700846700,1700860380,13680,89005,85670,US,US
113509,1700512440,1700532060,19620,105854,125876,DK,DK
24832,1700778060,1700811300,33240,106322,73723,TR,TR
37193,1700413200,1700417460,4260,145256,163555,GB,GB
129142,1699943640,1699947240,3600,137199,112421,GB,GB
147899,1700184540,1700216460,31920,47101,92797,TR,TR
71990,1698837000,1698869340,32340,90339,107985,TR,TR
178989,1699567620,1699592160,24540,94784,138245,DE,PL
190154,1699444680,1699473540,28860,111372,56438,TR,TR
26802,1700367720,1700379480,11760,185293,74841,IT,IT
191571,1699925880,1699958460,32580,172089,113296,TR,TR
162408,1700087460,1700121000,33540,8901,50759,TR,TR
105583,1700145660,1700166240,20580,115377,186797,FR,FR
106151,1700568180,1700575320,7140,193301,9755,NL,NL
171548,1700360760,1700396700,35940,45734,166915,TR,TR
118721,1700480220,1700506980,26760,186940,194449,DE,FR
158282,1700044560,1700079780,35220,66692,119258,MX,MX
18352,1698918840,1698953940,35100,96970,120637,TR,TR
33878,1700742360,1700745960,3600,44216,63818,NL,NL
71471,1699462920,1699469460,6540,68145,81767,GB,GB
120835,1700436660,1700470620,33960,26183,166437,TR,TR
25672,1699477260,1699508520,31260,56591,8259,TR,TR
146846,1699949220,1699980960,31740,68213,165230,TR,TR
160718,1700439840,1700449200,9360,10859,72735,ES,FR
30775,1700712360,1700739960,27600,124232,57017,DE,SK
37549,1700017560,1700047800,30240,58922,154367,TR,TR
149648,1698863340,1698866940,3600,136957,123238,GB,GB
191119,1699855740,1699868280,12540,106643,134677,US,US
174168,1700829900,1700833500,3600,127052,34873,GB,GB
101981,1699009140,1699012740,3600,156129,87547,NL,DE
65734,1699678140,1699709880,31740,46456,67251,TR,TR
97832,1700309940,1700314680,4740,150199,133663,NL,NL
63817,1700101020,1700112120,11100,64430,16706,IT,IT
24291,1700045940,1700057940,12000,3257,144301,IT,IT
199027,1699813620,1699846680,33060,74660,147978,TR,TR
115390,1699103160,1699108500,5340,157201,61694,NL,NL
153861,1699934040,1699966740,32700,180948,43638,TR,TR
196674,1700120940,1700153820,32880,94997,199190,TR,TR
65506,1698899340,1698934620,35280,62854,60069,TR,TR
172607,1699588440,1699609200,20760,46980,146877,FR,FR
138904,1700147580,1700151180,3600,39031,98801,NL,NL
48844,1700432880,1700468460,35580,89977,158777,TR,TR
110166,1699290660,1699308300,17640,148424,68349,RS,RS
107623,1700586780,1700616540,29760,66284,83401,TR,TR
98420,1699346820,1699382040,35220,126206,45935,TR,TR
44587,1699311720,1699329360,17640,192082,185604,BE,NL
104377,1698865560,1698869160,3600,60164,44730,GB,GB
103338,1699125060,1699160340,35280,74177,89917,TR,TR
57675,1699961460,1699972260,10800,199707,165325,US,US
69574,1700853300,1700883720,30420,107285,62525,TR,TR
166133,1700370660,1700401560,30900,4975,86763,TR,TR
91024,1700363880,1700397300,33420,78158,69373,MX,MX
62468,1699472280,1699485960,13680,48134,148827,HR,RS
101051,1699858020,1699869900,11880,43303,22666,AT,DE
161298,1699864980,1699876740,11760,77156,1273,US,US
107891,1698982980,1698994620,11640,74752,11095,US,US
118456,1698955500,1698977280,21780,105272,177774,CH,FR
49083,1699148640,1699178880,30240,92134,165166,TR,TR
116870,1699345860,1699351080,5220,164570,156136,NL,NL
181718,1699194720,1699230300,35580,64926,67518,TR,TR
148174,1699511400,1699526280,14880,7333,3522,US,US
44054,1699323780,1699339740,15960,31809,10793,US,US
81947,1699446600,1699479420,32820,25464,100507,TR,TR
166471,1700048460,1700081280,32820,91230,198924,TR,TR
156447,1700013180,1700048700,35520,91652,111837,TR,TR
160873,1698808140,1698823800,15660,173911,90844,US,US
175152,1698836340,1698869040,32700,134660,199644,TR,TR
15119,1700389740,1700400840,11100,153010,18051,US,US
99039,1699569900,1699599780,29880,120889,181385,TR,TR
72667,1699020780,1699052940,32160,145347,6121,TR,TR
137153,1699003800,1699030860,27060,23455,48265,DE,BG
54511,1698878580,1698914220,35640,53122,166590,TR,TR
29294,1700540400,1700572020,31620,151651,77213,TR,TR
88241,1700174940,1700213280,38340,144832,136204,MX,MX
22051,1700569200,1700576640,7440,29504,20687,IT,IT
156362,1698797100,1698814260,17160,185216,6148,FR,FR
26982,1700144460,1700159220,14760,39966,172240,CA,US
98537,1699871280,1699898940,27660,33327,140130,RO,MD
63071,1698901380,1698906180,4800,5556,47994,GB,GB
131139,1700224080,1700254200,30120,108814,144481,TR,TR
40656,1699612080,1699615680,3600,133243,180904,NL,NL
44291,1700065200,1700088300,23100,127754,153688,PL,SE
109730,1700834220,1700850840,16620,189964,125915,US,US
190590,1700033580,1700046180,12600,103266,120301,US,US
117799,1699930860,1699936740,5880,132521,90611,NL,NL
38536,1700815920,1700819520,3600,140817,18680,GB,GB
7373,1699687620,1699692840,5220,108520,118467,GB,GB
38449,1700616660,1700635080,18420,152099,40433,FR,NL
56588,1699898640,1699918860,20220,64506,157026,FR,FR
107468,1698999180,1699016880,17700,196738,142770,US,US
69688,1699692360,1699723320,30960,13350,182580,TR,TR
56560,1700773740,1700804460,30720,126050,167040,TR,TR
131091,1699092180,1699106280,14100,45230,195130,IT,IT
44115,1699121580,1699136400,14820,139923,46173,US,MX
95453,1699518900,1699541340,22440,105787,62831,DE,DE
105403,1700667480,1700702820,35340,66908,13974,TR,TR
25510,1699235040,1699247400,12360,133108,136562,US,US
168319,1699231980,1699267620,35640,167725,149925,TR,TR
59300,1700287620,1700301720,14100,84800,61378,US,US
198562,1700035800,1700049720,13920,124722,135490,CZ,HU
161978,1699042680,1699046280,3600,192413,121651,NL,NL
164220,1699570980,1699601280,30300,92847,173462,TR,TR
68131,1699123860,1699145100,21240,48675,140256,MD,RO
95176,1699353840,1699367880,14040,76324,124114,CZ,CZ
148921,1698907920,1698937200,29280,56465,44920,TR,TR
26467,1700854260,1700859600,5340,170285,3200,GB,GB
81517,1699349580,1699402020,52440,184195,156106,BG,DE
32353,1700590080,1700611020,20940,125450,1262,FR,FR
168983,1699232220,1699236120,3900,190083,196859,NL,FR
31345,1698895380,1698929220,33840,116602,118382,TR,TR
160560,1700021760,1700053080,31320,69375,87937,TR,TR
137138,1700826120,1700856780,30660,56403,14300,TR,TR
132698,1700670300,1700681460,11160,34106,183710,US,US
34412,1700104860,1700134680,29820,37260,106736,TR,TR
128565,1700395140,1700424300,29160,148552,96303,TR,TR
185287,1700394060,1700401800,7740,171274,187082,IT,IT
64256,1699029360,1699042320,12960,124599,152663,HR,DE
129935,1699955640,1699969020,13380,68787,146777,US,US
116782,1699129320,1699134420,5100,150750,37867,GB,GB
137983,1700451000,1700463480,12480,157494,53400,CZ,HU
161424,1700703180,1700726400,23220,62861,28520,DE,SK
32302,1700720040,1700753640,33600,69676,162507,TR,TR
88551,1699940460,1699969500,29040,146469,127743,TR,TR
162952,1700340540,1700352840,12300,132131,192637,IT,IT
105214,1700702220,1700713440,11220,86732,148387,IT,IT
65612,1699303080,1699328700,25620,163532,24083,PL,PL
163958,1700814900,1700827920,13020,170421,186912,US,US
162980,1699881720,1699900320,18600,176244,37427,SI,BA
50577,1699926240,1699939740,13500,137541,98114,IT,MK
43791,1700838960,1700870640,31680,129572,13576,TR,TR
74836,1699445700,1699480680,34980,177395,33685,TR,TR
183447,1700450460,1700484360,33900,121746,88486,TR,TR
43861,1700053860,1700070120,16260,169760,188879,FR,IT
155736,1700487600,1700516460,28860,108061,60584,TR,TR
113441,1699187340,1699209540,22200,91932,135591,PL,BE
169597,1699164720,1699175640,10920,147400,126683,ES,FR
183288,1699522980,1699552380,29400,41237,161473,TR,TR
65830,1698941400,1698948660,7260,8015,82100,IT,IT
113510,1699119480,1699129620,10140,174174,1395,IT,IT
13820,1699774200,1699785480,11280,132036,127555,US,US
125410,1699352820,1699378920,26100,12809,163943,DE,PL
18403,1700308560,1700312160,3600,9644,175245,GB,GB
194514,1699184340,1699201800,17460,180099,48046,US,US
60070,1700653080,1700656680,3600,55379,26587,NL,GB
160871,1700282040,1700295780,13740,49708,80132,HR,HR
108568,1699656180,1699685940,29760,152014,3305,TR,TR
69869,1699774380,1699782300,7920,35547,83469,IT,IT
154745,1700214600,1700222340,7740,82525,116120,AD,ES
197053,1698843660,1698856200,12540,86666,199447,ES,ES
195182,1698835320,1698866280,30960,93753,100213,TR,TR
89238,1699122240,1699134420,12180,156263,53587,IT,IT
155955,1698855420,1698867900,12480,52519,74053,IT,CH
161503,1699047960,1699051560,3600,157951,19903,GB,GB
160348,1700330460,1700347140,16680,34235,141027,US,US
124517,1699303320,1699312020,8700,182646,105771,AD,ES
36104,1700425500,1700436360,10860,12627,116771,IT,IT
82681,1700304780,1700339640,34860,186990,153185,TR,TR
57701,1700455920,1700459520,3600,4217,74976,NL,NL
10599,1700745900,1700774880,28980,189855,136741,TR,TR
136192,1699219320,1699222920,3600,181155,48269,GB,GB
100350,1699768440,1699796580,28140,47250,97314,BA,HR
7629,1699500120,1699510920,10800,177822,68739,US,US
129303,1699962960,1699997640,34680,17384,174959,TR,TR
68717,1699261500,1699290840,29340,56391,96360,TR,TR
113734,1700238960,1700242560,3600,40228,149272,GB,GB
107357,1700169480,1700202060,32580,151472,81750,TR,TR
184455,1700365800,1700405340,39540,14839,163382,MX,US
114046,1700649900,1700680320,30420,154419,157261,TR,TR
94988,1700406120,1700441340,35220,183317,163462,TR,TR
64364,1699663260,1699666860,3600,16650,168488,NL,NL
43664,1700677140,1700706540,29400,849,43582,TR,TR
175196,1699715400,1699719000,3600,94525,81801,NL,NL
147094,1700761980,1700768580,6600,48523,174717,GB,GB
16123,1699459320,1699473480,14160,78895,106706,ES,FR
110987,1699525980,1699535760,9780,104319,186258,IT,IT
85796,1700568840,1700603460,34620,91541,40380,TR,TR
41696,1698809220,1698831300,22080,76090,50416,PL,PL
41540,1700435100,1700451060,15960,84651,187702,FR,ES
136971,1700098380,1700129640,31260,77173,161364,TR,TR
186070,1699634760,1699640460,5700,95820,98186,GB,GB
166504,1700085420,1700119800,34380,86291,158843,TR,TR
178041,1700361540,1700394420,32880,60938,128899,TR,TR
182827,1698991680,1699013160,21480,730,158553,FR,FR
91256,1699112160,1699144380,32220,76066,165748,TR,TR
54676,1700156760,1700180520,23760,21767,36484,CH,DE
83178,1700283720,1700296980,13260,175086,188260,US,US
31180,1700653260,1700681100,27840,71379,41070,CH,DE
115125,1698887940,1698920880,32940,70100,45765,TR,TR
42887,1700285700,1700307600,21900,127354,46755,BR,BR
174509,1700621820,1700628000,6180,119397,150877,NL,NL
34429,1700641440,1700652540,11100,8897,89798,SK,SK
81259,1699363680,1699392600,28920,66053,24368,TR,TR
85280,1698933840,1698947160,13320,172292,199806,RS,RS
20802,1700042220,1700050920,8700,183007,17424,IT,IT
34800,1699467720,1699495140,27420,135040,160636,DE,DE
52743,1698886500,1698890100,3600,197284,89120,NL,NL
81961,1699119000,1699136880,17880,39333,139080,AT,AT
143359,1700379840,1700396640,16800,41884,71386,BE,NL
86643,1699171260,1699177620,6360,5930,105683,GB,GB
190216,1700302440,1700336880,34440,183306,151054,TR,TR
103667,1699036080,1699066980,30900,102716,154185,TR,TR
125454,1700784180,1700795280,11100,75971,12344,SK,CZ
96218,1700788860,1700824320,35460,163236,168154,TR,TR
92582,1700466900,1700492640,25740,92490,113581,RO,RO
151629,1700288880,1700292480,3600,61112,70076,NL,BE
156802,1700397120,1700432880,35760,115084,146049,TR,TR
78015,1699670400,1699685880,15480,148512,157517,US,US
139823,1700222520,1700238360,15840,153442,127596,CZ,CZ
86410,1700047620,1700055600,7980,45186,48733,IT,IT
52665,1699889580,1699923540,33960,129768,111186,TR,TR
174651,1699602720,1699631640,28920,117319,82487,TR,TR
9552,1700703960,1700708700,4740,101851,177425,NL,NL
26827,1700451120,1700465460,14340,150544,85832,US,US
105708,1699975140,1699980780,5640,26936,72565,GB,GB
72033,1700067060,1700098440,31380,3410,195817,TR,TR
165699,1699742160,1699753200,11040,22810,76081,US,US
197007,1700497440,1700501040,3600,53010,78392,GB,GB
4944,1699569540,1699581300,11760,126934,178146,IT,IT
10252,1700104740,1700137020,32280,90479,61876,TR,TR
35409,1700031720,1700064600,32880,143762,59857,TR,TR
55498,1698962460,1698969180,6720,81323,197752,GB,GB
78425,1699735920,1699767180,31260,130935,76990,TR,TR
48506,1700303040,1700337120,34080,13530,38670,TR,TR
10767,1699214700,1699245180,30480,109176,55711,TR,TR
93604,1699108860,1699112460,3600,48878,149217,GB,GB
32982,1699346700,1699375500,28800,35793,183918,TR,TR
119492,1699414860,1699426920,12060,14823,155222,CZ,CZ
52430,1699493220,1699510200,16980,57500,47189,AT,AT
89296,1699701540,1699731720,30180,77635,166007,TR,TR
102309,1699726680,1699735020,8340,60464,48990,EE,FI
110764,1699919760,1699923360,3600,78754,188242,GB,GB
114677,1700579820,1700602320,22500,56749,183711,RO,MD
82934,1699734720,1699752420,17700,153724,74480,US,US
144659,1699437840,1699458360,20520,129751,17159,FR,FR
9066,1699385160,1699415340,30180,68329,92929,TR,TR
145939,1698924240,1698928980,4740,3058,64600,GB,GB
182039,1699225080,1699260900,35820,66456,156362,MX,MX
143116,1699152240,1699167360,15120,1271,78347,AT,BG
86032,1700542140,1700575680,33540,107170,6067,TR,TR
111812,1700244000,1700279700,35700,94016,162716,TR,TR
46968,1699659780,1699664580,4800,133756,194596,NL,NL
145497,1700285700,1700314560,28860,95032,34016,TR,TR
197755,1699392360,1699409400,17040,108653,146223,US,US
115723,1699408140,1699425480,17340,173789,35353,US,US
8363,1700348940,1700364240,15300,148054,58809,US,US
153808,1699128900,1699161300,32400,192436,197610,MX,MX
199149,1700539080,1700543820,4740,173987,127597,GB,GB
138794,1700707200,1700737200,30000,186608,58312,TR,TR
7651,1699211940,1699233720,21780,45161,17338,DE,PL
192181,1699760040,1699777620,17580,49941,106683,RS,RS
61760,1699357980,1699393860,35880,97544,115934,TR,TR
187871,1699447560,1699451160,3600,86915,141166,NL,NL
63707,1700378940,1700409480,30540,151431,125796,TR,TR
152190,1700062080,1700097060,34980,124145,172728,TR,TR
26974,1699214400,1699225020,10620,159590,34243,CL,CL
146273,1700644320,1700654040,9720,115122,98314,ES,RO
196255,1699530840,1699555380,24540,17156,27210,PL,PL
101457,1700538240,1700547600,9360,66192,180181,ES,FR
109527,1699439520,1699453320,13800,48497,8256,US,US
134685,1700849760,1700853360,3600,25720,182740,GB,GB
103227,1700753820,1700786340,32520,47501,48927,TR,TR
66308,1700077440,1700089500,12060,30090,190524,US,US
162526,1700157780,1700190960,33180,87431,154207,TR,TR
39199,1699438260,1699468800,30540,177569,33875,TR,TR
54240,1700215380,1700221020,5640,13865,64528,AD,ES
69390,1698909300,1698921900,12600,170650,58420,US,US
34179,1700744460,1700758800,14340,43525,85603,US,CA
74629,1700719500,1700749080,29580,80290,60614,TR,TR
126528,1699717380,1699724580,7200,6322,18887,AD,ES
179245,1700479560,1700489880,10320,120973,124852,SK,AT
171032,1700109360,1700117100,7740,73898,121125,ES,IT
65779,1699031340,1699066200,34860,148324,21931,TR,TR
5636,1699779240,1699815180,35940,44391,153543,TR,TR
195934,1700064240,1700093100,28860,159574,193488,TR,TR
90059,1699645800,1699679880,34080,4034,39961,MX,MX
129176,1700442780,1700449620,6840,52574,86893,EE,LT
18369,1699602120,1699632540,30420,53544,33072,TR,TR
137274,1699121400,1699125000,3600,29662,56065,NL,NL
190266,1699471500,1699483320,11820,81357,180900,IT,IT
185485,1700655540,1700662680,7140,192783,79880,NL,NL
174047,1700816280,1700850660,34380,173638,69616,TR,TR
66290,1699471140,1699500120,28980,76293,23892,TR,TR
99653,1700573580,1700587680,14100,19948,54980,IT,IT
13302,1700125200,1700155740,30540,81133,114984,TR,TR
111451,1699215720,1699237980,22260,67213,25656,AL,MK
144607,1699682340,1699712040,29700,89461,51657,TR,TR
182359,1700336040,1700339640,3600,188331,27367,NL,NL
41438,1698957720,1698992700,34980,162909,120828,TR,TR
125279,1699636140,1699649580,13440,138778,142220,HR,FR
131444,1700046360,1700079180,32820,20648,79627,TR,TR
124269,1700198400,1700202000,3600,100659,182106,NL,NL
125307,1699972740,1699976340,3600,14010,36972,GB,GB
68867,1699207680,1699241280,33600,163682,106638,TR,TR
187546,1700223900,1700243460,19560,17280,100920,FR,FR
68108,1699049040,1699054140,5100,79412,160412,GB,GB
191493,1700155320,1700158920,3600,107391,118681,GB,GB
150658,1699784340,1699814220,29880,23772,186357,TR,TR
116718,1700327640,1700337360,9720,19097,144425,IT,IT
8587,1700324700,1700357160,32460,197623,74724,TR,TR
89070,1700842020,1700873460,31440,189135,161815,TR,TR
158814,1698892260,1698915180,22920,130490,102385,RO,AT
91091,1699786740,1699805580,18840,47276,135822,FR,FR
48981,1699939500,1699971540,32040,123161,103145,TR,TR
194092,1699401720,1699421700,19980,175510,104655,FR,BE
107126,1700069940,1700081040,11100,57904,126548,CZ,PL
168418,1699838340,1699856220,17880,75252,1398,FR,FR
73794,1700491380,1700521440,30060,151052,100465,TR,TR
154276,1700504940,1700509560,4620,27133,146674,NL,NL
64372,1699992420,1700004240,11820,186390,107594,IT,IT
17423,1700287080,1700295780,8700,43600,154340,HR,NL
41202,1700707080,1700715420,8340,174992,150300,PT,PT
176411,1699992840,1700027040,34200,185810,32024,MX,MX
168558,1700276160,1700287860,11700,122841,70818,US,US
92182,1700351100,1700358780,7680,188828,145229,HR,HR
114089,1699886940,1699915200,28260,8443,103737,DE,ES
102956,1699566720,1699570320,3600,76257,120610,GB,GB
59997,1700856360,1700892000,35640,107429,158239,TR,TR
187224,1699315920,1699319520,3600,43358,75752,GB,GB
97116,1700821800,1700860020,38220,2494,344,MX,MX
169841,1700049780,1700055240,5460,26257,146727,GB,GB
106121,1700733780,1700740200,6420,86893,180438,NL,NL
156339,1700819520,1700833440,13920,168937,138054,IT,IT
22893,1699202640,1699219620,16980,176907,132315,US,US
160058,1699544400,1699553160,8760,99712,143196,PT,PT
142619,1699670400,1699684440,14040,58741,19117,IT,IT
22089,1700302560,1700338860,36300,158733,107337,MX,US
92020,1699833300,1699863540,30240,143505,176908,TR,TR
100402,1700193660,1700204940,11280,129629,69186,IT,IT
58628,1700110020,1700120880,10860,141050,38684,US,US
118934,1700532060,1700563320,31260,149443,116705,TR,TR
156270,1699965480,1699995960,30480,88834,63669,TR,TR
98962,1699689840,1699693440,3600,151891,27799,GB,GB
150246,1699394280,1699429320,35040,155744,127654,TR,TR
166609,1699582380,1699617960,35580,94044,150168,TR,TR
116915,1700015760,1700029860,14100,142809,37717,HR,HR
79899,1699865760,1699869360,3600,80740,46972,GB,GB
47438,1698970020,1698984360,14340,167188,68989,US,US
144194,1699159860,1699197180,37320,184037,192584,MX,MX
59288,1699755600,1699772040,16440,93537,150465,US,US
10978,1699215540,1699227240,11700,100523,148579,SK,SK
199718,1698896640,1698910200,13560,15713,77050,HR,HR
173118,1699619400,1699624140,4740,89026,68125,EE,EE
4061,1700185560,1700205060,19500,95421,175901,BE,DE
140769,1700380800,1700395920,15120,105027,87598,FR,FR
114314,1700255940,1700286480,30540,165218,175118,TR,TR
194183,1699628580,1699662960,34380,144300,185527,TR,TR
84444,1699606260,1699638900,32640,92074,80414,TR,TR
58733,1699003260,1699037820,34560,5685,154498,TR,TR
138811,1700641260,1700646900,5640,86869,68238,FI,EE
18525,1699673400,1699677000,3600,24147,132222,GB,GB
78573,1699569240,1699581840,12600,192745,22630,US,US
370,1700071920,1700083980,12060,88690,7106,US,US
199539,1700161140,1700188320,27180,35958,185364,PL,DE
133038,1700371320,1700389260,17940,11673,54714,SE,SE
56678,1700101440,1700105760,4320,41194,156890,NL,NL
132747,1700852340,1700868300,15960,119052,2259,US,US
19090,1700588940,1700608620,19680,98937,185351,FR,FR
111211,1699624020,1699635720,11700,133662,92339,US,US
44960,1699395960,1699430640,34680,144481,174069,TR,TR
61091,1699477080,1699492740,15660,116951,163571,US,US
40758,1699989540,1700007960,18420,70765,129156,DK,DK
86223,1699329480,1699361880,32400,43498,74121,TR,TR
46358,1699258080,1699271100,13020,75766,149140,ES,FR
160563,1700242080,1700271300,29220,60107,24895,TR,TR
62638,1698986940,1699019340,32400,173776,93047,TR,TR
65332,1700226120,1700229720,3600,131279,74267,GB,GB
182002,1699707300,1699722540,15240,111865,193978,RS,RS
177495,1699051800,1699086780,34980,74418,191209,TR,TR
11826,1699983180,1700012940,29760,156704,14764,TR,TR
122822,1698863220,1698892560,29340,149426,12878,TR,TR
6996,1699884360,1699887960,3600,92916,29157,GB,GB
93192,1699162500,1699174500,12000,141796,162218,US,US
31953,1700451600,1700480880,29280,163851,119274,TR,TR
71139,1699882500,1699915740,33240,186059,188211,MX,MX
141877,1700151780,1700182500,30720,138171,1718,TR,TR
123033,1699747680,1699775760,28080,196769,186006,DE,BG
31292,1698896520,1698922800,26280,7196,48039,DE,DE
12229,1698868200,1698899400,31200,75295,86212,TR,TR
4891,1700687520,1700714160,26640,46433,92247,BR,BR
146098,1699135380,1699169520,34140,37996,78156,TR,TR
4469,1699035240,1699061160,25920,112265,93659,DE,CH
87430,1699164840,1699182360,17520,12668,24321,FR,FR
3423,1699310220,1699315080,4860,43453,198108,NL,NL
62756,1699051680,1699057800,6120,14504,50693,NL,NL
113324,1700257260,1700274840,17580,109949,189528,FR,GB
155618,1699336380,1699353720,17340,128797,11190,US,US
43096,1699586640,1699596660,10020,60161,70936,CL,CL
11010,1699998840,1700014680,15840,102865,107205,US,US
142751,1699849140,1699879980,30840,142220,187063,TR,TR
27363,1699769520,1699800420,30900,100685,119357,TR,TR
78766,1699485480,1699515780,30300,8164,183004,TR,TR
196028,1699799100,1699827060,27960,123975,195907,PL,PL
59884,1699539960,1699556820,16860,80354,34155,FR,FR
119630,1699855200,1699886640,31440,48456,6561,TR,TR
37697,1700106420,1700140200,33780,183345,120726,TR,TR
138359,1699055640,1699059240,3600,94244,189625,GB,GB
56081,1699021620,1699055640,34020,116909,165500,TR,TR
176004,1699836300,1699839900,3600,145801,106862,GB,GB
178602,1700383800,1700388660,4860,43533,30746,NL,NL
75577,1699533360,1699563420,30060,177121,30416,TR,TR
11610,1699268220,1699298160,29940,142956,44857,TR,TR
54284,1700391420,1700424600,33180,49202,112838,TR,TR
26564,1699014180,1699027680,13500,163113,119132,IT,IT
11275,1699937400,1699971600,34200,151397,176767,MX,MX
67278,1700077620,1700113260,35640,51772,51118,TR,TR
27385,1699554960,1699584720,29760,46821,141090,TR,TR
133056,1699473900,1699480080,6180,67523,154035,GB,GB
130095,1700017920,1700022600,4680,50211,125620,GB,GB
64843,1700687040,1700699760,12720,44368,69822,US,US
101720,1700518620,1700530680,12060,65978,38209,US,US
108922,1699253220,1699274340,21120,18288,102397,SE,SE
169512,1700729520,1700756400,26880,97538,957,DE,DE
58651,1699959720,1699980720,21000,157901,105817,BE,NL
71125,1700440440,1700451960,11520,174608,89841,US,US
189321,1699801140,1699804740,3600,24900,111236,GB,GB
71332,1698884940,1698888540,3600,33905,8545,NL,NL
46812,1700736480,1700769660,33180,111591,183864,TR,TR
91828,1699271820,1699300620,28800,163323,66926,TR,TR
114523,1699034280,1699057980,23700,74543,104787,DE,DE
163610,1699806600,1699812300,5700,58097,107957,GB,GB
40236,1699814280,1699830000,15720,107495,138735,US,US
173550,1699499040,1699531680,32640,83692,87589,TR,TR
28812,1700791740,1700818800,27060,158731,118986,PL,HU
6159,1700644200,1700679780,35580,146075,116548,MX,MX
27616,1700469060,1700488740,19680,195363,19290,BE,NL
74798,1700700780,1700704380,3600,138235,107060,GB,GB
129956,1700120520,1700156100,35580,174958,156351,MX,MX
29647,1700423100,1700454060,30960,177458,48392,TR,TR
44691,1700371920,1700397000,25080,43126,91636,PL,UA
114172,1700420760,1700429880,9120,65454,55323,HR,RS
113364,1700457660,1700486460,28800,20601,131285,TR,TR
69636,1699053660,1699064040,10380,192079,89425,IT,IT
152593,1700354160,1700411640,57480,4383,11707,BG,BG
69737,1700036580,1700058120,21540,165871,104995,BE,DE
78398,1699360320,1699391880,31560,139110,14092,TR,TR
54639,1700269860,1700294220,24360,188385,43885,DE,IT
109138,1699961040,1699967880,6840,2550,120645,NL,NL
41938,1699576020,1699579620,3600,77523,146755,NL,NL
167301,1699025520,1699037880,12360,152092,196728,IT,IT
27667,1699739160,1699773600,34440,81465,175076,MX,MX
180151,1700732640,1700763780,31140,34246,38608,TR,TR
192845,1699530360,1699552440,22080,124547,198254,MD,RO
95788,1700247300,1700271660,24360,47754,127508,PL,PL
89140,1700368920,1700401320,32400,160983,185562,MX,MX
6388,1698993960,1699026360,32400,50137,192410,TR,TR
35456,1699797960,1699804980,7020,129599,39684,NL,NL
72949,1700418960,1700432880,13920,162977,175468,US,US
4720,1699083060,1699086660,3600,178992,167798,GB,GB
154619,1699616880,1699646640,29760,174450,193538,TR,TR
188366,1699474380,1699482960,8580,235,172467,IT,IT
162762,1698893220,1698904380,11160,29188,43201,HR,DE
155231,1700111220,1700123700,12480,105919,10786,US,US
65890,1698945000,1698977580,32580,199124,5021,TR,TR
168870,1699633740,1699643400,9660,159013,170029,ES,ES
162042,1699739040,1699748880,9840,42706,98035,PT,PT
60548,1700440440,1700446560,6120,66935,20358,NL,HR
89207,1700166480,1700198160,31680,31553,26556,TR,TR
165878,1698822420,1698847860,25440,131527,18604,PL,NL
173882,1700270460,1700274060,3600,100604,34223,NL,NL
13962,1700741820,1700773440,31620,158742,175581,TR,TR
144300,1699269120,1699282380,13260,9562,48666,US,MX
43971,1700118780,1700153220,34440,12286,133442,TR,TR
164143,1700357400,1700386860,29460,117036,108660,TR,TR
175821,1699966200,1699969800,3600,199775,152099,GB,GB
158412,1700785740,1700797080,11340,142594,145570,AT,DE
54241,1699819380,1699833360,13980,183388,117906,PT,PT
25238,1700431980,1700436180,4200,88477,143272,EE,EE
153174,1699849140,1699884240,35100,157579,194732,TR,TR
79101,1700120220,1700123820,3600,4725,176320,NL,NL
82773,1698990660,1699002780,12120,197946,301,US,US
48989,1699290180,1699308180,18000,187326,47748,FR,FR
86925,1699776120,1699809540,33420,26848,5898,TR,TR
85959,1700457420,1700493360,35940,196580,191066,TR,TR
158986,1699019700,1699023300,3600,67091,109599,NL,NL
13491,1700131080,1700136300,5220,113171,49164,GB,GB
61719,1698950160,1698961800,11640,59773,71362,IT,IT
70030,1699853880,1699859520,5640,127044,153881,NL,NL
116660,1700645640,1700677320,31680,197419,176194,TR,TR
185346,1700769660,1700774520,4860,43105,194705,GB,FR
123736,1698795300,1698813240,17940,35270,181920,AT,NL
22344,1700545800,1700557500,11700,31797,74190,US,US
27916,1699477380,1699494300,16920,91245,157660,US,US
77635,1699621260,1699638900,17640,39016,79189,US,US
192559,1700355420,1700365260,9840,18485,32486,IT,IT
188228,1699470600,1699500720,30120,125425,56841,TR,TR
103628,1700340720,1700344320,3600,50240,174677,GB,GB
192544,1698995340,1699011360,16020,189291,55645,US,US
537,1699859760,1699868040,8280,113546,11101,SK,AT
137914,1699781880,1699785480,3600,177211,185159,GB,GB
34811,1700553960,1700584320,30360,5856,24450,TR,TR
75775,1699322760,1699336800,14040,178791,177520,US,US
79287,1700237280,1700240880,3600,84209,131144,GB,GB
130001,1698949920,1698977640,27720,166477,51180,PL,PL
66010,1699971960,1699996680,24720,31751,191112,DE,DE
65166,1699860900,1699872360,11460,4003,60736,IT,IT
46739,1699230480,1699243680,13200,83279,81761,IT,IT
41910,1700215020,1700242560,27540,189940,82172,DE,NL
174701,1700498760,1700512260,13500,12947,134329,IT,IT
115079,1699495680,1699508700,13020,89092,116331,US,US
12236,1698912180,1698945960,33780,192348,162496,TR,TR
7625,1700218860,1700222460,3600,65906,180349,GB,GB
164187,1698975780,1699003320,27540,79122,84867,RO,RO
44193,1700460540,1700495520,34980,42170,149882,TR,TR
21384,1699140540,1699169820,29280,184980,94409,TR,TR
127458,1699710720,1699729320,18600,136690,127446,FR,BE
87655,1700252880,1700283120,30240,42107,198634,TR,TR
132459,1700446140,1700451120,4980,130857,33207,GB,GB
26363,1700232120,1700270340,38220,78672,16716,MX,MX
70714,1699696080,1699708560,12480,154580,152404,US,US
175022,1700703420,1700737380,33960,156864,160000,TR,TR
63587,1699097820,1699101420,3600,65019,173088,GB,GB
137786,1699955100,1699979340,24240,89156,137283,HU,AT
129997,1699931820,1699945560,13740,130596,186644,CZ,SK
85221,1700695500,1700699100,3600,168728,103650,GB,GB
146455,1698996660,1699027200,30540,86024,149089,TR,TR
46817,1699047840,1699076700,28860,188932,3540,TR,TR
160614,1699116660,1699147500,30840,170537,100091,TR,TR
113659,1699282500,1699300020,17520,87278,105522,RS,RS
196749,1699225980,1699239120,13140,144603,66597,US,US
171883,1699235940,1699262820,26880,46688,153836,RO,RO
84401,1699761780,1699795860,34080,36310,147715,TR,TR
44525,1700178480,1700206920,28440,56205,36215,PL,DE
145234,1699299540,1699307460,7920,42530,53046,HR,HR
151844,1700823420,1700855640,32220,77837,172324,TR,TR
88080,1700105220,1700137920,32700,41652,196959,MX,US
48322,1700232480,1700262840,30360,101219,99578,TR,TR
60946,1700223600,1700257020,33420,166349,160411,TR,TR
92599,1700754360,1700783700,29340,181165,85825,TR,TR
26461,1700109480,1700141640,32160,107030,136022,TR,TR
123107,1699789200,1699801200,12000,186973,123269,HR,HR
139634,1699175760,1699192740,16980,149027,158830,RS,RS
75019,1699696920,1699701540,4620,154564,21303,GB,GB
166773,1698837540,1698863280,25740,152524,74081,RO,RO
166188,1699317600,1699332480,14880,162312,16046,FR,DE
15269,1700780580,1700814480,33900,150543,128023,TR,TR
195779,1699890600,1699925580,34980,12714,112829,TR,TR
142500,1699818720,1699851480,32760,179911,137756,TR,TR
41617,1700864580,1700890440,25860,11117,117659,PL,DE
132821,1700238060,1700267040,28980,50128,123713,TR,TR
50674,1700829720,1700854260,24540,130802,153626,AL,HR
94355,1698877440,1698908700,31260,41862,71179,TR,TR
93906,1699081920,1699096080,14160,152246,175000,HR,HR
112403,1700650140,1700667360,17220,59111,122146,FR,FR
38998,1700657280,1700669160,11880,78690,172090,IT,IT
152250,1699772040,1699792320,20280,1894,39221,FR,FR
80528,1700473500,1700485920,12420,126513,134945,US,US
111154,1700663700,1700680740,17040,18188,51114,US,CA
95030,1699626660,1699658040,31380,109194,101295,TR,TR
137151,1700465580,1700469180,3600,137033,142668,GB,GB
46556,1698880680,1698892800,12120,102195,136704,US,US
144909,1699433640,1699461540,27900,164381,152694,PL,PL
146532,1699251840,1699282080,30240,138519,21473,TR,TR
165732,1700649240,1700653920,4680,128490,10440,NL,NL
179087,1700210100,1700231880,21780,66056,82322,DE,BG
195101,1700498820,1700530680,31860,56223,163498,TR,TR
95263,1699482240,1699489260,7020,48644,152066,NL,NL
8943,1700030280,1700062320,32040,146602,161818,TR,TR
109541,1699944420,1699955700,11280,157972,80554,IT,IT
157144,1699686600,1699720500,33900,164387,159905,TR,TR
38121,1699066920,1699078680,11760,42644,121685,PT,ES
56156,1698842280,1698875160,32880,31823,52742,TR,TR
20506,1700094060,1700127360,33300,72858,160060,TR,TR
184576,1699723140,1699757640,34500,95687,73049,TR,TR
21618,1700692080,1700723280,31200,93413,60945,TR,TR
47208,1700027820,1700031900,4080,60056,105514,NL,NL
6621,1699521000,1699549920,28920,53248,78841,TR,TR
90053,1700211780,1700222520,10740,84411,21400,IT,FR
165387,1699413240,1699440780,27540,79959,62970,DE,IT
18892,1700174580,1700209800,35220,165685,22896,TR,TR
85202,1700522340,1700552280,29940,159791,180256,TR,TR
148296,1698987720,1699013880,26160,21130,148630,DE,BA
45683,1699930740,1699963920,33180,73381,82138,TR,TR
120144,1700291580,1700295180,3600,28959,56556,GB,GB
178230,1700650500,1700668140,17640,114308,133994,US,US
192789,1698989280,1699019160,29880,91948,165338,TR,TR
64415,1700233260,1700245860,12600,85939,137100,IT,IT
138401,1700740500,1700748300,7800,20876,132144,ES,AD
123767,1698964140,1698998700,34560,196394,16979,TR,TR
172308,1700216040,1700230620,14580,46505,163725,AT,AT
41684,1699517820,1699548240,30420,183785,171916,TR,TR
164315,1699534860,1699545240,10380,105139,108658,IT,IT
62426,1700132220,1700164800,32580,97280,120491,TR,TR
151300,1699882500,1699915620,33120,95734,138592,TR,TR
99395,1699614780,1699646580,31800,49995,177370,TR,TR
187618,1700038080,1700044560,6480,39869,137455,GB,GB
171171,1699762440,1699767540,5100,86368,86124,NL,NL
166935,1699145340,1699178400,33060,98109,144077,TR,TR
18811,1700750400,1700784360,33960,83990,120320,TR,TR
180126,1700127420,1700162700,35280,102664,196536,TR,TR
137861,1699745220,1699759920,14700,103486,60689,US,US
118639,1700053320,1700083740,30420,56952,39603,TR,TR
98798,1700066280,1700079420,13140,10469,29839,PT,PT
19854,1699354080,1699361220,7140,165846,177754,GB,GB
192324,1699367100,1699384800,17700,129022,52677,BE,ES
28193,1700125980,1700157120,31140,86925,145544,TR,TR
124123,1700374080,1700388480,14400,49691,187197,AT,CZ
100474,1700584560,1700617320,32760,3619,38218,TR,TR
168963,1700153520,1700170320,16800,133983,168058,US,US
108980,1700687280,1700722260,34980,112882,82488,TR,TR
93105,1698941220,1698950820,9600,91005,149577,IT,IT
44235,1700818980,1700850120,31140,6725,36613,TR,TR
88574,1698960120,1698995340,35220,87012,193453,TR,TR
101776,1700223480,1700230080,6600,124110,181567,NL,NL
67330,1699289220,1699300680,11460,69560,67301,HR,HR
113696,1699889340,1699900860,11520,40138,84151,IT,IT
30331,1698904500,1698940080,35580,29541,46835,TR,TR
47891,1699885380,1699896360,10980,53548,191901,CA,US
29240,1699297620,1699301220,3600,70957,61970,GB,GB
141142,1699122060,1699138320,16260,88114,179241,RS,AT
30157,1700745540,1700752260,6720,45251,92955,GB,GB
111651,1699523340,1699534740,11400,146875,191031,HR,HR
83695,1699855020,1699869780,14760,179100,83177,US,US
130533,1700865420,1700901120,35700,79551,101286,TR,TR
170133,1700597220,1700631180,33960,131930,26423,TR,TR
132246,1699698600,1699713840,15240,128311,132273,AT,PL
64128,1699055280,1699089240,33960,6392,64187,TR,TR
93454,1699514940,1699548180,33240,142527,153210,TR,TR
139089,1700052060,1700074560,22500,76781,103461,DE,AT
164480,1698860940,1698895980,35040,23699,48770,TR,TR
12153,1699491780,1699504380,12600,182247,114881,US,US
31064,1700001360,1700014980,13620,116576,177063,HR,HR
144583,1699550100,1699560420,10320,197697,125823,HR,HR
180252,1700179260,1700209080,29820,15525,48224,TR,TR
84779,1700274180,1700291940,17760,22242,155683,US,US
108686,1698823380,1698837300,13920,172970,64568,HR,CZ
158443,1699082760,1699095660,12900,85277,8289,IT,IT
125645,1699520880,1699528860,7980,103440,108329,PT,PT
196888,1699103640,1699121340,17700,59750,40801,FR,ES
191965,1699859640,1699894680,35040,141422,14935,TR,TR
207,1700795520,1700827380,31860,113734,11035,TR,TR
7057,1700688240,1700701260,13020,199158,144006,US,US
122752,1700139360,1700151480,12120,104720,106189,US,US
22242,1700760720,1700821620,60900,129158,159855,UA,DE
6242,1699570380,1699599720,29340,17663,195667,TR,TR
12330,1700272380,1700308320,35940,7154,119576,TR,TR
83233,1700177340,1700188080,10740,127493,120429,AD,FR
150816,1699717680,1699746780,29100,190133,119436,TR,TR
54152,1699853940,1699884720,30780,196272,28045,TR,TR
38719,1698993780,1699029480,35700,170321,107913,TR,TR
153497,1699927440,1699960680,33240,64299,40564,TR,BG
97518,1700342040,1700354940,12900,66051,161183,PT,ES
33289,1699583700,1699600740,17040,190688,158958,US,US
152245,1699241040,1699273860,32820,61830,21307,TR,TR
56852,1700057820,1700066160,8340,141365,125277,IT,IT
61655,1699368240,1699381680,13440,38847,11570,IT,IT
75410,1700420520,1700427180,6660,191579,15008,GB,GB
73319,1700360340,1700396400,36060,38489,35628,MX,MX
106196,1700041200,1700059980,18780,119205,49985,FR,FR
30285,1699303740,1699309500,5760,59963,149107,GB,GB
6534,1699302840,1699317300,14460,51944,89433,US,US
174024,1699731960,1699748580,16620,20198,18286,CA,CA
196225,1699123740,1699127340,3600,95794,172549,GB,GB
22184,1699951080,1699957200,6120,126313,162134,NL,NL
28867,1699153860,1699184820,30960,114031,123469,TR,TR
151598,1700008560,1700041080,32520,20827,143807,MX,MX
199564,1700683140,1700700420,17280,49064,114995,US,US
120296,1700652900,1700686800,33900,94015,144839,TR,TR
187663,1700853480,1700875140,21660,84442,24702,DE,DE
10524,1699574640,1699578240,3600,150328,184995,GB,GB
158419,1700283420,1700297880,14460,36405,56916,FR,ES
117706,1699700400,1699718940,18540,151243,99963,FR,FR
82259,1698983700,1699013280,29580,124975,129337,TR,TR
142825,1700316120,1700327700,11580,70245,14417,US,US
48056,1700276040,1700310300,34260,57176,35696,TR,TR
29739,1699568160,1699575480,7320,160930,193815,IT,IT
122028,1700199420,1700212260,12840,81175,24578,PT,PT
42560,1699517640,1699552020,34380,75158,20650,TR,TR
75162,1700748840,1700764680,15840,148336,93459,US,US
23261,1699103640,1699117860,14220,14203,23478,US,US
108357,1699986180,1699999380,13200,69002,144737,US,US
113111,1700413080,1700446980,33900,140866,130561,TR,TR
179824,1700510400,1700522460,12060,27007,109181,US,US
15617,1700060700,1700089920,29220,194274,158183,TR,TR
146468,1700084400,1700099520,15120,197985,177625,AT,AT
139385,1700223660,1700234640,10980,92138,12027,US,US
163406,1699642620,1699668120,25500,66618,108970,DE,DE
190450,1700566800,1700596320,29520,91285,117302,TR,TR
172834,1700140740,1700171400,30660,146141,106529,MK,DE
54543,1700360100,1700391300,31200,163055,107617,TR,TR
45017,1700663640,1700697480,33840,188024,144270,TR,TR
6424,1700840940,1700854800,13860,132256,164367,AT,AT
48800,1700381880,1700415780,33900,114456,123550,TR,TR
199819,1699290720,1699322820,32100,180979,65497,TR,TR
147592,1698854640,1698875580,20940,123364,59050,FR,PT
183404,1699837500,1699868040,30540,15867,47500,TR,TR
24419,1699258680,1699278900,20220,96775,176817,DK,DK
238,1700840280,1700849760,9480,50938,182727,IT,IT
72881,1699090200,1699122660,32460,115526,82316,TR,TR
143300,1699970460,1699981140,10680,72791,95663,IT,IT
177807,1699526460,1699560060,33600,45893,118402,TR,TR
63625,1699974180,1699996800,22620,81235,148625,BR,BR
113410,1699761660,1699816500,54840,159572,158923,BG,BG
18289,1699118760,1699129080,10320,11116,76636,PT,PT
110768,1698830940,1698843120,12180,152058,141153,US,US
167652,1700603880,1700617440,13560,141441,29263,US,US
197844,1700797560,1700802960,5400,132721,107176,NL,NL
69251,1700570400,1700602860,32460,172731,111262,TR,TR
194369,1700124900,1700158980,34080,122399,43865,MX,MX
49887,1699822020,1699854660,32640,101482,7906,TR,TR
81617,1700580840,1700592780,11940,28452,89873,AT,AT
181435,1699044960,1699048560,3600,102603,58048,GB,GB
167051,1700782080,1700813400,31320,142255,7196,TR,TR
58736,1700425860,1700479740,53880,43085,160981,BG,BG
159879,1699826460,1699860900,34440,21828,110641,TR,TR
25650,1698945540,1698956220,10680,199301,120203,IT,IT
175531,1699803360,1699839960,36600,139894,157950,MX,MX
111815,1698975540,1698989100,13560,147820,157331,HR,HR
10797,1699396860,1699428540,31680,188405,167529,TR,TR
20513,1700321940,1700346660,24720,159038,131064,DE,IT
148429,1700067000,1700072700,5700,167699,84624,NL,NL
162263,1698830940,1698834540,3600,160597,130212,NL,NL
193969,1699020180,1699047300,27120,29783,195699,PL,AT
6381,1698860040,1698892440,32400,40553,126230,TR,TR
172788,1700565960,1700601300,35340,141029,62776,TR,TR
130226,1699423740,1699427340,3600,163553,66275,NL,NL
119474,1700317740,1700328180,10440,85190,18596,HR,HU
66284,1699645560,1699677180,31620,156338,46642,TR,TR
154875,1699845600,1699859520,13920,112843,178525,US,US
69121,1699769400,1699793820,24420,30423,34263,PL,LT
21465,1699764120,1699795980,31860,175276,106473,TR,TR
46701,1700353620,1700371800,18180,104483,3267,FR,FR
13036,1700030760,1700045160,14400,157358,108575,US,US
124183,1699351620,1699362480,10860,136727,72765,US,US
185420,1700030640,1700044920,14280,167269,99535,PT,PT
77249,1700116740,1700151360,34620,32145,74470,TR,TR
12842,1700786100,1700790720,4620,176425,8785,GB,GB
76606,1700318580,1700322540,3960,185922,198195,GB,GB
90084,1700508060,1700513400,5340,89462,162537,NL,NL
158067,1698900000,1698935520,35520,196381,33501,TR,TR
109643,1699055580,1699068960,13380,54258,165477,IT,IT
46908,1699869060,1699898400,29340,145372,79267,TR,TR
160209,1700273160,1700287200,14040,66828,7024,IT,IT
18753,1699428240,1699433940,5700,143439,73816,GB,GB
95544,1700590020,1700623860,33840,115533,20890,TR,TR
19331,1699564500,1699578720,14220,21695,197992,IT,HU
23777,1699177560,1699208940,31380,6849,22098,TR,TR
183716,1699788060,1699800720,12660,175106,156910,HR,HR
10062,1700621280,1700653260,31980,196964,49761,TR,TR
185063,1700010960,1700037300,26340,190358,146638,DE,DE
193048,1700436900,1700440500,3600,105975,192255,GB,GB
68137,1700487480,1700512080,24600,50904,56533,ME,RS
179598,1700860020,1700893320,33300,185385,154266,TR,TR
164170,1699403400,1699435080,31680,79088,87157,TR,TR
68479,1699236180,1699239780,3600,17831,142649,GB,GB
168043,1699218300,1699230960,12660,108308,102193,CA,CA
139327,1699060320,1699072800,12480,59864,6095,IT,IT
52698,1698865020,1698896460,31440,54362,174446,TR,TR
16308,1698889980,1698899220,9240,105276,177311,IT,IT
147196,1700842020,1700871060,29040,14646,54897,TR,TR
65271,1699792440,1699796040,3600,19651,173364,NL,NL
161316,1699947480,1699953780,6300,140298,40148,GB,GB
130437,1700017440,1700025660,8220,41811,32959,IT,IT
174532,1698970080,1699005840,35760,118243,117062,TR,TR
161781,1699817580,1699824300,6720,197143,19256,GB,GB
77261,1698875220,1698887640,12420,150287,28087,IT,IT
98290,1699621440,1699626600,5160,29801,56715,NL,NL
173915,1700278800,1700288580,9780,136580,6808,SK,AT
98026,1699438620,1699442520,3900,177234,2371,GB,GB
84336,1699685760,1699702920,17160,44297,163290,FR,FR
106629,1699188900,1699221540,32640,167163,108387,TR,TR
141469,1699621860,1699652640,30780,108280,153373,TR,TR
20465,1700545800,1700549400,3600,16625,10977,GB,GB
48475,1699250760,1699282380,31620,148126,7238,TR,TR
83357,1699866060,1699874100,8040,12513,190688,PT,PT
64680,1698914520,1698949200,34680,103898,8908,TR,TR
66583,1700538360,1700567520,29160,63713,12791,TR,TR
188480,1700350200,1700385480,35280,197062,26785,TR,TR
194899,1699296420,1699347960,51540,153620,112301,BG,AT
192218,1700750940,1700758860,7920,168876,162245,PT,PT
110243,1699806480,1699810500,4020,167846,62741,NL,NL
100913,1700127420,1700131020,3600,191272,79768,NL,NL
157051,1700071680,1700081940,10260,39286,191296,ES,ES
84039,1700733360,1700758740,25380,21683,79172,DE,DE
64064,1698831360,1698862920,31560,88118,44086,TR,TR
7403,1700675040,1700709060,34020,117636,56292,TR,TR
84760,1700272800,1700291940,19140,80867,93966,FR,FR
153160,1700581020,1700591220,10200,135135,24288,IT,IT
110559,1700749920,1700767200,17280,14527,29774,FR,FR
150680,1699030800,1699066620,35820,160199,134541,TR,TR
33465,1700394240,1700397840,3600,125566,156836,NL,NL
45603,1699143540,1699147140,3600,82190,49960,GB,GB
67676,1699488000,1699503900,15900,156906,89382,US,US
28815,1700235240,1700242080,6840,177950,178597,GB,GB
198316,1700482620,1700512860,30240,57984,48088,TR,TR
53469,1699080000,1699114500,34500,96169,145547,TR,TR
127203,1700834760,1700849160,14400,75312,62749,SE,SE
160047,1698871500,1698875580,4080,121100,142043,EE,EE
177709,1699455840,1699464960,9120,53043,140793,SK,AT
170180,1699573740,1699607940,34200,199871,53079,TR,TR
100430,1699579020,1699591260,12240,162595,3248,HR,HR
42430,1699721280,1699738980,17700,149497,123447,US,US
163538,1698848280,1698860400,12120,28539,122709,HR,HR
57393,1700396340,1700409780,13440,4847,35611,IT,IT
145263,1699955880,1699959480,3600,60224,192188,GB,GB
138028,1700379540,1700414160,34620,161433,60588,TR,TR
16973,1699506360,1699537980,31620,57368,148934,TR,TR
43292,1699306200,1699310580,4380,160602,176428,GB,GB
163359,1700335320,1700366520,31200,184943,70182,TR,TR
89968,1699426800,1699444080,17280,161289,106988,US,US
146616,1699591260,1699604280,13020,131017,16257,US,US
48203,1698853500,1698857100,3600,106867,115105,NL,NL
156776,1699156140,1699179360,23220,161562,55400,DE,FR
10413,1698984540,1699019340,34800,180977,128267,TR,TR
80452,1699699800,1699732740,32940,164169,173116,TR,TR
46445,1700529660,1700544900,15240,1884,27967,US,US
38504,1699192380,1699216500,24120,145837,96861,HU,AT
26898,1700402340,1700427840,25500,97328,77853,HU,IT
26803,1699603140,1699613580,10440,108121,27611,IT,IT
144568,1699255500,1699276200,20700,95982,77198,FR,BE
105504,1700757300,1700771760,14460,186431,132743,BE,NL
157485,1699501620,1699533660,32040,147494,31635,TR,TR
116990,1700533440,1700548380,14940,28078,37045,US,US
126901,1700866680,1700898660,31980,137854,83602,TR,TR
196585,1699924500,1699946280,21780,82039,13685,DE,AT
95770,1700617140,1700630520,13380,77742,142994,IT,IT
38223,1699691460,1699712520,21060,34915,38600,FR,DE
22398,1699753320,1699766220,12900,144064,173474,IT,IT
146061,1700327940,1700362080,34140,115396,158704,TR,TR
172361,1700660820,1700686380,25560,158,124519,PL,SI
125140,1700603460,1700607060,3600,149274,53791,NL,NL
166071,1699626480,1699630080,3600,108416,171522,GB,GB
60181,1700108100,1700131320,23220,132504,92241,PL,DE
42520,1700158980,1700187600,28620,54845,138938,CH,DE
197665,1700017680,1700050620,32940,124173,74647,TR,TR
173398,1700191800,1700226660,34860,38254,51427,TR,TR
179295,1700763300,1700787540,24240,109940,123719,DE,FR
80730,1699903320,1699906920,3600,36454,73277,NL,NL
153286,1699257180,1699268640,11460,106366,111986,IT,IT
62933,1699423860,1699435020,11160,34833,114594,US,US
152277,1699569900,1699605480,35580,149822,156198,TR,TR
174439,1700249340,1700270460,21120,110973,59436,FR,IT
195625,1700295840,1700310000,14160,167791,34713,PT,PT
40975,1699637040,1699650540,13500,63603,163125,IT,IT
92308,1699832580,1699849320,16740,24051,102290,US,US
35525,1700803380,1700835240,31860,63317,150477,TR,TR
56366,1700207220,1700216100,8880,198133,162836,HR,HR
190783,1699957920,1699961520,3600,27139,65871,GB,GB
192275,1700660040,1700673780,13740,75183,93846,US,US
150447,1698881220,1698913980,32760,84184,45135,MX,MX
144021,1700276220,1700283360,7140,63544,51836,NL,BE
162338,1698996840,1699030680,33840,161281,30448,TR,TR
166946,1699448520,1699460400,11880,191943,14364,CA,US
127521,1698965640,1698969240,3600,66074,189740,GB,GB
146510,1700634600,1700638200,3600,133094,29072,GB,GB
109078,1699329780,1699333380,3600,158351,23996,NL,NL
12957,1700580780,1700588220,7440,132909,5853,IT,IT
53001,1699094700,1699102620,7920,30586,27870,IT,IT
75012,1700035980,1700050080,14100,156207,143969,US,US
90014,1700631540,1700638860,7320,193166,1845,HR,HR
65614,1700557920,1700576040,18120,190318,88035,FR,DE
67893,1699311360,1699339860,28500,34985,116919,BA,DE
129055,1699252680,1699264500,11820,21655,165371,US,US
119974,1699935900,1699962360,26460,80709,165622,DE,DE
115534,1698979260,1698990660,11400,103564,182598,US,US
170114,1699820760,1699838520,17760,85064,43475,US,CA
153603,1700596440,1700618580,22140,97101,177480,MD,RO
51156,1699325460,1699351200,25740,120698,110529,DE,DE
173367,1700773080,1700807760,34680,26060,32371,TR,TR
15755,1699301160,1699335840,34680,60125,185089,TR,TR
96851,1699390500,1699397100,6600,18946,5413,NL,NL
131133,1699171440,1699175040,3600,93980,131124,GB,GB
57870,1700700900,1700707560,6660,128076,9629,GB,GB
55326,1699634280,1699662360,28080,72719,78888,ME,BA
117803,1699220220,1699233720,13500,189547,78296,RS,SI
27143,1700094840,1700100420,5580,165340,123128,GB,GB
71588,1700070720,1700103780,33060,84909,69031,TR,TR
156191,1699192800,1699226040,33240,194911,34872,TR,TR
95208,1699553100,1699561920,8820,137508,145748,IT,IT
14506,1699967580,1699999020,31440,38056,40980,TR,TR
147407,1699129620,1699135080,5460,194491,97506,GB,GB
71897,1700072520,1700089680,17160,13305,93292,FR,FR
102327,1699870260,1699901820,31560,54913,62995,TR,TR
187708,1699766040,1699795860,29820,181195,165986,TR,TR
57730,1700493480,1700529120,35640,117378,10845,TR,TR
171953,1700688660,1700718180,29520,189433,53278,TR,TR
84547,1700428020,1700458080,30060,170658,184148,TR,TR
183057,1700109120,1700112720,3600,53181,93457,GB,GB
100286,1700016840,1700028540,11700,163039,168751,US,US
108578,1700024400,1700061420,37020,76818,10633,MX,MX
145855,1699381800,1699415040,33240,23377,167902,TR,TR
128167,1698930720,1698944520,13800,198004,33000,US,US
38963,1700678640,1700708340,29700,183661,172374,TR,TR
91965,1699929420,1699933020,3600,106448,91162,GB,GB
28265,1698824460,1698857940,33480,64372,73241,TR,TR
53171,1699755300,1699762560,7260,5473,34045,HR,HR
73328,1700760600,1700781600,21000,193625,26298,FR,GB
129146,1700014380,1700047260,32880,21832,124271,TR,TR
58278,1700057700,1700061300,3600,107299,165008,GB,GB
102933,1698916080,1698922740,6660,177514,144281,EE,FI
12681,1699493160,1699496760,3600,185758,101156,GB,GB
177345,1700733960,1700750400,16440,196020,32932,FR,FR
55189,1699862220,1699895340,33120,553,24479,TR,TR
125637,1700310000,1700345280,35280,199618,2682,TR,TR
155972,1699849860,1699862040,12180,137990,77047,US,US
132924,1699969560,1700000700,31140,99286,129843,TR,TR
178517,1700417580,1700435100,17520,36419,137092,US,US
120859,1699402320,1699419840,17520,77258,80248,SE,SE
69087,1699564080,1699579980,15900,165843,163756,US,US
24949,1700170740,1700179440,8700,11412,143433,AD,ES
174452,1700086740,1700103720,16980,42057,145850,US,US
169986,1700129160,1700165820,36660,40865,89384,MX,MX
44137,1700048880,1700052600,3720,91331,53109,GB,GB
96135,1700229480,1700259660,30180,177843,141299,TR,TR
53226,1699353120,1699369980,16860,1180,143914,US,US
188587,1699249020,1699271940,22920,121929,101211,SI,RS
159898,1699084200,1699110060,25860,97419,66700,PL,PL
123877,1700660220,1700666160,5940,164900,44860,GB,GB
140159,1700501400,1700505480,4080,110614,47183,NL,NL
194236,1698922740,1698956640,33900,4685,50447,TR,TR
61705,1700408220,1700443680,35460,137058,102152,TR,TR
59658,1699402500,1699438200,35700,117527,74334,TR,TR
183249,1699355940,1699363500,7560,80594,176067,HR,HR
47877,1699144080,1699147680,3600,169457,168263,GB,GB
164458,1700536500,1700542680,6180,95994,49189,GB,GB
72362,1700480520,1700511900,31380,45088,102516,TR,TR
48274,1700275800,1700287980,12180,122309,40982,CZ,CZ
174982,1699882920,1699894380,11460,90667,185330,IT,IT
77305,1698924900,1698928500,3600,188587,104523,GB,GB
71952,1700028480,1700061720,33240,21146,188487,TR,TR
51328,1699013760,1699044360,30600,130796,92967,TR,TR
27251,1700701680,1700731200,29520,126224,76299,TR,TR
27870,1699202700,1699211880,9180,140512,114198,IT,IT
174927,1700371260,1700406120,34860,139882,3175,TR,TR
114310,1699713060,1699747920,34860,15438,44334,TR,TR
15227,1699173180,1699186200,13020,70203,82720,ES,ES
139728,1698970920,1699006560,35640,3581,11089,TR,TR
62866,1699646160,1699702200,56040,181793,82920,BG,DE
103742,1699223460,1699276860,53400,28110,177856,BG,BG
60590,1700604120,1700617860,13740,44685,72095,IT,IT
122871,1699403100,1699425960,22860,111906,123005,PL,PL
117432,1700253720,1700289540,35820,165357,97289,TR,TR
109957,1699336260,1699356780,20520,43733,180937,FR,FR
108280,1699137600,1699173300,35700,15943,72623,TR,TR
97969,1700695200,1700707380,12180,42462,13455,IT,IT
90505,1699083060,1699086660,3600,100441,39831,NL,NL
198154,1699923840,1699927440,3600,119849,13231,GB,GB
28730,1698844680,1698871440,26760,186440,148682,DE,DE
20281,1699007340,1699019340,12000,70892,138064,US,US
152777,1699391280,1699421760,30480,82253,98952,TR,TR
153411,1699070700,1699086300,15600,140095,146086,US,US
173909,1699925460,1699929060,3600,94968,147501,NL,NL
108793,1700128560,1700143740,15180,183412,175971,US,US
17035,1700440260,1700470440,30180,6766,4825,TR,TR
73198,1700277120,1700309640,32520,124351,144565,TR,TR
122596,1700045880,1700074380,28500,19492,68766,DE,DE
182160,1699822080,1699854300,32220,87561,90178,TR,TR
10990,1700194620,1700217120,22500,39001,112254,DE,DE
35890,1699403760,1699408980,5220,41400,181768,GB,GB
80576,1700700420,1700704860,4440,132157,112050,AD,ES
68543,1700179560,1700214000,34440,123044,71359,TR,TR
197150,1700450220,1700462340,12120,80980,80951,US,US
173779,1699095960,1699151280,55320,177486,163551,UA,PL
92223,1699981080,1700001240,20160,169277,91935,SE,SE
51735,1700623140,1700656740,33600,19487,65411,TR,TR
176830,1699368480,1699398780,30300,96972,117038,TR,TR
123887,1699445040,1699479840,34800,147078,56948,TR,TR
42365,1700044320,1700047920,3600,22623,157365,NL,NL
15874,1699059660,1699084020,24360,154199,167273,DE,BE
106419,1699205460,1699237500,32040,49390,30747,TR,TR
140479,1699404120,1699454520,50400,195069,112795,BG,AT
96038,1699964460,1699993440,28980,7362,53377,TR,TR
102656,1698808200,1698842940,34740,120347,163657,TR,TR
163642,1700478180,1700486760,8580,177573,43767,PT,PT
147263,1700515080,1700522160,7080,134622,157557,GB,GB
167660,1700204580,1700215800,11220,22718,58734,HR,HR
137618,1698906960,1698918300,11340,2895,187305,HR,HR
164163,1699194600,1699198200,3600,198691,96475,GB,GB
107703,1699570500,1699607340,36840,43071,18957,MX,MX
144410,1699711140,1699725000,13860,3091,46603,HR,HR
139770,1700210340,1700216460,6120,130766,59163,NL,NL
96141,1698959280,1698971280,12000,58271,73739,US,US
110244,1699372920,1699407660,34740,33904,50373,TR,TR
26824,1700533500,1700537100,3600,191281,23178,GB,GB
107681,1699946040,1699977480,31440,194211,120461,TR,TR
136361,1699051620,1699065060,13440,36243,43832,US,US
156733,1699570320,1699604640,34320,79993,25694,TR,TR
47082,1699185540,1699199340,13800,25050,8824,US,US
53224,1700346360,1700380440,34080,51744,96050,TR,TR
46922,1699915980,1699946880,30900,8199,21624,TR,TR
187971,1698894960,1698898560,3600,175628,181121,NL,NL
164720,1700089740,1700125200,35460,193197,54105,TR,TR
50969,1700625180,1700646960,21780,192850,127833,HU,AT
191973,1700460780,1700478180,17400,199101,114131,US,US
172971,1699439760,1699471800,32040,111242,6499,TR,TR
55555,1700772840,1700783640,10800,88325,66975,PT,PT
65701,1700607240,1700637480,30240,154213,41106,MK,AL
157749,1699051260,1699068780,17520,157903,13647,US,US
188308,1700112540,1700134980,22440,76964,22285,DE,DE
19397,1700343900,1700347500,3600,120879,24900,GB,GB
141202,1700287800,1700307960,20160,158824,117225,FR,BE
187707,1700464500,1700478480,13980,144097,55057,IT,IT
137955,1699672020,1699688160,16140,183633,34040,US,US
100716,1698939540,1698951780,12240,133067,64915,US,MX
106099,1699468020,1699498080,30060,187038,142593,TR,TR
169114,1700508420,1700543160,34740,124056,60163,TR,TR
119806,1700601660,1700611800,10140,85577,191529,IT,IT
123112,1700258100,1700287080,28980,192519,91305,TR,TR
62739,1700156100,1700183760,27660,8619,12292,HU,DE
106186,1700313360,1700346060,32700,196152,26467,TR,TR
154773,1699264800,1699276020,11220,40144,92977,IT,IT
155924,1699767000,1699771080,4080,18726,18452,GB,GB
65374,1699299660,1699333800,34140,98608,113553,MX,MX
101446,1699559940,1699574880,14940,3829,55456,US,US
65746,1699340040,1699375980,35940,73871,189647,TR,TR
192097,1699549260,1699554360,5100,90962,6596,GB,GB
67372,1699930140,1699941300,11160,183533,153116,IT,IT
192911,1699274700,1699278420,3720,189934,136648,GB,GB
134404,1700288160,1700301000,12840,135582,118880,US,US
78743,1700788920,1700815980,27060,104668,164852,PL,FR
177089,1699792200,1699801560,9360,107443,76418,IT,IT
8940,1698816900,1698846000,29100,136403,189923,TR,TR
82503,1699444680,1699448280,3600,96159,113276,NL,NL
107331,1700168040,1700180760,12720,11998,155349,IT,IT
38211,1699116420,1699122420,6000,47631,21142,GB,GB
29751,1699295880,1699329360,33480,104206,117373,TR,TR
94280,1699040880,1699052640,11760,116762,73656,US,US
84703,1699046280,1699057080,10800,1949,97678,US,US
135927,1699081800,1699117260,35460,41732,48428,TR,TR
178862,1700820960,1700833860,12900,87667,75979,IT,IT
140696,1700479260,1700482860,3600,143846,20348,GB,GB
58847,1698911100,1698942600,31500,172487,57005,TR,TR
165113,1700843220,1700878500,35280,143807,37154,TR,TR
80865,1700048760,1700083860,35100,195926,118906,TR,TR
146672,1699251420,1699283640,32220,114206,43719,TR,TR
79514,1700297400,1700306880,9480,69341,52924,PT,PT
187621,1700094600,1700125380,30780,72192,166085,TR,TR
112618,1700206680,1700236380,29700,57379,125626,TR,TR
33219,1699941780,1699966200,24420,170876,85343,RO,RO
2747,1698840840,1698844440,3600,120323,48361,GB,GB
138062,1699182960,1699211460,28500,123981,199253,DE,DE
136927,1699663680,1699696680,33000,196311,176941,TR,TR
181642,1699513920,1699544220,30300,179487,151412,TR,TR
188001,1700661000,1700693580,32580,117847,48512,TR,TR
10044,1700312340,1700343840,31500,144499,33081,TR,TR
10829,1699018560,1699049700,31140,5633,150769,TR,TR
84364,1700493660,1700519760,26100,40655,72568,PL,DE
172410,1700536260,1700570640,34380,40127,5316,TR,TR
145720,1700067960,1700101140,33180,75550,188174,TR,TR
108478,1700734740,1700758500,23760,34316,63214,CH,FR
7638,1700513460,1700546520,33060,168086,24476,TR,TR
192327,1700547120,1700550720,3600,22987,81182,GB,GB
69053,1699745280,1699749660,4380,98668,62915,GB,GB
80373,1700793720,1700803140,9420,30639,75548,PT,PT
49147,1699895220,1699904100,8880,185689,119123,HR,HR
134595,1699194120,1699202820,8700,104058,199423,IT,IT
52462,1699897920,1699926900,28980,134772,27559,TR,TR
145243,1699945620,1699966680,21060,16449,29811,FR,FR
74863,1700534100,1700563560,29460,85501,170541,TR,TR
50966,1699098180,1699115880,17700,176669,166580,US,US
66975,1700814840,1700831700,16860,3540,84383,US,US
101199,1700631120,1700662560,31440,55963,31820,TR,TR
153385,1699190460,1699207620,17160,139047,139799,US,US
199362,1699315800,1699371900,56100,169029,93010,BG,BG
23257,1699928700,1699963740,35040,188559,87648,TR,TR
194542,1700361480,1700367600,6120,193451,144476,NL,NL
67431,1699571040,1699595460,24420,153998,111795,PL,PL
13071,1700312880,1700348220,35340,47925,89281,MX,MX
93873,1700792340,1700795940,3600,184857,63172,GB,GB
19314,1699810740,1699816080,5340,22348,82830,GB,GB
189441,1699856760,1699888560,31800,92644,106457,TR,TR
118272,1699698540,1699703460,4920,147992,23690,FI,EE
137047,1699602480,1699624020,21540,196351,116956,FR,FR
39447,1699585320,1699614540,29220,27844,182409,TR,TR
41354,1700236080,1700258580,22500,86536,177608,BR,BR
136378,1700401680,1700418960,17280,185342,191856,US,US
90540,1700441580,1700466180,24600,152618,55923,BR,BR
6272,1700853180,1700886180,33000,153093,171157,TR,TR
35386,1698903780,1698936060,32280,25520,130616,TR,TR
167702,1698995880,1699028400,32520,5486,95836,TR,TR
87887,1700660220,1700690040,29820,168315,35154,TR,TR
189533,1700284380,1700292660,8280,28057,30661,IT,IT
96501,1700246700,1700261880,15180,36810,13243,FR,ES
60301,1699739340,1699771200,31860,188060,75690,TR,TR
190810,1699493940,1699525080,31140,160763,174787,TR,TR
184852,1700779260,1700814840,35580,172844,184564,TR,TR
133414,1699369680,1699404240,34560,67361,149837,TR,TR
138723,1699036560,1699070940,34380,13124,50722,TR,TR
11691,1700474400,1700506200,31800,108976,129733,TR,TR
150699,1699055040,1699067880,12840,58977,168278,US,US
75897,1699624740,1699655640,30900,189736,2693,TR,TR
191533,1699367820,1699375140,7320,187439,102457,PT,PT
41374,1700303040,1700313180,10140,155698,38681,IT,IT
4800,1700791440,1700820540,29100,139643,16148,TR,TR
69472,1699584600,1699612380,27780,38945,23637,PL,PL
75807,1699789560,1699795440,5880,99783,90069,NL,NL
48008,1700365380,1700373180,7800,152193,120759,IT,IT
198398,1700822700,1700854140,31440,75045,91003,TR,TR
194957,1699566120,1699580220,14100,4161,135296,CZ,PL
81130,1699383780,1699415700,31920,88823,99087,TR,TR
183963,1699358940,1699370040,11100,71900,164897,US,US
142985,1699738860,1699752960,14100,140896,73658,US,US
77363,1699312740,1699319640,6900,191329,158235,GB,GB
142943,1700467260,1700491440,24180,108122,83158,CH,IT
145326,1699042740,1699052160,9420,156963,38093,IT,IT
129092,1698868500,1698897540,29040,137532,167581,TR,TR
10357,1699357440,1699368120,10680,90655,180740,IT,IT
173649,1700154960,1700162820,7860,7919,131008,IT,IT
54777,1699513320,1699524540,11220,121483,73019,IT,IT
74211,1698908040,1698916200,8160,104314,142995,IT,IT
120837,1700665020,1700676540,11520,100435,112063,PT,PT
102698,1700289000,1700320500,31500,114112,116079,TR,TR
193383,1699362900,1699376640,13740,137176,86388,IT,IT
73202,1699601280,1699636500,35220,124628,43658,TR,TR
110342,1698967140,1698974340,7200,83119,17708,PT,PT
60422,1699020720,1699051860,31140,147750,55052,TR,TR
14922,1699301220,1699337040,35820,11345,195368,TR,TR
123430,1698877920,1698910440,32520,86366,176946,TR,TR
171936,1699186800,1699199700,12900,123816,66271,CZ,CZ
134362,1698884580,1698890340,5760,170103,6835,GB,GB
70055,1700052660,1700079300,26640,198913,75996,PL,PL
5334,1699820880,1699831920,11040,99624,38128,ES,ES
99930,1699062900,1699075020,12120,48583,70532,RS,SI
141360,1699368180,1699371780,3600,24486,67210,NL,NL
33828,1699576620,1699581600,4980,129593,24588,GB,GB
194351,1700461140,1700467920,6780,137690,137836,GB,GB
135844,1700391300,1700403240,11940,162727,151752,CZ,DE
184767,1700681340,1700719200,37860,137687,172471,MX,MX
168167,1700740860,1700774700,33840,162868,43396,TR,TR
14462,1699575840,1699592400,16560,175384,173719,US,US
29117,1698894840,1698909120,14280,158547,11993,IT,IT
190408,1699856280,1699891560,35280,564,53423,TR,TR
140463,1700405880,1700421360,15480,31531,155247,FR,NL
167843,1699261500,1699295940,34440,140273,25904,TR,TR
84273,1699983900,1700018520,34620,74254,142630,TR,TR
82987,1699953840,1699983660,29820,83949,49519,TR,TR
155737,1700440500,1700469420,28920,148416,173925,TR,TR
80061,1699636620,1699649820,13200,38977,128037,PT,PT
134167,1700404740,1700435460,30720,105882,79072,TR,TR
40197,1699485960,1699497840,11880,114468,5713,PT,PT
166561,1700784540,1700810160,25620,149495,169639,DE,FR
3420,1699989120,1700002020,12900,101889,20953,IT,IT
61849,1699485300,1699498980,13680,100876,192666,IT,IT
75707,1700640540,1700651220,10680,156547,186793,PT,PT
43485,1698839160,1698845220,6060,77424,135847,GB,GB
4231,1699747200,1699758720,11520,100976,26105,HR,ME
122777,1700304600,1700333880,29280,180992,116582,TR,TR
73330,1700264220,1700271300,7080,131760,27196,GB,GB
177459,1699362540,1699387800,25260,162073,67141,DE,HR
67337,1698860760,1698891120,30360,166616,139773,TR,TR
150955,1700292420,1700321280,28860,531,8444,TR,TR
115476,1700219940,1700226300,6360,154309,24910,AD,FR
105680,1699733100,1699767120,34020,48812,79999,TR,TR
90500,1700034900,1700038500,3600,139638,92864,NL,NL
78705,1699153140,1699163160,10020,51818,181856,ES,ES
132711,1700293440,1700311440,18000,142852,70986,FR,BE
185274,1700097180,1700100780,3600,61943,90018,GB,GB
121696,1699743960,1699774080,30120,40150,143888,TR,TR
123368,1700224320,1700227920,3600,184678,130858,GB,GB
177092,1699859160,1699891860,32700,143687,114575,TR,TR
102242,1700045100,1700050980,5880,66342,57414,NL,NL
47797,1700543100,1700579040,35940,100222,62969,TR,TR
175593,1700752680,1700759520,6840,133908,22159,GB,GB
154478,1699135680,1699166940,31260,86578,64733,TR,TR
151196,1699537020,1699559040,22020,177819,191117,DE,DK
111137,1699425180,1699458840,33660,182372,74218,TR,TR
12831,1700098620,1700102400,3780,83655,199893,GB,GB
13538,1699119540,1699159020,39480,192166,139677,LV,PL
82782,1699992720,1700005620,12900,14530,93612,CZ,CZ
121410,1699876680,1699880940,4260,161818,129667,GB,GB
17010,1700537100,1700540700,3600,123962,128980,NL,NL
167427,1700683800,1700687400,3600,140384,34882,NL,NL
33007,1700289540,1700293260,3720,13300,199948,GB,GB
111434,1700378760,1700410200,31440,134188,77420,TR,TR
152826,1700298540,1700307060,8520,194968,11733,IT,IT
107162,1699303380,1699314540,11160,159521,53024,US,US
190079,1699171140,1699203240,32100,136910,181590,TR,TR
59805,1699172160,1699203120,30960,155748,177005,TR,TR
30011,1699050180,1699105380,55200,96694,13040,BG,DE
111964,1700477880,1700492160,14280,180532,159585,US,US
148379,1699985700,1700016840,31140,70652,72148,TR,TR
174986,1700379540,1700413620,34080,99654,14856,TR,TR
155052,1699350180,1699384320,34140,181523,98075,TR,TR
194666,1699056720,1699084500,27780,52294,72276,PL,PL
7817,1699722300,1699737660,15360,50226,42635,AT,AT
40228,1698840060,1698851580,11520,194289,1179,US,US
77912,1700084820,1700088420,3600,181047,64430,NL,NL
49907,1699656360,1699690440,34080,72721,192369,MX,MX
179681,1699728720,1699734420,5700,23366,86611,GB,GB
189101,1700388540,1700401680,13140,194238,90710,IT,IT
59156,1700320500,1700352000,31500,149475,122728,TR,TR
186571,1699948620,1699978680,30060,108708,120268,TR,TR
152269,1699385340,1699421160,35820,45589,1299,MX,MX
198270,1700580600,1700589360,8760,64362,45566,HR,HR
126900,1699004940,1699020900,15960,199789,46752,US,US
150070,1700809440,1700841420,31980,83465,155386,TR,TR
140275,1699046460,1699058580,12120,85380,74678,IT,IT
172147,1700183580,1700215980,32400,86402,69769,MX,MX
31655,1699334160,1699369260,35100,9341,836,TR,TR
195239,1700408340,1700424900,16560,35438,132259,US,US
127125,1699260960,1699269600,8640,160488,81282,PT,PT
54238,1699484460,1699491000,6540,11184,186800,GB,GB
106234,1699731300,1699754580,23280,40041,34442,PL,UA
23761,1700565960,1700596200,30240,33320,166000,TR,TR
60723,1699944240,1699952340,8100,62844,113035,IT,IT
38940,1698843060,1698873360,30300,93067,165203,TR,TR
115595,1700215380,1700222640,7260,106561,101626,IT,IT
14754,1700247480,1700280120,32640,188135,169421,TR,TR
14510,1698853080,1698885420,32340,154138,167973,TR,TR
69982,1700757000,1700760600,3600,158862,139671,GB,GB
452,1700056500,1700070480,13980,81249,151128,HR,HR
98412,1699815600,1699844460,28860,172706,145370,BA,DE
41209,1699809900,1699840860,30960,44791,142478,TR,TR
21297,1700145120,1700159580,14460,114420,89849,US,US
91057,1699695060,1699708260,13200,93013,149764,US,US
46346,1700176800,1700188740,11940,69881,145343,IT,IT
184577,1699532760,1699564800,32040,66947,148366,TR,TR
180,1699030440,1699038420,7980,169009,143339,IT,IT
64019,1700430300,1700433900,3600,118743,89592,NL,NL
119832,1700686080,1700709960,23880,47408,46710,BR,BR
77692,1699828860,1699861320,32460,44093,103082,TR,TR
84608,1699159860,1699174380,14520,175263,12007,BE,NL
63262,1700836920,1700868660,31740,10220,163002,TR,TR
186329,1699736820,1699771440,34620,76830,176867,TR,TR
45541,1698989280,1699024020,34740,199650,186173,TR,TR
170503,1700838540,1700847240,8700,5068,127437,IT,IT
83686,1699494480,1699520220,25740,71907,101187,CH,FR
104140,1700670960,1700692620,21660,114938,35859,RO,RO
71997,1700572500,1700590440,17940,179489,18598,FR,FR
172939,1699705680,1699741560,35880,98423,84077,TR,TR
56686,1698903540,1698907140,3600,50232,42750,GB,GB
124686,1698852180,1698858180,6000,34526,70406,GB,GB
152890,1700623860,1700651280,27420,6427,136224,DE,DE
8562,1700073300,1700105640,32340,16373,115764,TR,TR
90942,1699463400,1699495200,31800,90395,100215,TR,TR
71321,1699012320,1699043460,31140,129450,42075,TR,TR
161266,1700328060,1700342460,14400,74323,55497,US,US
149332,1698823380,1698857400,34020,89534,160956,TR,TR
179195,1700340120,1700355780,15660,109847,114946,BE,FR
195829,1699349400,1699354260,4860,120704,136608,GB,GB
122627,1700431800,1700466300,34500,132941,13366,MX,MX
119942,1700242440,1700252100,9660,162076,44342,PT,PT
17730,1700248200,1700279340,31140,189210,38987,TR,TR
22343,1699903260,1699906860,3600,11432,194697,GB,GB
191339,1699470120,1699480680,10560,100484,171402,IT,FR
136202,1700701380,1700705940,4560,122446,127316,GB,GB
182673,1699129200,1699161240,32040,69970,133415,TR,TR
136609,1698881880,1698907020,25140,104848,32831,PL,PL
45862,1698839760,1698864180,24420,2160,31229,BR,BR
15461,1700829660,1700844300,14640,26799,179608,FR,FR
79271,1699046820,1699080300,33480,137731,101857,TR,TR
173424,1699193580,1699201020,7440,146680,136964,IT,IT
129496,1699268640,1699303260,34620,76423,91142,TR,TR
62035,1699516200,1699551780,35580,121300,156182,TR,TR
95354,1699882080,1699911540,29460,6199,117525,TR,TR
123519,1700467980,1700473980,6000,163540,148821,NL,NL
157385,1699204920,1699222260,17340,154859,3302,US,US
46507,1699679880,1699710060,30180,137445,84828,TR,TR
30763,1699652580,1699688280,35700,50458,130488,TR,TR
51562,1700318400,1700350980,32580,76458,166451,TR,TR
108784,1700801400,1700834820,33420,112566,135762,TR,TR
117523,1698880080,1698908940,28860,26964,33430,TR,TR
48792,1700491620,1700509020,17400,194266,30149,US,US
141900,1699408200,1699422120,13920,54621,142074,HR,HR
83725,1699110600,1699127220,16620,163334,193167,FR,FR
9933,1700280240,1700285700,5460,100508,91260,GB,GB
173237,1700725320,1700741520,16200,82438,27437,US,US
137799,1699544400,1699576140,31740,183924,79850,TR,TR
174104,1699419960,1699449720,29760,78115,153282,TR,TR
12050,1700113800,1700121660,7860,11376,188891,IT,IT
131674,1699280760,1699306680,25920,183776,154566,RO,RO
32224,1699881060,1699894680,13620,104899,112261,RS,RS
154373,1699754100,1699782180,28080,16023,122624,DE,CH
63192,1700088120,1700104800,16680,63577,136344,US,US
172100,1699935240,1699942080,6840,39630,134819,GB,GB
28489,1699958220,1699972440,14220,38216,90459,ES,ES
197519,1700490900,1700524800,33900,61662,56405,TR,TR
85588,1699627680,1699639860,12180,139317,149006,IT,DE
82369,1698916800,1698920400,3600,169995,86230,NL,NL
70753,1699482000,1699485600,3600,141734,53422,GB,GB
115339,1700367840,1700385060,17220,137522,173378,FR,CH
37179,1698889620,1698922920,33300,159083,141289,TR,TR
59359,1700583300,1700618100,34800,71295,132295,TR,TR
3429,1699019040,1699048920,29880,96455,9682,TR,TR
179831,1700182560,1700216040,33480,10699,77278,TR,TR
158409,1698952980,1698985980,33000,177519,68602,TR,TR
106627,1700592300,1700619180,26880,134017,38422,DE,DE
7854,1700337120,1700350140,13020,147734,93315,US,MX
162727,1699894500,1699913280,18780,104023,63941,IN,IN
123475,1700656200,1700671620,15420,75966,67560,AT,DE
182630,1699306980,1699340760,33780,130637,152411,TR,TR
169744,1700173680,1700179860,6180,44467,72347,GB,GB
135246,1700515920,1700530560,14640,23878,40909,US,US
64840,1699173960,1699178940,4980,11843,80360,GB,GB
91448,1699961640,1699974300,12660,198379,147427,SK,DE
124343,1700474400,1700487900,13500,8181,6522,IT,IT
96046,1699480380,1699485600,5220,67657,171268,GB,GB
39415,1699521960,1699536420,14460,30253,189831,US,US
39986,1700120100,1700135100,15000,36342,77276,US,US
49005,1699966560,1699979700,13140,77342,69298,AT,BG
179646,1699705140,1699717440,12300,27920,185932,US,US
153821,1699312980,1699343820,30840,178553,96432,TR,TR
79430,1699405920,1699435140,29220,145119,20734,TR,TR
120116,1700571540,1700629260,57720,28833,77793,UA,PL
193642,1699230720,1699236660,5940,11288,137661,GB,GB
106343,1700705640,1700721360,15720,66103,124370,BE,FR
122418,1700661000,1700666580,5580,124292,38838,NL,NL
98421,1698950820,1698970080,19260,73560,104401,FR,PT
141569,1699453980,1699460220,6240,52464,160415,GB,GB
146286,1699658820,1699690980,32160,9400,111528,TR,TR
41881,1699491120,1699497780,6660,86888,145609,NL,DE
17220,1699568100,1699578900,10800,11667,1296,IT,IT
61395,1699808580,1699838760,30180,4854,154099,TR,TR
97341,1698820680,1698848880,28200,160911,104419,DE,DE
86816,1699693860,1699706220,12360,140006,26905,US,US
10312,1700254320,1700266080,11760,60334,174621,US,CA
189784,1699640640,1699676460,35820,191639,11167,TR,TR
191320,1699483140,1699498260,15120,71069,38839,FR,FR
125625,1699403640,1699407240,3600,94480,146619,NL,NL
174466,1700205720,1700237280,31560,188792,40682,TR,TR
50320,1699527360,1699546920,19560,199015,93470,SI,RS
116331,1700388900,1700417820,28920,103701,104989,TR,TR
56175,1700153460,1700159340,5880,95801,150076,NL,NL
192459,1699475280,1699509840,34560,34109,144769,TR,TR
30307,1699224900,1699239120,14220,15566,181249,IT,IT
126867,1699655280,1699680720,25440,131273,49636,DE,NL
72870,1699315500,1699319100,3600,127022,164153,NL,NL
97805,1699383840,1699416300,32460,88663,140659,MX,MX
187209,1700864580,1700876040,11460,196632,90878,AT,AT
55493,1699945680,1699957020,11340,156853,140095,IT,IT
147717,1699766640,1699790160,23520,141461,117323,DE,DE
168000,1699590900,1699620420,29520,85369,36482,TR,TR
146011,1700149500,1700174640,25140,26549,46445,PL,DE
25493,1699990860,1700028060,37200,115906,109842,MX,MX
108117,1700828760,1700853660,24900,171033,92938,DE,IT
25278,1699743660,1699763160,19500,70687,196422,FR,FR
104866,1700733300,1700750040,16740,118873,147907,AT,AT
167684,1699550340,1699554720,4380,99905,12659,GB,GB
69144,1700508900,1700521260,12360,120942,117104,CZ,CZ
61345,1700200380,1700221860,21480,188396,98349,FR,PT
6176,1699482120,1699513740,31620,117664,30152,TR,TR
95860,1699513920,1699518720,4800,35942,52380,GB,GB
40082,1699424640,1699460040,35400,111855,172845,TR,TR
92136,1700555700,1700568720,13020,4398,15285,IT,IT
149934,1699643460,1699676280,32820,28681,135302,TR,TR
60564,1700157600,1700173860,16260,165584,1400,US,US
48862,1699099920,1699132440,32520,102899,166380,TR,TR
9101,1700844360,1700883780,39420,12607,30039,MX,MX
119364,1699766640,1699779300,12660,96396,151364,SK,AT
142787,1699794240,1699799040,4800,12485,65678,NL,NL
179966,1699384140,1699413240,29100,78005,65347,TR,TR
47158,1700066160,1700069760,3600,185363,123081,NL,NL
151417,1699940340,1699949340,9000,16828,28497,ES,ES
680,1700375580,1700392860,17280,93789,138607,AT,AT
146552,1700377680,1700413440,35760,184830,94342,TR,TR
72197,1699929000,1699935120,6120,30949,164108,GB,GB
74245,1699619280,1699650720,31440,37677,136476,TR,TR
166640,1698810360,1698826320,15960,197823,98003,US,US
183434,1699409220,1699445100,35880,53884,190979,TR,TR
132841,1699765200,1699798500,33300,84217,122021,TR,TR
142229,1699015740,1699028640,12900,95670,73105,ES,ES
199303,1699972500,1700005380,32880,154417,196626,TR,TR
194636,1699394700,1699426800,32100,102120,49478,TR,TR
24060,1700180280,1700194680,14400,51016,51499,AT,HU
113834,1699405740,1699441320,35580,95082,82587,MX,MX
105704,1698919920,1698943140,23220,68768,125474,PL,PL
49519,1699219920,1699233540,13620,18194,196067,PT,PT
199858,1699873740,1699884960,11220,65590,82195,US,US
102671,1700331120,1700337360,6240,98371,197631,NL,NL
35601,1699044120,1699073700,29580,164989,134387,TR,TR
1541,1699367880,1699393800,25920,172594,128082,BR,BR
99273,1700718060,1700752500,34440,23690,148364,TR,TR
155884,1698898860,1698907800,8940,108136,92863,IT,IT
169646,1700851740,1700882940,31200,24834,125272,TR,TR
71510,1699083660,1699115700,32040,155134,69153,TR,TR
4076,1699521660,1699533300,11640,169407,166654,US,US
186087,1699625580,1699637940,12360,110002,70391,RS,RS
115549,1699947720,1699982520,34800,181472,123929,TR,TR
125730,1699191720,1699221540,29820,176291,104877,TR,TR
92431,1700010180,1700043660,33480,117044,175249,TR,TR
152504,1700483700,1700513640,29940,57800,59051,TR,TR
176098,1700238540,1700267160,28620,53756,169029,DE,BG
91623,1700343480,1700378580,35100,127337,16435,TR,TR
94575,1700470080,1700473680,3600,101301,188589,NL,NL
50156,1699076820,1699080420,3600,169491,162329,GB,GB
57580,1700653020,1700661540,8520,124436,199611,IT,IT
111782,1699578720,1699590720,12000,162107,102233,HR,AL
48448,1700122140,1700156160,34020,152049,171446,TR,TR
149679,1699550820,1699565160,14340,183617,97082,US,US
154082,1700292720,1700327940,35220,87301,174343,TR,TR
23192,1700717760,1700743980,26220,94375,160649,BR,BR
79549,1698983340,1699015680,32340,168932,135646,TR,TR
179932,1699431720,1699461840,30120,147733,188419,TR,TR
190743,1699656960,1699688700,31740,100738,177391,TR,TR
11894,1700821200,1700837520,16320,146467,128013,AT,AT
110172,1699363560,1699377780,14220,98553,87673,US,US
82670,1700502300,1700515860,13560,35755,61424,PT,PT
19853,1700488560,1700494080,5520,107995,49798,NL,NL
78560,1700321700,1700332560,10860,125943,146606,US,US
44592,1699238940,1699269480,30540,164135,159606,TR,TR
127173,1699165140,1699197480,32340,86275,27622,TR,TR
105053,1699959300,1699994580,35280,116758,179745,MX,MX
37230,1700080920,1700089620,8700,119055,15126,IT,IT
122388,1699167600,1699203300,35700,39217,89126,TR,TR
22462,1699395120,1699430700,35580,84258,165922,TR,TR
166070,1699541160,1699570440,29280,154750,139143,TR,TR
92290,1699123620,1699140420,16800,151632,154323,US,US
93307,1700305860,1700320020,14160,100072,98515,ES,PT
101859,1700757720,1700766960,9240,94374,99650,EE,EE
138851,1700434020,1700450940,16920,162951,177848,RS,BA
129785,1700034540,1700046360,11820,102096,16575,CZ,CZ
92669,1700685000,1700720220,35220,45245,180770,TR,TR
186517,1700046300,1700071980,25680,146352,41323,DE,DE
63361,1698863340,1698879720,16380,194610,193067,FR,FR
92093,1699100820,1699104420,3600,151462,6006,GB,GB
8105,1699114440,1699143360,28920,70486,111804,TR,TR
79178,1699249080,1699265220,16140,110824,137817,FR,ES
57305,1698827760,1698854820,27060,74200,197287,PL,PL
3437,1699422720,1699458180,35460,85212,37397,TR,TR
46801,1700777520,1700802720,25200,68543,117625,DE,DE
131882,1699924500,1699954860,30360,80263,156608,TR,TR
171467,1699894200,1699929000,34800,110627,187343,TR,TR
77952,1699053660,1699060620,6960,153065,173540,GB,GB
13863,1700343660,1700360220,16560,17668,187423,AT,SK
90822,1699839120,1699871340,32220,146162,2351,TR,TR
173777,1699747500,1699781700,34200,157825,141055,TR,TR
4186,1700860020,1700874720,14700,70999,38738,FR,FR
140339,1698913680,1698948180,34500,158291,125982,TR,TR
20390,1700852220,1700884080,31860,131253,77726,TR,TR
40410,1699827300,1699830900,3600,169894,88002,GB,GB
133870,1699748280,1699779720,31440,70197,164832,TR,TR
167778,1699848000,1699857840,9840,107492,172109,HR,HR
30033,1699463280,1699493580,30300,121976,11082,TR,TR
189032,1699641300,1699675200,33900,99706,104091,TR,TR
108717,1700478840,1700482860,4020,84716,115451,NL,NL
10301,1698988200,1699000500,12300,9506,127864,AT,AT
88247,1700638200,1700649240,11040,120736,119446,HR,AT
94670,1700591820,1700602740,10920,148129,76121,US,US
49817,1700429880,1700436360,6480,137277,54251,GB,GB
31344,1699167720,1699196580,28860,20471,122452,TR,TR
3709,1699564260,1699575480,11220,199906,113610,CZ,HU
81565,1699131720,1699167540,35820,170377,180598,TR,TR
121883,1699053960,1699067160,13200,23188,91403,PT,PT
29849,1699164060,1699198920,34860,75050,125448,TR,TR
10836,1698815700,1698819300,3600,65649,193096,GB,GB
162809,1699766280,1699769880,3600,92187,73479,GB,GB
177619,1699923000,1699958220,35220,171918,13363,TR,TR
180707,1700056380,1700061720,5340,137126,110849,GB,GB
72076,1699435260,1699468620,33360,180042,91068,MX,MX
15307,1700077560,1700112180,34620,157877,5245,TR,TR
13576,1700810880,1700822340,11460,121265,26539,US,US
11262,1698864060,1698873120,9060,128728,138009,EE,FI
54862,1700717220,1700727060,9840,150748,124099,IT,IT
174966,1699922040,1699956540,34500,166872,146121,TR,TR
52567,1698934920,1698945900,10980,156157,45421,ES,ES
58574,1700195400,1700202780,7380,196007,54390,HR,HR
176331,1700846340,1700875500,29160,102431,11497,TR,TR
115675,1700111700,1700146800,35100,103757,187568,TR,TR
131633,1699191180,1699216380,25200,164293,2138,HU,DE
120514,1700493600,1700504340,10740,165625,106581,ES,AD
169395,1699968120,1699984560,16440,35275,186278,US,US
110156,1700403480,1700417820,14340,133916,37444,US,US
171859,1699967400,1699998600,31200,160884,131608,TR,TR
106301,1700598120,1700608800,10680,190767,144249,ES,ES
197599,1700621340,1700624940,3600,114020,106467,GB,GB
100762,1700746620,1700777220,30600,168608,146756,TR,TR
84950,1699467240,1699470840,3600,150819,187837,GB,GB
28212,1700529600,1700563080,33480,93849,20731,TR,TR
151274,1699081800,1699092900,11100,23585,26997,US,US
29578,1699009920,1699023540,13620,196803,55355,AT,DE
131114,1700447160,1700456880,9720,130853,145150,HR,HR
33514,1699725960,1699730400,4440,9675,180234,GB,GB
6243,1700352960,1700378820,25860,53503,89692,DE,DE
180277,1698793560,1698819720,26160,112630,160724,DE,DE
57821,1699572420,1699603800,31380,193683,39703,TR,TR
138973,1700847360,1700879820,32460,110152,24873,TR,TR
168533,1699521780,1699551720,29940,99840,131470,TR,TR
34999,1698885120,1698919560,34440,75433,64811,TR,TR
20835,1700546160,1700559480,13320,44236,99477,US,US
67933,1699066980,1699096620,29640,93434,119931,TR,TR
37504,1700024940,1700057460,32520,150688,29321,TR,TR
153830,1699719180,1699753680,34500,181053,196940,TR,TR
135083,1699438140,1699472880,34740,155346,122830,TR,TR
157622,1699621020,1699631160,10140,111605,151706,IT,IT
131300,1699698180,1699729260,31080,179550,43150,TR,TR
23103,1698814500,1698818100,3600,115309,53685,GB,GB
3797,1699571280,1699575780,4500,136071,33136,GB,GB
86896,1699889820,1699898340,8520,168757,154450,EE,EE
22291,1700279520,1700288940,9420,195226,131565,IT,IT
114991,1700707740,1700711340,3600,65021,187620,NL,NL
164571,1698907560,1698919920,12360,352,135059,IT,IT
182510,1700810580,1700823180,12600,131514,137512,PT,PT
126809,1700046240,1700078520,32280,195715,126362,TR,TR
63455,1699237260,1699248840,11580,107733,47,IT,IT
8817,1699898040,1699927920,29880,93394,139706,TR,TR
55950,1699437960,1699467120,29160,156172,182115,TR,TR
136681,1699061280,1699095180,33900,55462,163678,TR,TR
16486,1698993900,1699023660,29760,25449,56014,TR,TR
5259,1699868580,1699879020,10440,119029,170863,ES,ES
127099,1698797820,1698833760,35940,186758,64965,TR,TR
136901,1700523240,1700526840,3600,75334,19493,GB,GB
56973,1700292840,1700323200,30360,130058,117094,MK,AL
116610,1700629140,1700632740,3600,115180,55908,GB,GB
133959,1699090380,1699103580,13200,19110,3729,US,US
11647,1700303820,1700316420,12600,93461,138141,CA,US
118010,1700320440,1700347680,27240,6163,21602,DE,HR
62064,1700380440,1700384040,3600,105814,149372,GB,GB
125002,1700373000,1700410320,37320,139509,24995,MX,MX
48121,1698794280,1698825840,31560,99343,159850,TR,TR
2188,1700009580,1700022600,13020,77622,58798,AT,AT
167405,1699630020,1699666080,36060,13110,186250,MX,MX
123425,1700412240,1700422980,10740,98756,27319,ES,ES
185351,1700013600,1700026980,13380,115937,62253,US,US
61529,1699168380,1699200780,32400,177693,174645,MX,MX
140924,1698875280,1698907740,32460,62823,106070,TR,TR
169513,1699104480,1699117680,13200,101779,100827,US,US
140063,1700380800,1700390220,9420,183762,105766,IT,IT
49337,1699654860,1699677420,22560,176267,167819,DE,IT
2391,1699501560,1699520940,19380,28760,77432,BE,NL
74488,1700491920,1700521020,29100,64986,178277,TR,TR
163153,1700348220,1700380680,32460,192976,168541,TR,TR
149525,1700641980,1700655840,13860,127230,121471,CZ,CZ
133444,1700852760,1700869620,16860,113184,97792,US,MX
45079,1700551560,1700565060,13500,148663,165453,ES,ES
49633,1699640100,1699658280,18180,115713,164071,FR,FR
190131,1699915140,1699931580,16440,27290,134485,US,US
82867,1700141760,1700176020,34260,146710,149215,TR,TR
850,1699282560,1699300320,17760,198841,96628,US,US
52195,1700498340,1700528580,30240,191183,21343,TR,TR
110440,1698904860,1698935880,31020,98064,40032,TR,TR
77233,1699508760,1699538940,30180,83534,118197,TR,TR
13009,1700404920,1700412180,7260,49289,148230,HR,HR
194453,1699698660,1699732200,33540,185660,69202,TR,TR
34478,1699033260,1699036860,3600,62640,102113,GB,GB
155948,1699290480,1699319040,28560,79397,49058,DE,SK
182194,1700700600,1700705400,4800,113776,113932,GB,GB
70745,1699666440,1699695420,28980,41988,25536,TR,TR
170039,1700015280,1700029140,13860,23389,11757,AT,AT
86515,1700517240,1700528880,11640,142051,187288,SK,AT
173993,1700626680,1700656680,30000,41937,136798,TR,TR
80513,1699709640,1699728960,19320,117254,3627,FR,NL
81810,1699093020,1699102380,9360,125840,89907,IT,IT
17310,1700194500,1700209440,14940,146358,117332,AT,AT
189152,1699375980,1699384620,8640,172476,83220,IT,IT
123761,1699158240,1699190220,31980,69042,6400,TR,TR
117444,1700072940,1700105040,32100,970,47675,TR,TR
19958,1699330320,1699345080,14760,32921,57649,US,US
193855,1700492820,1700505960,13140,163617,94579,IT,IT
87315,1700652420,1700687160,34740,25398,176843,TR,TR
45553,1699354740,1699359780,5040,186821,131254,GB,GB
143907,1700012940,1700046300,33360,194878,90642,TR,TR
71857,1700066040,1700076420,10380,130219,161495,IT,DE
142724,1700473800,1700484840,11040,153808,128973,HR,HR
175521,1699405140,1699408740,3600,112163,169222,NL,NL
69587,1699627140,1699631460,4320,165321,24823,NL,NL
85914,1699584900,1699593660,8760,136404,176840,PT,PT
25284,1700142120,1700159820,17700,111874,160984,US,US
166008,1700407680,1700420760,13080,14332,55495,ES,FR
53391,1699830480,1699835220,4740,190734,73973,GB,GB
136822,1699307280,1699318860,11580,100632,164596,ES,AD
55917,1699710660,1699724460,13800,194598,107879,AT,AT
39174,1700220180,1700249760,29580,178104,175563,TR,TR
173248,1699928460,1699939620,11160,24867,177346,PT,PT
50681,1698990420,1698996360,5940,118181,112409,NL,NL
14352,1700269740,1700287500,17760,105312,142261,CZ,CZ
191558,1700692680,1700722200,29520,192315,117102,TR,TR
120709,1699889580,1699925340,35760,25150,70590,TR,TR
54994,1698964500,1698969600,5100,185494,139316,GB,GB
138664,1700102700,1700117940,15240,21061,125457,SE,SE
71210,1699585980,1699597620,11640,171019,19318,CZ,CH
197657,1700172900,1700176500,3600,3919,145930,GB,GB
19861,1700257260,1700286540,29280,147904,76338,TR,TR
73992,1698852000,1698859020,7020,114582,185278,GB,GB
77914,1699572720,1699607520,34800,69242,179172,TR,TR
18200,1699693140,1699696980,3840,59767,184492,NL,NL
29080,1698892140,1698921780,29640,128256,148129,TR,TR
141147,1700418000,1700452860,34860,136630,90613,TR,TR
149900,1699220520,1699251240,30720,51150,163461,TR,TR
197926,1698909960,1698941040,31080,104183,40452,TR,TR
65586,1700617680,1700652180,34500,4889,22399,TR,TR
163754,1700463840,1700488320,24480,23384,100166,DE,PL
82677,1699830840,1699837080,6240,89529,128718,NL,NL
58016,1699379100,1699385040,5940,148997,24157,NL,NL
45060,1700430060,1700450820,20760,10230,32065,FR,BE
89153,1700668800,1700695860,27060,100629,138760,DE,BG
774,1700361300,1700366340,5040,101938,24924,GB,GB
125482,1700539800,1700552040,12240,163420,142167,ES,ES
140075,1699308360,1699315380,7020,46503,32682,GB,GB
89221,1699339620,1699356240,16620,171194,58575,AT,SK
120034,1699733280,1699766460,33180,134361,63368,TR,TR
103879,1699450200,1699455720,5520,48653,148117,GB,GB
158316,1699717620,1699732080,14460,48068,15335,US,US
194976,1698829560,1698857040,27480,11969,145944,CH,DE
161144,1700120940,1700155740,34800,7826,22194,TR,TR
23752,1700792700,1700802420,9720,173577,156882,HR,HR
73914,1700518020,1700548500,30480,141435,45053,TR,TR
66264,1699558620,1699570200,11580,18966,101876,IT,IT
1501,1699014780,1699046640,31860,87812,184522,TR,TR
192858,1700336220,1700340840,4620,74825,122771,NL,NL
56374,1700519280,1700529300,10020,155685,39143,HR,HR
10944,1699261800,1699273560,11760,73735,189,US,US
139661,1699784520,1699794180,9660,46562,87662,PT,PT
174243,1700281800,1700295900,14100,198931,8204,US,US
13503,1700421540,1700425200,3660,39710,61156,NL,BE
47402,1698931740,1698966720,34980,21192,8900,TR,TR
30021,1699936380,1699966020,29640,66049,24308,TR,TR
13423,1700587680,1700602860,15180,171871,174419,US,US
13280,1699086060,1699112160,26100,122629,141768,CH,PT
49,1699080480,1699084080,3600,190760,110656,NL,NL
187616,1699434240,1699440660,6420,101130,71589,GB,GB
97323,1699888740,1699921440,32700,142537,148984,TR,TR
192162,1699352820,1699370760,17940,65431,119319,CZ,CZ
64118,1699624740,1699654080,29340,10311,173624,TR,TR
75,1700705760,1700737200,31440,63974,83799,TR,TR
59264,1699521180,1699526400,5220,199805,34439,NL,NL
124652,1700385360,1700390160,4800,162313,119506,GB,GB
85968,1699987500,1699999740,12240,168898,178281,US,US
16265,1700729100,1700740680,11580,150505,161963,HR,HR
112233,1699710120,1699724580,14460,2555,84487,US,US
107842,1700206500,1700231640,25140,48764,63544,PL,PL
114647,1699288800,1699300080,11280,153271,195840,HR,HR
72826,1699408980,1699444620,35640,146053,8038,TR,TR
31574,1700183520,1700188500,4980,120405,108185,GB,GB
140525,1699373580,1699387200,13620,6790,82743,US,US
82574,1699534500,1699567740,33240,123197,184514,TR,TR
38332,1699688460,1699719120,30660,55072,6113,TR,TR
162728,1698884520,1698888120,3600,87828,31335,NL,NL
184298,1699070580,1699076520,5940,6833,74,NL,NL
55568,1698874560,1698878160,3600,12851,43469,NL,NL
54726,1700544540,1700559780,15240,123851,183873,AT,AT
100457,1700818440,1700830800,12360,76906,84385,US,US
20286,1699581780,1699592880,11100,102805,73868,HR,HR
104777,1698890220,1698905760,15540,66490,121544,US,US
155444,1699244340,1699258200,13860,117100,67496,US,US
31186,1699698840,1699728720,29880,170173,86097,TR,TR
133832,1699594440,1699601040,6600,105785,156186,GB,GB
92057,1699519140,1699548900,29760,164838,128717,TR,TR
162896,1700240700,1700270340,29640,95744,2948,TR,TR
195665,1699096500,1699109100,12600,91191,155262,IT,IT
10664,1700200620,1700233740,33120,31994,66646,TR,TR
129690,1699463940,1699497600,33660,9439,132344,TR,TR
129592,1698985980,1698989580,3600,182352,126333,GB,GB
142774,1699212420,1699221960,9540,18859,26323,ES,ES
51768,1700175840,1700187360,11520,61227,166584,ES,ES
36934,1700816940,1700834040,17100,136913,78045,US,CA
197551,1700728860,1700764380,35520,152781,192051,TR,TR
197834,1699991520,1700006820,15300,187217,122445,RS,RS
113963,1699296480,1699326180,29700,193121,45819,TR,TR
37791,1700472480,1700503080,30600,199498,32062,TR,TR
73033,1698979800,1698983400,3600,74972,188997,GB,GB
189764,1700193000,1700196600,3600,96500,81210,NL,NL
176749,1699539720,1699543320,3600,105375,131824,NL,NL
16350,1700745600,1700757720,12120,33528,66435,IT,IT
177387,1700575320,1700584260,8940,78444,163285,IT,IT
27391,1699175460,1699180680,5220,35671,124822,NL,NL
30393,1700525040,1700532900,7860,165117,17397,PT,PT
190700,1700428620,1700438220,9600,25373,5769,HR,HR
114441,1698851640,1698868680,17040,153087,67844,CZ,CZ
5828,1699268280,1699273860,5580,95969,91453,GB,GB
50113,1700428860,1700439600,10740,153095,80868,EE,EE
54888,1700280360,1700315040,34680,163432,164778,TR,TR
49280,1700796840,1700800440,3600,106218,187170,GB,GB
141521,1700643480,1700673960,30480,86134,4436,TR,TR
138069,1699831440,1699863660,32220,67363,156148,TR,TR
186902,1699666080,1699683060,16980,142427,189641,US,US
67669,1699600440,1699610340,9900,130995,189658,IT,IT
30713,1700223780,1700257680,33900,191929,39364,TR,TR
86439,1700590200,1700600400,10200,28640,137396,HR,HR
112509,1699772640,1699805880,33240,80026,130058,TR,TR
184757,1699896360,1699930740,34380,56150,191386,TR,TR
137475,1700756520,1700783820,27300,124880,102506,BR,BR
188028,1700408520,1700422380,13860,131375,168191,ES,ES
180734,1699473720,1699479780,6060,60480,18393,GB,GB
84161,1700492580,1700502480,9900,122463,145874,EE,FI
5073,1700615160,1700645460,30300,98907,177116,TR,TR
45293,1700605440,1700641380,35940,171971,71504,TR,TR
63876,1699464000,1699492020,28020,197912,5039,BR,BR
175329,1699176780,1699212180,35400,197213,121843,TR,TR
30909,1699913040,1699927380,14340,193627,190025,US,US
143938,1700216580,1700241120,24540,66079,87116,DE,HU
71539,1699323900,1699336260,12360,97234,92907,US,US
142058,1699566540,1699600680,34140,182512,33199,TR,TR
144443,1700148600,1700152200,3600,139647,133108,GB,GB
161127,1700745360,1700756160,10800,87327,59975,CZ,CZ
84546,1700037900,1700054460,16560,35524,122149,FR,FR
109969,1699613640,1699626600,12960,73642,38140,AT,BG
172388,1699759440,1699763040,3600,160528,3819,GB,GB
98627,1699066020,1699101840,35820,124936,175982,MK,RS
146101,1700321460,1700353740,32280,3849,122484,TR,TR
147380,1699714440,1699730820,16380,191014,197740,FR,DE
139961,1700072460,1700087100,14640,158704,52556,CZ,AT
186012,1699805400,1699839780,34380,171718,94049,TR,TR
122428,1700583000,1700614860,31860,55849,24378,TR,TR
11901,1700219820,1700235780,15960,198405,68497,RS,BG
152254,1700248200,1700262480,14280,87933,49245,US,US
66846,1700004720,1700022120,17400,17982,65595,AT,BG
195009,1700543100,1700573640,30540,38337,135850,TR,TR
43156,1699398180,1699415940,17760,43902,4391,BE,NL
12848,1699391100,1699402380,11280,90697,25564,US,CA
18860,1699525920,1699560360,34440,59501,192138,TR,TR
34995,1699920480,1699950840,30360,53437,151256,TR,TR
33998,1699378380,1699408800,30420,45610,102949,TR,TR
138460,1700321640,1700355240,33600,37238,180075,TR,TR
62535,1699589280,1699600740,11460,83626,99297,US,US
74814,1700695800,1700726880,31080,7881,33084,TR,TR
157488,1699712580,1699748160,35580,122553,48645,TR,TR
169430,1698974520,1699008840,34320,197144,96814,TR,TR
144312,1699045980,1699049580,3600,164219,22401,NL,NL
128667,1699295760,1699329840,34080,118330,1189,TR,TR
53218,1700401920,1700413560,11640,175471,107212,US,US
92941,1699802640,1699806240,3600,155850,81585,GB,GB
100164,1699937640,1699949400,11760,10876,105353,AT,HR
25916,1700426460,1700461200,34740,195860,39005,TR,TR
50359,1699773240,1699800840,27600,3191,127415,DE,BG
93178,1699551060,1699583460,32400,153209,13882,TR,TR
146882,1699434900,1699442700,7800,104751,192802,IT,IT
45544,1698947460,1698979440,31980,147125,78714,TR,TR
100321,1700850720,1700880720,30000,93432,180,TR,TR
128137,1699513920,1699526760,12840,78434,199124,HR,HR
23798,1699083720,1699119660,35940,76794,25217,TR,TR
48516,1699252380,1699255980,3600,28083,114792,GB,GB
23435,1699792140,1699822320,30180,59508,100547,TR,TR
132898,1700014740,1700044500,29760,61106,47055,TR,TR
49429,1698967260,1698981300,14040,86987,63831,US,US
111966,1698820500,1698846360,25860,27463,96591,DE,AT
77052,1699442040,1699456620,14580,166638,151715,BE,FR
11199,1700815500,1700820960,5460,89337,101048,GB,GB
23376,1700130300,1700161860,31560,86968,107148,TR,TR
90420,1700828460,1700838660,10200,114323,109896,SK,AT
159693,1700623440,1700653740,30300,98184,149344,TR,TR
122619,1700034540,1700072280,37740,175293,104217,MX,US
188856,1698858120,1698872040,13920,175460,89871,CZ,CZ
198052,1699184160,1699217040,32880,86030,175212,TR,TR
126995,1699722360,1699756620,34260,50012,123492,TR,TR
158225,1699292160,1699301640,9480,190325,191601,EE,EE
81029,1699148280,1699169940,21660,187244,37632,DE,PL
138796,1699248600,1699277520,28920,115503,185849,TR,TR
97944,1699264680,1699274700,10020,180648,51611,IT,IT
117893,1699494000,1699497600,3600,178810,85899,NL,NL
142745,1700230200,1700239980,9780,33104,112518,PT,PT
63947,1700181480,1700216880,35400,55420,187008,TR,TR
16808,1700609400,1700631660,22260,98851,32119,DE,DE
169293,1700284560,1700288160,3600,94795,109691,NL,NL
155188,1699362240,1699373820,11580,180306,48786,AT,AT
51017,1700153520,1700159640,6120,139086,144273,GB,GB
187076,1700516100,1700551440,35340,2256,133950,TR,TR
73178,1699469340,1699476120,6780,77384,131308,NL,NL
84432,1699295520,1699327020,31500,119221,116301,TR,TR
60696,1699842120,1699856460,14340,177638,65640,US,US
162779,1700644020,1700678340,34320,56883,118006,TR,TR
27355,1700362440,1700367000,4560,111149,2061,NL,NL
152228,1698890280,1698896580,6300,184822,109079,GB,GB
135106,1700494980,1700528160,33180,90969,100295,TR,TR
147639,1700792040,1700827620,35580,9410,40249,TR,TR
172316,1699527660,1699563300,35640,191087,165179,TR,TR
118992,1700198820,1700229360,30540,62116,88123,TR,TR
52915,1699193940,1699206480,12540,80089,98441,US,US
51858,1700403720,1700437800,34080,51344,87958,TR,TR
16124,1699676100,1699693860,17760,165765,21194,CZ,CZ
127043,1699593180,1699622340,29160,140824,117200,BA,DE
101786,1700180940,1700212080,31140,80471,48302,TR,TR
112073,1699341660,1699359180,17520,55827,193008,US,US
27687,1700469600,1700481000,11400,31967,158123,AT,HU
116450,1699671900,1699677600,5700,111847,162572,GB,GB
77735,1699173180,1699192620,19440,11696,40484,SE,SE
4687,1699147800,1699162200,14400,174896,14336,US,US
73999,1698890820,1698917880,27060,183638,19917,DE,DE
193993,1699874160,1699888320,14160,145749,64765,CA,CA
86552,1700263740,1700293440,29700,75238,136660,TR,TR
105877,1700418660,1700428140,9480,54605,21323,PT,PT
82200,1699558260,1699563060,4800,25024,89908,NL,NL
192573,1700846100,1700859420,13320,35723,144900,IT,IT
70520,1700753280,1700785380,32100,65003,176955,TR,TR
60999,1699539480,1699570740,31260,125675,85661,TR,TR
167272,1700718180,1700724840,6660,45872,121068,NL,NL
95202,1700091360,1700125860,34500,46603,197049,TR,TR
74077,1698847920,1698852240,4320,96073,97958,NL,DE
114353,1698864420,1698897540,33120,179423,15612,TR,TR
25442,1700262960,1700274840,11880,67951,104103,US,US
92394,1698944700,1698955260,10560,81070,155062,IT,IT
92056,1699474800,1699505280,30480,39044,88838,TR,TR
142931,1699631640,1699653780,22140,83784,78247,DE,CH
60657,1698984300,1699013640,29340,82705,137378,TR,TR
126432,1700154300,1700210940,56640,192465,135410,BG,RO
120618,1700414220,1700420040,5820,89138,25356,NL,NL
130424,1699427100,1699458540,31440,129880,111017,TR,TR
188019,1700439720,1700453340,13620,140735,56420,HR,HR
34601,1698871980,1698894300,22320,73109,47397,PL,PL
161545,1700219340,1700229360,10020,16912,51188,IT,IT
116492,1699685760,1699702920,17160,181008,152500,US,US
109237,1698850500,1698858180,7680,56261,138202,PT,PT
38246,1700824980,1700861280,36300,103731,95062,MX,MX
144155,1698817740,1698830280,12540,132740,96452,IT,IT
17712,1699380120,1699413420,33300,52436,155098,TR,TR
103810,1700137260,1700148840,11580,39537,147032,US,US
161841,1698955740,1698994380,38640,190385,70054,MX,MX
55663,1700277480,1700308680,31200,83718,126623,TR,TR
137686,1700306700,1700322180,15480,39608,143629,US,US
13465,1700139120,1700173860,34740,138798,197251,TR,TR
91073,1699539300,1699566780,27480,57782,93555,DE,PL
109723,1700822880,1700851980,29100,145644,36759,TR,TR
149195,1699536240,1699541100,4860,155813,150738,GB,GB
138127,1699913640,1699949160,35520,109331,25396,TR,TR
57419,1699980420,1699984020,3600,62179,9508,NL,NL
38055,1699283340,1699315920,32580,145334,78592,TR,TR
31412,1700215860,1700219460,3600,54156,150085,NL,NL
79076,1699381260,1699417020,35760,135614,32598,TR,TR
6961,1700442300,1700445900,3600,70078,111681,GB,GB
162757,1699857420,1699886400,28980,199721,106731,TR,TR
64670,1700463240,1700477700,14460,114181,90603,US,US
38793,1699927740,1699963200,35460,125209,13294,TR,TR
57720,1698981360,1698984960,3600,132492,267,NL,NL
18852,1700127300,1700142480,15180,61270,66393,AT,AT
185083,1700051460,1700058060,6600,111470,101208,GB,GB
45221,1700767200,1700779620,12420,37839,3653,US,US
157828,1700001540,1700017560,16020,95623,141716,AT,AT
176745,1700742060,1700755020,12960,73037,67864,HR,AT
99853,1699048200,1699058460,10260,146802,47106,IT,IT
125777,1700678760,1700682480,3720,153830,57276,NL,NL
24392,1700728980,1700765820,36840,36821,42451,MX,MX
35035,1700169120,1700199660,30540,123807,172481,TR,TR
160904,1698816600,1698827460,10860,51916,193305,US,US
166354,1699578540,1699590960,12420,70015,166543,HR,PL
43940,1699139700,1699165680,25980,84367,28055,RO,MD
136543,1700398500,1700433060,34560,98496,173742,TR,TR
89513,1699894560,1699927920,33360,103396,62947,TR,TR
3280,1698909360,1698945000,35640,126078,39898,TR,TR
51945,1699887420,1699905840,18420,72876,77942,DK,SE
23697,1699689840,1699697940,8100,55051,115024,PT,PT
157017,1699240500,1699254660,14160,38712,176269,IT,IT
22655,1699267140,1699274520,7380,109054,82525,IT,IT
138687,1699604640,1699640160,35520,182490,76200,TR,TR
82358,1699944120,1699955820,11700,32054,43979,US,US
138733,1699780320,1699809540,29220,162691,93243,TR,TR
196293,1699558620,1699583940,25320,54709,139331,BR,BR
196951,1700345160,1700355660,10500,8410,8692,PT,PT
107053,1700034180,1700037780,3600,64994,2559,GB,GB
116864,1699402440,1699416420,13980,27086,67752,US,US
187855,1700463660,1700489040,25380,170995,136385,PL,PL
166892,1700146200,1700153040,6840,23461,195320,NL,NL
114661,1699325460,1699337580,12120,150915,34552,IT,IT
67292,1699619460,1699630680,11220,180982,14440,US,US
41789,1699994820,1700011380,16560,112100,30764,US,US
94955,1698809700,1698845100,35400,154720,198079,TR,TR
162908,1699258560,1699278360,19800,98656,34258,FR,FR
175560,1699721280,1699774680,53400,198783,144287,BG,RS
55010,1700298120,1700303880,5760,55992,192442,NL,NL
129486,1699913100,1699916700,3600,162809,110432,GB,GB
91088,1699625220,1699658040,32820,133502,193984,TR,TR
31918,1700114160,1700147940,33780,35582,121055,TR,TR
129515,1698844980,1698874980,30000,66799,37854,TR,TR
122843,1699101900,1699140300,38400,128439,46970,MX,MX
7361,1700398020,1700430420,32400,22851,4501,TR,TR
118072,1699352700,1699385040,32340,129297,56863,TR,TR
67314,1698837840,1698869280,31440,71619,69142,TR,TR
193901,1699922700,1699954680,31980,97790,60071,TR,TR
48806,1700589180,1700595900,6720,127280,46905,GB,GB
171826,1700368200,1700394240,26040,157744,6896,HU,AT
106755,1699055340,1699088760,33420,104719,11844,TR,TR
132046,1699394760,1699399380,4620,191147,116176,EE,FI
41699,1700838780,1700842380,3600,92711,181236,GB,GB
128107,1700196480,1700200080,3600,39346,104634,GB,GB
139594,1699696020,1699699740,3720,50780,150266,NL,NL
57380,1700839800,1700875140,35340,113705,7005,TR,TR
7545,1699516620,1699544100,27480,42582,158127,RO,ES
111301,1699359900,1699389000,29100,28677,102295,TR,TR
18912,1700115720,1700148060,32340,172255,75456,TR,TR
115770,1699407060,1699435620,28560,145245,44951,RO,RO
144951,1700314080,1700339580,25500,4044,172057,DE,DE
165864,1699441080,1699456260,15180,164647,22267,FR,FR
38707,1700022780,1700057220,34440,141396,135198,TR,TR
179108,1700816520,1700845980,29460,34482,189092,TR,TR
81341,1699795080,1699814100,19020,37600,198610,FR,PL
167218,1699301520,1699332180,30660,49585,167911,TR,TR
186988,1700536980,1700570640,33660,110568,4314,TR,TR
49680,1699607400,1699625340,17940,154511,39016,AT,AT
94553,1700761980,1700796780,34800,134751,174556,TR,TR
162767,1700370720,1700380260,9540,47982,96084,IT,IT
47852,1698950880,1698984960,34080,50946,4777,TR,TR
58637,1700155200,1700191140,35940,117572,180368,TR,TR
36694,1700732940,1700756460,23520,150391,111732,DE,DE
132913,1699948620,1699982280,33660,120683,23380,TR,TR
168565,1699299420,1699330380,30960,57884,71138,TR,TR
59721,1699486980,1699494600,7620,25353,88846,IT,IT
15904,1700739900,1700754960,15060,7317,91017,US,US
88583,1698899460,1698922320,22860,27863,47511,DE,DE
185347,1699791900,1699797000,5100,32069,43514,GB,GB
18217,1700231100,1700239080,7980,151336,167318,IT,IT
179383,1699879320,1699882920,3600,14358,18487,NL,NL
145056,1699058940,1699072800,13860,76356,75953,IT,IT
177876,1699774620,1699779000,4380,121136,144584,NL,NL
161510,1700260200,1700272860,12660,83607,78413,ES,PT
171439,1699721640,1699750680,29040,144102,198167,TR,TR
34576,1700778360,1700804580,26220,176430,29260,DE,DE
127718,1699139880,1699173900,34020,154734,107552,TR,TR
50941,1699583820,1699617720,33900,39572,72165,TR,TR
38827,1700459040,1700475660,16620,147912,91581,US,US
139387,1700583600,1700590440,6840,16403,12658,GB,GB
170677,1699201020,1699235520,34500,2065,195405,TR,TR
20555,1700363280,1700376540,13260,60917,8027,HR,HR
8172,1699982100,1700016240,34140,123896,110216,TR,TR
48329,1700440140,1700473380,33240,167451,711,MX,MX
35643,1700524620,1700554200,29580,188790,193357,TR,TR
68283,1699597380,1699628220,30840,160384,37742,TR,TR
132445,1699267200,1699283460,16260,177677,195630,US,US
53549,1700492340,1700496360,4020,136200,131995,NL,NL
93212,1699504800,1699518000,13200,112960,192025,US,US
157064,1699437720,1699468380,30660,94376,10340,TR,TR
195108,1698951420,1698964800,13380,33372,115814,US,US
175589,1700632560,1700665440,32880,10185,104708,TR,TR
193518,1699893600,1699910760,17160,81094,64789,AT,NL
132425,1699750200,1699761480,11280,85842,115501,AT,AT
143341,1700684940,1700717700,32760,8830,64785,MX,MX
53507,1700819700,1700844480,24780,52679,53967,PL,PL
25790,1699484700,1699517820,33120,31496,33619,TR,TR
85263,1699686120,1699707060,20940,177168,38538,FR,FR
96017,1699899240,1699931640,32400,14566,54153,MX,MX
5285,1699364820,1699393560,28740,28224,29982,DE,AT
188395,1700863560,1700892360,28800,51822,106344,TR,TR
188667,1699092420,1699112400,19980,16883,4260,FR,FR
126794,1698866760,1698899520,32760,87648,174468,TR,TR
143175,1700165700,1700194200,28500,191234,108777,DE,DE
181750,1699152060,1699162920,10860,108984,16653,IT,IT
103970,1699335000,1699340820,5820,106458,139369,NL,NL
101559,1698856260,1698871320,15060,38047,128326,US,US
2526,1700385720,1700419140,33420,88509,131573,TR,TR
162028,1698893160,1698903300,10140,162808,31243,IT,IT
177891,1699524660,1699537380,12720,112962,11762,US,US
187798,1700657520,1700687040,29520,178892,52554,TR,TR
122667,1699797480,1699812060,14580,118693,107100,US,US
64986,1700357880,1700373060,15180,180397,185573,AT,BG
41681,1699007040,1699024680,17640,41660,94915,CZ,CZ
61428,1700004900,1700018100,13200,103220,76103,US,US
151120,1699603200,1699616940,13740,62510,87480,US,US
142386,1699287840,1699299840,12000,151406,30635,CZ,CZ
83628,1700003340,1700007060,3720,93468,185556,AD,ES
181706,1699865760,1699888140,22380,115374,113252,PL,PL
21941,1700606820,1700630100,23280,16256,26159,PL,DE
49992,1698832440,1698864300,31860,32341,103840,TR,TR
16021,1699964700,1699971900,7200,97673,177644,IT,IT
152616,1700215320,1700250300,34980,69335,53589,TR,TR
143459,1700723340,1700726940,3600,102420,65203,NL,NL
140017,1699497600,1699527000,29400,4309,40563,TR,TR
109368,1699694880,1699723740,28860,134115,118438,TR,TR
7322,1699848600,1699864740,16140,184197,20030,US,US
86826,1699052460,1699086720,34260,198973,73081,TR,TR
10969,1699926420,1699961160,34740,78022,45622,TR,TR
198690,1699649940,1699653540,3600,28479,174909,GB,GB
52606,1698909480,1698913080,3600,154401,5546,GB,GB
68258,1699741440,1699754040,12600,120719,40660,US,US
168055,1700142480,1700146080,3600,255,36544,GB,GB
140513,1700572620,1700584740,12120,87941,119435,RS,RS
28827,1699596180,1699599780,3600,57611,162087,GB,GB
195639,1699801020,1699817040,16020,153063,65526,AT,DE
160005,1699400820,1699413900,13080,41786,155894,US,US
124019,1699033620,1699065660,32040,63431,151112,TR,TR
18438,1698848880,1698855540,6660,111492,87129,NL,NL
177440,1699962420,1699974900,12480,5950,64511,HR,RS
50788,1699999620,1700014860,15240,116661,2522,US,MX
96110,1699167540,1699186200,18660,55531,57172,FR,BE
22773,1699624500,1699657980,33480,94101,43515,TR,TR
22460,1698916980,1698951060,34080,164456,184790,TR,TR
86871,1699155180,1699158780,3600,22911,166241,NL,NL
77779,1699063560,1699094400,30840,16547,186439,TR,TR
188793,1700839740,1700857500,17760,90647,114361,US,US
69194,1700193660,1700203020,9360,120151,144801,PT,PT
194886,1699606560,1699611600,5040,78709,151486,GB,GB
61839,1699532640,1699561560,28920,108828,82298,TR,TR
102389,1699715340,1699726140,10800,113050,173335,IT,IT
143450,1700473680,1700485980,12300,55480,27757,US,US
54049,1700196480,1700229960,33480,173179,90112,TR,TR
60935,1700016780,1700048460,31680,62123,131635,TR,TR
171036,1699718820,1699743660,24840,82148,127210,CH,BE
6802,1699239900,1699253100,13200,8262,151217,US,US
198548,1699281900,1699302480,20580,122127,155657,FR,CZ
26842,1699101720,1699117920,16200,131438,186172,US,US
147452,1699188300,1699218540,30240,114408,156157,TR,TR
83920,1700289540,1700300280,10740,26623,144045,IT,IT
89643,1700820900,1700844660,23760,108296,109217,DE,FR
47215,1700227320,1700232120,4800,54300,192844,NL,NL
127986,1700790720,1700824620,33900,196860,77227,TR,TR
12381,1700572980,1700580900,7920,82994,168240,IT,IT
27789,1698935400,1698949380,13980,32638,63152,US,US
28869,1700140260,1700151480,11220,84233,68050,US,US
193660,1699021320,1699054080,32760,43234,77054,MX,MX
105972,1700282160,1700298000,15840,61044,45323,US,US
31651,1700365740,1700374800,9060,67623,149513,HR,HR
10172,1699143840,1699172880,29040,36083,128669,TR,TR
76765,1700549100,1700562360,13260,1592,130842,AT,CZ
101300,1700003280,1700017200,13920,123102,53544,US,US
126914,1699225800,1699241100,15300,27253,123111,RS,RS
55329,1699692420,1699696020,3600,66848,98578,GB,GB
168564,1699000740,1699018440,17700,86738,84618,FR,FR
83833,1700580600,1700615520,34920,74058,189169,TR,TR
169339,1698840960,1698851280,10320,19619,166542,HR,HR
99333,1700141700,1700148420,6720,112955,167701,AD,ES
115685,1700435580,1700448900,13320,148519,194688,HR,BA
51280,1699514220,1699534200,19980,88320,82081,FR,FR
6227,1700437860,1700446200,8340,129243,53949,HR,HR
166687,1699526640,1699562580,35940,40589,109364,MX,MX
39747,1700160660,1700196360,35700,152040,45902,TR,TR
32375,1699855500,1699861980,6480,51496,181216,NL,NL
112628,1700193720,1700206020,12300,48322,11130,HR,DE
79641,1699479060,1699490340,11280,96596,66099,IT,FR
176514,1700663700,1700672460,8760,11728,130332,IT,CH
59222,1699194360,1699226820,32460,34214,181119,TR,TR
64755,1699095000,1699122840,27840,103057,71426,DE,BG
155165,1699776720,1699805820,29100,66110,91432,TR,TR
109864,1700662860,1700697960,35100,78645,7404,TR,TR
61289,1700474280,1700504700,30420,189914,155133,TR,TR
139890,1700599500,1700638500,39000,11743,20750,MX,MX
83917,1700813100,1700825280,12180,105103,192403,US,US
126112,1700024040,1700053860,29820,26842,175404,TR,TR
133246,1700558460,1700575860,17400,112298,140373,US,US
45493,1700025360,1700041380,16020,141549,149173,US,US
36397,1699881480,1699911240,29760,15204,181308,BA,DE
56815,1699536900,1699552860,15960,99921,63966,AT,AT
113125,1699151280,1699185060,33780,69498,63426,TR,TR
174572,1700213280,1700221740,8460,136345,185070,IT,IT
97667,1700836080,1700865000,28920,66860,108089,TR,TR
78053,1700613480,1700624640,11160,86504,110130,IT,IT
152962,1700430000,1700444040,14040,173803,10069,US,US
137705,1699381140,1699413300,32160,126469,184153,TR,TR
188620,1700435100,1700441940,6840,129808,103510,GB,GB
194838,1700449920,1700460600,10680,189113,157856,IT,IT
185991,1699220280,1699255800,35520,56371,68333,TR,TR
178380,1699564440,1699597380,32940,3386,100669,TR,TR
160874,1699729080,1699732680,3600,139112,98671,GB,GB
94608,1700080200,1700106540,26340,13136,155969,BR,BR
96697,1700172420,1700188740,16320,116519,189448,US,US
92851,1699694520,1699729500,34980,48050,135174,TR,TR
156150,1698887100,1698921240,34140,75578,32859,TR,TR
152429,1698889620,1698922140,32520,68120,173878,TR,TR
87464,1700470800,1700502840,32040,187783,7663,TR,TR
10945,1700353440,1700385480,32040,93393,159210,TR,TR
184589,1699000020,1699029180,29160,86129,162306,TR,TR
131688,1698995760,1699003740,7980,51194,190187,PT,PT
110192,1699650420,1699672080,21660,186724,101952,RO,MD
151387,1699286580,1699315380,28800,167751,9579,TR,TR
25367,1700656620,1700668140,11520,187500,145112,IT,IT
125531,1698910500,1698914100,3600,86488,80795,GB,GB
91257,1698939420,1698959340,19920,119329,194279,IN,IN
43480,1700760300,1700778180,17880,107524,48225,FR,FR
4503,1700275620,1700279220,3600,164003,647,NL,NL
134460,1699455480,1699466580,11100,22044,173173,AT,SK
164265,1698846300,1698860220,13920,98211,77335,AT,AT
186440,1700747880,1700758980,11100,67096,119581,ES,ES
147345,1699294080,1699327080,33000,99109,105152,TR,TR
10067,1699515720,1699527120,11400,6434,117730,HR,HR
74663,1699008060,1699014120,6060,71591,64104,NL,NL
161729,1700073120,1700107200,34080,40888,52444,TR,TR
76994,1699066200,1699101060,34860,68421,90707,TR,TR
158722,1699541100,1699544700,3600,188431,15433,GB,GB
61425,1699550040,1699553640,3600,93853,181229,GB,GB
54604,1700614440,1700649480,35040,172526,69187,TR,TR
132723,1698875820,1698883320,7500,77642,191847,PT,PT
66214,1699740780,1699776720,35940,142746,17066,TR,TR
66704,1698824340,1698848940,24600,78933,19964,DE,HU
122987,1700163360,1700179140,15780,76840,30593,FR,BE
57639,1700086500,1700099040,12540,124896,86138,US,US
166893,1698830280,1698860520,30240,34003,31972,TR,TR
67259,1700595480,1700628480,33000,91237,87718,TR,TR
197372,1699065660,1699100640,34980,171271,16098,TR,TR
175753,1699597020,1699608600,11580,55106,37622,ES,ES
167311,1700326440,1700345160,18720,88947,90007,FR,ES
127935,1700123340,1700156460,33120,18463,125224,TR,TR
12511,1699996080,1700001240,5160,57962,152648,GB,GB
111647,1699084980,1699114260,29280,162781,195730,TR,TR
104363,1699296960,1699309440,12480,102711,166991,US,US
62811,1699091580,1699106940,15360,70278,87198,CA,US
31279,1700512440,1700518680,6240,61118,73616,GB,GB
181500,1699606020,1699617300,11280,106715,62885,RS,RS
129685,1700267460,1700278020,10560,152440,107077,IT,IT
31996,1699614240,1699647000,32760,131257,42865,TR,TR
31977,1698840180,1698861600,21420,195892,143488,SE,DE
180296,1699540620,1699545060,4440,188501,35657,GB,GB
84122,1698893340,1698922380,29040,75935,34918,TR,TR
81567,1700288580,1700317680,29100,28751,13490,TR,TR
21717,1699981680,1699998600,16920,56732,197852,US,US
161253,1700832180,1700835780,3600,84228,127497,GB,GB
10961,1699645740,1699675320,29580,176134,45651,TR,TR
29736,1699612140,1699641720,29580,77966,31400,TR,TR
195277,1700173740,1700202720,28980,188626,156494,TR,TR
114176,1700426340,1700460480,34140,57310,82983,TR,TR
117833,1699867560,1699882680,15120,46357,46749,US,US
43989,1700125440,1700139780,14340,123797,175825,IT,IT
122270,1699091700,1699120020,28320,121432,148030,DE,DE
194452,1700584080,1700613540,29460,24371,174107,TR,TR
161273,1699563660,1699582620,18960,41014,151312,FR,FR
191668,1699930080,1699949160,19080,149577,128964,FR,ES
160309,1699977240,1700009220,31980,6479,37365,TR,TR
41618,1700004300,1700036400,32100,168243,154117,TR,TR
108775,1699892340,1699895940,3600,79804,156837,GB,GB
41955,1699127520,1699138140,10620,68704,33241,IT,IT
193609,1699380660,1699400280,19620,113606,180612,FR,FR
175958,1700356800,1700376180,19380,159902,84057,FR,FR
158635,1700077920,1700107440,29520,117899,58122,TR,TR
162374,1698913860,1698917460,3600,151519,137062,GB,GB
76103,1700600520,1700620380,19860,104748,23562,BE,NL
123987,1699416840,1699452660,35820,130343,75158,TR,TR
133648,1698976980,1699002240,25260,4436,198464,BR,BR
50086,1699250400,1699269540,19140,96137,86573,FR,FR
70859,1700311440,1700336760,25320,60788,117556,PL,PL
100146,1699049820,1699081860,32040,33909,106184,TR,TR
6169,1700823060,1700851560,28500,15488,62884,BR,BR
28848,1700766660,1700795580,28920,48121,109046,TR,TR
37871,1700359440,1700389260,29820,139513,37286,TR,TR
187391,1699238040,1699265760,27720,180752,27398,BR,BR
134881,1698867120,1698870720,3600,83764,32357,GB,GB
197603,1698829380,1698845220,15840,120749,2499,FR,FR
59125,1700525160,1700528760,3600,66045,133526,GB,GB
46050,1699519740,1699524960,5220,19847,173996,NL,CZ
174015,1700378580,1700416200,37620,84139,13917,MX,MX
49432,1699028640,1699032240,3600,85363,15299,NL,NL
108621,1699197060,1699226580,29520,171949,126539,TR,TR
158372,1698809340,1698821820,12480,30607,55340,IT,HR
84591,1698823680,1698838380,14700,139466,175611,FR,IT
85244,1700771640,1700802780,31140,36255,70639,TR,TR
70054,1698958980,1698991620,32640,70546,72550,TR,TR
4557,1700739120,1700755200,16080,149757,78872,FR,FR
132324,1699362540,1699366140,3600,196636,138111,NL,NL
152326,1699150680,1699184580,33900,133524,86779,TR,TR
140784,1700808720,1700838780,30060,34404,128107,TR,TR
39152,1699907700,1699916820,9120,129730,56297,IT,IT
95062,1700067420,1700080560,13140,108794,139955,HR,HR
187253,1699265940,1699293720,27780,28117,181160,DE,SE
188888,1700282940,1700318640,35700,135099,67422,TR,TR
142343,1700713020,1700745480,32460,135636,14550,TR,TR
165344,1699649820,1699681920,32100,135166,185530,TR,TR
20113,1700257560,1700278320,20760,52619,167026,BE,FR
45,1700732160,1700758260,26100,147422,41252,DE,DE
148487,1698886800,1698922740,35940,56167,116495,TR,TR
140618,1698961020,1699000020,39000,137638,56362,MX,MX
131214,1700549460,1700562600,13140,100460,57285,SK,AT
112119,1699365360,1699372740,7380,115270,104470,IT,IT
152980,1699660500,1699696260,35760,169587,102871,TR,TR
124349,1700823600,1700832240,8640,160376,62157,IT,IT
41031,1699023180,1699054260,31080,137374,184601,TR,TR
190707,1700815620,1700851560,35940,150902,61888,TR,TR
161569,1698915600,1698947820,32220,98797,85827,TR,TR
70686,1699802460,1699806060,3600,110714,36059,GB,GB
17221,1698921660,1698933180,11520,119146,41493,IT,IT
107674,1699746480,1699778220,31740,172758,197928,TR,TR
131142,1700109300,1700123460,14160,161604,135609,HR,ME
190645,1700207760,1700211900,4140,179674,171829,GB,GB
171406,1700776800,1700804520,27720,166064,44785,BR,BR
97391,1699841880,1699873500,31620,130294,138575,TR,TR
60645,1699359600,1699393080,33480,71251,167271,TR,TR
150454,1700809260,1700819820,10560,20627,53496,IT,IT
58155,1700276280,1700311680,35400,112854,132917,TR,TR
93434,1700144760,1700179020,34260,118347,180296,TR,TR
106546,1700462880,1700468760,5880,22807,66101,GB,GB
183189,1700660400,1700673480,13080,93415,117812,SK,SK
12998,1698844860,1698879240,34380,179360,143088,TR,TR
179737,1700577600,1700602920,25320,80970,77870,DE,PL
176271,1699542600,1699550760,8160,191517,141128,ES,ES
140602,1699115580,1699125300,9720,123013,106623,IT,IT
137916,1700295360,1700300160,4800,120094,144731,GB,GB
80210,1700029620,1700061240,31620,93143,9043,TR,TR
124774,1698990660,1698999360,8700,147580,160490,PT,PT
100224,1700071020,1700078040,7020,132497,57638,GB,GB
78175,1699100220,1699129800,29580,108390,154279,TR,TR
3335,1699749540,1699783380,33840,97102,68504,TR,TR
28181,1700127180,1700141400,14220,7623,179133,HR,HR
108630,1699007040,1699018500,11460,101626,28233,ES,ES
147863,1699645920,1699660800,14880,93105,133895,US,US
192534,1700280120,1700288880,8760,173379,179616,AD,ES
171117,1700534700,1700591580,56880,190004,148664,UA,PL
80882,1700773680,1700807880,34200,52225,137509,TR,TR
95803,1700002260,1700028000,25740,96255,161847,RO,RO
190730,1699829040,1699841880,12840,77377,7519,IT,IT
166087,1700848440,1700853600,5160,40722,145601,GB,GB
110465,1700209860,1700232840,22980,109450,69855,BR,BR
4110,1698836580,1698870120,33540,32297,64515,TR,TR
198888,1698849600,1698885000,35400,74538,133913,TR,TR
9110,1700453340,1700484420,31080,91022,158569,TR,TR
141557,1699041540,1699075140,33600,17729,51892,TR,TR
192605,1700023260,1700026860,3600,134241,197576,GB,GB
65567,1699702980,1699713000,10020,1628,40553,IT,IT
183327,1700156700,1700160300,3600,67010,132724,NL,NL
196540,1699430340,1699446360,16020,97022,93569,US,US
164577,1698858180,1698893760,35580,148548,77999,TR,TR
15201,1699886460,1699893360,6900,158379,156171,NL,NL
140020,1698852180,1698870180,18000,150315,64241,FR,GB
119266,1699412220,1699423320,11100,24076,94354,IT,IT
175628,1700545560,1700558280,12720,85340,73517,PT,PT
155574,1700336700,1700346540,9840,127679,177772,IT,IT
149423,1699634520,1699669920,35400,6342,120846,TR,TR
185176,1700214300,1700248920,34620,42746,73674,TR,TR
51452,1700422080,1700454060,31980,147693,155840,TR,TR
159020,1699510560,1699540140,29580,138494,52505,TR,TR
131071,1700613180,1700638860,25680,79548,185880,DE,BG
45733,1700460420,1700477220,16800,83695,95363,AT,BG
105052,1699058640,1699091220,32580,37552,44612,TR,TR
50873,1699302960,1699315860,12900,130268,78319,US,US
144098,1700561760,1700578560,16800,156112,109303,SE,SE
88089,1700740140,1700746200,6060,187260,143026,FI,EE
68895,1699290060,1699295940,5880,80457,21101,GB,GB
170244,1699110780,1699122660,11880,47531,15224,HR,HR
737,1700193780,1700200680,6900,81226,168397,NL,NL
118444,1699988220,1700023800,35580,67194,43883,TR,TR
196865,1699411680,1699445340,33660,96626,60959,TR,TR
161439,1700658960,1700696640,37680,55375,111410,MX,MX
185188,1700099520,1700129460,29940,198318,86288,TR,TR
119789,1700815200,1700823120,7920,166579,53344,PT,PT
145302,1700865360,1700895660,30300,97426,59889,TR,TR
103150,1698957840,1698965100,7260,192125,192033,IT,IT
198348,1700828340,1700844600,16260,101393,44751,AT,BG
5943,1700534580,1700565720,31140,189054,12035,TR,TR
55068,1699653480,1699676460,22980,16577,9945,DE,DE
161282,1699490880,1699520520,29640,84076,28127,TR,TR
131567,1699497180,1699503060,5880,188352,186004,GB,GB
126709,1698909180,1698920520,11340,47122,11678,US,US
83492,1700027220,1700044800,17580,67071,9865,US,US
196211,1698805500,1698829380,23880,1671,60169,DK,DK
168234,1699466580,1699500120,33540,5195,120100,TR,TR
74064,1700292180,1700299140,6960,73313,40237,GB,GB
3545,1699022340,1699055520,33180,172873,59125,TR,TR
110655,1699446360,1699458000,11640,181537,154589,AT,CZ
28064,1700314140,1700317740,3600,67467,16615,GB,GB
198458,1699860600,1699871940,11340,70475,153084,US,US
96763,1700804580,1700809500,4920,106694,192328,GB,GB
117085,1700562180,1700565780,3600,197467,62779,GB,GB
181823,1699217520,1699249140,31620,16375,121556,TR,TR
65686,1698811500,1698826260,14760,79601,187771,US,US
186082,1698888180,1698901980,13800,82700,69230,US,US
111195,1699545660,1699581540,35880,86088,150833,TR,TR
17120,1699071720,1699100100,28380,66679,10125,HU,DE
13818,1700710020,1700726400,16380,61812,28640,US,US
62575,1700579460,1700591940,12480,106096,92776,CZ,CZ
136155,1699817940,1699832160,14220,179841,136458,US,CA
171489,1699290840,1699299600,8760,62933,190839,HR,RS
101379,1700107740,1700141340,33600,146,189529,TR,TR
74196,1700537280,1700543340,6060,173013,7088,NL,NL
124086,1700349480,1700385300,35820,44854,99642,TR,TR
177727,1699250460,1699263420,12960,138220,29911,US,MX
140282,1700006100,1700034420,28320,36263,5520,DE,FR
83488,1698801600,1698807420,5820,117219,99698,GB,GB
115641,1700461320,1700466540,5220,125562,164356,GB,GB
135519,1700240940,1700271060,30120,197248,117961,TR,TR
17750,1699057440,1699070100,12660,66256,95252,IT,IT
126533,1700481960,1700485560,3600,74988,39553,NL,NL
98786,1700151480,1700162820,11340,171530,182219,IT,IT
128378,1699621800,1699650960,29160,35528,147803,TR,TR
85975,1699108680,1699130520,21840,25065,188628,PL,FI
80427,1700714220,1700725680,11460,199704,91608,PT,PT
26746,1699415460,1699419060,3600,180260,27313,GB,GB
167758,1700850900,1700885940,35040,196616,153990,TR,TR
93640,1699632600,1699662780,30180,33242,142617,TR,TR
80230,1699112580,1699144080,31500,39820,154257,TR,TR
146167,1698988440,1698999600,11160,73169,180338,PT,PT
81476,1700795100,1700829120,34020,117072,94938,TR,TR
41221,1700837460,1700863260,25800,167912,135036,BA,BA
121989,1700797620,1700830200,32580,79113,179969,TR,TR
116004,1700083380,1700115600,32220,96768,127302,TR,TR
98912,1698914640,1698940080,25440,74384,57118,PL,PL
167147,1699180140,1699209000,28860,52023,105919,TR,TR
195123,1700194260,1700209260,15000,138804,169944,US,US
91713,1699118460,1699149720,31260,17160,158792,TR,TR
196825,1699604640,1699627560,22920,178292,61276,RO,MD
47100,1698885900,1698918060,32160,177146,189890,TR,TR
107722,1700786760,1700814660,27900,183934,141589,RO,MD
101613,1700460780,1700474220,13440,69578,14632,IT,IT
105999,1700627820,1700633160,5340,49649,186758,GB,GB
55577,1699473060,1699485900,12840,141228,8000,US,US
137018,1700736900,1700770260,33360,151282,152923,TR,TR
166745,1699759860,1699770900,11040,112856,18531,US,US
199743,1699945980,1699978200,32220,182140,141783,TR,TR
180510,1699440060,1699447380,7320,119650,72543,IT,IT
5618,1698815280,1698835140,19860,91322,49986,FR,FR
168030,1700341680,1700371260,29580,1534,40166,TR,TR
57193,1699681080,1699715100,34020,29462,126804,TR,TR
6329,1699793460,1699814520,21060,169619,154018,AL,MK
20399,1700301060,1700304660,3600,79855,43473,GB,GB
104686,1700357460,1700391840,34380,143701,84462,TR,TR
126297,1699524780,1699528380,3600,147511,159959,GB,GB
75258,1699382940,1699415700,32760,133691,43077,TR,TR
20144,1700773680,1700805900,32220,80064,90654,TR,TR
25894,1699945500,1699954200,8700,195311,45778,PT,PT
149020,1698980640,1698993720,13080,185718,122531,AT,NL
75764,1700401140,1700431380,30240,30015,121506,TR,TR
91014,1700228400,1700266140,37740,155025,198346,MX,MX
123392,1699822860,1699836240,13380,11565,157421,HR,HR
116907,1699212180,1699225620,13440,102342,37254,US,US
54048,1700829780,1700835600,5820,97330,5829,GB,GB
179813,1700527440,1700558040,30600,153780,125348,TR,TR
19803,1699849440,1699856340,6900,36952,64372,NL,NL
80740,1699732500,1699744440,11940,158392,128978,US,US
73373,1700838300,1700849040,10740,7667,56732,IT,IT
96653,1699570140,1699600320,30180,180252,85826,TR,TR
31068,1699858320,1699861920,3600,23565,81122,NL,NL
166731,1700224740,1700255940,31200,148329,175271,TR,TR
148318,1698965520,1699000440,34920,158933,155824,TR,TR
149635,1700085300,1700103900,18600,167127,155332,FR,FR
32434,1699210320,1699224360,14040,59701,79806,US,US
112412,1700700480,1700733900,33420,195755,9481,TR,TR
87310,1699836240,1699868400,32160,112606,1102,TR,TR
86492,1699425600,1699456320,30720,156118,29131,TR,TR
145486,1698949440,1698984120,34680,42604,11496,TR,TR
52534,1700013540,1700017140,3600,165928,159781,GB,GB
78777,1699175880,1699211820,35940,197135,160804,TR,TR
36126,1699321860,1699351140,29280,130412,23724,TR,TR
26000,1699044780,1699071840,27060,78045,131180,BR,BR
98644,1698924420,1698932280,7860,161423,6391,CL,CL
179094,1700832660,1700846760,14100,174693,54139,US,US
29175,1699377840,1699386000,8160,129146,87823,IT,IT
48537,1700750220,1700762940,12720,178540,179122,US,US
87197,1699464480,1699490280,25800,122045,16756,RO,RO
77737,1700568780,1700572380,3600,47619,62949,GB,GB
150106,1700848320,1700866020,17700,194403,166482,FR,FR
28332,1700330220,1700344500,14280,12996,108791,US,US
88473,1699520640,1699524240,3600,20337,81699,GB,GB
1319,1700664720,1700676180,11460,60095,75331,US,US
74868,1699005360,1699039140,33780,165564,112843,TR,TR
25340,1699450260,1699473900,23640,91210,120780,PL,HU
59026,1700732580,1700749320,16740,112419,81408,US,US
6460,1699596060,1699609500,13440,168815,187731,US,MX
103430,1699909980,1699945920,35940,75304,195809,TR,TR
34141,1699147020,1699178940,31920,32036,148275,TR,TR
46633,1699226040,1699261500,35460,179565,199653,TR,TR
171282,1699990680,1700023920,33240,91628,26918,TR,TR
9142,1699488540,1699512780,24240,156110,162386,DK,DK
76249,1699683840,1699701540,17700,156182,74378,US,US
121876,1699836300,1699848180,11880,68335,185651,US,US
133941,1699019100,1699049460,30360,14064,133085,TR,TR
58249,1698921240,1698939780,18540,81460,8411,FR,FR
169747,1700851860,1700869440,17580,102087,126614,US,US
141057,1699780020,1699817640,37620,96964,143626,MX,MX
58454,1700066160,1700100000,33840,158835,174300,TR,TR
165835,1700646120,1700676720,30600,187123,1036,TR,TR
77807,1700139000,1700155380,16380,13663,8794,RS,RS
93587,1700160900,1700169360,8460,134341,184854,ES,ES
165132,1700682900,1700686500,3600,162269,62323,NL,NL
197252,1700110500,1700138580,28080,178400,184366,DE,NL
193825,1700745600,1700774460,28860,37483,135933,TR,TR
107014,1699323060,1699332300,9240,57142,7517,IT,IT
76274,1700338200,1700346480,8280,24178,47312,IT,IT
163745,1699126020,1699161120,35100,165224,89102,TR,TR
146130,1700526420,1700534760,8340,77068,194423,IT,FR
7973,1700373240,1700392980,19740,77807,54421,FR,FR
147433,1699531020,1699555260,24240,197685,59668,DE,DE
139173,1700684040,1700699460,15420,101030,38439,US,US
123826,1699467840,1699503060,35220,7010,3953,TR,TR
125393,1699730280,1699742760,12480,128083,20758,PT,PT
28602,1698820800,1698828000,7200,54573,71676,IT,IT
162503,1700388480,1700394060,5580,50953,38204,NL,NL
37127,1699990740,1700004720,13980,196788,144960,US,US
123185,1699180500,1699187520,7020,39348,112211,GB,GB
180560,1700195160,1700199660,4500,109905,90778,NL,NL
72102,1700294760,1700311680,16920,134897,8634,US,US
121483,1700595780,1700632680,36900,154187,164842,MX,MX
54433,1699393860,1699408020,14160,34306,119988,US,US
192659,1699295220,1699312740,17520,65953,145389,US,US
9980,1699132140,1699164000,31860,100101,123468,TR,TR
96636,1700527200,1700540820,13620,190901,63972,US,US
126597,1699459440,1699471320,11880,95305,148688,HR,HR
99263,1700015460,1700031300,15840,145435,111081,US,US
65960,1699580760,1699610460,29700,191991,63942,TR,TR
127340,1699897020,1699900620,3600,74052,39723,GB,GB
22468,1699718100,1699721700,3600,13734,174423,GB,GB
130036,1700164140,1700202480,38340,111074,79529,MX,MX
145311,1698963540,1698967140,3600,149223,162540,GB,GB
34641,1699323720,1699329780,6060,99518,181811,GB,GB
73592,1700174400,1700206800,32400,15597,15117,TR,TR
99614,1700705400,1700714400,9000,82033,73765,IT,IT
193482,1700169480,1700173800,4320,126897,120869,NL,NL
123937,1698947640,1698960600,12960,35996,67280,US,US
19264,1700741340,1700776740,35400,179514,183056,TR,TR
156970,1699816980,1699852740,35760,125697,165056,TR,TR
170081,1699598040,1699610700,12660,68796,131611,IT,IT
165755,1700089560,1700143860,54300,195643,31640,UA,PL
101472,1700111580,1700124960,13380,66459,119809,IT,IT
112108,1698883440,1698894660,11220,188856,97564,HR,HR
39440,1700690340,1700693940,3600,33581,86258,GB,GB
124204,1699930560,1699958700,28140,68574,339,DE,BG
65370,1699326420,1699345620,19200,80169,5778,BE,FR
165810,1699025640,1699035720,10080,196840,22070,IT,IT
128653,1700162280,1700179440,17160,88372,20498,CZ,PL
100202,1700330760,1700334360,3600,142586,123898,NL,NL
197662,1698904740,1698940680,35940,88704,27331,TR,TR
121435,1699291140,1699321320,30180,120589,54902,TR,TR
194483,1700011500,1700015100,3600,30691,27563,GB,GB
26650,1699902300,1699930560,28260,16956,103870,DE,PL
176758,1699170840,1699187040,16200,70480,159799,US,US
134157,1700439900,1700454240,14340,36050,177402,US,US
195608,1700658660,1700662260,3600,27741,34586,GB,GB
190931,1699305660,1699336620,30960,79173,6308,TR,TR
66723,1700188860,1700193420,4560,188428,80757,NL,NL
134713,1700628540,1700654940,26400,50239,107141,PL,HU
182166,1699303740,1699315260,11520,122705,126164,RS,RS
96263,1700140020,1700143620,3600,102905,166160,GB,GB
30327,1698822360,1698837540,15180,76416,40142,FR,DE
15432,1700487900,1700523480,35580,133008,50120,TR,TR
167772,1699074660,1699094100,19440,165732,61736,FR,FR
191765,1699009260,1699021680,12420,111467,110205,IT,HU
81654,1700169060,1700181840,12780,168097,102491,HR,HR
199038,1700285700,1700302980,17280,172685,11379,US,US
110769,1699830120,1699862580,32460,125813,124130,TR,TR
14091,1700383500,1700387100,3600,34518,80446,NL,NL
98566,1700561760,1700593560,31800,179384,128689,TR,TR
5405,1699989780,1700021880,32100,84173,13497,TR,TR
20939,1700729760,1700761860,32100,189442,96965,TR,TR
166905,1699418460,1699434420,15960,166916,143469,CA,CA
161596,1699745580,1699778940,33360,164678,50717,TR,TR
120532,1698975300,1699006380,31080,122350,7725,TR,TR
83573,1699780140,1699814100,33960,140399,111647,TR,TR
113755,1700380260,1700412600,32340,190213,146461,TR,TR
128290,1699236360,1699269600,33240,53946,80223,TR,TR
44640,1698953700,1698972660,18960,116510,184757,FR,FR
67298,1699551720,1699566900,15180,188593,28738,SE,DE
102316,1700537220,1700545440,8220,109627,19244,IT,IT
172414,1699402680,1699406280,3600,73387,174549,GB,GB
131378,1699492500,1699504200,11700,76172,114764,IT,HU
41797,1699263780,1699297620,33840,120643,153126,TR,TR
110572,1699978380,1699981980,3600,188544,77456,GB,GB
165783,1699648080,1699653300,5220,61008,187257,NL,NL
56236,1700539320,1700553780,14460,150435,148304,US,US
160955,1699417320,1699420920,3600,150276,164103,GB,GB
165405,1700704560,1700738820,34260,41861,63177,TR,TR
54414,1700402820,1700413800,10980,10362,192422,IT,FR
29058,1700725140,1700750520,25380,8918,63625,PL,PL
100006,1699908420,1699919880,11460,105283,161415,AT,DE
5747,1699590480,1699604280,13800,107609,21103,IT,IT
23011,1698865200,1698876240,11040,155406,150842,ES,FR
132507,1700705880,1700730060,24180,46402,65021,PL,HU
46380,1699451220,1699457400,6180,58523,111832,GB,GB
178506,1699571220,1699606320,35100,42096,75514,TR,TR
72804,1699251660,1699264140,12480,182133,1348,IT,MK
30362,1699695420,1699707600,12180,97899,36679,AT,AT
123692,1699513920,1699527960,14040,133256,17891,IT,IT
25066,1699998540,1700029200,30660,42313,130828,TR,TR
82810,1700643180,1700646780,3600,186684,143066,NL,NL
25446,1700417760,1700427960,10200,24669,615,IT,IT
2303,1699851900,1699862220,10320,74791,117528,IT,IT
10846,1700517840,1700532120,14280,36537,115188,RS,SI
196704,1698821700,1698825300,3600,50662,111810,NL,NL
30663,1700596320,1700599920,3600,191428,197275,GB,GB
162680,1699808340,1699819440,11100,185759,183336,IT,IT
82990,1699347960,1699378800,30840,42928,107701,TR,TR
12276,1699995360,1700022000,26640,103716,49809,DE,RS
171325,1699795620,1699806540,10920,78879,179061,HR,HR
11293,1699603200,1699635600,32400,170618,193914,TR,TR
61412,1700406360,1700419200,12840,193338,152569,AT,AT
51474,1699496520,1699527240,30720,27000,171640,TR,TR
8341,1700679600,1700693280,13680,143668,152683,IT,IT
22513,1699403400,1699436700,33300,184676,17286,TR,TR
157207,1699515720,1699551000,35280,140933,118287,TR,TR
108891,1699396320,1699402320,6000,145762,116393,NL,NL
82861,1698979380,1699013700,34320,59690,129213,TR,TR
7115,1699616640,1699632120,15480,6868,151479,US,MX
151815,1699218720,1699236120,17400,169778,9493,US,US
108452,1699892700,1699921500,28800,66608,193457,TR,TR
87978,1700331780,1700339940,8160,117818,110313,IT,IT
19248,1699164540,1699168140,3600,88920,143802,NL,NL
31264,1698989760,1699004700,14940,94160,195833,US,US
61093,1700682660,1700688180,5520,20354,102064,GB,GB
196829,1699930380,1699941060,10680,110161,135777,IT,IT
63933,1700293860,1700327940,34080,63791,32053,TR,TR
15462,1700693520,1700697120,3600,74094,37744,NL,NL
19520,1698876180,1698880500,4320,87566,31889,GB,GB
31269,1699442700,1699459500,16800,100477,138948,US,US
158936,1699833180,1699838040,4860,178094,123147,GB,GB
83861,1700260380,1700289360,28980,69036,166719,TR,TR
17001,1699332660,1699347900,15240,55642,96916,CZ,CZ
47888,1700865960,1700895780,29820,197166,23134,TR,TR
108401,1700192460,1700207340,14880,9510,52817,RS,DE
96282,1699010520,1699016280,5760,15711,148751,GB,GB
48614,1699090620,1699101900,11280,28098,36645,CA,US
150457,1699943280,1699976640,33360,185854,10820,TR,TR
34987,1698829380,1698835020,5640,101754,163820,NL,NL
79600,1699309920,1699339860,29940,59728,198731,TR,TR
197052,1700701620,1700705220,3600,192483,103611,GB,GB
25961,1700763900,1700767500,3600,140513,110466,NL,NL
85075,1700351760,1700382000,30240,76384,103886,TR,TR
52368,1699563060,1699574340,11280,155635,68136,IT,IT
81269,1700834880,1700868180,33300,118793,72664,TR,TR
131895,1698832260,1698846540,14280,191848,29202,RS,RS
43720,1699184460,1699219500,35040,87302,167839,MX,MX
115855,1700086860,1700100540,13680,43175,822,ES,ES
124834,1699550640,1699564080,13440,52975,91238,US,US
152934,1699312140,1699329660,17520,128471,185617,US,US
182726,1700284740,1700288340,3600,145336,53156,GB,GB
171186,1698963060,1698997140,34080,32613,25179,TR,TR
182450,1700080860,1700091540,10680,187779,153029,HR,HR
60693,1699682580,1699713900,31320,109607,166677,TR,TR
78614,1699476900,1699510080,33180,95644,31543,TR,TR
45728,1700055900,1700065380,9480,85299,32258,IT,IT
56022,1699784460,1699806000,21540,144588,133394,BE,FR
57930,1698934500,1698965820,31320,36845,94752,TR,TR
161996,1699774200,1699778640,4440,54469,134844,GB,GB
74026,1699877340,1699899600,22260,70184,86556,DE,DE
9296,1699101180,1699104780,3600,91313,181950,NL,BE
174069,1699731720,1699743600,11880,21180,184345,US,US
88120,1700592120,1700626980,34860,172525,69790,TR,TR
161082,1699881000,1699892520,11520,34011,174880,US,US
49348,1700066940,1700095980,29040,127276,142421,TR,TR
148881,1700013180,1700029920,16740,182888,144670,FR,FR
150767,1699631100,1699636920,5820,178194,102834,AD,ES
121152,1698955080,1698962520,7440,65193,5522,IT,IT
117515,1699109160,1699140900,31740,12492,116902,TR,TR
98961,1700188380,1700218320,29940,89135,138781,TR,TR
119618,1699921620,1699940220,18600,65049,150271,FR,FR
162780,1699830360,1699860660,30300,65683,190827,TR,TR
119044,1699003020,1699017360,14340,109741,171598,US,US
156078,1699645560,1699678200,32640,125126,9821,TR,TR
12912,1700170440,1700186820,16380,160655,151291,CA,US
34553,1699873080,1699908180,35100,85446,80026,TR,TR
196658,1698806160,1698819840,13680,19811,33325,IT,IT
1293,1699137960,1699153080,15120,145362,44177,US,US
100948,1699371660,1699385520,13860,26709,179742,HR,HR
75574,1699727880,1699741440,13560,145952,21877,US,US
113124,1700743140,1700752140,9000,38614,23954,ES,ES
87730,1700542860,1700556240,13380,168184,54515,IT,IT
177885,1698826080,1698839520,13440,140249,54887,US,US
168500,1700475360,1700488740,13380,5642,106549,IT,IT
41588,1699417620,1699424400,6780,156795,22794,GB,GB
110812,1700262300,1700265900,3600,155130,47589,GB,GB
58989,1699763880,1699768740,4860,27948,52813,GB,GB
193529,1698938820,1698966420,27600,15904,175525,DE,PL
148437,1699147020,1699158540,11520,199598,147242,US,US
93684,1700242620,1700246220,3600,32088,185229,NL,NL
55249,1700655240,1700667600,12360,168697,29154,IT,IT
135984,1699889040,1699894800,5760,51644,23440,GB,GB
65376,1699500240,1699531620,31380,147227,79024,TR,TR
60719,1699367400,1699378560,11160,9535,80848,HR,DE
149188,1699291020,1699320720,29700,47467,50703,TR,TR
160256,1700333760,1700338080,4320,75192,50218,GB,GB
149344,1699263360,1699296300,32940,192001,37385,TR,TR
144344,1699255380,1699260720,5340,65779,36163,GB,GB
119883,1700120280,1700129460,9180,67606,112821,IT,FR
145641,1700094600,1700123700,29100,172215,176648,TR,TR
195047,1699559100,1699590240,31140,77126,190801,TR,TR
129282,1700254980,1700268540,13560,65618,66556,IT,IT
19260,1699915800,1699950000,34200,51277,168475,TR,TR
42101,1700094720,1700105760,11040,8326,125166,RS,RS
176358,1699055880,1699062480,6600,170684,67220,NL,NL
32894,1700043060,1700057400,14340,74938,67267,IT,IT
135707,1699137780,1699171980,34200,58357,54089,TR,TR
163303,1699331460,1699336200,4740,52738,104526,GB,GB
199634,1699181100,1699197660,16560,162847,169565,US,US
117006,1700088600,1700119320,30720,59090,122956,TR,TR
61652,1698804480,1698821700,17220,16296,154513,US,US
142435,1699774500,1699790640,16140,188798,83454,CZ,CZ
113331,1700737260,1700746920,9660,188836,6348,IT,IT
124475,1700367480,1700371080,3600,84219,82367,GB,GB
126884,1699915800,1699933620,17820,21662,16355,US,US
107604,1700123700,1700132520,8820,136776,130639,IT,IT
68312,1699811760,1699822560,10800,25824,101132,IT,IT
169544,1700464260,1700487240,22980,103233,193539,DE,GB
62157,1700140980,1700152920,11940,123650,2746,IT,IT
28494,1698845700,1698875100,29400,52754,119208,TR,TR
148511,1699986600,1700019960,33360,149065,13362,TR,TR
114945,1699355640,1699372080,16440,33702,120530,FR,PT
82402,1699292580,1699296180,3600,137217,183845,GB,GB
159319,1699290660,1699298640,7980,196577,33631,PT,PT
152644,1700649600,1700677680,28080,122480,60910,DE,NL
164459,1700162820,1700176080,13260,133753,7422,IT,IT
72633,1698937080,1698940680,3600,34443,5515,GB,GB
46881,1700464260,1700467860,3600,32151,182605,GB,GB
17879,1699490400,1699505460,15060,87046,14290,US,US
140707,1699197780,1699229520,31740,104032,33550,TR,TR
189298,1700459880,1700471400,11520,66584,108756,HR,HR
57413,1700628660,1700651700,23040,51705,160495,BR,BR
140263,1699849920,1699859400,9480,195578,147423,PT,PT
136234,1699185300,1699188900,3600,66067,77446,NL,NL
159256,1698935760,1698945000,9240,55269,31739,ES,ES
46818,1699368360,1699378560,10200,136966,54997,CL,CL
162024,1698896220,1698914100,17880,56161,64859,AT,AT
74818,1699718940,1699749360,30420,119211,171444,TR,TR
14260,1699413660,1699419660,6000,118501,188471,GB,GB
195953,1699061160,1699094760,33600,184115,194421,TR,TR
132759,1700460360,1700477760,17400,4770,93254,US,US
139056,1699854300,1699886280,31980,156002,118635,TR,TR
165542,1700535960,1700549640,13680,164681,78890,PT,PT
188582,1699058880,1699068480,9600,172939,9404,AD,ES
170191,1699235640,1699247160,11520,1898,6429,ES,PT
182974,1700296500,1700313060,16560,81312,111286,US,US
93784,1699056000,1699074000,18000,195511,197077,FR,BE
176164,1698800820,1698832920,32100,69345,68916,TR,TR
96030,1699301940,1699306440,4500,176713,147213,GB,GB
73298,1699846080,1699878720,32640,65812,27598,TR,TR
154468,1700494980,1700525820,30840,199486,144141,TR,TR
88863,1700051640,1700061240,9600,3704,94960,IT,IT
6656,1699906440,1699924380,17940,141061,169128,US,US
115769,1700009220,1700012820,3600,190706,20522,NL,NL
66957,1700158980,1700162580,3600,6867,171914,GB,GB
39041,1699499280,1699506360,7080,105733,3087,GB,GB
84113,1699717440,1699748280,30840,83820,28,TR,TR
94660,1699577940,1699583760,5820,136384,7626,NL,NL
145015,1700597820,1700624100,26280,52620,86728,PL,DE
50878,1699237680,1699275360,37680,45492,105611,MX,MX
80536,1700001480,1700023800,22320,129068,7125,PL,PL
133652,1699855740,1699866720,10980,41959,143867,US,US
34855,1698832260,1698883680,51420,154431,23131,BG,AT
15320,1699465320,1699471740,6420,114446,176445,NL,NL
8329,1700535180,1700564760,29580,91076,134759,TR,TR
35346,1698942060,1698975720,33660,182310,141061,TR,TR
109351,1699870980,1699900620,29640,187641,111992,TR,TR
72161,1700050200,1700053800,3600,30705,65597,GB,GB
108858,1699468140,1699477620,9480,100443,9185,PT,PT
115140,1700274780,1700309340,34560,120326,162061,TR,TR
163539,1699435680,1699458180,22500,25774,99773,PL,SI
146035,1699978140,1699995900,17760,59175,133933,US,US
109784,1699427280,1699439460,12180,94172,124126,US,US
16955,1699684020,1699698360,14340,56477,74362,US,US
2592,1700208720,1700232660,23940,190990,47566,BR,BR
134828,1699340460,1699374360,33900,178877,31616,TR,TR
132932,1699755840,1699789380,33540,133542,184842,TR,TR
93654,1700300640,1700314080,13440,177928,86146,IT,IT
46293,1700623020,1700638140,15120,69227,17543,US,US
44201,1698908400,1698912540,4140,118323,118643,NL,NL
58657,1699585980,1699617600,31620,71139,49585,TR,TR
124457,1700842140,1700874120,31980,151424,193221,TR,TR
32130,1699667940,1699699920,31980,128330,6609,TR,TR
165832,1699933380,1699936980,3600,151969,140439,NL,BE
116054,1699688940,1699700400,11460,59004,48405,US,US
144982,1700570760,1700577000,6240,142827,158528,EE,EE
60408,1699991340,1700023260,31920,100553,189752,TR,TR
106709,1698932880,1698947400,14520,19132,158744,US,US
15925,1700110740,1700144460,33720,38197,56451,TR,TR
115433,1699294920,1699330680,35760,83492,164686,MX,MX
93770,1699937880,1699971120,33240,174046,17970,TR,TR
135898,1700554740,1700570520,15780,10297,109295,BE,DE
23594,1699451700,1699476780,25080,83426,42994,DK,DE
41400,1698938880,1698951780,12900,64856,68709,US,US
165419,1699783080,1699817160,34080,12115,58475,TR,TR
180350,1699618260,1699628760,10500,49051,73717,SK,SK
160465,1699284900,1699317000,32100,42236,95533,TR,TR
44046,1699614240,1699619880,5640,50427,138321,GB,FR
163190,1698997440,1699001040,3600,159974,119356,GB,GB
11563,1700481660,1700507940,26280,24940,103722,BR,BR
56389,1700325660,1700330760,5100,75009,196651,GB,GB
45141,1699528320,1699559100,30780,160601,146656,TR,TR
191228,1699120140,1699123740,3600,29489,121312,GB,GB
188960,1700020080,1700053560,33480,178242,167594,TR,TR
88568,1700463120,1700486100,22980,145702,26902,RO,RO
131820,1700433660,1700459700,26040,74268,195853,RO,MD
71908,1699280760,1699302420,21660,29980,112095,AL,BA
68277,1700405880,1700433840,27960,134833,166778,PL,PL
86066,1700292960,1700299020,6060,85965,31129,NL,NL
102565,1699636980,1699650180,13200,146851,91667,US,US
79439,1700478720,1700488620,9900,181613,96750,IT,IT
197892,1700375880,1700385960,10080,148726,196697,IT,IT
154061,1700260860,1700277360,16500,128059,86926,US,US
39633,1699696560,1699712880,16320,71380,192407,FR,PT
30574,1699281060,1699287900,6840,190683,47842,GB,GB
66026,1700804880,1700811180,6300,35129,17656,GB,GB
56127,1700336640,1700352300,15660,193170,183495,US,US
179713,1699233720,1699237320,3600,69553,17441,NL,NL
173769,1700672340,1700689920,17580,86068,87319,US,US
109747,1699821900,1699825800,3900,192463,72203,NL,NL
126494,1699204860,1699219140,14280,74161,61467,US,MX
142480,1699556940,1699562340,5400,14479,189888,GB,GB
26074,1700083560,1700115300,31740,6638,13724,TR,TR
42269,1698807720,1698814320,6600,148844,75649,NL,NL
184681,1699974780,1699991700,16920,110833,86956,US,US
67481,1700437800,1700468400,30600,34161,58975,TR,TR
13089,1699573440,1699579800,6360,49890,127354,EE,EE
114359,1700354640,1700384400,29760,72432,119664,TR,TR
94820,1700468520,1700493480,24960,160939,17531,PL,PL
60479,1699726260,1699738320,12060,122574,95581,PT,PT
23313,1699188660,1699194960,6300,166190,80592,NL,NL
159793,1698886860,1698912180,25320,192316,47178,RO,RO
78124,1700129580,1700151180,21600,68324,123387,DE,DE
125258,1699923660,1699955160,31500,72924,139856,TR,TR
189120,1699939860,1699953600,13740,105267,192822,US,CA
110942,1700827800,1700835300,7500,95221,48124,IT,IT
148786,1699712400,1699748100,35700,191895,97398,TR,TR
110344,1700814000,1700832300,18300,52002,78227,FR,NL
22097,1699590000,1699621800,31800,98386,71353,TR,TR
47425,1698825180,1698855000,29820,88805,179726,TR,TR
182784,1699986420,1700018160,31740,109429,164839,TR,TR
196541,1700689260,1700710500,21240,178117,188181,BE,FR
190479,1700194620,1700228280,33660,93244,77468,TR,TR
30404,1700837580,1700849160,11580,128063,141516,US,US
64854,1699057080,1699087800,30720,135496,152225,TR,TR
119074,1700016540,1700055660,39120,58379,11938,MX,MX
96331,1700184780,1700220120,35340,199529,69473,TR,TR
129999,1700017440,1700026380,8940,165271,17569,HR,HR
178312,1699159380,1699192020,32640,57374,157366,TR,TR
115130,1699978980,1700010300,31320,37432,111896,TR,TR
148844,1700754480,1700764260,9780,180746,120897,IT,IT
86823,1699745760,1699770120,24360,31391,153442,DE,DE
12257,1699116480,1699146720,30240,150326,167139,TR,TR
108682,1699312200,1699327740,15540,2354,57804,AT,AT
186173,1699998900,1700028240,29340,91069,85335,TR,TR
166562,1699447920,1699457700,9780,72663,23297,IT,IT
111487,1699217700,1699230540,12840,144872,59004,ES,ES
115044,1699739280,1699742880,3600,151355,43737,NL,NL
130435,1698797640,1698804120,6480,101811,21630,NL,NL
75762,1699795800,1699830480,34680,136884,120782,TR,TR
43667,1699169880,1699177740,7860,33584,178918,PT,PT
104252,1700731200,1700764080,32880,57996,6503,TR,TR
45845,1700285160,1700319840,34680,35674,44303,TR,TR
6516,1700124660,1700141340,16680,49088,68470,AT,AT
70763,1700676540,1700680980,4440,34931,140898,GB,GB
110363,1700486880,1700491560,4680,81225,4590,GB,GB
5289,1698987000,1699021140,34140,167630,54315,TR,TR
117125,1699363500,1699379520,16020,168927,17529,US,US
144491,1699957320,1699987860,30540,171711,131301,TR,TR
166365,1698941880,1698954360,12480,6515,127132,RS,RS
23269,1700023800,1700058720,34920,162065,128924,TR,TR
842,1700362200,1700377800,15600,122174,151653,US,CA
131213,1700010480,1700030820,20340,135095,173966,FR,ES
101550,1700097480,1700131020,33540,171969,3853,TR,TR
188906,1699132920,1699136520,3600,75609,65038,GB,GB
178902,1700473380,1700505240,31860,102187,131307,TR,TR
154036,1700235780,1700249820,14040,45065,151636,RS,HU
9143,1699198020,1699221600,23580,173210,27733,DE,CZ
147037,1698971520,1698985440,13920,60371,134399,US,US
74577,1700284740,1700288340,3600,89923,133303,GB,GB
166262,1699137060,1699146600,9540,115563,166369,IT,IT
83592,1699212960,1699221900,8940,74755,59801,IT,IT
5423,1699573860,1699578360,4500,183058,141615,GB,GB
144326,1700697300,1700711340,14040,71995,176073,IT,IT
12262,1699224660,1699228620,3960,25580,156448,GB,GB
118637,1699403160,1699412940,9780,51750,27038,IT,IT
3419,1700118840,1700125320,6480,42934,101448,NL,NL
198034,1699442580,1699457520,14940,71560,23991,RS,RS
189925,1699253520,1699282380,28860,116196,25237,TR,TR
90690,1699360080,1699395780,35700,104638,190230,TR,TR
134627,1699354620,1699358220,3600,26656,90677,GB,GB
178343,1698954600,1698960960,6360,26591,35798,GB,GB
186593,1698968760,1698982920,14160,59124,135572,US,US
188286,1699865280,1699871640,6360,189546,119617,GB,GB
99992,1700217900,1700249100,31200,64574,162188,TR,TR
25360,1699452060,1699457640,5580,157974,44132,EE,EE
63181,1700761980,1700772780,10800,39783,197950,IT,IT
91594,1700522100,1700551260,29160,85555,59377,TR,TR
149634,1700545140,1700576400,31260,67837,149567,TR,TR
126691,1699409460,1699413060,3600,53992,86058,GB,GB
51932,1699333260,1699366020,32760,176916,167511,TR,TR
157871,1699365300,1699390440,25140,9957,93341,DE,MK
18609,1700177640,1700183640,6000,136037,988,GB,GB
6842,1700685240,1700735640,50400,21869,130983,BG,BG
117536,1700547900,1700580480,32580,5176,119491,TR,TR
31995,1699373040,1699382340,9300,64045,167498,HR,HR
50051,1699228320,1699242000,13680,177909,131365,US,US
107912,1699652280,1699681140,28860,4832,197782,TR,TR
141801,1699371120,1699395720,24600,92036,149500,RO,RO
148215,1699963380,1699998480,35100,12470,112216,MX,MX
31066,1700614680,1700625120,10440,27951,31430,IT,IT
106771,1699827840,1699852020,24180,25366,79560,RO,RO
77303,1699447860,1699451460,3600,144270,93780,GB,GB
112224,1699127400,1699142940,15540,94699,72242,CZ,SK
127212,1700285400,1700320980,35580,165467,121919,MX,MX
121048,1699597380,1699600980,3600,125531,144727,GB,GB
157638,1699913400,1699917000,3600,77289,18176,GB,GB
79850,1699254420,1699272120,17700,12833,129378,BE,FR
37718,1698855120,1698867960,12840,96338,171490,IT,IT
98027,1699573020,1699595940,22920,52330,71020,DK,DK
107451,1700803200,1700829960,26760,6035,74892,PL,PL
12160,1699433100,1699444500,11400,91326,53128,US,US
67296,1699844940,1699878840,33900,111394,185957,TR,TR
9800,1699461300,1699465500,4200,129340,194359,GB,GB
79011,1700227920,1700259060,31140,197408,84543,TR,TR
161413,1699043280,1699066260,22980,189426,32914,PL,DE
171785,1700115540,1700125380,9840,50269,60371,IT,IT
188915,1699020720,1699026600,5880,78514,54499,EE,EE
31624,1699732980,1699736580,3600,45106,144957,GB,GB
74459,1699915980,1699919580,3600,80668,140288,GB,GB
163502,1699941660,1699945260,3600,68140,100887,GB,GB
129943,1698913740,1698923160,9420,127836,45999,HR,HR
91763,1699168680,1699200000,31320,150938,157603,TR,TR
190766,1698945360,1698981060,35700,175710,8673,TR,TR
34832,1699110780,1699119900,9120,83671,36987,IT,IT
106017,1699201500,1699214400,12900,26162,171165,PT,PT
118590,1698999120,1699031580,32460,186467,68450,TR,TR
8995,1699725900,1699758120,32220,35632,58871,TR,TR
60379,1699622700,1699634160,11460,100914,90164,PT,PT
36677,1699300440,1699312800,12360,147359,2349,US,MX
56855,1700187540,1700222880,35340,32159,149026,TR,TR
3972,1699319460,1699350480,31020,99060,77677,TR,TR
113779,1700789520,1700793120,3600,155798,43784,GB,GB
124505,1700226480,1700257080,30600,195181,166266,TR,TR
170466,1699459920,1699489200,29280,36554,150560,TR,TR
61167,1699765800,1699798920,33120,38561,30097,MX,MX
28852,1699774380,1699807860,33480,82818,94703,TR,TR
49964,1699471020,1699507140,36120,145167,76278,MX,MX
163991,1699753620,1699765620,12000,122334,197045,IT,HR
86674,1699517400,1699521000,3600,94168,146424,NL,NL
87183,1699651740,1699702680,50940,96330,71697,BG,DE
140992,1699234800,1699246140,11340,125338,187035,US,US
5308,1699347780,1699378140,30360,195846,28900,TR,TR
148211,1700532780,1700567460,34680,159686,15956,TR,TR
19696,1699759020,1699793520,34500,101114,35938,TR,TR
8394,1700002860,1700006460,3600,81531,27066,GB,GB
13306,1700194200,1700204400,10200,98516,176221,IT,IT
118575,1699029360,1699062600,33240,185982,103299,TR,TR
88419,1700224980,1700248260,23280,192278,175629,DE,PL
161123,1699557060,1699589640,32580,192180,87677,TR,TR
176465,1699807380,1699820940,13560,157279,33948,SK,AT
52708,1699221900,1699247880,25980,13342,24959,CH,BE
149589,1699797060,1699804560,7500,38157,102617,IT,IT
97535,1699712820,1699747500,34680,103480,85390,TR,TR
199307,1700581680,1700592660,10980,138075,6416,US,US
153287,1699989060,1700021640,32580,22328,106724,TR,TR
188933,1700033520,1700064960,31440,199865,20799,TR,TR
135526,1700056320,1700086980,30660,15096,194724,TR,TR
12612,1699065300,1699074240,8940,124794,32071,CL,CL
59101,1699613040,1699645860,32820,179266,56619,TR,TR
152340,1700340600,1700350260,9660,28219,136228,PT,PT
121269,1700124360,1700158380,34020,105650,196147,TR,TR
83537,1699973880,1699992180,18300,152739,130976,FR,FR
77253,1699452180,1699463760,11580,189806,86310,US,US
2804,1699070760,1699087200,16440,11392,90578,US,US
35582,1700061960,1700065560,3600,128411,36203,NL,NL
58075,1700273640,1700286600,12960,187218,95025,IT,IT
188217,1700658420,1700688420,30000,184660,192656,TR,TR
166265,1699335180,1699367160,31980,14704,76185,TR,TR
60888,1700460840,1700466840,6000,193952,81438,GB,GB
45282,1700261220,1700273760,12540,185543,131013,RS,RS
104913,1699770180,1699782540,12360,69974,78643,US,US
114268,1699268520,1699286400,17880,123365,20692,FR,IT
101836,1699318680,1699335840,17160,139485,84398,US,US
141309,1700414220,1700448360,34140,32871,34802,TR,TR
54859,1699745640,1699768740,23100,72510,120448,DE,SE
62014,1699395840,1699422960,27120,196309,106199,DE,DE
182727,1700362020,1700374320,12300,149948,107513,US,US
179451,1700764560,1700789400,24840,188752,138407,PL,PL
102080,1700813580,1700818560,4980,25511,123410,NL,NL
197035,1699677120,1699681440,4320,7910,115917,NL,NL
168241,1699478700,1699495920,17220,136138,190825,FR,BE
84767,1698921300,1698956280,34980,142371,198660,TR,TR
84024,1700636280,1700648580,12300,132613,192782,IT,IT
64194,1699117980,1699131960,13980,99598,166849,AT,AT
5818,1700364780,1700381040,16260,199462,51579,US,US
11336,1700211180,1700244180,33000,11697,54435,TR,TR
48319,1700359620,1700390280,30660,165740,27185,TR,TR
103257,1700078820,1700111040,32220,121553,47268,TR,TR
119152,1700441760,1700445360,3600,180057,38982,NL,NL
8798,1700130840,1700162460,31620,13174,195464,MK,RS
111151,1699714260,1699724640,10380,113978,45504,ES,ES
196226,1699109940,1699137420,27480,68726,9483,PL,PL
192557,1700406420,1700432880,26460,89222,84068,DE,DE
54412,1700216280,1700224440,8160,89634,11203,IT,IT
16565,1698862140,1698878880,16740,170038,140580,CZ,UA
185275,1698978900,1699011660,32760,177056,189175,TR,TR
48253,1699299180,1699314600,15420,19961,145750,SE,SE
169560,1699467480,1699474980,7500,151310,131929,AD,ES
164439,1699808340,1699825800,17460,128927,64269,US,US
75049,1699777680,1699781280,3600,184455,146893,NL,NL
93440,1699758540,1699787820,29280,102501,104333,TR,TR
35465,1700860080,1700893380,33300,14491,123212,TR,TR
55004,1699945380,1699979100,33720,122262,65345,TR,TR
50776,1699860720,1699870680,9960,82862,166887,PT,PT
143121,1699144260,1699147860,3600,181417,123237,NL,NL
65861,1698810240,1698844380,34140,9188,175023,TR,TR
37464,1700327940,1700331540,3600,87494,136172,GB,GB
123914,1699176900,1699183740,6840,136040,90584,GB,GB
34733,1700837220,1700848560,11340,129848,57935,US,US
157291,1700598480,1700606820,8340,7453,170046,HR,HR
176158,1700692020,1700698020,6000,32076,165433,GB,GB
10929,1698800880,1698835560,34680,10241,84380,TR,TR
4532,1700204340,1700228400,24060,119266,11450,DE,PL
71931,1698927720,1698961800,34080,87073,182385,TR,TR
90412,1699934220,1699967460,33240,195592,167499,TR,TR
112339,1700382540,1700406300,23760,20547,109507,BR,BR
132566,1700078580,1700113680,35100,179218,147274,TR,TR
27578,1699828320,1699860300,31980,103077,12006,TR,TR
47879,1699092240,1699108020,15780,105172,11295,FR,FR
128586,1699203480,1699237980,34500,79435,151669,TR,TR
36930,1700615160,1700644920,29760,194311,108313,TR,TR
112173,1700225220,1700230260,5040,17924,156616,NL,NL
54188,1699067100,1699086420,19320,171522,137938,FR,FR
161784,1699377060,1699383720,6660,42476,138203,GB,GB
118650,1700797500,1700813880,16380,87606,163440,US,US
134281,1699403460,1699414140,10680,192014,75522,IT,IT
74224,1699035600,1699056240,20640,33826,66547,FR,BE
58183,1700349540,1700381400,31860,25615,42967,TR,TR
23443,1699184400,1699214880,30480,120941,90985,TR,TR
42951,1698987600,1698999600,12000,152511,21810,IT,SK
29297,1699475280,1699478880,3600,190584,37080,GB,GB
191738,1700481000,1700512860,31860,28745,182287,TR,TR
143055,1700682240,1700711460,29220,185310,153341,TR,TR
139843,1699213380,1699223700,10320,47689,195345,PT,PT
56313,1700129160,1700134200,5040,131650,18953,GB,GB
57798,1700767260,1700770860,3600,21735,154735,NL,NL
59514,1700027700,1700057880,30180,20550,156622,TR,TR
18329,1699377300,1699394460,17160,109145,121326,US,US
156292,1698813300,1698816900,3600,114364,89195,GB,GB
99489,1700555700,1700589840,34140,87747,83255,TR,TR
184776,1699956480,1699986540,30060,126947,197273,TR,TR
192085,1699220280,1699226880,6600,141642,43863,EE,EE
239,1700279460,1700293980,14520,8690,77339,US,US
36014,1699029900,1699046880,16980,50773,64967,US,US
415,1700262360,1700293200,30840,52484,145045,TR,TR
62611,1699564260,1699600200,35940,134545,74708,TR,TR
165705,1700126880,1700130480,3600,177826,185077,GB,GB
37716,1700284440,1700318580,34140,198106,31816,TR,TR
125509,1698795480,1698820440,24960,187116,147398,RO,RO
156910,1699500780,1699511700,10920,57980,121218,HR,HR
53876,1699678260,1699691640,13380,174119,179618,CZ,CZ
190574,1698801000,1698832200,31200,151337,4572,TR,TR
33404,1699495980,1699530180,34200,154645,158709,TR,TR
121982,1699441920,1699473000,31080,159622,173199,TR,TR
91755,1700025240,1700038740,13500,181034,39227,US,US
131221,1700811840,1700826360,14520,196532,77764,US,US
195155,1700313420,1700321220,7800,129720,132498,IT,IT
22618,1700654280,1700684400,30120,194546,77670,TR,TR
153150,1700562720,1700597460,34740,151630,89093,TR,TR
10309,1699559880,1699576440,16560,181396,196601,US,US
20053,1699111080,1699145100,34020,67210,195739,TR,TR
188430,1700042460,1700069820,27360,131987,130457,DE,CH
184041,1700032320,1700044500,12180,171461,9760,US,US
163710,1700242920,1700268240,25320,125130,67667,CH,IT
122813,1699825500,1699860900,35400,118492,16496,TR,TR
109119,1699427580,1699440420,12840,161737,177880,IT,IT
177209,1699376940,1699408920,31980,138154,97133,TR,TR
48843,1699456260,1699485180,28920,1174,181783,TR,TR
199728,1699987380,1700016660,29280,123860,195734,TR,TR
70052,1700382180,1700397120,14940,100913,81971,AT,RS
131323,1699754820,1699790520,35700,24307,61536,MX,MX
38426,1698821520,1698854520,33000,107766,94057,TR,TR
67625,1699947300,1699962240,14940,13930,196936,US,US
101730,1698890520,1698909720,19200,183358,110589,FR,FR
170945,1700388780,1700401680,12900,80893,186281,SK,SK
183027,1700511240,1700544600,33360,83389,17988,TR,TR
124669,1700597700,1700631300,33600,146825,90894,TR,TR
1682,1700689320,1700696880,7560,120720,183924,PT,PT
185451,1699476300,1699480260,3960,33712,99999,GB,GB
129536,1698922200,1698926520,4320,136480,62470,NL,NL
4038,1699479840,1699497240,17400,151317,165432,US,US
75877,1699258380,1699269300,10920,71526,39223,IT,IT
100710,1699597080,1699608600,11520,15115,156884,US,US
166869,1699294620,1699299840,5220,109030,145565,NL,NL
158708,1699867380,1699896480,29100,152468,102784,TR,TR
33649,1700713440,1700717040,3600,199826,198815,GB,GB
142977,1699601400,1699621080,19680,5358,82299,DK,DK
153271,1699148100,1699170480,22380,75470,27517,PL,PL
80507,1699222560,1699226160,3600,135748,175653,GB,GB
6724,1700280600,1700284320,3720,179715,16259,GB,GB
180645,1699987260,1700012580,25320,77164,38247,PL,UA
135435,1700595420,1700599020,3600,37452,49977,GB,GB
40227,1700025000,1700036520,11520,570,142466,IT,IT
88113,1700409240,1700440260,31020,11037,9521,TR,TR
46765,1699260120,1699274640,14520,138460,131629,CZ,PL
24598,1699775100,1699789020,13920,59306,170743,IT,CZ
113980,1699237200,1699269480,32280,28837,197267,TR,TR
168472,1698839640,1698843240,3600,95559,165676,GB,GB
15834,1698881100,1698897360,16260,126960,104100,US,US
115984,1699017060,1699033500,16440,88239,179637,US,US
130670,1700111940,1700126940,15000,199163,27048,US,CA
109867,1700468220,1700474040,5820,138463,105861,GB,GB
199826,1700089380,1700100300,10920,27364,82930,IT,IT
44117,1699736880,1699772580,35700,66147,87427,TR,TR
165326,1699172760,1699205700,32940,92165,88410,TR,TR
22774,1698959340,1698972240,12900,70898,136440,CZ,CZ
52805,1699417800,1699445880,28080,145068,178647,DE,DE
129264,1700836920,1700871660,34740,124591,191587,TR,TR
166666,1698965340,1698979320,13980,12146,20969,US,US
139303,1700452380,1700476140,23760,198509,139772,HU,AT
152418,1699785420,1699790940,5520,132942,103719,GB,GB
199678,1700153100,1700160840,7740,43445,2444,IT,IT
171477,1700179560,1700214240,34680,81784,52963,TR,TR
86900,1700808300,1700835960,27660,92443,50768,DE,AT
62342,1699408800,1699443480,34680,74591,101069,TR,TR
53565,1698915180,1698930960,15780,174129,196933,FR,FR
25049,1700141580,1700170920,29340,190690,49782,TR,TR
102085,1699067580,1699099320,31740,181314,8740,TR,TR
161215,1699168740,1699182660,13920,30473,126945,RS,RS
159285,1700164260,1700170080,5820,45755,175883,NL,NL
199493,1699928340,1699963320,34980,45943,41700,TR,TR
7962,1699647300,1699654740,7440,175197,112584,IT,IT
160470,1698923580,1698953160,29580,76813,63811,TR,TR
104471,1700826660,1700834400,7740,104320,198487,EE,EE
185883,1699601580,1699631280,29700,51911,88699,TR,TR
12116,1699355580,1699365300,9720,53573,81300,HR,HR
103757,1699092300,1699122120,29820,163633,106077,TR,TR
66063,1700345340,1700351580,6240,176221,7286,GB,GB
166207,1700717160,1700743680,26520,144575,56721,DE,AT
71894,1699168080,1699194300,26220,82688,113720,DE,IT
3305,1700162160,1700195400,33240,142230,96789,TR,TR
107143,1700198820,1700215800,16980,101106,91408,AT,AT
143845,1700758800,1700762640,3840,102985,152132,NL,BE
64356,1700118540,1700151300,32760,42974,36799,TR,TR
147980,1700014860,1700050080,35220,40013,66291,MX,MX
79451,1699757640,1699792320,34680,93142,135808,MX,MX
18427,1700045580,1700080080,34500,156437,156079,TR,TR
179107,1700682540,1700717280,34740,52719,80604,TR,TR
119452,1699113480,1699118640,5160,63649,13376,NL,AT
169424,1699894860,1699923840,28980,57286,66443,TR,TR
137994,1700796120,1700802000,5880,29760,153316,EE,EE
152433,1700585340,1700616000,30660,41399,172357,TR,TR
68535,1699803240,1699819740,16500,109727,196382,FR,FR
107094,1700534400,1700559900,25500,165417,82357,DE,AT
151996,1700557680,1700589480,31800,99766,168250,TR,TR
123536,1699071360,1699076580,5220,30231,61523,GB,GB
9771,1700595000,1700626440,31440,87127,165737,TR,TR
9912,1699391820,1699401000,9180,80769,199937,PT,PT
176848,1700838060,1700850900,12840,31204,40110,HR,HR
17306,1699971240,1699976100,4860,71312,80387,GB,GB
81443,1700351280,1700385120,33840,66511,134482,TR,TR
141610,1699710120,1699721820,11700,89184,105298,PT,PT
174696,1699305780,1699320720,14940,179714,95853,RS,RS
130831,1699432620,1699449600,16980,14108,146046,US,US
128724,1700363040,1700371980,8940,161849,68991,IT,IT
5603,1699347780,1699356060,8280,70050,115299,IT,IT
101526,1700834940,1700850180,15240,120733,176195,US,US
79924,1700610780,1700641860,31080,111484,102998,TR,TR
143,1700494380,1700527260,32880,4839,130323,TR,TR
6264,1700749020,1700763420,14400,43845,47037,FR,FR
95929,1700190240,1700202480,12240,102451,71331,US,US
32633,1698823200,1698831480,8280,47496,122842,ES,AD
8653,1700183520,1700212380,28860,61665,17620,TR,TR
51458,1700468400,1700482500,14100,47511,35856,PT,ES
104117,1700533920,1700550000,16080,63231,82420,US,US
6853,1699875660,1699905000,29340,12443,2932,TR,TR
93402,1699625700,1699656780,31080,127177,102156,TR,TR
151044,1700057040,1700062980,5940,165893,83233,NL,BE
49920,1700332920,1700367360,34440,122620,195834,MX,MX
145659,1699311840,1699338420,26580,190725,31924,BR,BR
152854,1700844900,1700857800,12900,38284,85117,US,US
167438,1700213100,1700236080,22980,168807,19138,DE,IT
86815,1699831980,1699838400,6420,142620,193555,GB,GB
92174,1699832580,1699840200,7620,54553,32116,HR,IT
148542,1699287480,1699300860,13380,111555,79622,AT,AT
85060,1699929900,1699933500,3600,120905,45479,GB,GB
41587,1700732100,1700747880,15780,13095,721,US,US
39999,1700744520,1700757540,13020,75993,109036,US,US
9299,1700553660,1700566260,12600,36275,195621,US,CA
60605,1700697360,1700748540,51180,184992,236,BG,AT
115115,1699040580,1699054680,14100,156121,160370,IT,IT
102286,1700482320,1700518020,35700,170351,61940,TR,TR
65917,1699007880,1699019760,11880,10388,83949,PT,PT
41770,1699084980,1699088580,3600,146732,145564,NL,NL
34875,1699776540,1699787520,10980,156744,121669,US,US
51350,1700105640,1700113920,8280,123155,51348,IT,IT
147258,1699523340,1699532340,9000,10482,85783,IT,IT
139602,1700627460,1700643720,16260,39148,90371,US,US
117348,1700618340,1700647920,29580,48,62411,TR,TR
146361,1700172900,1700188320,15420,35134,157862,US,US
145534,1699427040,1699438860,11820,105527,166089,IT,IT
162116,1700403360,1700430540,27180,51482,188910,PL,PL
30821,1699368780,1699382520,13740,16871,87329,IT,IT
14376,1700563740,1700586960,23220,71531,53954,PL,UA
193885,1699191780,1699228620,36840,184930,16236,MX,MX
1519,1698990960,1699014840,23880,72622,112384,DE,PL
187786,1700534280,1700545200,10920,30550,96994,PT,PT
153133,1700508000,1700520840,12840,137970,101014,ES,FR
177305,1699796520,1699813200,16680,174604,119218,US,US
144980,1699784460,1699789800,5340,174579,178005,EE,EE
38017,1699978440,1700012460,34020,181270,131069,TR,TR
168017,1700180220,1700214420,34200,149311,129727,TR,TR
75360,1700394300,1700424720,30420,134420,10344,TR,TR
41124,1700705400,1700734080,28680,19714,197194,PL,PL
65414,1700484240,1700542440,58200,8018,143810,UA,DE
65531,1700621160,1700626560,5400,72437,148812,GB,GB
42181,1699544340,1699573320,28980,166043,123082,TR,TR
94669,1700293380,1700316060,22680,30709,84016,DE,FR
135645,1700380080,1700393400,13320,161680,84818,US,US
65388,1698976380,1698992040,15660,177893,152255,AT,BG
124423,1700689260,1700705760,16500,156410,85234,US,US
35777,1700791560,1700821560,30000,124768,45263,TR,TR
161327,1700563920,1700585400,21480,100946,144219,FR,FR
100356,1699034760,1699046100,11340,132932,65910,US,US
15702,1699170900,1699200660,29760,112174,103936,TR,TR
190046,1700853780,1700867040,13260,139723,69676,RS,RS
70867,1700227380,1700257740,30360,195915,5925,TR,TR
64753,1699566300,1699573740,7440,177602,197060,IT,IT
174525,1699692540,1699723920,31380,49007,45387,TR,TR
87289,1698924000,1698930840,6840,118387,79360,GB,GB
4585,1700757600,1700787240,29640,155120,124760,TR,TR
22065,1700034900,1700070000,35100,154433,85605,TR,TR
109153,1699815480,1699825020,9540,39880,76250,IT,IT
2037,1698958080,1698962580,4500,49679,149381,GB,GB
173347,1700239260,1700242860,3600,61475,70345,GB,GB
84347,1700402580,1700406180,3600,113966,52585,GB,GB
10294,1699294200,1699323900,29700,36496,99061,TR,TR
110520,1699400820,1699432920,32100,88465,459,TR,TR
128091,1699752180,1699783200,31020,145131,26173,TR,TR
13174,1699846200,1699876800,30600,61704,196492,TR,TR
126473,1699935360,1699969200,33840,59211,130784,TR,TR
98090,1699869600,1699882680,13080,153613,195680,US,US
43908,1699663800,1699681080,17280,48398,195613,FR,DE
76007,1700019180,1700035560,16380,72360,108858,US,US
172877,1699149060,1699172880,23820,75199,21855,DE,NL
8457,1700134500,1700166180,31680,19795,11317,TR,TR
105526,1700572020,1700584860,12840,122818,152366,HR,HR
157794,1700712480,1700722020,9540,89893,73856,IT,IT
84751,1699639860,1699651080,11220,107706,97187,CZ,PL
173228,1700386200,1700416980,30780,195965,132469,TR,TR
163100,1699341120,1699354260,13140,99528,29065,IT,FR
17207,1699968240,1699971840,3600,105871,63243,NL,NL
22983,1700793900,1700817660,23760,197020,18042,PL,PL
112297,1699270680,1699301160,30480,161432,114078,TR,TR
24479,1698846840,1698864300,17460,68279,9382,AT,DE
9183,1699918260,1699952640,34380,13387,54046,TR,TR
117158,1699709280,1699723560,14280,52671,153893,US,US
163123,1700714280,1700742180,27900,85789,80117,DE,BG
148358,1698793620,1698806640,13020,139126,156998,US,US
159658,1699713420,1699717020,3600,145991,76608,GB,GB
89615,1699188120,1699223220,35100,77902,13829,TR,TR
160051,1700079180,1700110440,31260,129686,17173,TR,TR
46355,1699234500,1699267560,33060,66573,160474,MX,MX
156023,1698853800,1698879000,25200,51395,107110,BR,BR
164007,1699960020,1699971420,11400,120012,125732,ES,ES
79985,1699667400,1699680540,13140,101338,97137,PT,PT
64219,1700065800,1700094540,28740,43550,31296,RO,MD
84824,1700713320,1700723880,10560,73483,141411,ES,FR
122172,1699301040,1699333680,32640,42138,183147,TR,TR
78984,1698836100,1698839700,3600,36973,114035,GB,GB
171446,1700277780,1700302920,25140,114100,110874,DE,HU
56896,1699574940,1699603860,28920,130887,152333,TR,TR
182982,1700244660,1700280540,35880,138715,160982,TR,TR
16515,1699639980,1699653000,13020,109677,195952,IT,IT
22622,1699748880,1699756020,7140,151191,5249,GB,GB
133931,1699235340,1699267080,31740,79401,18524,TR,TR
615,1698815280,1698846600,31320,72224,65330,TR,TR
141373,1699430520,1699435620,5100,143566,94069,GB,GB
83205,1699851600,1699885800,34200,193200,124695,TR,TR
81040,1699484880,1699502700,17820,42005,130548,US,US
13822,1699318080,1699331280,13200,39418,159663,PT,PT
45098,1698997260,1699026540,29280,171272,60529,TR,TR
56158,1700283780,1700289720,5940,145826,115520,GB,GB
54887,1700764140,1700767740,3600,197845,86166,GB,GB
63167,1700793900,1700798340,4440,149961,156698,GB,GB
141836,1700386800,1700426040,39240,156049,101568,MX,MX
146665,1700602980,1700633700,30720,157278,134966,TR,TR
15475,1699709580,1699718040,8460,196589,21977,HR,HR
166056,1699929780,1699959720,29940,24485,102019,TR,TR
183370,1700092200,1700103240,11040,44482,133319,IT,IT
104141,1699925340,1699933620,8280,52872,47486,IT,IT
27516,1699874160,1699891200,17040,43545,42032,US,US
153274,1699945020,1699974540,29520,24795,114466,TR,TR
170549,1699289640,1699321920,32280,95653,81534,TR,TR
176584,1698940260,1698957240,16980,84278,192131,US,MX
148177,1700187540,1700192700,5160,88287,2987,EE,EE
38149,1700762760,1700790960,28200,28021,31214,BR,BR
29995,1700762520,1700778420,15900,133578,78516,US,US
45062,1699208040,1699261200,53160,171134,174164,BG,RO
105636,1699740900,1699754340,13440,9052,180845,HR,HR
7386,1700288280,1700303700,15420,93101,152620,FR,FR
148156,1700818560,1700823540,4980,28795,53720,GB,GB
183099,1700146680,1700153760,7080,116002,65889,GB,GB
50319,1699082460,1699095780,13320,191348,57511,US,US
24562,1700836140,1700840160,4020,1318,54825,NL,NL
36635,1699958520,1699976340,17820,138600,71781,US,US
135185,1700321100,1700329380,8280,42577,70925,EE,FI
21979,1699075200,1699109400,34200,110871,101710,TR,TR
174183,1700383320,1700395620,12300,190903,69752,IT,IT
47054,1698957060,1698962520,5460,45232,17266,GB,GB
147750,1699415160,1699421700,6540,12676,40834,CL,CL
40287,1700327520,1700334060,6540,94507,6,NL,NL
186371,1700571600,1700575560,3960,156039,186382,NL,NL
53327,1700699460,1700732700,33240,143318,42761,TR,TR
87019,1699592880,1699628040,35160,43729,69331,TR,TR
58669,1699729320,1699734540,5220,128409,46638,GB,GB
92287,1700013900,1700045160,31260,121843,156862,TR,TR
185311,1700288580,1700322480,33900,5899,1046,TR,TR
74918,1700854620,1700871420,16800,60991,47636,US,US
89295,1699471260,1699501140,29880,90235,6661,TR,TR
152256,1698905940,1698916860,10920,189384,118341,ES,ES
21547,1700589660,1700619120,29460,141408,150307,TR,TR
17889,1699034100,1699052580,18480,120955,43655,FR,BE
73474,1699441140,1699444860,3720,2198,180840,GB,GB
125205,1700775360,1700778960,3600,54213,50753,GB,DE
33809,1700572560,1700590560,18000,188710,30464,SI,BA
31595,1699044360,1699069740,25380,117102,198283,DE,DE
180854,1699250580,1699257660,7080,43769,178919,NL,NL
90662,1700162820,1700191920,29100,74554,7667,TR,TR
29527,1700221740,1700237640,15900,129619,33373,CZ,RO
46054,1698858120,1698861720,3600,176688,110970,NL,BE
19087,1699331400,1699366800,35400,102001,138955,TR,TR
199254,1700820780,1700835120,14340,37890,116205,HR,HR
198156,1699528440,1699532040,3600,88906,74934,GB,GB
197736,1699477800,1699492200,14400,198910,51166,US,US
55523,1699537980,1699566960,28980,61435,72840,TR,TR
111644,1698965520,1698975840,10320,180322,22951,IT,IT
161903,1700298660,1700302260,3600,875,176391,NL,NL
118604,1700154780,1700180940,26160,75567,101038,DE,DE
180907,1699375920,1699391700,15780,184249,177806,US,US
135895,1699884960,1699895100,10140,98499,108760,IT,HR
13128,1699513560,1699524420,10860,184646,70585,IT,IT
173763,1699113240,1699117740,4500,171662,180107,GB,GB
17413,1699971240,1699974960,3720,36994,17919,GB,GB
164130,1700306760,1700330160,23400,180297,67545,PL,PL
95412,1699142940,1699150380,7440,168386,158109,PT,PT
99522,1700173140,1700178300,5160,77224,65500,NL,NL
105334,1699774260,1699795080,20820,191472,18453,FR,RO
103582,1699607640,1699620420,12780,75431,133809,US,US
75923,1700288040,1700291640,3600,132888,101526,GB,GB
132406,1700140080,1700152740,12660,94232,100467,US,US
101554,1699362240,1699393320,31080,9440,7964,TR,TR
194618,1700392860,1700405460,12600,104591,58059,CZ,DE
35494,1699092120,1699121700,29580,154538,17981,TR,TR
98708,1700583420,1700614020,30600,130002,161803,TR,TR
126348,1699973940,1699988160,14220,30162,106964,US,US
107560,1700273280,1700285220,11940,198681,167345,AT,AT
190925,1700695320,1700724540,29220,71554,149601,TR,TR
47258,1700557260,1700566500,9240,101781,63433,IT,IT
127647,1699244520,1699262280,17760,141893,30140,US,US
128649,1700178180,1700190120,11940,186714,76923,PT,PT
11763,1700356500,1700360100,3600,71645,68406,GB,GB
97917,1699481400,1699513860,32460,24580,91006,TR,TR
95846,1700109720,1700143320,33600,184174,87385,TR,TR
134744,1700520600,1700524200,3600,57528,72267,NL,NL
182636,1699463280,1699488360,25080,192097,59946,RO,BG
39933,1700107020,1700117820,10800,156319,153743,HR,HR
10449,1698982500,1698990480,7980,163715,166749,HR,HR
112250,1699521120,1699532400,11280,97078,45754,US,US
148571,1700665140,1700668740,3600,58166,158585,GB,GB
114943,1699690260,1699693860,3600,192610,50571,GB,GB
199880,1699259220,1699265820,6600,181246,688,GB,GB
80654,1700106300,1700114880,8580,163358,60089,IT,HR
6640,1699820880,1699852320,31440,38077,123314,TR,TR
115903,1699728000,1699732860,4860,58092,81962,GB,GB
184868,1699329180,1699345680,16500,102550,80822,US,US
147031,1700832780,1700836380,3600,86900,68551,GB,GB
79892,1699488000,1699497180,9180,120381,17896,HR,HR
48604,1698823020,1698833460,10440,168515,9413,IT,IT
45575,1699985640,1699996560,10920,117732,60792,US,US
69347,1700866260,1700869860,3600,125871,87284,NL,AT
167870,1698893700,1698927960,34260,128889,158529,TR,TR
18756,1699932120,1699948260,16140,37451,15424,US,US
145363,1700528100,1700536680,8580,134701,22113,PT,PT
7756,1698864180,1698874500,10320,118589,26629,IT,IT
198167,1700133180,1700155020,21840,186917,33220,PL,PL
195512,1700814120,1700825040,10920,135299,178042,US,US
22544,1700591700,1700596020,4320,188258,109585,NL,BE
190191,1700818500,1700827920,9420,59919,133377,IT,IT
191616,1699735800,1699744860,9060,68843,142165,IT,IT
126335,1698999600,1699010820,11220,24765,31326,IT,IT
24257,1699114140,1699145220,31080,196874,37887,TR,TR
99231,1700174640,1700234400,59760,159068,165086,UA,PL
170686,1699143360,1699160760,17400,47380,28579,FR,FR
108303,1700696100,1700712180,16080,135580,146676,US,US
75205,1700294640,1700304060,9420,96807,103064,ES,ES
176357,1699258500,1699264680,6180,25495,50883,GB,GB
149943,1700384400,1700392800,8400,48814,176866,HR,AT
169151,1700864400,1700896500,32100,59816,67766,TR,TR
7401,1699739340,1699772760,33420,197887,99044,TR,TR
62719,1700006100,1700018520,12420,186394,36982,IT,IT
157205,1699356540,1699374240,17700,153997,100299,US,US
197809,1699087920,1699101540,13620,74479,60111,IT,IT
31864,1700232360,1700266440,34080,62079,178846,TR,TR
95033,1699161960,1699193940,31980,111878,16918,TR,TR
70148,1699215420,1699240920,25500,60185,19316,DE,NL
159044,1700210160,1700241180,31020,72720,114456,TR,TR
197434,1700812980,1700840040,27060,9570,57482,PL,LT
193049,1700844960,1700848560,3600,73699,42949,NL,NL
168364,1700747460,1700779560,32100,34434,144929,TR,TR
49486,1700136300,1700142660,6360,160867,179751,GB,GB
192815,1700807640,1700816040,8400,94151,113755,IT,IT
66008,1699010820,1699021620,10800,92426,193672,SK,SK
191662,1699286580,1699298700,12120,22028,165943,IT,IT
167243,1700316900,1700347320,30420,187477,90217,TR,TR
54977,1700534820,1700567820,33000,51739,192569,TR,TR
147045,1700512740,1700517960,5220,6228,90451,NL,NL
103336,1698964080,1698996000,31920,183162,61512,TR,TR
96097,1700408940,1700424960,16020,79363,90684,AT,AT
105488,1698936960,1698965760,28800,153378,127710,TR,TR
155257,1699987020,1700004960,17940,100218,96488,AT,AT
141918,1699429920,1699441080,11160,181263,199336,US,US
97011,1699703040,1699718100,15060,124658,72845,BE,NL
80388,1699118340,1699153800,35460,79403,39855,TR,TR
117243,1700135400,1700150220,14820,33773,150458,US,US
141393,1700088300,1700113980,25680,161192,101277,PL,PL
44921,1700587320,1700617800,30480,38991,142634,TR,TR
87490,1700327760,1700344740,16980,82073,22494,FR,FR
51333,1699707480,1699721280,13800,54240,54272,US,US
8321,1700647740,1700661360,13620,111702,5854,IT,IT
51638,1698909720,1698925260,15540,145640,32724,US,US
104072,1699875660,1699894800,19140,160673,31173,FR,ES
62499,1700175960,1700187060,11100,123534,81542,GR,BG
12819,1699408740,1699432800,24060,88728,35815,MD,RO
129880,1700501640,1700516100,14460,81046,44053,US,US
66297,1699867800,1699871400,3600,181960,116701,GB,NL
154283,1699060680,1699094220,33540,149929,169158,TR,TR
4545,1699310760,1699344420,33660,67970,34904,TR,TR
175792,1700635320,1700641560,6240,112388,160679,GB,GB
130729,1700510760,1700528580,17820,105867,146259,RS,RS
118489,1699208280,1699222440,14160,77715,65950,US,US
111992,1699690680,1699721400,30720,130546,194837,TR,TR
177763,1699148100,1699181160,33060,184003,76295,TR,TR
197931,1699563420,1699593480,30060,20680,88030,TR,TR
35179,1699149660,1699161780,12120,11459,131716,SK,PL
175549,1699918320,1699935420,17100,137410,199284,FR,FR
70232,1699291200,1699299900,8700,37398,130579,IT,IT
16455,1700292060,1700318400,26340,4486,117126,RO,SE
145202,1700124120,1700153700,29580,53682,132961,TR,TR
173280,1698858000,1698875580,17580,182040,176703,US,US
110624,1699463040,1699466640,3600,64293,168019,GB,GB
97310,1700349000,1700384220,35220,90543,22902,TR,TR
150588,1699980360,1699993680,13320,165554,139473,US,CA
63569,1700307060,1700321280,14220,72147,59195,IT,IT
174170,1699809720,1699835220,25500,89740,17354,BR,BR
199673,1699971240,1700002020,30780,175364,132716,TR,TR
52627,1699755780,1699768860,13080,170680,54797,US,US
49411,1699477860,1699489860,12000,28632,185367,HR,HR
123874,1699908420,1699920360,11940,121083,182042,RS,RS
176571,1700273940,1700286120,12180,21394,112467,IT,IT
67605,1699137240,1699166280,29040,159600,95211,TR,TR
112866,1699163280,1699168500,5220,146564,77748,GB,GB
5345,1699996860,1700030460,33600,142211,99547,MX,MX
151507,1700337120,1700368200,31080,116483,154259,TR,TR
27382,1699815900,1699822440,6540,8005,15753,NL,NL
171958,1700001720,1700020680,18960,25883,36526,SE,SE
67428,1699543020,1699554000,10980,1635,197958,IT,IT
148908,1700412720,1700429820,17100,85958,139715,US,US
137469,1698809820,1698844800,34980,167381,170463,TR,TR
148564,1699544460,1699577460,33000,55614,116442,TR,TR
71277,1699141380,1699162320,20940,39337,29267,BE,DE
62414,1699450560,1699477800,27240,97676,110977,RO,RO
3540,1699621800,1699626720,4920,197320,81910,NL,NL
23723,1699280760,1699314300,33540,28120,53723,MX,MX
116501,1699426560,1699458480,31920,38386,129464,TR,TR
42025,1698946080,1698961320,15240,38494,17985,US,MX
13679,1699652460,1699676880,24420,187125,10085,DE,BG
134414,1699503120,1699519260,16140,160548,121242,US,US
197940,1699786680,1699799400,12720,123537,81687,US,US
22660,1698827940,1698841680,13740,184988,53067,SK,SK
26481,1699308360,1699323120,14760,157335,49629,US,US
176455,1700312700,1700344680,31980,132772,108966,TR,TR
183362,1700297760,1700325120,27360,79701,141791,DE,FR
122918,1698806220,1698831300,25080,174454,49338,DE,RS
47226,1699231920,1699264200,32280,137845,13463,TR,TR
172724,1700448780,1700478000,29220,89264,15921,TR,TR
109287,1699399800,1699433700,33900,178461,56094,TR,TR
68180,1700336940,1700340540,3600,151588,44648,NL,NL
51443,1699242300,1699253160,10860,115372,6389,ES,ES
186747,1698951240,1698980640,29400,72459,191074,TR,TR
28303,1698899280,1698934980,35700,165840,58703,TR,TR
45256,1700333040,1700344620,11580,174281,62444,HR,PL
111549,1700667780,1700690580,22800,102303,19381,BR,BR
72540,1700365380,1700373060,7680,39853,28547,ES,ES
88656,1700192760,1700204640,11880,191113,143301,HR,HR
44527,1699027200,1699035060,7860,5447,79035,SK,AT
160559,1699596780,1699628100,31320,73907,41688,TR,TR
174501,1699983240,1699994160,10920,159556,162784,US,US
138051,1699217700,1699225740,8040,92668,26874,SK,SK
94659,1700132340,1700164800,32460,19693,67837,TR,TR
133730,1699943520,1699964160,20640,139199,27452,FR,FR
141519,1699093860,1699125120,31260,132233,22133,TR,TR
89743,1698798900,1698813240,14340,26495,67529,US,US
5894,1699567920,1699600620,32700,37436,194584,MX,US
138750,1700306160,1700309760,3600,199106,192430,GB,GB
122679,1699082940,1699112820,29880,92131,97890,TR,TR
96699,1699410780,1699446060,35280,183228,29094,TR,TR
54731,1700787540,1700817300,29760,75670,118089,TR,TR
75080,1699448520,1699463580,15060,55927,99257,US,US
43184,1700841660,1700852580,10920,34668,161431,IT,IT
30790,1699671600,1699723860,52260,179396,96271,BG,DE
158039,1699231680,1699245120,13440,68932,34197,AT,BG
52312,1700263080,1700270040,6960,153298,136552,NL,NL
175055,1699107900,1699142460,34560,35837,195786,TR,TR
95329,1700267160,1700300280,33120,180417,186197,TR,TR
131119,1699928700,1699941360,12660,23639,20762,US,US
138721,1700476560,1700509380,32820,110083,68516,TR,TR
49854,1700720100,1700751840,31740,65641,10847,TR,TR
174918,1700349240,1700355840,6600,3015,126313,NL,IT
40038,1699389960,1699393560,3600,159951,116982,GB,GB
3225,1699064280,1699098060,33780,184394,57981,TR,TR
25818,1699339740,1699370460,30720,18470,140701,TR,TR
20771,1700324820,1700330760,5940,146650,18349,GB,GB
8947,1699143480,1699173420,29940,1632,70979,TR,TR
148592,1700834400,1700858520,24120,151399,10491,RO,SE
59328,1699312320,1699335900,23580,120796,146241,PL,PL
106836,1699182000,1699188600,6600,109805,168212,GB,GB
33516,1699568760,1699572360,3600,147161,133652,GB,GB
188266,1699322700,1699340400,17700,176243,70270,US,US
142465,1699916760,1699931040,14280,37723,177299,IT,IT
192281,1698815040,1698827220,12180,151870,146716,US,US
133988,1699728180,1699731780,3600,70498,37378,GB,GB
17925,1699021560,1699028160,6600,66971,46333,NL,NL
606,1700205840,1700215920,10080,125239,15739,IT,IT
123690,1699957080,1699960680,3600,197746,6666,GB,GB
109363,1699907040,1699911000,3960,155840,64425,NL,NL
165478,1699544760,1699574940,30180,174406,127533,TR,TR
158156,1700754240,1700771880,17640,99467,199501,RS,AT
131360,1699749840,1699771860,22020,183623,198255,BR,BR
11991,1699390080,1699419780,29700,102426,181636,TR,TR
103907,1699722960,1699732560,9600,159476,62672,IT,IT
182494,1700730120,1700754360,24240,125246,135071,DE,DE
60284,1699576800,1699611360,34560,61849,154426,TR,TR
51656,1698910380,1698940260,29880,159610,65247,TR,TR
37705,1699816980,1699836600,19620,122437,51012,FR,BE
52498,1699960860,1699964460,3600,139751,195276,GB,GB
75810,1699452900,1699464120,11220,199197,179572,IT,IT
51391,1699774080,1699805460,31380,121458,26722,TR,TR
106680,1700767740,1700801160,33420,124001,14823,TR,TR
132381,1699600080,1699610880,10800,131084,191027,IT,IT
78357,1699293120,1699328460,35340,21931,47441,TR,TR
40750,1699988520,1700021100,32580,78063,116916,TR,TR
48859,1700324820,1700342160,17340,130124,95315,US,US
197649,1700618400,1700651940,33540,70641,19858,TR,TR
161294,1699467840,1699502160,34320,177984,40920,TR,TR
22429,1700414040,1700435280,21240,133897,29940,FR,DE
43443,1699626780,1699643040,16260,123724,154564,AT,DE
178540,1699034940,1699067760,32820,129186,47774,MX,MX
35416,1700655840,1700689380,33540,159577,57255,TR,TR
5561,1699609140,1699620840,11700,136555,142268,IT,IT
55571,1700441280,1700471580,30300,152053,125435,TR,TR
137072,1700655000,1700684460,29460,106726,65090,TR,TR
32630,1699690200,1699718700,28500,144537,152714,DE,DE
1017,1699172040,1699176600,4560,72047,10731,NL,NL
98690,1699604940,1699608540,3600,175501,89928,NL,BE
167483,1699280220,1699312560,32340,9082,82749,TR,TR
187437,1699067220,1699073820,6600,182413,186358,NL,NL
13716,1698991560,1699017900,26340,39776,118850,DE,NL
147866,1698866340,1698873660,7320,41549,10603,HR,HR
39529,1699456020,1699491300,35280,168726,185910,TR,TR
27922,1700105220,1700139960,34740,103260,139501,TR,TR
74807,1699612200,1699633560,21360,30373,97071,FR,DE
178432,1698879600,1698890460,10860,199463,168407,AT,SK
38200,1700295240,1700309760,14520,39303,129750,US,US
17505,1699373100,1699398240,25140,66133,70501,RO,RO
20902,1700382360,1700411160,28800,54511,183448,TR,TR
28090,1700775600,1700784540,8940,123411,182963,IT,IT
84384,1699909920,1699913700,3780,21867,78252,NL,NL
100896,1699366980,1699397280,30300,8547,138153,TR,TR
67102,1699078320,1699110000,31680,27494,159455,TR,TR
66961,1699368840,1699400340,31500,33246,170989,TR,TR
144608,1700423160,1700453580,30420,148151,88251,TR,TR
127135,1699916460,1699924440,7980,10302,189147,IT,IT
86582,1699857240,1699887780,30540,91581,104609,TR,TR
176892,1700008260,1700040540,32280,194474,158262,TR,TR
161001,1699121580,1699150500,28920,75780,199684,TR,TR
136900,1700627760,1700666100,38340,42555,67140,MX,MX
829,1700685300,1700715420,30120,44220,101763,TR,TR
81053,1699435440,1699450980,15540,185677,157109,US,US
116205,1699341540,1699377480,35940,61284,139592,MX,MX
114861,1699701060,1699731540,30480,2710,22619,TR,TR
93471,1700208300,1700221320,13020,199901,21672,IT,IT
8801,1700030940,1700063580,32640,144791,173534,TR,TR
8076,1700809740,1700839800,30060,71837,174402,TR,TR
81705,1699672620,1699685520,12900,75160,156891,US,US
187082,1700678940,1700689020,10080,19927,164256,IT,IT
114721,1699072980,1699076580,3600,69981,186036,GB,GB
53311,1700105040,1700111940,6900,85517,70452,GB,GB
93196,1698990900,1699006440,15540,5440,104262,SE,SE
127075,1700814360,1700843340,28980,123433,76994,TR,TR
13742,1700001240,1700018640,17400,108260,65324,US,US
12713,1700005200,1700016300,11100,11992,157678,US,US
136589,1700316240,1700347380,31140,96089,120864,TR,TR
184896,1699211220,1699218840,7620,133324,49742,IT,IT
193535,1700701860,1700712060,10200,137124,138452,IT,IT
28423,1700589840,1700621040,31200,35285,16508,TR,TR
128408,1699897380,1699926240,28860,33465,188899,TR,TR
170468,1698848880,1698883560,34680,112422,40444,TR,TR
58866,1699596720,1699602060,5340,48161,57174,NL,NL
78472,1699559040,1699571640,12600,148010,74701,HR,HR
116485,1700342700,1700381640,38940,46230,61644,MX,MX
64258,1700157240,1700187420,30180,74000,172815,TR,TR
122864,1699235040,1699242300,7260,78721,121044,PT,PT
197033,1699664280,1699676460,12180,156315,2827,CA,US
170305,1699412460,1699436520,24060,89851,33368,DE,DE
168422,1700283660,1700318940,35280,167002,171290,TR,TR
197055,1699195560,1699219440,23880,79843,196636,RO,RO
70152,1699801200,1699830840,29640,80191,25389,TR,TR
130575,1699166220,1699198920,32700,1374,65255,TR,TR
82069,1698970380,1699005420,35040,843,113187,TR,TR
22981,1698852600,1698884940,32340,13126,170630,TR,TR
185908,1700382060,1700385960,3900,110705,7854,GB,GB
4684,1699524000,1699536060,12060,174416,28260,IT,IT
30878,1700852640,1700883000,30360,185321,86251,TR,TR
4177,1700196540,1700209260,12720,93611,195366,HR,HR
49743,1700102280,1700134140,31860,35323,11550,TR,TR
43304,1700518140,1700538420,20280,95144,152654,FR,CZ
107748,1700140320,1700159100,18780,42633,76333,FR,FR
169669,1699068000,1699077120,9120,63877,169952,IT,IT
171733,1699803960,1699829280,25320,142786,173596,RO,AT
174637,1700736660,1700771340,34680,133872,169686,TR,TR
93385,1699984620,1699991160,6540,84521,132874,GB,GB
174026,1700560500,1700573340,12840,45059,25936,US,US
128752,1699830180,1699842540,12360,51782,165115,US,US
57221,1699643520,1699654440,10920,163864,171698,IT,IT
60173,1699747080,1699750680,3600,682,84691,GB,GB
125021,1700574660,1700610060,35400,47953,89431,TR,TR
26659,1700490360,1700522880,32520,167416,177343,TR,TR
183772,1700246160,1700274240,28080,21677,185244,DE,DE
150494,1699131000,1699134600,3600,97337,25881,NL,NL
27607,1700320680,1700346780,26100,7384,65939,CH,IT
145528,1699082280,1699092420,10140,29771,121385,SK,AT
41685,1699192020,1699203780,11760,11979,183939,IT,IT
158695,1699964100,1699995300,31200,84940,182084,TR,TR
122212,1699764840,1699769400,4560,26872,30757,GB,GB
114312,1699924980,1699956720,31740,73137,145136,TR,TR
193824,1700695920,1700712060,16140,103597,49910,RS,DE
8135,1699928580,1699959780,31200,175974,19805,TR,TR
113886,1700758620,1700770140,11520,125367,171558,IT,IT
129516,1700647620,1700656500,8880,183902,99364,SK,SK
80233,1699139400,1699173360,33960,165900,47680,TR,TR
154091,1699208340,1699211940,3600,63588,107996,GB,GB
152053,1700178600,1700195580,16980,68923,177276,FR,DE
113505,1699786740,1699815960,29220,48156,157488,TR,TR
126119,1700272680,1700281500,8820,72345,61618,IT,IT
173482,1700524140,1700557200,33060,56642,131360,TR,TR
116351,1700113020,1700131620,18600,90546,164612,FR,BE
119990,1699322640,1699333260,10620,77909,31177,IT,IT
152387,1700336100,1700345520,9420,150052,97113,IT,IT
197945,1700015100,1700030640,15540,53486,148798,AT,AT
34435,1700373600,1700385660,12060,68022,36204,IT,IT
125147,1699904100,1699921200,17100,168474,174602,US,US
172091,1699604460,1699635240,30780,97581,192650,TR,TR
165792,1698965760,1698969360,3600,147082,100724,NL,NL
77300,1699354200,1699385100,30900,55504,155866,TR,TR
64287,1699791840,1699796940,5100,42715,104413,NL,NL
56610,1699554900,1699584840,29940,7626,156553,BA,HR
124620,1700236920,1700265780,28860,162363,86199,TR,TR
30176,1700619720,1700635800,16080,147945,118324,RS,RS
123075,1699661640,1699692540,30900,90341,39876,TR,TR
144171,1699987320,1700004720,17400,100319,3990,US,US
153288,1699207440,1699218120,10680,152164,68983,PT,LU
177019,1700508180,1700540580,32400,151236,29864,TR,TR
146450,1700703300,1700735820,32520,36068,2404,TR,TR
105916,1699945140,1699957200,12060,183869,7760,IT,ES
46307,1700648640,1700682900,34260,113654,195028,TR,TR
143543,1699239480,1699251180,11700,100677,23260,US,US
98227,1700377800,1700390340,12540,17444,61413,US,US
110783,1698901200,1698915180,13980,196271,52391,PT,IT
127467,1699224600,1699235520,10920,128288,63054,IT,IT
61920,1698818220,1698821880,3660,38958,131492,GB,GB
135635,1700030460,1700034060,3600,15231,5716,GB,GB
33108,1699941600,1699945200,3600,28933,62520,GB,GB
112516,1700024520,1700035560,11040,126335,154032,ES,ES
21675,1700512500,1700544360,31860,65455,189653,TR,TR
32529,1698857580,1698868800,11220,61778,161636,US,US
108673,1700569860,1700578920,9060,92776,64140,HR,HR
58491,1700358120,1700374320,16200,32848,162210,US,US
97786,1700424540,1700428140,3600,20171,115539,GB,GB
89579,1699468320,1699503540,35220,192505,84860,TR,TR
140842,1700648100,1700662260,14160,51335,193724,PT,PT
65266,1700223360,1700237160,13800,151608,170929,US,US
184821,1699071840,1699084320,12480,126487,21927,US,US
76210,1700005380,1700012040,6660,180195,62906,NL,NL
142875,1700339460,1700352000,12540,19119,23139,IT,IT
12872,1700232960,1700267700,34740,152176,69952,TR,TR
191241,1700655480,1700662200,6720,26109,22554,NL,NL
97933,1700788500,1700818020,29520,123110,198593,TR,TR
155152,1699633620,1699664700,31080,48620,82958,TR,TR
179427,1700473560,1700489280,15720,54672,100071,RS,RS
13653,1700622120,1700629920,7800,148963,142633,ES,ES
185084,1699207680,1699237260,29580,56704,40591,TR,TR
186528,1700094180,1700113860,19680,196382,175072,BE,NL
28154,1700249580,1700275140,25560,38546,16126,DE,DE
121502,1700263020,1700296980,33960,39859,65447,TR,TR
68519,1700306580,1700339160,32580,186493,58893,TR,TR
130792,1700235540,1700241960,6420,167030,114701,GB,GB
106599,1700581800,1700592240,10440,162672,31643,IT,IT
179458,1699441380,1699477140,35760,192930,180131,TR,TR
486,1700747820,1700779440,31620,46552,35272,TR,TR
137902,1699730040,1699738920,8880,57078,25622,ES,ES
125510,1698968640,1699004100,35460,17996,158573,TR,TR
141189,1699552920,1699564800,11880,18223,114743,US,US
30688,1700372940,1700407680,34740,81578,137019,MX,MX
105893,1700398860,1700402460,3600,48036,74292,GB,GB
32728,1699048140,1699060800,12660,164144,142635,US,US
133550,1700750640,1700770860,20220,155963,168637,FR,IT
32681,1700692980,1700715180,22200,26002,57009,RO,RO
184967,1698987840,1699017000,29160,133394,161370,TR,TR
165887,1699765620,1699799220,33600,158904,138185,MX,MX
124164,1699841820,1699875360,33540,198980,140523,MX,MX
100790,1699503420,1699526700,23280,39487,196229,DE,DE
137240,1700025060,1700036820,11760,92209,115452,US,US
165362,1699195080,1699198680,3600,40864,54666,GB,GB
138031,1700145600,1700149260,3660,62250,88804,GB,GB
185391,1699987500,1699996440,8940,71659,152360,IT,IT
164342,1700295600,1700318460,22860,2453,142071,RO,RO
190871,1700695260,1700707620,12360,124198,178978,CZ,CZ
174911,1700033520,1700037720,4200,69305,70525,GB,GB
134594,1699269660,1699299300,29640,49309,26451,TR,TR
41071,1700726280,1700740500,14220,158930,6103,IT,IT
179551,1699112820,1699120920,8100,105481,112671,IT,IT
128472,1700167560,1700200740,33180,123645,104408,TR,TR
176702,1699559400,1699566900,7500,80371,181479,IT,DE
67840,1700336040,1700364720,28680,185979,99865,RO,MD
195753,1700516460,1700553060,36600,22414,178657,MX,US
86941,1700554980,1700587860,32880,32157,34376,TR,TR
8020,1699696860,1699731660,34800,180608,165410,TR,TR
148712,1699945560,1699949760,4200,24283,50942,GB,GB
184510,1699554960,1699562460,7500,178866,61290,IT,IT
162842,1698883320,1698919080,35760,103428,122655,TR,TR
14661,1698897720,1698930720,33000,15602,3179,TR,TR
162699,1698820980,1698828360,7380,166901,95668,HR,HR
122402,1700644500,1700678580,34080,175178,183732,TR,TR
46973,1699907460,1699912260,4800,197852,181084,GB,GB
92194,1700142300,1700154240,11940,117551,184582,ES,ES
157393,1699633320,1699641120,7800,31956,112492,ES,PT
149429,1700209020,1700224320,15300,27865,19544,US,US
196798,1699376820,1699393440,16620,154404,163793,US,MX
137296,1699921200,1699953780,32580,81248,130851,TR,TR
52637,1700673960,1700697480,23520,167382,37277,DE,DE
137215,1700835780,1700839380,3600,65048,66485,GB,GB
46663,1700403600,1700413440,9840,83599,152419,IT,IT
155362,1700665260,1700690220,24960,197441,81308,BR,BR
116093,1699835940,1699866360,30420,69577,48541,TR,TR
57950,1700419080,1700431620,12540,56054,27,IT,IT
157903,1700312940,1700348340,35400,178392,25748,TR,TR
40618,1699935120,1699962480,27360,172511,166293,CH,IT
38990,1700090220,1700125200,34980,112338,67052,MX,MX
140312,1700383320,1700386920,3600,60999,4539,NL,NL
136373,1700409240,1700425020,15780,53283,198770,US,US
61374,1700646000,1700680080,34080,69337,7060,TR,TR
140092,1699026780,1699062540,35760,111888,130399,TR,TR
175208,1699241460,1699255260,13800,114375,193128,US,US
30607,1699825920,1699842420,16500,189147,197377,US,US
199767,1700295900,1700322720,26820,50993,126582,DE,DE
78144,1699318560,1699348560,30000,168544,119975,TR,TR
89350,1698965880,1698978600,12720,62236,154861,IT,IT
46470,1700839980,1700872320,32340,103714,187609,TR,TR
23163,1700810460,1700819340,8880,158780,126625,IT,IT
45768,1698959280,1698986160,26880,183153,194674,BA,SI
124958,1700308140,1700325000,16860,90792,15311,RS,FR
68574,1700596440,1700613900,17460,35197,47238,US,US
92310,1699588080,1699618440,30360,10867,52851,TR,TR
171126,1700222040,1700226000,3960,116677,115294,GB,GB
1419,1699887360,1699891980,4620,143499,2176,GB,GB
157725,1699166580,1699180020,13440,4891,25269,US,US
25757,1699841460,1699845060,3600,23282,122972,NL,NL
168489,1699440660,1699449960,9300,135071,187379,HR,HR
199040,1700644980,1700674200,29220,43486,118239,TR,TR
96753,1700556120,1700567220,11100,184259,57799,US,US
78360,1700180160,1700183760,3600,36594,186827,NL,DE
114554,1699363080,1699366680,3600,100188,14576,NL,FR
163157,1700448840,1700481420,32580,199217,87110,TR,TR
46710,1700742300,1700775660,33360,51696,136326,TR,TR
72354,1700845920,1700875320,29400,32873,5789,TR,TR
108264,1699305780,1699330380,24600,107599,26362,DE,CZ
115234,1700402880,1700425440,22560,2854,152520,DE,FR
169519,1699606020,1699618080,12060,159141,35819,IT,IT
146049,1700100300,1700134740,34440,188015,50158,TR,TR
109893,1700616360,1700631840,15480,94640,121365,US,US
32857,1700263560,1700298480,34920,199766,53725,TR,TR
83420,1698858000,1698881100,23100,91465,96359,CH,FR
14024,1699407780,1699430040,22260,83435,101829,DE,DE
131032,1699476420,1699505760,29340,126188,103335,TR,TR
190260,1700025540,1700054880,29340,18529,58399,TR,TR
14173,1699119180,1699138380,19200,72406,55490,FR,ES
54890,1698863580,1698867180,3600,84979,144297,NL,DE
58019,1699113000,1699144080,31080,110362,140850,TR,TR
115669,1699543140,1699574400,31260,155447,16847,TR,TR
190355,1699694880,1699707420,12540,58602,139037,HR,HR
5924,1699763160,1699791840,28680,58355,62448,DE,DE
147392,1699634640,1699638720,4080,96503,60485,NL,NL
11632,1699107360,1699116360,9000,191999,68286,HR,HR
107538,1700156220,1700168700,12480,1793,83411,US,US
13637,1699891680,1699919100,27420,45832,101026,DE,CZ
44026,1700439420,1700450340,10920,142976,137971,US,US
31580,1700783400,1700808180,24780,42545,69217,DE,ES
94246,1699213920,1699225860,11940,155855,77837,US,US
104399,1700096460,1700130360,33900,163980,162634,TR,TR
199972,1699056840,1699092120,35280,135988,90286,TR,TR
10288,1699937460,1699972500,35040,126407,125441,TR,TR
199320,1700425560,1700438580,13020,48539,94867,CZ,CZ
75523,1698823380,1698843240,19860,103708,183539,FR,FR
102692,1700437680,1700447820,10140,92488,188895,ES,DE
113655,1698836160,1698839760,3600,160252,154458,GB,GB
78805,1699917120,1699922280,5160,150502,196988,NL,NL
169417,1700133900,1700151600,17700,38214,181692,US,MX
96614,1699126080,1699154940,28860,174808,109609,TR,TR
64020,1699149000,1699154040,5040,12362,179834,NL,NL
20447,1700481240,1700513580,32340,60945,47638,TR,TR
109173,1700607420,1700636460,29040,190847,141748,TR,TR
83817,1700585580,1700614500,28920,1310,128832,TR,TR
96383,1700376120,1700392020,15900,167795,58138,FR,PL
186176,1699542660,1699576260,33600,149571,119578,TR,TR
41197,1700028480,1700083260,54780,31773,135951,BG,DE
155355,1700415420,1700422620,7200,158110,195587,PT,PT
75815,1700513160,1700547480,34320,40050,123770,TR,TR
166390,1700630460,1700664660,34200,55951,96028,TR,TR
138054,1699163220,1699180380,17160,90101,56099,US,US
140353,1700410800,1700434920,24120,16085,176219,BR,BR
36132,1699165560,1699182600,17040,49877,68382,US,US
115742,1699818180,1699829880,11700,139184,86863,HR,HR
187038,1700692560,1700700420,7860,193924,188281,AD,ES
144809,1699674360,1699705140,30780,134128,133634,TR,TR
1722,1699646640,1699681980,35340,146927,99295,TR,TR
84114,1700285520,1700289120,3600,15572,35779,GB,GB
192457,1700383500,1700395560,12060,84801,95601,IT,IT
57995,1699929420,1699963260,33840,199170,125943,TR,TR
107121,1699729680,1699760220,30540,196764,24414,TR,TR
119415,1699334400,1699365300,30900,91018,24485,TR,TR
13193,1700117100,1700133660,16560,48919,192163,RS,RS
138717,1700178240,1700211720,33480,26061,89853,TR,TR
43040,1700203740,1700235240,31500,144134,40012,TR,TR
8733,1700310240,1700323920,13680,136483,42496,AT,AT
168096,1699403820,1699437600,33780,136740,163413,TR,TR
81627,1700273640,1700283000,9360,117384,129136,HR,HR
194097,1700799300,1700835300,36000,133628,183453,MX,MX
137859,1699856280,1699891260,34980,161311,135241,TR,TR
26597,1700428560,1700436540,7980,124409,14309,SK,SK
142741,1699688460,1699700940,12480,19798,197839,IT,IT
31112,1700706300,1700713680,7380,71491,163649,ES,ES
52548,1698865980,1698882240,16260,114729,110606,US,US
49318,1699645020,1699661940,16920,79343,128421,US,US
106279,1700043660,1700055780,12120,8971,91753,CZ,HU
175646,1700861940,1700884500,22560,92260,120214,BR,BR
77689,1699119780,1699147560,27780,114740,109721,PL,PL
27941,1699497180,1699511940,14760,182618,176409,US,US
193388,1700463900,1700498460,34560,5872,152184,TR,TR
1844,1699215900,1699250100,34200,166531,63103,TR,TR
162534,1700339340,1700353080,13740,31935,153070,CZ,SK
8768,1699826700,1699861320,34620,55231,99039,TR,TR
114960,1699869840,1699882860,13020,187920,84975,US,US
176380,1699607640,1699625520,17880,103214,45849,US,US
45882,1699194840,1699198440,3600,23805,110181,GB,GB
70612,1700781840,1700795760,13920,105410,194939,PT,PT
96253,1700802000,1700835540,33540,171426,71133,TR,TR
103055,1700823540,1700832000,8460,69428,21589,IT,FR
185530,1699450080,1699485960,35880,103055,46683,TR,TR
17402,1700096340,1700114640,18300,75899,148218,FR,FR
167714,1700424480,1700437860,13380,2803,84831,US,US
91577,1699378620,1699394280,15660,68685,156116,US,US
127376,1700670420,1700677860,7440,59165,116432,HR,HR
102335,1700549280,1700583960,34680,181528,165811,TR,TR
46767,1700768220,1700771820,3600,3743,175301,GB,GB
116286,1699846920,1699879860,32940,113839,143223,TR,TR
43269,1699664700,1699693320,28620,148248,119311,CH,FR
51623,1700190720,1700200260,9540,100236,24745,IT,IT
138099,1699503720,1699529820,26100,56945,18548,PL,HR
165767,1699815600,1699833000,17400,171209,80100,FR,FR
122307,1700397900,1700431380,33480,135566,159636,TR,TR
55667,1699090860,1699124580,33720,175305,160241,TR,TR
6873,1700282400,1700306700,24300,163015,145639,DE,PL
72729,1700043180,1700046780,3600,67707,197953,GB,GB
191011,1699847280,1699858140,10860,99720,181223,US,US
115025,1700592780,1700611140,18360,137821,12811,SE,SE
60039,1700697780,1700721900,24120,60746,48251,PL,PL
104003,1699282020,1699293540,11520,47686,149860,US,US
172021,1700090940,1700098800,7860,187186,89991,IT,IT
48238,1698960000,1698975780,15780,121787,45191,US,US
125703,1699200780,1699212180,11400,128909,125293,IT,IT
93264,1699269840,1699274700,4860,82142,153224,NL,NL
113578,1700210520,1700217120,6600,118335,133168,GB,GB
136544,1700563440,1700576640,13200,107777,9929,US,US
129609,1699076280,1699090620,14340,98909,125949,US,US
27158,1699462020,1699476780,14760,176395,182666,US,US
116479,1700826600,1700858700,32100,89257,20419,TR,TR
81636,1700748540,1700762100,13560,173950,23696,US,US
82508,1700111220,1700116800,5580,125132,199223,GB,GB
196747,1700433780,1700440140,6360,8632,167062,NL,NL
91666,1699343700,1699378320,34620,113245,60150,TR,TR
55514,1700040480,1700051940,11460,173338,81985,ES,ES
36596,1698879000,1698914820,35820,170966,104462,TR,TR
158820,1700788260,1700826960,38700,108856,113620,MX,US
83966,1700519520,1700523120,3600,136721,78653,GB,GB
161352,1699270440,1699303260,32820,38628,47021,TR,TR
181248,1699592460,1699597320,4860,130505,73746,NL,BE
26710,1699318200,1699321860,3660,170607,146650,NL,NL
62550,1700067060,1700096940,29880,91874,48002,TR,TR
135032,1699871520,1699903440,31920,31607,160483,TR,TR
13101,1699288440,1699298220,9780,196299,45985,IT,IT
183531,1700198640,1700216460,17820,48336,148203,US,US
137913,1698967620,1698996780,29160,181229,29716,TR,TR
29347,1698989460,1699018740,29280,63524,137356,TR,TR
143903,1700735820,1700747880,12060,160541,101273,US,US
108121,1699982640,1700002560,19920,10543,92098,FR,FR
28778,1700269440,1700296740,27300,25791,175363,DE,FR
102364,1699584900,1699614060,29160,155009,123115,TR,TR
28109,1698843660,1698878460,34800,70168,67795,MX,MX
171000,1699421400,1699454700,33300,53145,167221,TR,TR
140152,1700337360,1700343600,6240,37792,111782,GB,GB
96163,1699649340,1699665480,16140,190927,113450,CZ,FR
197458,1699701240,1699726620,25380,75606,40186,DE,DE
21904,1699057740,1699082460,24720,172738,194907,DE,LU
141258,1699839300,1699842900,3600,117558,136090,NL,NL
57805,1700185800,1700196780,10980,138081,143094,AT,DE
70746,1699118520,1699150680,32160,10180,127955,TR,TR
79508,1700392620,1700396220,3600,106239,108363,NL,NL
127582,1700526960,1700534040,7080,198416,99503,NL,FR
14850,1699720800,1699727460,6660,76235,69760,GB,GB
129469,1698906000,1698935820,29820,147492,85551,TR,TR
157885,1700723460,1700731320,7860,159125,195358,HR,HR
17204,1700171640,1700175240,3600,148620,148452,GB,GB
90871,1699291380,1699316940,25560,132065,64161,BR,BR
141903,1700849400,1700853000,3600,89379,143084,GB,GB
170027,1700388900,1700401980,13080,113217,154267,AT,AT
175029,1700301840,1700336280,34440,108104,92100,TR,TR
3775,1699388400,1699392000,3600,42437,176331,GB,GB
12127,1699336320,1699341480,5160,152914,45510,GB,GB
165198,1699971060,1700004180,33120,114144,9073,TR,TR
60462,1699427280,1699447800,20520,106147,100707,FR,DE
9272,1699892400,1699905300,12900,197049,6871,RS,RS
69491,1699031820,1699059120,27300,157549,1295,DE,IT
159492,1699531620,1699565640,34020,187945,95970,TR,TR
123365,1700535960,1700561760,25800,174537,115710,PL,DE
321,1699009500,1699013100,3600,127876,184892,GB,GB
88492,1700215200,1700226840,11640,80364,103151,HR,HR
55011,1700833440,1700837160,3720,166329,61462,NL,NL
37404,1700192760,1700199240,6480,140571,46120,NL,NL
7500,1700736060,1700747100,11040,144601,198461,HR,HR
11648,1700644800,1700662380,17580,185394,166826,US,US
92826,1699700940,1699711740,10800,169500,165182,US,US
125684,1698977340,1698994980,17640,133579,16100,US,US
49661,1700701080,1700704680,3600,5841,40002,GB,GB
143784,1700738820,1700772000,33180,140167,110407,TR,TR
104465,1699993260,1700044320,51060,9357,179696,BG,TR
93621,1700605860,1700621700,15840,97067,149376,US,US
186203,1699995960,1700029860,33900,93691,102160,TR,TR
64641,1700628660,1700663640,34980,40091,54402,TR,TR
3371,1700204100,1700234700,30600,69158,106022,TR,TR
114155,1699082340,1699114440,32100,100104,161399,TR,TR
56751,1699687920,1699699800,11880,139069,7673,AT,AT
99327,1700162100,1700195640,33540,67954,159512,TR,TR
65079,1700235420,1700258940,23520,105699,17504,DE,DE
95261,1698869220,1698903900,34680,11616,190270,TR,TR
115040,1699524300,1699532460,8160,131367,50856,PT,PT
106061,1699146180,1699152540,6360,18349,29085,NL,NL
163066,1699860360,1699876680,16320,92897,27410,US,US
192515,1699423980,1699459740,35760,192066,127688,TR,TR
73407,1699336920,1699343880,6960,21250,183582,GB,GB
37819,1700653380,1700674380,21000,153700,143902,FR,NL
118164,1699408860,1699423560,14700,156075,46271,FR,IT
17323,1700337480,1700374680,37200,102647,159931,MX,MX
25922,1699740180,1699744860,4680,41091,195974,EE,EE
143795,1699358640,1699364640,6000,175066,85481,GB,GB
11150,1699351080,1699359000,7920,135116,177046,EE,EE
132905,1700568000,1700581740,13740,182890,53455,US,US
167010,1699926960,1699952220,25260,172367,35590,DE,DE
107892,1699219080,1699254480,35400,138640,180169,MX,MX
149363,1699579320,1699583460,4140,91162,133798,NL,NL
63525,1700285640,1700296800,11160,172499,185139,US,US
59095,1699483260,1699495140,11880,8336,168799,US,US
92709,1699425720,1699452000,26280,131810,146513,HU,AT
77078,1699870680,1699880640,9960,63883,162961,HR,HR
162661,1700110080,1700143080,33000,180096,118167,TR,TR
114829,1700284260,1700288280,4020,46106,181417,NL,NL
39095,1700645040,1700654520,9480,118671,160754,IT,IT
22275,1700056560,1700088240,31680,95593,119060,TR,TR
74673,1699969740,1699973340,3600,56338,10307,NL,NL
156385,1700432400,1700462160,29760,183529,177060,TR,TR
42117,1700072460,1700098080,25620,121430,58574,BR,BR
33570,1699072200,1699105380,33180,11907,63618,MX,MX
55027,1699993920,1700007420,13500,88545,40102,HR,HR
95678,1699471140,1699500420,29280,96053,36681,TR,TR
118212,1700217300,1700249880,32580,81996,100345,TR,TR
132422,1700098140,1700119680,21540,149840,6539,BE,NL
167237,1699732620,1699757940,25320,63661,112086,CH,IT
105085,1699708800,1699741680,32880,156365,13532,TR,TR
63496,1698838860,1698857040,18180,96563,18731,BE,FR
74289,1698983160,1699000380,17220,58463,2962,FR,FR
191993,1700561700,1700595900,34200,173955,125079,TR,TR
153078,1699345560,1699378080,32520,102570,45486,TR,TR
74825,1699425900,1699461060,35160,146351,98785,TR,TR
145891,1699431360,1699435920,4560,180106,23084,NL,NL
34828,1700430360,1700438280,7920,166639,93427,HR,HR
169896,1699911960,1699923900,11940,53011,44022,PT,PT
198467,1699210800,1699226760,15960,63398,30446,FR,FR
92842,1699886040,1699918080,32040,57479,158581,TR,TR
83011,1700633160,1700650500,17340,129515,1269,RS,RS
43508,1698983820,1698998160,14340,100863,104726,RS,RS
134177,1699556640,1699590420,33780,62024,165544,MX,MX
47709,1700062800,1700098020,35220,168336,31078,TR,TR
24661,1698922620,1698956580,33960,21260,156100,TR,TR
90968,1699704780,1699722060,17280,82400,16213,US,US
174181,1699276020,1699279620,3600,180635,134997,GB,GB
61506,1699910340,1699923900,13560,50220,102003,US,US
32314,1699234680,1699245600,10920,103191,178801,HR,HR
40095,1699508280,1699561860,53580,50515,65144,BG,AL
19575,1699551900,1699567500,15600,72705,52483,US,US
116213,1699950480,1699978080,27600,96034,118764,PL,PL
104870,1700094660,1700127840,33180,160578,65961,TR,TR
194509,1699644660,1699678500,33840,16586,179832,TR,TR
150952,1699439520,1699452540,13020,152796,47084,US,US
2025,1699552800,1699569300,16500,155161,77146,US,US
24741,1700687460,1700701200,13740,57648,14136,IT,IT
116765,1699482720,1699499640,16920,197086,115312,US,US
21329,1700504700,1700511300,6600,38621,45568,NL,NL
138286,1698919500,1698934440,14940,1300,117907,BE,FR
100528,1699648920,1699657680,8760,12817,117863,IT,IT
193545,1699337580,1699350120,12540,120651,48905,CZ,CZ
108918,1699564740,1699587180,22440,155135,78703,PL,PL
45546,1699245480,1699251900,6420,50439,131515,GB,GB
87648,1700780760,1700791740,10980,47239,191610,IT,IT
102708,1700405160,1700438580,33420,58620,72464,TR,TR
52936,1699942140,1699958340,16200,48547,181239,US,US
145372,1699743300,1699777260,33960,49056,107191,TR,TR
96901,1699153320,1699159860,6540,16762,16955,GB,GB
88025,1699750200,1699764540,14340,132503,80263,PT,PT
188373,1700429640,1700442000,12360,73474,82476,IT,IT
167468,1698958680,1698985740,27060,1552,81733,DE,RS
155659,1699137000,1699169100,32100,92812,82608,TR,TR
10645,1699345800,1699350660,4860,142497,80410,NL,NL
2366,1699376580,1699407900,31320,186111,176645,TR,TR
90993,1699403520,1699413000,9480,114163,186312,IT,IT
39949,1698960240,1698973860,13620,174549,75198,US,US
32123,1700400960,1700404560,3600,134133,57558,NL,NL
176616,1699288200,1699304940,16740,32344,193257,US,MX
155818,1699091580,1699104600,13020,188176,188829,US,US
83733,1700076180,1700110140,33960,82025,26370,TR,TR
125090,1698922800,1698936420,13620,107942,42052,US,US
33419,1700635800,1700642520,6720,90610,88727,GB,GB
90818,1700375520,1700379120,3600,31653,109163,GB,GB
128346,1700269380,1700276280,6900,59279,158504,GB,GB
41262,1700190600,1700195460,4860,141100,195634,GB,GB
17332,1700849520,1700853480,3960,66,168178,GB,GB
11162,1699012200,1699047060,34860,25066,50810,TR,TR
144695,1699184340,1699187940,3600,162233,142028,NL,NL
98309,1699897980,1699906380,8400,148879,171639,IT,FR
126582,1699424640,1699437120,12480,21525,141360,IT,IT
109465,1700858820,1700862420,3600,136942,192402,NL,NL
120525,1699647960,1699677780,29820,156538,63446,TR,TR
125337,1698872580,1698907200,34620,145668,28691,TR,TR
149968,1699165320,1699179780,14460,11256,42210,US,US
162197,1699742760,1699762440,19680,49206,128520,SI,RS
113891,1699590000,1699596240,6240,99527,81536,GB,GB
135551,1699620540,1699652280,31740,16929,133425,TR,TR
127974,1700746080,1700759700,13620,83496,137961,US,US
78346,1698881640,1698898260,16620,162496,12120,FR,ES
185138,1699068420,1699083300,14880,198596,144815,US,US
134415,1700375280,1700380980,5700,163623,59938,NL,NL
30473,1700733240,1700760240,27000,187953,9638,PL,PL
38526,1700533860,1700541360,7500,127558,75180,HR,IT
53052,1699197600,1699209300,11700,130816,15780,US,US
95550,1699670940,1699710120,39180,4129,120703,MX,MX
19929,1698996240,1699011660,15420,147489,101983,RS,ME
182492,1700313360,1700345220,31860,71838,143519,TR,TR
115109,1700080740,1700091960,11220,47885,136081,US,US
134940,1699128720,1699137840,9120,784,171895,CL,CL
56539,1699180560,1699216140,35580,125263,80804,TR,TR
23822,1699413120,1699447080,33960,154543,22493,TR,TR
88724,1700760900,1700778540,17640,40971,87014,US,US
65325,1700403420,1700416800,13380,143527,45005,CZ,FR
114917,1700497320,1700527080,29760,199408,184043,TR,TR
112376,1698873000,1698884220,11220,49223,197553,US,US
183459,1700396580,1700431740,35160,167889,26818,TR,TR
21421,1700111880,1700117880,6000,27483,184142,NL,NL
7658,1699497180,1699511220,14040,63644,12981,US,US
169710,1700067840,1700084280,16440,41735,182461,US,US
156147,1699264920,1699268520,3600,89366,77827,NL,NL
176763,1699674900,1699689480,14580,79311,90120,US,US
135306,1699798620,1699802820,4200,26203,51332,NL,NL
23356,1700476080,1700485080,9000,29843,22975,IT,IT
23230,1699137720,1699157040,19320,123057,43574,FR,FR
106085,1700399940,1700403540,3600,38116,126924,GB,GB
85332,1700603940,1700632380,28440,160327,9816,ME,RS
41944,1699748340,1699783500,35160,162234,52325,MX,US
151540,1700253000,1700256600,3600,41889,51784,GB,GB
179123,1700012580,1700020680,8100,52994,40674,IT,IT
51934,1699991940,1700024580,32640,51519,197486,TR,TR
98112,1699849080,1699879380,30300,58580,33367,TR,TR
187234,1700776260,1700779860,3600,50815,83766,NL,NL
187919,1700094540,1700129880,35340,7068,136067,TR,TR
5722,1699494240,1699502280,8040,87483,138977,IT,HU
140636,1698944460,1698967440,22980,190914,8504,PL,DE
23528,1698822360,1698855960,33600,140442,86870,TR,TR
117742,1698815940,1698848340,32400,15412,97121,MX,MX
155224,1700809680,1700829960,20280,104420,121138,BE,NL
37449,1699581060,1699586820,5760,66773,95484,NL,DE
186477,1700766240,1700788980,22740,80875,145735,PL,HR
84270,1700082840,1700112720,29880,40027,41942,TR,TR
113445,1700427360,1700445300,17940,162634,50665,US,US
102530,1700843520,1700853360,9840,78588,127920,IT,IT
192574,1699719180,1699728420,9240,79107,60455,ES,AD
58780,1700471460,1700488080,16620,51805,89241,US,US
162832,1699587060,1699622580,35520,125625,70716,TR,TR
67912,1699101060,1699105800,4740,158147,24478,NL,NL
44171,1699976880,1700012100,35220,16120,183877,MX,MX
199936,1699862340,1699873380,11040,99644,84568,HR,PL
75950,1699641720,1699673340,31620,186328,158937,TR,TR
156418,1700375460,1700391660,16200,142902,186725,FR,NL
16023,1699787700,1699791300,3600,188774,152833,GB,GB
162982,1699064580,1699095480,30900,23115,88577,TR,TR
57268,1700057040,1700060640,3600,33483,74436,GB,GB
65619,1699405680,1699417440,11760,21727,119485,US,US
73253,1700406660,1700410260,3600,52025,34923,NL,NL
67679,1699844940,1699849920,4980,108647,54019,GB,GB
156360,1700057460,1700092980,35520,41086,189386,TR,TR
75770,1699202220,1699229580,27360,6075,109586,DE,PL
150755,1699180260,1699185540,5280,182081,97588,GB,GB
58732,1699743780,1699756140,12360,130221,162500,US,US
5102,1700865660,1700873580,7920,162345,44953,HR,HR
96870,1698897000,1698926400,29400,138706,161172,TR,TR
73421,1700584860,1700602680,17820,182276,56796,AT,AT
39226,1699193340,1699224060,30720,26170,140681,TR,TR
35091,1700640960,1700673780,32820,30695,167209,TR,TR
24975,1700688240,1700705220,16980,87784,165506,US,US
135054,1700546880,1700579520,32640,180498,52373,TR,TR
142579,1698805860,1698813900,8040,11267,60662,IT,IT
163940,1700378400,1700411820,33420,33298,56459,TR,TR
187115,1699818480,1699833780,15300,172581,111842,US,US
75142,1699337100,1699370460,33360,169355,17862,TR,TR
100324,1699055040,1699072800,17760,135417,10058,SE,SE
44864,1699033200,1699038240,5040,107803,124211,GB,GB
133283,1699680840,1699684440,3600,198308,151777,GB,GB
57070,1700345100,1700348700,3600,137995,77180,GB,GB
41759,1700546760,1700553420,6660,123631,136892,GB,GB
89807,1700320440,1700353980,33540,189357,169418,TR,TR
50629,1699419780,1699423380,3600,173441,81760,NL,NL
43726,1698800280,1698816000,15720,21810,140464,US,US
126835,1698962700,1698970320,7620,102355,187688,IT,IT
194098,1699447500,1699464180,16680,152289,162117,CZ,UA
120052,1699427940,1699440600,12660,38722,18224,IT,IT
58331,1700823960,1700840280,16320,28859,45419,US,US
42506,1699771500,1699783320,11820,76206,183769,US,US
7085,1699832820,1699868160,35340,79691,123067,TR,TR
162535,1700289120,1700303460,14340,127847,61898,US,US
150455,1700665440,1700681040,15600,44199,89712,US,US
128725,1699250160,1699282380,32220,32502,128935,TR,TR
174227,1700097600,1700109300,11700,36314,15060,AT,RS
218,1699500480,1699512660,12180,7115,21357,AT,AT
144826,1700005080,1700020380,15300,159638,44909,CZ,CZ
7509,1699790700,1699823940,33240,92645,198537,TR,TR
63722,1700326380,1700359020,32640,198700,10713,TR,TR
57118,1700512620,1700516220,3600,23642,28855,NL,FR
190864,1700828040,1700836500,8460,113740,35661,HR,HR
110860,1700446800,1700454120,7320,170232,3225,IT,IT
193586,1699576740,1699581900,5160,76844,18612,GB,GB
90149,1699310760,1699321620,10860,73,157731,US,US
13300,1699158900,1699173120,14220,112423,89566,HR,HR
141691,1699009560,1699044660,35100,193474,196311,TR,TR
186995,1699024020,1699074720,50700,136539,51025,BG,AT
67364,1700403660,1700438160,34500,5391,128778,TR,TR
38870,1700058720,1700086560,27840,103478,158419,PL,CZ
74899,1700519580,1700538360,18780,44586,177831,FR,FR
56693,1698910920,1698945540,34620,95055,70713,TR,TR
142051,1699363500,1699368060,4560,33307,192416,NL,NL
184838,1699767240,1699770840,3600,2064,34604,NL,NL
31280,1700049060,1700057280,8220,80232,156323,IT,IT
137557,1700283960,1700297520,13560,126021,162692,IT,IT
67609,1698801600,1698812100,10500,57697,190388,IT,IT
89607,1699020540,1699050660,30120,68280,23310,TR,TR
48254,1700603400,1700627460,24060,168025,68857,DE,PL
12643,1699162320,1699193820,31500,34686,31746,TR,TR
11677,1698877020,1698891060,14040,5895,99930,US,MX
14210,1700223240,1700255700,32460,137694,173104,TR,TR
170697,1699539240,1699543620,4380,174737,99643,GB,GB
163144,1698804720,1698817620,12900,15557,11833,US,US
3386,1700496720,1700501280,4560,109110,64301,GB,GB
100433,1699768500,1699786380,17880,133438,106766,CA,CA
7743,1699297980,1699301580,3600,60754,51307,GB,GB
40428,1699633140,1699649640,16500,158004,2825,FR,FR
40218,1700419260,1700454600,35340,143132,115025,TR,TR
135162,1700137440,1700171760,34320,44826,91653,TR,TR
131977,1698930780,1698960480,29700,161225,56771,TR,TR
160961,1699865220,1699881300,16080,186267,170059,US,US
23837,1699775700,1699792560,16860,5256,104521,RS,SI
103987,1699292220,1699347960,55740,138551,159034,UA,MD
79665,1700316360,1700324220,7860,95573,134567,IT,IT
35200,1699057140,1699086720,29580,99073,88831,TR,TR
31661,1700573700,1700604600,30900,197963,127514,TR,TR
170835,1700341260,1700368380,27120,40347,121723,BA,HR
109225,1700782620,1700796900,14280,85640,174324,IT,IT
196815,1699149660,1699153260,3600,120894,135233,NL,NL
61535,1700689200,1700706000,16800,24242,193739,US,US
1003,1700313120,1700327820,14700,75488,166170,CZ,CZ
199703,1699907580,1699921260,13680,185465,188089,IT,IT
145174,1699471380,1699481760,10380,27886,74418,PT,PT
144335,1700274180,1700306940,32760,152813,37659,TR,TR
113756,1700270340,1700286120,15780,198733,127488,US,US
161581,1700836500,1700840100,3600,135652,54077,GB,GB
74681,1700241360,1700244960,3600,135256,118388,NL,NL
50789,1700757060,1700791260,34200,938,167449,TR,TR
182370,1700351160,1700384520,33360,193956,31033,TR,TR
190550,1700126040,1700143260,17220,175438,81927,CZ,HR
197544,1700118000,1700149320,31320,146913,46818,TR,TR
31902,1699888920,1699910160,21240,194893,196138,FR,RO
124735,1699231740,1699244820,13080,97692,57499,IT,IT
52699,1700679240,1700690700,11460,119280,183466,US,US
42173,1700712480,1700729220,16740,112831,56579,US,CA
176298,1700854200,1700889300,35100,91108,145209,TR,TR
191585,1700338920,1700342520,3600,59956,194487,GB,GB
149542,1698982020,1698985620,3600,62599,74861,GB,GB
100248,1699365420,1699394820,29400,17771,10545,TR,TR
165276,1700589660,1700623080,33420,10921,4935,MX,MX
49412,1699336440,1699340040,3600,151886,178854,GB,GB
154957,1700199840,1700235300,35460,90902,112779,TR,TR
100553,1699698600,1699702200,3600,27528,161792,NL,NL
117269,1700575020,1700578620,3600,56690,127895,GB,GB
12095,1700639400,1700643000,3600,169424,60494,GB,GB
176939,1699523880,1699553340,29460,178894,54045,TR,TR
94813,1700866320,1700895540,29220,59860,177226,TR,TR
39621,1700024160,1700041500,17340,15719,80850,FR,FR
78385,1699939800,1699972560,32760,139717,82244,MX,MX
1315,1699502640,1699538220,35580,75885,176228,TR,TR
62758,1699827300,1699858140,30840,127046,26632,TR,TR
175227,1699923180,1699936440,13260,19174,143215,AT,AT
121585,1698904980,1698916440,11460,160558,140749,ES,ES
116202,1700403000,1700410920,7920,102873,131558,IT,IT
174517,1699520160,1699525980,5820,151687,148479,NL,NL
199099,1700790240,1700809680,19440,68107,33826,FR,NL
124253,1700086800,1700094840,8040,818,113888,CL,CL
189910,1698868860,1698880080,11220,193192,118557,CA,CA
161968,1699471680,1699509780,38100,179902,1540,MX,MX
160725,1700279640,1700314620,34980,60654,7327,TR,TR
85348,1700374320,1700410260,35940,46436,141905,TR,TR
106547,1700314980,1700347140,32160,7950,10383,TR,TR
158699,1700241900,1700249280,7380,105493,82880,ES,ES
44908,1700722500,1700754360,31860,95402,76144,TR,TR
25338,1700213100,1700219700,6600,64017,127119,GB,GB
52517,1700045820,1700062380,16560,196288,149613,RS,RS
14316,1699556340,1699578240,21900,45972,35168,DE,BA
4566,1700119380,1700142600,23220,54796,150584,DE,DK
81266,1698958980,1698989280,30300,34096,132516,TR,TR
199015,1700579520,1700606520,27000,125348,186586,RO,RO
52882,1700657700,1700668740,11040,106216,76231,US,US
143639,1700602320,1700615220,12900,163244,193873,US,US
130512,1699689540,1699697580,8040,69373,163627,IT,IT
107494,1699390980,1699394580,3600,96357,35788,GB,GB
12947,1699359840,1699370640,10800,58291,45463,HR,HR
195011,1700315220,1700320140,4920,11883,13076,NL,NL
31071,1700038800,1700044620,5820,97591,71692,NL,NL
9001,1699304700,1699339680,34980,174106,106577,TR,TR
68350,1699568700,1699573920,5220,58321,189530,NL,NL
179820,1700461440,1700466900,5460,91533,160871,GB,GB
122406,1699575300,1699604760,29460,122583,68763,TR,TR
103015,1699772520,1699776120,3600,46112,173917,NL,NL
4135,1699049760,1699070580,20820,195281,130942,FR,FR
82705,1699082100,1699097280,15180,184581,125822,US,US
153557,1700541780,1700555220,13440,42516,30825,RS,HR
141346,1700015640,1700027220,11580,4008,166936,SK,SK
6642,1700452860,1700485380,32520,101962,140788,TR,TR
109195,1700369400,1700382180,12780,133939,99091,HR,HR
180005,1699554780,1699584480,29700,96001,174349,TR,TR
198995,1699417320,1699431180,13860,60035,104304,IT,IT
99803,1699638240,1699644720,6480,109382,124745,NL,NL
178326,1700280120,1700294700,14580,28620,113097,US,US
177352,1699567620,1699591260,23640,197084,168047,DE,DK
117410,1700214060,1700239500,25440,137111,158291,PL,PL
167450,1699597560,1699609860,12300,181106,128277,RS,DE
53212,1698856800,1698886500,29700,175835,32731,TR,TR
80727,1700100240,1700134200,33960,77871,22540,TR,TR
33379,1699213380,1699228080,14700,180085,67104,US,US
59486,1699694460,1699725180,30720,183062,124431,TR,TR
170781,1699600320,1699634400,34080,159165,156597,TR,TR
6528,1699298880,1699313100,14220,136413,5913,US,US
26242,1699246080,1699283760,37680,94133,121965,MX,MX
99513,1699976640,1699990320,13680,133136,42005,IT,IT
61598,1700133000,1700147760,14760,45823,32869,US,US
119742,1699032480,1699037100,4620,184607,63577,GB,GB
45247,1699691340,1699713660,22320,176659,86028,PL,DE
69594,1700384520,1700388120,3600,76859,81753,GB,GB
20531,1700784540,1700805600,21060,166474,183823,AL,HR
161636,1699111800,1699115400,3600,114787,3357,GB,GB
76047,1699902540,1699912920,10380,191057,143963,HR,HR
37148,1700323980,1700354040,30060,22407,158075,TR,TR
120396,1700484420,1700499780,15360,172322,194096,US,US
7292,1700296620,1700317080,20460,6499,8007,FR,AD
12096,1699216920,1699228620,11700,103584,47281,IT,FR
199862,1700755200,1700762460,7260,27311,166935,IT,IT
27823,1700492340,1700511900,19560,80425,104472,FR,FR
109684,1700610600,1700615760,5160,193016,14419,GB,GB
38587,1700660940,1700674740,13800,66866,166274,US,US
193837,1700508780,1700520420,11640,110748,191231,US,MX
152382,1699990200,1700003220,13020,189874,104641,IT,IT
12557,1699476420,1699480560,4140,96677,165401,NL,NL
103076,1700723280,1700757240,33960,195936,95541,TR,TR
81165,1700490780,1700520660,29880,57582,167583,TR,TR
153351,1699360740,1699364760,4020,128583,138702,GB,GB
109292,1700487060,1700498460,11400,170547,48175,RS,ME
160235,1700229240,1700237640,8400,81662,143100,ES,ES
154451,1699332600,1699367340,34740,77579,107178,TR,TR
173855,1698842700,1698873120,30420,29821,126088,TR,TR
75026,1700402760,1700438040,35280,31606,112711,TR,TR
158888,1699876320,1699909980,33660,38855,84511,TR,TR
195607,1699170240,1699187040,16800,176998,59375,US,US
14003,1700607120,1700620980,13860,43500,121881,US,US
119831,1700309220,1700327100,17880,88519,45048,BE,FR
38947,1699948740,1699959900,11160,103007,66887,US,US
26382,1699115280,1699147500,32220,121341,19343,TR,TR
138267,1699458000,1699475640,17640,5871,146270,FR,FR
112679,1699100160,1699130700,30540,64410,88762,TR,TR
145448,1699618500,1699652940,34440,81063,60595,TR,TR
20903,1699702200,1699737960,35760,163029,20808,MX,MX
33359,1699233180,1699247160,13980,115177,172743,US,US
196486,1700225460,1700260560,35100,149241,157424,TR,TR
44936,1700029020,1700044260,15240,71737,82851,CZ,AT
33909,1698836820,1698868080,31260,131295,111174,TR,TR
45692,1699228260,1699238280,10020,18635,149124,IT,IT
60808,1700814960,1700829660,14700,103888,39544,AT,AT
58473,1700749560,1700767020,17460,167475,107616,US,US
41924,1700243100,1700254320,11220,88163,123262,US,US
33406,1699552260,1699575900,23640,98432,179464,DE,DE
10095,1700077740,1700090340,12600,186857,71545,IT,IT
165161,1698798180,1698833640,35460,152061,65277,MX,MX
151860,1699388340,1699400700,12360,87237,7795,US,US
105316,1700127840,1700148660,20820,57351,163964,SE,SE
137099,1699091160,1699102620,11460,122194,51425,IT,IT
97795,1700864580,1700875080,10500,191714,110067,SK,AT
1014,1699085880,1699097640,11760,31453,160614,US,US
109482,1700393880,1700424540,30660,159235,171152,TR,TR
12156,1700687520,1700703780,16260,196679,83680,US,US
79436,1700124480,1700134320,9840,59660,80995,IT,IT
56174,1699928880,1699961760,32880,82755,6605,TR,TR
161800,1699503480,1699535580,32100,199282,15763,TR,TR
40282,1700003700,1700009040,5340,118378,108578,GB,GB
68815,1699296180,1699301400,5220,188939,121918,NL,NL
60032,1700722500,1700730180,7680,179909,164767,HR,HR
70813,1698990420,1699021680,31260,12475,45543,TR,TR
150449,1699890660,1699896240,5580,172658,8301,GB,GB
65974,1699348800,1699354920,6120,120923,124934,AD,ES
36121,1698810480,1698840840,30360,173924,45793,TR,TR
17965,1699091760,1699127160,35400,185722,140875,MX,US
91167,1699041900,1699076280,34380,151458,8963,TR,TR
100943,1700504880,1700511900,7020,108037,57852,GB,GB
123577,1699079760,1699113480,33720,101722,112912,TR,TR
148813,1700160180,1700163780,3600,15308,198644,GB,GB
110745,1698988500,1699041420,52920,175543,2589,BG,HU
20083,1700311980,1700315580,3600,36842,24944,GB,GB
67458,1699916220,1699947600,31380,169518,118237,TR,TR
134999,1699970700,1699994940,24240,157820,24636,DE,NL
101538,1700386620,1700420520,33900,41357,102353,TR,TR
70369,1700343900,1700351520,7620,18763,54088,IT,IT
6772,1700673180,1700689380,16200,146737,180285,US,US
184197,1699067280,1699084500,17220,34398,26949,US,US
16795,1699591200,1699595040,3840,80294,155960,GB,GB
186303,1699498140,1699533540,35400,138607,70788,TR,TR
194191,1700390580,1700424000,33420,57497,79342,TR,TR
146401,1700356500,1700370660,14160,11500,178764,US,US
71737,1700815560,1700829900,14340,107773,435,IT,FR
165338,1699671240,1699677240,6000,60519,30970,NL,NL
161541,1699652820,1699705320,52500,191803,189447,BG,MK
52802,1700133600,1700137200,3600,58454,5604,NL,NL
67769,1700274180,1700308440,34260,98218,2189,TR,TR
43852,1700710260,1700742840,32580,107225,22119,TR,TR
90902,1700233080,1700245080,12000,74444,181204,US,US
195240,1700230860,1700264220,33360,652,146814,TR,TR
42691,1698920520,1698929640,9120,33183,4920,ES,AD
80056,1699573860,1699606800,32940,83298,123092,MX,MX
157234,1700157840,1700161440,3600,83533,90645,GB,GB
26235,1699505100,1699510620,5520,31835,84876,GB,GB
17748,1699060380,1699090140,29760,84517,108601,TR,TR
69690,1700209020,1700218140,9120,104144,158475,PT,PT
31491,1700034420,1700049360,14940,54869,102298,CZ,CZ
83507,1699044180,1699078500,34320,184718,39808,MK,RS
5120,1699112940,1699144140,31200,152141,12717,TR,TR
189395,1700275440,1700284080,8640,62665,85077,IT,IT
152001,1700610060,1700613660,3600,50050,14577,NL,NL
56683,1700001480,1700011620,10140,113811,180714,PT,PT
86158,1699213860,1699247820,33960,36257,67836,TR,TR
43732,1699493460,1699502460,9000,184664,44293,ES,ES
144281,1699573140,1699600020,26880,100924,160666,BR,BR
64051,1700753340,1700784180,30840,11110,128750,TR,TR
71026,1700290260,1700295660,5400,176547,58375,NL,NL
61762,1699977840,1700009940,32100,108076,28584,TR,TR
182235,1700262600,1700290440,27840,187801,143515,DE,HR
164701,1700003580,1700020920,17340,54187,176766,FR,GB
48947,1700738340,1700771220,32880,155923,124287,TR,TR
39505,1699186080,1699209360,23280,64435,144784,PL,FR
150287,1699113600,1699145580,31980,193880,74921,TR,TR
45489,1698897540,1698930360,32820,911,143148,TR,TR
50839,1698801120,1698808980,7860,65476,73942,IT,IT
84615,1699959480,1699970820,11340,133428,84286,US,US
126070,1700379300,1700385660,6360,150230,138689,GB,GB
41257,1700105580,1700135940,30360,14260,144527,TR,TR
122581,1700786520,1700822460,35940,177626,123534,TR,TR
100743,1699860180,1699876800,16620,136648,15668,AT,DE
12967,1700692140,1700706840,14700,89585,166721,US,US
128104,1698990180,1699001580,11400,128931,166811,US,US
99865,1700829240,1700859960,30720,29934,188128,TR,TR
131906,1699716540,1699769460,52920,151155,41043,BG,BG
157625,1699500420,1699531920,31500,181345,137179,TR,TR
10949,1699968000,1699995780,27780,95014,73416,DE,DE
120838,1700125020,1700156400,31380,17215,112215,TR,TR
192226,1700382180,1700385780,3600,134397,56121,GB,GB
11359,1700591400,1700596020,4620,81115,42449,GB,GB
175799,1699067100,1699081320,14220,179618,51580,PT,PT
145422,1700696100,1700720040,23940,184336,120601,DE,FR
95146,1699268400,1699273560,5160,164598,90401,GB,GB
193108,1698984180,1699014360,30180,98716,9402,TR,TR
153080,1700630880,1700649120,18240,105178,59253,AL,MK
55709,1700210760,1700243340,32580,18909,109332,TR,TR
163814,1700450160,1700480700,30540,7036,1549,TR,TR
96101,1699036620,1699068660,32040,37625,85487,TR,TR
143428,1699674900,1699704120,29220,107240,8505,TR,TR
175994,1700759340,1700763540,4200,80511,196554,GB,GB
24838,1698807660,1698817380,9720,20834,97759,EE,FI
109875,1699844520,1699880040,35520,4298,188916,TR,TR
153842,1699939800,1699955340,15540,86153,51001,US,US
132182,1699871880,1699877340,5460,116499,106162,FI,EE
109401,1700282700,1700295300,12600,90064,76559,PT,PT
88639,1700495580,1700513400,17820,103967,64035,FR,FR
173092,1700472720,1700501940,29220,172155,35830,TR,TR
86436,1699554600,1699564200,9600,171800,187422,IT,IT
1373,1699816500,1699829640,13140,42583,197124,PT,PT
55871,1699253520,1699268160,14640,109366,160089,FR,FR
49996,1700147640,1700159700,12060,125424,18718,PT,PT
127805,1700564460,1700600220,35760,162676,42316,TR,TR
148911,1699110660,1699114860,4200,59456,191152,NL,NL
83087,1699336560,1699349460,12900,71875,196719,US,US
130109,1699500180,1699522500,22320,180105,18312,PL,PL
113021,1700070300,1700083620,13320,75629,51376,RS,RS
177187,1700589660,1700620380,30720,39868,70691,TR,TR
116656,1698969000,1698972780,3780,197951,12023,GB,GB
29856,1699430640,1699440600,9960,187722,42856,PT,PT
130244,1699530300,1699555320,25020,85394,1115,DE,FR
113777,1700590980,1700605260,14280,5563,94113,US,US
89330,1699758780,1699770180,11400,7478,172609,US,CA
76885,1698841740,1698847620,5880,151048,86412,GB,GB
30503,1700471280,1700488860,17580,172982,196871,US,US
191885,1700413380,1700416980,3600,97618,76951,GB,GB
140111,1699937280,1699970880,33600,65650,100010,TR,TR
117429,1699840140,1699853160,13020,175030,190892,US,US
84030,1699784580,1699788180,3600,138405,73827,GB,GB
111625,1700398740,1700402340,3600,72380,163040,GB,GB
183464,1700393640,1700397240,3600,145110,42020,GB,GB
124081,1699515180,1699525800,10620,87707,123530,IT,IT
7203,1700548560,1700579460,30900,10501,146576,TR,TR
52905,1700337420,1700372820,35400,83432,93232,TR,TR
126555,1700527380,1700540040,12660,29012,147426,PT,PT
75256,1700701680,1700734260,32580,160454,110731,MX,MX
118035,1700665440,1700697780,32340,77437,184289,TR,TR
49765,1699874880,1699888080,13200,140117,82453,HR,HR
185466,1698796260,1698804960,8700,158542,117986,SK,SK
99971,1700739540,1700773560,34020,60878,77861,TR,TR
44925,1699512300,1699525680,13380,191132,161069,US,US
132975,1699106700,1699110300,3600,63704,164828,GB,GB
195124,1699321140,1699354800,33660,118950,158688,TR,TR
86837,1699794900,1699811760,16860,6628,24511,US,US
170335,1698812760,1698824940,12180,107808,18587,CZ,CZ
187343,1698821760,1698828780,7020,137742,187968,GB,GB
164066,1698911460,1698925320,13860,158179,122254,US,US
43094,1700096040,1700101080,5040,147100,157132,NL,NL
12082,1700845980,1700880840,34860,149486,128640,MX,MX
136097,1699176960,1699202160,25200,32237,70369,PL,PL
183855,1699922760,1699951740,28980,92595,151140,TR,TR
164079,1699917960,1699932660,14700,29580,67714,US,US
166710,1700258760,1700284560,25800,82362,160568,DE,AT
93284,1699708440,1699712100,3660,150680,68637,NL,NL
17531,1699262700,1699274700,12000,165424,105699,HR,PL
83739,1700056980,1700086260,29280,154902,185945,TR,TR
173293,1698935340,1698966720,31380,182155,119916,TR,TR
176343,1699660680,1699693620,32940,19379,102676,MX,MX
160171,1700049660,1700063040,13380,92716,3904,IT,IT
70826,1699822320,1699874820,52500,111284,18493,BG,BG
133516,1700671620,1700679540,7920,32803,42231,PT,ES
95178,1699495140,1699525020,29880,175817,106408,TR,TR
3476,1699030320,1699042260,11940,144394,64375,US,US
175769,1699742400,1699757160,14760,114649,126478,FR,FR
55042,1699219080,1699226820,7740,160486,12429,IT,IT
53310,1700046060,1700057760,11700,92014,169746,US,US
80023,1699890180,1699923060,32880,187281,84963,TR,TR
75705,1700650500,1700684160,33660,195616,194756,TR,TR
99240,1699700280,1699733520,33240,56934,20950,TR,TR
191023,1699395720,1699424520,28800,11107,145929,TR,TR
103161,1699318140,1699335600,17460,156283,2983,FR,FR
121043,1700735880,1700739960,4080,37721,65425,GB,GB
128043,1700134020,1700164140,30120,32538,96169,TR,TR
137344,1700666460,1700701500,35040,161157,174210,TR,TR
148658,1699930020,1699956660,26640,40356,124972,BR,BR
26999,1700581140,1700608980,27840,57698,89547,BA,HR
126329,1698824940,1698829800,4860,105424,115102,GB,GB
34456,1699218000,1699235460,17460,48871,17175,CZ,DE
138384,1700570580,1700600640,30060,119793,93576,TR,TR
165733,1699733280,1699748700,15420,181438,116609,AT,DE
113038,1699395660,1699409640,13980,164346,113242,IT,IT
172923,1700200200,1700230380,30180,61809,147747,TR,TR
116903,1698832620,1698863280,30660,37937,136604,TR,TR
77916,1699919220,1699925520,6300,15776,42450,NL,FR
186471,1699561740,1699569060,7320,6857,3312,ES,FR
48548,1699299000,1699319520,20520,18513,7342,FR,HR
158063,1700679660,1700691240,11580,170114,136339,ES,AD
116380,1700115600,1700119200,3600,31511,146505,NL,BE
114701,1699513920,1699544520,30600,153410,134038,TR,TR
120589,1699203960,1699220280,16320,34974,132113,BE,FR
8160,1699378320,1699390380,12060,98444,71635,IT,IT
123253,1700277600,1700307240,29640,132140,79844,TR,TR
34307,1700774700,1700788560,13860,129590,149563,HR,HR
114511,1700834160,1700851380,17220,80427,106439,CA,US
11652,1699707480,1699715460,7980,66724,133176,IT,IT
53247,1700367300,1700422920,55620,97271,129772,BG,BG
86688,1700149620,1700153220,3600,83133,109037,GB,GB
109692,1699823340,1699832220,8880,180706,96328,CL,CL
88221,1699305720,1699309320,3600,182472,172697,GB,GB
123506,1699110960,1699128240,17280,175968,106856,FR,FR
110741,1699846380,1699857600,11220,50388,18273,US,US
88453,1700361000,1700365320,4320,132159,89094,GB,GB
133275,1700766600,1700775240,8640,30410,116486,IT,IT
48838,1700069760,1700102460,32700,134071,147124,TR,TR
169292,1698908220,1698940980,32760,143644,29228,TR,TR
189604,1698973200,1699004340,31140,53816,147895,TR,TR
143194,1700096160,1700110020,13860,104068,77004,CZ,CZ
79196,1699895040,1699903020,7980,193022,88772,EE,LT
93200,1699635000,1699664760,29760,199979,35091,TR,TR
18771,1700863680,1700880960,17280,14319,19465,RS,DE
3825,1699994520,1700001000,6480,152743,89411,GB,GB
40653,1699342080,1699371240,29160,60851,69773,TR,TR
122216,1698944580,1698961440,16860,41520,60238,FR,DE
184769,1699510800,1699543620,32820,68917,54596,TR,TR
63639,1698832200,1698861300,29100,42971,179715,TR,TR
111726,1699784520,1699818180,33660,149235,2419,TR,TR
136826,1699603020,1699613640,10620,114177,96734,IT,DE
196209,1699695480,1699724340,28860,176444,54829,TR,TR
149780,1699503360,1699536660,33300,26582,82638,TR,TR
186136,1699186380,1699222260,35880,98205,60105,TR,TR
61956,1700503920,1700510340,6420,180323,86346,NL,NL
146559,1700079000,1700093040,14040,12853,133531,ES,FR
146698,1699883160,1699915560,32400,70048,18006,TR,TR
77555,1700554200,1700566620,12420,77042,106697,US,US
49658,1700767440,1700801280,33840,157445,124010,TR,TR
113166,1699482840,1699495440,12600,35691,116868,US,US
136662,1699920840,1699935300,14460,158892,69466,US,US
190243,1698863880,1698894120,30240,181982,8321,TR,TR
133111,1699956660,1699974060,17400,17116,137733,US,US
199029,1700488020,1700521620,33600,397,187198,TR,TR
171326,1699277640,1699313520,35880,124448,75657,TR,TR
39924,1698901020,1698908460,7440,85126,69995,IT,IT
130291,1699006620,1699010940,4320,128322,11104,NL,NL
175956,1698896880,1698900480,3600,50710,89579,NL,NL
117652,1700862120,1700873100,10980,193568,57128,IT,IT
56218,1699570800,1699574400,3600,172273,183163,NL,NL
140753,1700786040,1700810100,24060,98647,43465,DE,DE
29987,1698868500,1698890340,21840,39530,169766,PL,PL
45054,1699085100,1699110360,25260,151320,57551,PL,PL
98111,1700282040,1700298960,16920,195256,40062,CZ,RS
20236,1700040600,1700051520,10920,160274,109415,US,US
198875,1700715540,1700750700,35160,4509,80558,TR,TR
186613,1699373640,1699388700,15060,190162,62872,US,US
2872,1699581240,1699612860,31620,42222,15482,TR,TR
168343,1698912420,1698916020,3600,114166,136921,NL,NL
149266,1699376160,1699409580,33420,13874,13537,TR,TR
159067,1700862240,1700882460,20220,145582,136323,FR,FR
173101,1700523840,1700537460,13620,35962,60958,US,US
7588,1699954440,1699960920,6480,141373,137550,GB,GB
3715,1699496820,1699503060,6240,102564,158007,GB,GB
15716,1698905880,1698909480,3600,117893,87625,NL,NL
189344,1700630460,1700636520,6060,185840,128009,GB,GB
174375,1700080920,1700084520,3600,39086,52345,NL,NL
118990,1699770300,1699773900,3600,152398,79876,GB,GB
131689,1698997860,1699009380,11520,83285,20327,HR,HR
46519,1700691420,1700720820,29400,189715,157935,TR,TR
21775,1700208120,1700213040,4920,193990,52311,GB,GB
56616,1699873320,1699908960,35640,79738,155013,TR,TR
112902,1700426580,1700456040,29460,23438,57860,TR,TR
185173,1699468080,1699481460,13380,4270,73099,US,US
179694,1699095300,1699112820,17520,181772,165162,BE,FR
26106,1699511040,1699543980,32940,99056,104889,TR,TR
160473,1699276200,1699299420,23220,678,49921,DK,DK
21404,1699499520,1699528380,28860,159935,122298,BA,AT
145099,1699339500,1699366860,27360,131172,113542,DE,GB
126375,1699092180,1699105140,12960,77380,18285,IT,IT
106379,1700829720,1700842140,12420,86423,155184,PT,PT
170761,1700614620,1700628540,13920,121282,127869,US,US
30752,1698957000,1698994320,37320,29688,63233,MX,MX
38328,1700711160,1700722920,11760,58033,139068,US,US
20550,1700309460,1700347680,38220,47868,77212,MX,MX
102336,1700203980,1700209740,5760,109441,91272,GB,GB
36667,1700138280,1700159280,21000,29063,57848,BE,FR
32269,1699215180,1699243020,27840,115728,137769,BR,BR
195978,1699298880,1699310880,12000,1214,99877,US,US
143308,1700746020,1700801520,55500,98487,151287,BG,BG
8177,1700197200,1700200800,3600,20008,181264,NL,BE
127323,1699469700,1699484760,15060,54577,4914,US,US
10886,1699092420,1699105260,12840,12128,69851,US,US
52928,1699593480,1699628880,35400,92351,39891,TR,TR
81314,1699980360,1700015340,34980,188812,129580,TR,TR
36755,1699892820,1699929060,36240,56671,51891,MX,MX
168994,1700773920,1700777520,3600,16874,90826,GB,GB
88095,1699320360,1699335180,14820,166774,105049,US,US
164555,1700557560,1700579100,21540,147137,52399,FR,FR
110137,1700787840,1700791440,3600,76113,74616,GB,GB
6429,1700575740,1700579340,3600,55047,103160,GB,GB
160485,1700622060,1700638200,16140,144593,25594,US,US
84805,1700556000,1700585100,29100,171805,34981,TR,TR
31047,1699822440,1699826040,3600,130788,2935,GB,GB
110621,1700047560,1700061660,14100,195144,85469,US,US
40333,1699751640,1699759440,7800,190465,144619,ES,ES
159480,1700599500,1700630160,30660,73021,178710,TR,TR
8427,1699398660,1699402260,3600,162670,51189,GB,GB
38799,1699059240,1699088640,29400,3856,174253,TR,TR
58726,1699638300,1699651320,13020,46699,195261,US,US
58064,1700429700,1700461740,32040,192872,50256,TR,TR
160715,1699248660,1699281420,32760,179463,119522,TR,TR
196457,1700836800,1700870820,34020,80596,168474,TR,TR
22624,1699357440,1699361640,4200,86551,86929,NL,DE
151886,1699213740,1699242180,28440,14684,78933,BA,AT
73075,1699149180,1699177980,28800,111848,78887,TR,TR
140825,1699126080,1699133220,7140,110272,27407,GB,GB
29193,1698935160,1698963360,28200,161158,21006,PL,HU
8028,1698999180,1699032000,32820,151338,28614,MX,MX
144920,1699088880,1699102020,13140,42618,3231,PT,PT
169464,1700340060,1700372220,32160,28495,33725,TR,TR
173551,1698904380,1698907980,3600,108092,95109,GB,GB
10538,1700710980,1700714700,3720,38759,55662,GB,GB
125816,1700404200,1700415900,11700,66863,65499,US,US
67142,1699230780,1699242600,11820,53557,3744,AT,DE
153202,1699262160,1699270080,7920,100336,26877,IT,IT
152813,1700820240,1700847360,27120,116092,90357,DE,UA
169319,1699861020,1699885140,24120,127319,98221,DE,NL
87977,1699835040,1699866060,31020,102517,69290,TR,TR
51868,1700101680,1700133960,32280,47318,97870,TR,TR
194762,1700113380,1700145900,32520,116228,135644,TR,TR
90918,1699126380,1699134720,8340,138191,132858,ES,ES
97476,1699897800,1699930320,32520,52110,26114,TR,TR
5225,1699815780,1699824000,8220,95029,30310,HR,HR
26092,1700175060,1700204760,29700,137412,151469,TR,TR
60737,1700208900,1700220000,11100,26643,173619,US,US
45873,1700281320,1700292960,11640,51991,16432,PT,PT
36788,1700773620,1700777220,3600,187248,55974,GB,GB
167194,1700866140,1700898720,32580,175449,145829,TR,TR
187088,1699630080,1699641000,10920,160032,155117,US,US
43734,1700034840,1700057460,22620,148193,23721,PL,CZ
194347,1699560120,1699589580,29460,26660,23647,TR,TR
15429,1700100240,1700115900,15660,2377,46779,US,US
142571,1699516200,1699519800,3600,84328,79397,GB,GB
2217,1700064180,1700067780,3600,83001,26980,GB,GB
120390,1699073700,1699108620,34920,170770,78477,MX,MX
60006,1700202000,1700234460,32460,176911,120694,TR,TR
145293,1699048440,1699057860,9420,96729,129700,PT,PT
11404,1700700600,1700715180,14580,108291,183932,US,US
105277,1700525460,1700541660,16200,147979,166161,BE,NL
180652,1698912480,1698945960,33480,82054,135575,TR,TR
93543,1700086020,1700117760,31740,77781,62321,TR,TR
82524,1700130300,1700161860,31560,3500,111865,TR,TR
103763,1699688460,1699718760,30300,155367,60264,TR,TR
83174,1700670420,1700706180,35760,104251,49897,TR,TR
83324,1700552040,1700586600,34560,40469,172489,TR,TR
23109,1699548480,1699582140,33660,183337,71226,TR,TR
165219,1699572840,1699602480,29640,15790,139883,TR,TR
1171,1699300620,1699334340,33720,115570,61135,TR,TR
13076,1699453680,1699457280,3600,115463,190065,GB,GB
111410,1699225320,1699283040,57720,119425,31752,UA,CZ
78995,1699910280,1699941900,31620,25904,141256,TR,TR
111270,1699532640,1699539960,7320,137281,1547,IT,IT
158248,1699767000,1699801320,34320,127592,193021,TR,TR
6965,1698894420,1698910020,15600,26362,34697,FR,IT
146099,1699549260,1699558140,8880,137969,34428,IT,IT
73486,1700181120,1700211300,30180,168502,162542,TR,TR
163009,1700175900,1700191920,16020,56877,37181,RS,ME
182692,1700043600,1700047200,3600,12395,164922,GB,GB
65597,1700363940,1700398380,34440,158856,39946,TR,TR
42237,1700762280,1700772600,10320,175270,149712,IT,IT
41922,1700830080,1700838360,8280,42751,39564,IT,IT
20638,1699346940,1699350540,3600,123397,61488,GB,GB
6872,1700806620,1700839740,33120,192762,83517,TR,TR
76571,1699019580,1699023180,3600,116773,15681,NL,NL
80342,1700696400,1700702160,5760,24754,82905,NL,NL
17747,1699207320,1699224660,17340,198701,191531,US,US
182833,1700170980,1700204100,33120,117634,92663,MX,MX
171142,1700520060,1700551980,31920,180858,150852,TR,TR
96177,1699087260,1699100160,12900,16496,131882,US,US
63023,1700735940,1700771880,35940,88538,90096,TR,TR
49904,1700840280,1700843880,3600,100391,25132,GB,GB
141206,1699966560,1699982160,15600,140610,165074,AT,AT
130261,1700093820,1700100000,6180,27654,171241,GB,GB
65164,1699040640,1699074540,33900,154324,184887,TR,TR
10270,1700346420,1700358300,11880,15816,155293,HR,HR
105165,1699985940,1700019420,33480,85470,84256,TR,TR
198586,1698892680,1698922320,29640,151178,86721,TR,TR
51143,1700542560,1700553600,11040,156928,98449,US,US
22215,1700442840,1700477100,34260,74355,146976,TR,TR
158030,1700726580,1700748600,22020,129081,162798,DE,DE
13900,1698936120,1698966060,29940,24335,38628,TR,TR
10212,1699772160,1699787340,15180,35095,69522,AT,AT
26250,1700086860,1700093280,6420,1162,152598,NL,NL
65053,1700336880,1700365980,29100,112585,12606,TR,TR
36521,1700362740,1700396940,34200,97374,174475,TR,TR
41778,1698844440,1698878880,34440,126177,103244,TR,TR
63913,1699407180,1699411920,4740,88171,3941,NL,NL
19871,1699061880,1699092960,31080,81156,132881,TR,TR
157517,1700813940,1700823420,9480,67050,21149,PT,PT
189392,1699066500,1699078800,12300,135226,180073,US,US
58449,1699005180,1699031160,25980,126541,194204,PL,HR
41813,1699393560,1699403460,9900,118075,30977,CL,CL
17549,1699288860,1699296720,7860,189703,195209,FI,EE
167969,1698898860,1698931860,33000,179675,44219,TR,TR
109642,1699289580,1699293180,3600,184756,103653,GB,GB
2631,1700360040,1700377140,17100,153376,119558,US,US
9069,1699163880,1699173060,9180,41952,151506,ES,BE
121446,1699181280,1699184880,3600,106908,194883,NL,NL
48716,1699490400,1699517160,26760,68901,125515,DE,DE
115839,1699606980,1699624500,17520,165606,51694,US,US
135374,1699810740,1699833960,23220,125439,164875,BR,BR
50954,1700675100,1700692320,17220,27461,38627,US,US
175598,1699603560,1699636080,32520,12737,56198,TR,TR
121213,1699494780,1699525320,30540,190983,108573,TR,TR
196223,1700826060,1700841540,15480,160866,46279,US,US
25569,1698855480,1698890580,35100,60844,4476,TR,TR
119857,1700546160,1700549760,3600,113754,61853,NL,NL
29718,1700500800,1700536380,35580,170676,141614,TR,TR
83196,1699029480,1699063320,33840,21003,56825,TR,TR
89572,1699238940,1699269060,30120,124905,103370,TR,TR
68876,1700321520,1700348040,26520,36925,70828,DE,FR
50799,1699748100,1699782780,34680,40459,168676,TR,TR
161062,1699319220,1699351980,32760,137798,57275,MX,MX
84916,1699600920,1699606440,5520,65848,68267,NL,NL
75506,1700562420,1700597880,35460,46894,63868,TR,TR
182676,1699537320,1699543800,6480,180280,66353,GB,GB
134746,1700391600,1700406840,15240,196492,72195,US,US
117709,1699375380,1699411260,35880,163281,18371,MX,MX
191927,1700653500,1700688660,35160,118859,16722,TR,TR
18194,1699062060,1699075140,13080,103150,174198,IT,IT
155273,1699063200,1699066800,3600,75260,71258,NL,NL
166221,1700057400,1700093220,35820,160629,46061,TR,TR
159873,1700592060,1700603220,11160,139732,196466,RS,RS
114779,1698906600,1698939360,32760,75632,143567,MX,MX
101435,1699300920,1699330200,29280,158869,172608,TR,TR
130736,1700374080,1700389920,15840,182693,149265,US,US
117230,1699791720,1699804440,12720,5144,45617,IT,IT
104544,1700414640,1700431140,16500,197979,81913,US,US
126362,1699465080,1699482840,17760,57634,78675,US,US
122188,1699099320,1699102920,3600,196947,79458,GB,GB
167401,1698805920,1698822600,16680,38638,34469,US,US
41275,1699415760,1699419360,3600,102211,195122,GB,GB
191251,1699952460,1699966320,13860,146937,107749,IT,IT
190667,1700284920,1700322240,37320,25847,130375,MX,MX
67171,1700571540,1700602020,30480,193412,91374,TR,TR
113663,1700605920,1700635560,29640,98723,93915,TR,TR
29678,1699329420,1699341540,12120,140423,105520,US,US
1466,1699321680,1699337220,15540,31028,179772,US,US
181934,1700039640,1700069640,30000,181297,196346,TR,TR
21793,1699064640,1699100400,35760,146567,111504,TR,TR
16200,1700575500,1700609400,33900,96078,1911,TR,TR
137673,1699837920,1699843920,6000,51379,42180,NL,NL
126161,1699184760,1699195620,10860,39605,31501,CA,US
157331,1700654820,1700678520,23700,17325,53249,DE,IT
109907,1698983460,1698997080,13620,10123,158082,US,US
103864,1699545540,1699579920,34380,44822,182443,TR,TR
63226,1699422660,1699428480,5820,76808,151553,AD,FR
26375,1700866080,1700890200,24120,115060,150309,RO,RO
187016,1700203860,1700215140,11280,56271,80845,US,US
182217,1699252560,1699264680,12120,76778,14660,US,US
124109,1699493100,1699516440,23340,110613,92574,HU,UA
151426,1699909500,1699916460,6960,166692,55012,NL,NL
186659,1699465020,1699499760,34740,37838,31395,TR,TR
192242,1699432260,1699465800,33540,183660,18546,MX,MX
172256,1699829580,1699842960,13380,73584,128193,PT,CH
77136,1699640460,1699664340,23880,87420,156700,BR,BR
41458,1699160100,1699163700,3600,58593,148058,NL,NL
173067,1699251420,1699257000,5580,169411,84938,GB,GB
147024,1700140260,1700148540,8280,180479,198243,IT,IT
142649,1700673480,1700703420,29940,62138,54166,TR,TR
116239,1699396320,1699425720,29400,74789,130233,TR,TR
20621,1700117580,1700128920,11340,134369,166050,US,US
73080,1699264980,1699300320,35340,96820,29076,TR,TR
128462,1700279820,1700288580,8760,183458,13186,IT,IT
107736,1698919080,1698931560,12480,166644,95552,IT,IT
1385,1699515600,1699549560,33960,18315,39754,TR,TR
26733,1699822200,1699854960,32760,142481,99518,TR,TR
10262,1699598340,1699601940,3600,34177,166853,GB,GB
56869,1699624740,1699628340,3600,18148,188744,GB,GB
156269,1699755900,1699785900,30000,199801,41328,TR,TR
4133,1700390160,1700420640,30480,117975,170180,TR,TR
180362,1699013580,1699043100,29520,27401,93308,TR,TR
70360,1700698380,1700730420,32040,76221,146524,TR,TR
75271,1700690340,1700696700,6360,12824,175185,GB,GB
162253,1700716860,1700749800,32940,152428,4682,TR,TR
148532,1700228820,1700259900,31080,123168,71690,TR,TR
57666,1700138820,1700149620,10800,160540,124243,IT,IT
121218,1699028160,1699034640,6480,199474,169307,NL,NL
43104,1700135460,1700151180,15720,128565,173639,RS,RS
9911,1698849720,1698882360,32640,102659,85873,TR,TR
39335,1699587960,1699591560,3600,121252,146159,NL,NL
25047,1700129940,1700133540,3600,191307,27703,GB,GB
38102,1699396260,1699428720,32460,117291,107776,TR,TR
141751,1699685040,1699720680,35640,164126,79985,TR,TR
130479,1699589460,1699600440,10980,173862,146300,CZ,CZ
18212,1699211220,1699218360,7140,176683,78910,GB,GB
149816,1699758060,1699785960,27900,113553,198569,RO,RO
92390,1699908240,1699921560,13320,132852,1324,IT,IT
150272,1699579020,1699613400,34380,95036,99790,TR,TR
29760,1700862660,1700892900,30240,169165,173733,TR,BG
69308,1700174040,1700199480,25440,199859,123798,RO,MD
166966,1699611300,1699622760,11460,49761,105764,US,US
150265,1699110840,1699142100,31260,73809,142347,TR,TR
116600,1700550840,1700585520,34680,198826,121206,TR,TR
169722,1699042860,1699047360,4500,154934,19211,NL,NL
78292,1700245380,1700280600,35220,152667,28626,TR,TR
97006,1699647240,1699655880,8640,66980,16743,ES,PT
180683,1700618280,1700637480,19200,76752,90323,FR,FR
120951,1700857980,1700874180,16200,160025,156601,US,US
92372,1699993020,1700017680,24660,189866,140164,DE,DE
180158,1699198320,1699212420,14100,137446,112871,US,US
124054,1699330800,1699353120,22320,85672,176483,PL,PL
164245,1700216580,1700220180,3600,1490,134009,NL,NL
101207,1700036160,1700044800,8640,68996,47668,IT,IT
108949,1700766000,1700776320,10320,51511,95808,IT,IT
39998,1700190660,1700194260,3600,92394,199782,GB,GB
2018,1700210400,1700243040,32640,50618,166326,MX,MX
80374,1699596540,1699605480,8940,40667,159731,IT,IT
104887,1700262000,1700274360,12360,20515,111399,US,US
141608,1699605300,1699610520,5220,194656,141728,NL,NL
177221,1699597620,1699601220,3600,26620,35681,GB,GB
193720,1699618080,1699623780,5700,142370,178162,GB,GB
124842,1698972180,1698983640,11460,99410,71578,PT,PT
124442,1699789020,1699800060,11040,142630,109748,IT,IT
5369,1699346760,1699358340,11580,87863,195555,US,US
160463,1698912300,1698923280,10980,194780,89809,US,US
88172,1700171940,1700207640,35700,62332,189069,TR,TR
88621,1700401080,1700407200,6120,6540,187927,GB,GB
48180,1699607220,1699620000,12780,120718,108932,US,US
159643,1699862880,1699893720,30840,140046,118619,TR,TR
21102,1699040880,1699048200,7320,71090,144055,IT,IT
97012,1699503060,1699532820,29760,183890,134508,TR,TR
96536,1699608840,1699640640,31800,148513,93725,TR,TR
82695,1700620680,1700632980,12300,38882,30914,US,US
28295,1700551320,1700584380,33060,166175,146889,TR,TR
135488,1699654380,1699667280,12900,34018,126093,US,MX
91270,1700532960,1700545020,12060,36468,27455,IT,IT
136339,1698927960,1698933300,5340,17253,52029,NL,NL
160406,1700602500,1700635080,32580,145575,53147,TR,TR
8344,1698795420,1698811560,16140,186292,178502,FR,FR
129446,1699493820,1699508400,14580,100349,124966,US,US
22087,1700587920,1700591520,3600,174612,118395,NL,NL
106400,1699411500,1699417320,5820,191889,28301,GB,GB
38196,1700556720,1700586540,29820,73523,142958,TR,TR
92622,1699268160,1699271760,3600,90975,87099,GB,GB
8789,1699255020,1699285740,30720,141469,112688,TR,TR
17868,1700797320,1700826480,29160,112482,123963,TR,TR
11186,1700130540,1700159340,28800,22115,12146,TR,TR
149472,1700191380,1700207820,16440,29695,193737,US,US
35286,1699797660,1699810740,13080,55056,106876,AT,AT
183664,1700525400,1700535300,9900,183157,103884,IT,IT
17382,1700287740,1700319900,32160,129852,4606,TR,TR
70535,1700063700,1700079120,15420,20964,83905,US,US
124059,1699758900,1699763640,4740,103513,55474,GB,GB
144685,1699818540,1699830060,11520,164001,111617,IT,DE
76157,1700048280,1700078220,29940,100278,144523,BA,BA
44212,1699839540,1699845000,5460,190650,162297,GB,GB
62189,1699082700,1699088100,5400,145877,113435,GB,GB
56821,1700721840,1700755380,33540,144500,22429,TR,TR
77608,1699944660,1699963620,18960,5985,147545,BE,FR
179179,1700726460,1700740860,14400,136114,49466,AT,AT
92085,1699109100,1699122420,13320,24596,131859,HR,HR
40599,1699308420,1699337340,28920,11437,89844,TR,TR
197909,1698893580,1698897180,3600,77360,133618,GB,GB
109852,1699540860,1699553880,13020,87719,104214,IT,IT
117180,1700097060,1700118240,21180,162168,95325,FR,FR
101928,1699312140,1699325940,13800,153152,146136,US,US
103134,1699269660,1699298880,29220,64187,158754,TR,TR
113497,1699365180,1699379220,14040,104560,63742,HR,IT
13399,1699605480,1699622400,16920,175868,130984,FR,BE
170791,1700781840,1700812980,31140,87929,156974,TR,TR
115250,1699320120,1699345920,25800,182543,190655,PL,PL
17528,1700479860,1700489100,9240,183916,138789,IT,IT
193966,1700558880,1700585760,26880,45658,57072,DE,NL
147534,1699230000,1699263780,33780,59381,158179,TR,TR
95726,1699308660,1699313580,4920,135053,27251,GB,GB
185480,1700188920,1700202660,13740,21831,20776,PT,PT
99057,1699486320,1699499580,13260,19738,157006,IT,IT
21708,1699282860,1699293900,11040,44653,59373,PT,PT
145759,1699209600,1699214760,5160,197323,121283,GB,GB
17817,1700420580,1700431500,10920,138823,64367,GR,MK
45434,1700140620,1700166240,25620,148774,195243,PL,PL
61350,1699858080,1699868040,9960,185099,28877,IT,IT
66937,1700176080,1700181300,5220,196798,175484,GB,GB
195960,1699471860,1699500720,28860,157276,142641,TR,TR
44511,1699967400,1699982100,14700,17374,198528,US,US
189846,1700389200,1700422380,33180,41144,58497,TR,TR
84853,1700008740,1700018460,9720,29004,155290,IT,IT
91370,1700584620,1700613900,29280,64059,195538,TR,TR
108521,1699448040,1699470120,22080,135489,1397,DE,BG
77941,1699539720,1699566660,26940,29766,84362,BR,BR
189841,1700673900,1700691840,17940,169107,22816,AT,SK
38369,1699123740,1699146060,22320,51294,104730,HU,CZ
64791,1700270640,1700296860,26220,199038,58327,DE,HR
2486,1699356660,1699387920,31260,175947,66193,TR,TR
140427,1699358880,1699395060,36180,110093,150142,MX,MX
29464,1699867260,1699882680,15420,114898,193925,AT,AT
78581,1698887040,1698918960,31920,43843,100105,TR,TR
107302,1700523660,1700537820,14160,196404,942,SK,SK
163668,1698826080,1698848880,22800,32349,127525,BR,BR
162964,1699632360,1699671060,38700,185291,159333,MX,MX
184339,1700405400,1700416320,10920,189868,43736,US,US
112909,1699151700,1699177980,26280,197057,144751,DE,BG
145966,1699944840,1699974300,29460,93103,81781,TR,TR
70371,1700427540,1700433540,6000,71768,175170,GB,GB
12954,1700858220,1700892000,33780,46087,199090,TR,TR
82492,1698986280,1698999240,12960,169114,174682,IT,IT
196090,1699288500,1699301640,13140,198458,122734,IT,IT
79298,1700502720,1700532120,29400,55734,133155,TR,TR
12624,1700419500,1700431800,12300,102743,103855,US,US
136514,1700737140,1700747160,10020,178606,108369,HR,HR
56765,1700617440,1700629320,11880,177953,144837,US,US
24769,1700266260,1700302140,35880,152373,47989,TR,TR
199846,1699778040,1699807740,29700,85330,32684,TR,TR
72158,1700505480,1700539620,34140,162790,82333,TR,TR
130610,1700088060,1700122440,34380,22771,143262,TR,TR
46432,1700852280,1700855880,3600,168529,182785,NL,NL
87972,1699657560,1699689600,32040,54031,155409,TR,TR
21628,1699118280,1699121880,3600,63810,166976,GB,GB
137132,1699384680,1699417740,33060,76386,144641,TR,TR
50534,1699799040,1699817460,18420,167836,65481,FR,FR
4484,1698995580,1699024860,29280,144340,56886,TR,TR
67076,1700460300,1700493600,33300,113394,39188,TR,TR
70171,1699063740,1699093020,29280,26644,138934,TR,TR
47741,1699095000,1699125780,30780,111265,14557,TR,TR
165172,1700437200,1700450100,12900,36612,109212,AT,PL
3864,1699711080,1699727280,16200,36631,134682,CA,US
117770,1699823820,1699858800,34980,156689,193479,TR,TR
17675,1699211220,1699214820,3600,158601,15955,GB,GB
65819,1700642820,1700649720,6900,103114,29647,NL,NL
147758,1700699400,1700703000,3600,102467,193973,GB,GB
129105,1699697100,1699709340,12240,186530,12966,PT,ES
97301,1699537140,1699540740,3600,177576,159465,NL,NL
85748,1699186440,1699208940,22500,169781,185680,RO,RO
46087,1699664220,1699696260,32040,120931,3589,TR,TR
116451,1700682240,1700691720,9480,142671,174922,IT,CH
146728,1699520640,1699555620,34980,191930,138238,TR,TR
75706,1699076760,1699087260,10500,81901,60131,SK,SK
74988,1700448720,1700477520,28800,23125,135099,TR,TR
128342,1699291680,1699303440,11760,111576,21214,US,US
32644,1699742400,1699771680,29280,116361,153572,TR,TR
33910,1699070400,1699083300,12900,51296,184814,AT,BG
144232,1699079280,1699111140,31860,43342,84102,TR,TR
138220,1698896040,1698926460,30420,103806,137474,TR,TR
68351,1699834080,1699869300,35220,16668,191689,TR,TR
179246,1699250700,1699281180,30480,176402,98763,TR,TR
170902,1699155420,1699168200,12780,136297,132856,IT,IT
133378,1700569500,1700579040,9540,40847,1834,HR,HR
179281,1700073000,1700076960,3960,165010,99595,NL,NL
142540,1700620620,1700624220,3600,188377,125693,GB,GB
168875,1700497200,1700532720,35520,30111,159303,TR,TR
184629,1700633820,1700668860,35040,120504,43750,TR,TR
81919,1699201200,1699223160,21960,66366,141109,DE,AT
75953,1699791540,1699808700,17160,694,3334,US,US
185425,1699388820,1699420560,31740,57440,140775,TR,TR
23653,1699700160,1699727160,27000,39737,120362,BA,RS
38651,1699388220,1699413960,25740,52693,46314,BA,DE
19540,1699899840,1699909380,9540,40695,68417,CL,CL
173029,1699397820,1699433040,35220,76321,97170,TR,TR
192577,1699281600,1699316640,35040,155031,23056,TR,TR
175324,1699708620,1699746720,38100,63534,80664,MX,MX
181866,1699357140,1699373640,16500,90836,101318,US,US
176244,1699283640,1699295100,11460,35686,75754,US,US
95048,1700558940,1700591160,32220,112071,15012,TR,TR
73494,1699803600,1699838220,34620,40270,172249,TR,TR
5634,1699110660,1699132680,22020,128758,73864,NO,PL
41130,1699271880,1699301220,29340,1187,14422,TR,TR
99902,1699066920,1699078080,11160,55200,176585,US,US
71079,1699333740,1699368300,34560,182196,28316,TR,TR
75881,1698858600,1698871320,12720,1258,195958,HR,HR
65449,1700537160,1700571360,34200,153346,27047,TR,TR
60358,1700328780,1700365200,36420,76310,96343,MX,MX
187364,1700427060,1700462940,35880,65225,36430,TR,TR
39898,1699603560,1699621080,17520,172064,799,AT,AT
128638,1699302780,1699317900,15120,36714,179374,RS,IT
138617,1700828940,1700863500,34560,31746,48298,MX,MX
131277,1699720800,1699736280,15480,118100,1308,US,US
151284,1699250280,1699259700,9420,56124,170589,IT,IT
134601,1699832220,1699861740,29520,10690,140666,TR,TR
97438,1700291940,1700324520,32580,165036,47332,TR,TR
119157,1698858480,1698863340,4860,51363,143080,GB,GB
31613,1698861240,1698895980,34740,103766,126170,TR,TR
115602,1700821140,1700828340,7200,1924,169063,IT,FR
56816,1700506200,1700509800,3600,84882,4922,NL,NL
31032,1700804100,1700837340,33240,71472,49665,TR,TR
160827,1700440140,1700454540,14400,156995,198422,RS,DE
71382,1699102620,1699134720,32100,132688,41787,TR,TR
189468,1699570080,1699602060,31980,74063,138513,TR,TR
189679,1700492220,1700526960,34740,178820,15027,TR,TR
53859,1698887580,1698916440,28860,46845,155239,TR,TR
44994,1700721060,1700726400,5340,121251,102926,GB,GB
118002,1699610220,1699614720,4500,2724,115381,GB,GB
78266,1699209900,1699213500,3600,35201,175559,GB,GB
159589,1699477080,1699489080,12000,198608,17152,US,US
34308,1700333460,1700348160,14700,171063,128854,US,US
147496,1699009140,1699026720,17580,153727,153156,BE,ES
95211,1699179720,1699190160,10440,59730,197420,PT,PT
42403,1699777440,1699809060,31620,87624,173792,TR,TR
11076,1699559400,1699594500,35100,9845,60025,TR,TR
198544,1699924380,1699930920,6540,81348,179844,NL,NL
29895,1700297700,1700312460,14760,153426,60818,US,US
138470,1698933960,1698963540,29580,103490,56147,TR,TR
162004,1699663620,1699689420,25800,174477,184578,DE,FR
183367,1699558740,1699570140,11400,74201,2957,US,US
123514,1699931280,1699961820,30540,171596,171857,TR,TR
112773,1700697660,1700706180,8520,131277,9158,HR,HR
91176,1700059680,1700072340,12660,192882,25804,US,MX
3196,1700593440,1700625840,32400,127365,80319,TR,TR
137283,1698801480,1698832500,31020,33975,127464,TR,TR
164435,1698861120,1698868440,7320,4824,8044,IT,IT
52918,1699824060,1699855620,31560,21309,15551,TR,TR
121745,1699733100,1699764060,30960,11755,14064,TR,TR
106485,1700743320,1700778240,34920,54923,175267,TR,TR
163059,1700504880,1700536440,31560,125977,60290,TR,TR
57421,1700076840,1700086860,10020,23463,81449,SK,SK
25092,1699124280,1699155480,31200,63383,90682,TR,TR
40988,1699739940,1699770180,30240,8851,173675,TR,TR
81168,1699184340,1699187940,3600,125442,192819,GB,GB
82268,1699000680,1699024440,23760,20100,91447,PL,PL
151285,1698866520,1698871620,5100,192352,155664,GB,GB
87450,1699711500,1699742700,31200,135898,157,TR,TR
51507,1699562640,1699596840,34200,50456,157263,TR,TR
5970,1698814800,1698832500,17700,194995,194884,US,US
22997,1699981320,1699990740,9420,152327,26892,PT,PT
152700,1699708320,1699737480,29160,46447,44139,TR,TR
101460,1699373340,1699407240,33900,10668,145455,TR,TR
186606,1699471680,1699496100,24420,67655,108865,RO,SE
20731,1700679060,1700682660,3600,185375,46725,GB,GB
3997,1699578900,1699591920,13020,136009,35356,US,US
142955,1698906300,1698931680,25380,50796,46020,ME,RS
186061,1699386960,1699394340,7380,140596,175915,IT,IT
10358,1700573340,1700598120,24780,166913,154096,PL,PL
182953,1699719600,1699724160,4560,164536,93813,GB,GB
130508,1698977520,1699011480,33960,180075,158144,TR,TR
164354,1699470300,1699486020,15720,86363,187964,US,US
107776,1698922380,1698954180,31800,63623,181741,TR,TR
180637,1699876740,1699910220,33480,112647,173693,TR,TR
92569,1699340640,1699373160,32520,191961,139400,TR,TR
107665,1699757520,1699770000,12480,188268,56938,US,US
146410,1699891920,1699925400,33480,104371,156510,TR,TR
24620,1699709880,1699717020,7140,69783,179955,NL,FR
29061,1700063040,1700066640,3600,94302,125254,GB,GB
4525,1700592720,1700626800,34080,24336,145420,TR,TR
51842,1700775180,1700798820,23640,199796,116507,RO,BG
98789,1699170720,1699174320,3600,6882,129692,GB,FR
75614,1699451640,1699469580,17940,32910,45962,US,US
164046,1699913820,1699939140,25320,4037,10602,BA,DE
95504,1699027800,1699036080,8280,121863,29235,IT,IT
173941,1699791180,1699810200,19020,78705,4032,FR,FR
198855,1700382120,1700397000,14880,34411,70748,US,US
44331,1700595720,1700626560,30840,109494,190251,TR,TR
74765,1700185140,1700214300,29160,64995,6936,TR,TR
134011,1700056320,1700087760,31440,156652,11355,TR,TR
40771,1698953940,1698962340,8400,59453,60090,FI,EE
162770,1699592460,1699597440,4980,82604,40092,GB,GB
19336,1699734300,1699746960,12660,76678,140760,US,US
172629,1700173080,1700205180,32100,20750,42506,TR,TR
102466,1699987260,1700021100,33840,79383,29638,TR,TR
82005,1698901260,1698916980,15720,63224,133852,FR,FR
192929,1698860160,1698870240,10080,159021,76099,IT,IT
69155,1699341600,1699357260,15660,12673,46793,FR,FR
163625,1700131500,1700137380,5880,128659,149846,NL,NL
136909,1699844760,1699850820,6060,71469,48499,GB,GB
187540,1699337880,1699367760,29880,164806,68670,TR,TR
6985,1700277720,1700281320,3600,22280,48346,GB,GB
29637,1699991700,1699995300,3600,10356,128447,NL,NL
140676,1699669020,1699678200,9180,170683,184793,ES,ES
125898,1699485720,1699516500,30780,70909,156638,TR,TR
167718,1699543380,1699568580,25200,88854,30836,BR,BR
172628,1700660460,1700675460,15000,64167,141681,US,US
195356,1699839540,1699853160,13620,63761,173766,IT,IT
146941,1700316420,1700320020,3600,140105,68592,GB,GB
48802,1699915740,1699926660,10920,156671,96979,US,US
117670,1700168700,1700199960,31260,72351,135924,TR,TR
32318,1700620500,1700632860,12360,129827,156334,US,US
35882,1698920460,1698929640,9180,156258,14716,IT,DE
171029,1699796700,1699835460,38760,92237,166800,MX,MX
194496,1698965700,1698978780,13080,171062,30216,RS,BG
105437,1699418940,1699429260,10320,113128,100969,PT,PT
2852,1700370900,1700397720,26820,103061,79583,DE,DE
61076,1700576160,1700587620,11460,172429,62428,US,US
99686,1699618920,1699631580,12660,39277,46009,US,US
187064,1700395440,1700424600,29160,167698,15016,TR,TR
56440,1699897500,1699932120,34620,115760,11679,TR,TR
72604,1699727460,1699736520,9060,151734,125426,IT,IT
144068,1699996380,1700031960,35580,103106,119996,TR,TR
46074,1700788200,1700799900,11700,34942,10667,US,US
127325,1700283900,1700292180,8280,34428,115288,SK,SK
101096,1699500420,1699512000,11580,6602,133844,US,US
193307,1698832680,1698842760,10080,77391,45707,IT,CH
117405,1699890960,1699901040,10080,137900,42664,IT,IT
99235,1699533180,1699561500,28320,14679,60436,BA,HR
108790,1700615100,1700647560,32460,25371,30628,TR,TR
131163,1700049180,1700078040,28860,160529,186667,TR,TR
14245,1700146500,1700170740,24240,180274,142842,DE,DE
84565,1699922400,1699955640,33240,150991,14285,TR,TR
17313,1700230200,1700241180,10980,22629,171191,US,US
143214,1699661400,1699676100,14700,51189,41084,RS,RS
94278,1700025000,1700057160,32160,33943,93668,TR,TR
180930,1699309320,1699342680,33360,60995,101846,TR,TR
178800,1699999020,1700014080,15060,178986,130065,US,US
76323,1700596620,1700630640,34020,71310,188766,TR,TR
117482,1699822020,1699827720,5700,57771,190700,GB,GB
172502,1699955280,1699959240,3960,96905,134266,AD,ES
111667,1700657700,1700661300,3600,186449,192849,NL,NL
12677,1698927120,1698958140,31020,108755,31004,TR,TR
157243,1699164660,1699196100,31440,153475,143073,TR,TR
166584,1700340600,1700371020,30420,122724,50076,TR,TR
134456,1700022360,1700026620,4260,121641,123288,NL,NL
68967,1699282320,1699291740,9420,43139,128837,HR,HR
786,1699926180,1699949580,23400,192221,78396,PL,PL
189021,1699954560,1699970040,15480,193329,168882,US,US
85681,1700515740,1700547120,31380,181404,162828,TR,TR
35685,1698815220,1698830640,15420,38023,78468,CZ,CZ
167644,1699741260,1699752060,10800,36024,51899,US,US
133728,1700178780,1700187480,8700,75103,9720,IT,IT
186908,1699174440,1699180020,5580,64733,153883,AD,FR
150241,1699933560,1699950120,16560,172911,33658,CA,CA
94189,1698835380,1698870720,35340,175752,77538,TR,TR
134988,1699169700,1699202580,32880,24140,45638,TR,TR
167444,1699399260,1699432080,32820,125528,92894,TR,TR
53687,1700861220,1700875380,14160,166308,48081,HR,HR
4399,1699923900,1699957440,33540,150390,59317,TR,TR
185915,1700464320,1700495520,31200,198019,182597,TR,TR
82307,1699979820,1700011800,31980,101643,117169,TR,TR
61141,1700641620,1700680260,38640,94250,166662,MX,US
177308,1699957920,1699992360,34440,123742,123543,TR,TR
129322,1700252700,1700269080,16380,43010,176316,US,US
97877,1699986780,1699990380,3600,63583,50212,GB,GB
122725,1700706300,1700709900,3600,29556,81148,GB,GB
159222,1699519020,1699553820,34800,114165,188841,TR,TR
162703,1700780940,1700809980,29040,172424,144602,TR,TR
114468,1700379060,1700382660,3600,146004,78109,NL,NL
155782,1699977300,1699983600,6300,43925,196994,GB,GB
108232,1699384620,1699399800,15180,7570,77282,AT,DE
96760,1699327440,1699340400,12960,166368,99823,IT,IT
143310,1699840740,1699844520,3780,43463,110600,GB,GB
12163,1700087940,1700123580,35640,133960,107403,TR,TR
87069,1700161380,1700176740,15360,9087,87208,FR,DE
118588,1699829580,1699845600,16020,155169,65188,US,US
130465,1699526880,1699540920,14040,6988,89954,IT,IT
160305,1700544480,1700579400,34920,78329,194205,TR,TR
162,1700403180,1700416740,13560,88782,83377,PT,PT
25574,1698922860,1698957780,34920,16061,488,TR,TR
188281,1699601940,1699634100,32160,48586,189061,TR,TR
182971,1700566260,1700579040,12780,147730,182954,IT,IT
79432,1700362800,1700375400,12600,62520,48614,IT,IT
79467,1699518540,1699524660,6120,38648,32510,NL,NL
171236,1700521320,1700554320,33000,141755,40694,MX,MX
66670,1700644020,1700677860,33840,74888,189492,TR,TR
59948,1699745880,1699776720,30840,2794,127698,TR,TR
19794,1700302320,1700315040,12720,25616,9590,US,US
77259,1698939060,1698956940,17880,49335,159193,FR,FR
21826,1699360980,1699370100,9120,301,194888,SK,SK
109459,1699972620,1700004240,31620,105432,108330,TR,TR
116517,1699575720,1699579320,3600,12618,16030,GB,GB
62606,1699175940,1699180680,4740,195075,161480,GB,GB
177033,1700151180,1700180760,29580,95275,143364,TR,TR
140578,1699664640,1699686720,22080,8877,110617,DE,BE
77569,1700267040,1700297460,30420,182716,95329,BA,HR
108007,1700689620,1700724660,35040,66956,92857,MX,MX
36564,1700343060,1700348820,5760,191663,119257,GB,GB
81178,1700051280,1700073240,21960,88245,125493,PL,PL
118818,1699041120,1699054140,13020,92055,106278,IT,IT
187653,1699095660,1699128900,33240,143665,111707,TR,TR
81401,1699440420,1699452780,12360,30394,96951,IT,IT
184792,1698955860,1698959460,3600,104988,51502,GB,GB
184029,1699868340,1699898100,29760,16565,82836,TR,TR
175348,1699370700,1699398360,27660,186651,140849,HU,AT
9130,1699121640,1699153020,31380,162748,51867,TR,TR
37013,1699699440,1699731960,32520,183373,157393,TR,TR
79602,1700694960,1700707680,12720,39520,186365,US,US
22455,1700754900,1700789880,34980,138723,186990,TR,TR
155520,1700002740,1700006340,3600,98826,114194,GB,GB
151130,1700493900,1700500800,6900,1365,152815,GB,GB
1254,1699052760,1699086420,33660,95816,53863,TR,TR
161953,1699866960,1699899000,32040,150026,91252,TR,TR
177933,1700356800,1700360400,3600,174592,1792,NL,NL
31431,1700447700,1700481180,33480,145587,49926,TR,TR
30541,1700091180,1700098320,7140,43564,178330,EE,EE
107757,1699091520,1699120980,29460,4010,13486,TR,TR
39469,1700345340,1700374740,29400,42675,48901,TR,TR
176783,1699447380,1699467060,19680,142460,87409,SI,RS
38846,1700370360,1700386260,15900,182231,9304,US,US
27899,1699776300,1699809420,33120,4630,22653,TR,TR
61156,1700507580,1700536920,29340,53365,160121,TR,TR
3330,1699277940,1699293780,15840,46519,84987,BE,NL
66403,1698886440,1698900840,14400,68203,193292,US,US
67728,1700742300,1700777760,35460,171020,72487,TR,TR
124027,1700093460,1700102400,8940,71125,169141,IT,IT
27505,1699349700,1699380060,30360,139390,173056,TR,TR
36665,1700089560,1700100840,11280,38215,128941,IT,IT
135007,1699041000,1699048800,7800,16462,103634,IT,IT
4291,1699190880,1699207800,16920,171411,157040,US,US
123961,1699183980,1699213440,29460,187096,25241,TR,TR
194045,1700742120,1700772840,30720,121297,155433,TR,TR
190723,1699074780,1699091700,16920,140687,116376,RS,SI
131238,1700652180,1700710680,58500,119367,154311,UA,DE
31017,1700550360,1700561640,11280,29732,87418,IT,DE
136891,1699405020,1699420500,15480,189491,24629,US,US
6520,1699464780,1699499640,34860,4515,159607,TR,TR
169226,1700244180,1700272980,28800,47260,53300,TR,TR
69944,1698929520,1698948420,18900,105575,139651,BE,NL
173493,1699651080,1699680780,29700,18981,177252,TR,TR
97221,1699175340,1699210860,35520,134888,141218,TR,TR
196422,1699898040,1699926780,28740,143693,151028,RO,RO
159986,1700023140,1700031120,7980,3520,182391,HR,HR
120298,1700713920,1700729580,15660,148241,186837,US,US
38584,1699114320,1699127940,13620,156237,58996,US,US
70572,1700484900,1700497740,12840,44442,159958,US,US
102560,1700384700,1700400060,15360,20912,64937,US,US
184636,1700863560,1700898480,34920,110996,113090,TR,TR
130137,1700731980,1700742180,10200,176120,100935,EE,EE
169734,1700163900,1700168100,4200,47583,152810,NL,NL
116013,1699776120,1699810500,34380,74731,175377,TR,TR
176121,1700194560,1700220720,26160,173432,123390,DE,CH
155710,1699809840,1699818480,8640,56383,145889,ES,ES
152355,1700030040,1700036940,6900,176077,78520,NL,NL
121947,1700217480,1700250000,32520,43968,143954,TR,TR
129153,1699450800,1699484820,34020,136999,67373,TR,TR
181173,1699125720,1699161660,35940,32715,117840,TR,TR
11424,1700360820,1700370480,9660,173288,172719,IT,IT
164148,1700261280,1700273160,11880,145750,19087,PT,PT
80863,1700479380,1700491740,12360,125483,71528,IT,IT
159718,1699976820,1699987380,10560,128980,139424,IT,IT
106550,1699341900,1699377480,35580,59399,112404,TR,TR
64385,1699986960,1700000820,13860,46646,86319,US,US
151232,1699820040,1699844400,24360,60541,27525,PL,PL
180703,1700227080,1700242980,15900,179076,36213,FR,AD
142920,1700085960,1700099100,13140,80761,197817,IT,IT
87202,1699520580,1699549800,29220,124157,9041,TR,TR
102232,1698951840,1698965760,13920,177025,157671,US,US
15610,1700377980,1700410680,32700,62675,151902,TR,TR
109231,1699876380,1699905540,29160,171073,144740,TR,TR
131254,1699466700,1699493760,27060,148394,19633,BR,BR
61221,1699865700,1699871280,5580,87497,194441,GB,GB
77147,1700604720,1700610840,6120,189831,94948,AD,ES
188002,1699661100,1699695060,33960,5461,157075,TR,TR
106293,1699705200,1699716060,10860,188719,121020,US,US
41116,1699667160,1699702380,35220,161621,65479,TR,TR
19592,1699289280,1699306140,16860,10762,81977,RS,RS
73938,1700382900,1700392800,9900,95830,89303,HR,HR
169004,1699573620,1699601520,27900,189028,98032,PL,PL
24033,1699761600,1699777860,16260,61796,78649,AT,AT
168186,1699512540,1699529220,16680,166996,128801,US,US
166148,1700634660,1700638260,3600,27114,178443,NL,NL
96502,1699284240,1699311000,26760,51540,109702,PL,PL
15126,1699477500,1699489560,12060,194751,140276,US,US
109083,1699363500,1699374120,10620,77607,33562,HR,HR
145621,1700602860,1700615400,12540,187264,112504,IT,IT
194658,1700665200,1700722140,56940,90154,44273,BG,BG
71376,1699015200,1699022820,7620,375,101895,IT,IT
191811,1698919140,1698923760,4620,111263,167601,GB,GB
77192,1699020000,1699049460,29460,22014,34160,TR,TR
3721,1700433180,1700439600,6420,131580,16,NL,NL
41756,1700324100,1700355660,31560,94753,198728,TR,TR
151981,1699698360,1699704000,5640,98514,32879,NL,NL
18089,1700740320,1700769300,28980,1142,196653,TR,TR
52897,1699031460,1699045620,14160,8114,43180,ES,AD
112531,1700503020,1700516760,13740,100971,98739,US,US
73593,1700138460,1700142900,4440,150307,105541,GB,GB
7313,1700154180,1700159160,4980,15215,162625,GB,GB
177580,1699877220,1699902060,24840,124862,162967,DE,DE
88442,1699638900,1699672860,33960,60648,40491,TR,TR
13583,1700622720,1700630340,7620,30860,4692,PT,PT
157140,1700734620,1700767020,32400,36706,172958,TR,TR
66345,1699107780,1699139520,31740,27432,90082,TR,TR
155575,1699400520,1699432920,32400,26850,33092,TR,TR
181153,1700097420,1700113020,15600,23646,139206,US,US
103325,1700197500,1700214900,17400,38860,160492,FR,NL
184538,1699082700,1699095300,12600,36089,8177,IT,IT
19982,1699187760,1699191360,3600,133141,68662,NL,FR
194493,1699029000,1699036140,7140,161611,86911,GB,GB
70,1699716480,1699723620,7140,71916,23726,NL,NL
76090,1699873080,1699904880,31800,46584,84644,TR,TR
136153,1700675220,1700690640,15420,77809,27790,US,US
90725,1699349280,1699352880,3600,139552,60673,NL,NL
79225,1699875900,1699892100,16200,85073,9370,US,US
177327,1700458500,1700492820,34320,59539,37948,TR,TR
69476,1700496240,1700530500,34260,82758,33301,TR,TR
67584,1698794340,1698829080,34740,81873,131103,TR,TR
56478,1699437660,1699461780,24120,89148,47504,HU,AT
175098,1699206480,1699235400,28920,2712,147756,TR,TR
39196,1699812300,1699840560,28260,101373,62966,BR,BR
173995,1699173120,1699193400,20280,73239,19747,FR,ES
9241,1699001760,1699034340,32580,27011,134936,TR,TR
159299,1698939780,1698956520,16740,13842,85680,AT,PL
12204,1700334060,1700344860,10800,26587,44634,US,US
11687,1699786320,1699815600,29280,97856,23457,TR,TR
68322,1699887000,1699918440,31440,57486,179239,TR,TR
7132,1698924540,1698930960,6420,155092,41776,NL,NL
174549,1700153220,1700185320,32100,32531,164344,TR,TR
65773,1700857080,1700890200,33120,180422,115454,TR,TR
84859,1699166400,1699178520,12120,48648,117815,US,US
65040,1700470320,1700528160,57840,174632,15259,UA,CZ
117224,1699087860,1699110600,22740,10058,82566,PL,PL
149811,1698885840,1698918420,32580,108902,115462,TR,TR
149654,1699856160,1699865820,9660,39009,36842,IT,FR
3928,1700341680,1700366940,25260,26892,103152,BA,DE
70117,1699261260,1699270500,9240,95614,183511,IT,IT
101774,1699228020,1699233600,5580,2686,161728,NL,NL
55875,1699679460,1699703760,24300,142681,185759,DE,IT
28656,1698835080,1698869820,34740,78724,79710,TR,TR
143944,1699320540,1699354380,33840,9778,83030,TR,TR
52315,1699013040,1699045560,32520,87350,90477,TR,TR
183816,1699099680,1699103280,3600,85910,163383,GB,GB
17314,1700468640,1700498460,29820,34692,157904,TR,TR
161881,1699838040,1699872720,34680,11060,90496,TR,TR
152889,1700445120,1700473920,28800,151749,159195,TR,TR
74113,1700275740,1700309760,34020,54498,83624,MX,MX
9529,1699876980,1699904160,27180,65538,165609,PL,PL
175215,1699114380,1699128360,13980,10141,28997,US,US
135818,1699991520,1700003760,12240,136283,7294,US,US
111202,1699169160,1699198560,29400,125679,185585,TR,TR
68059,1700406000,1700409600,3600,72612,29442,NL,NL
99885,1700296140,1700300940,4800,192799,87542,GB,GB
50443,1699141620,1699162560,20940,35769,147458,FR,FR
199832,1699213440,1699221600,8160,179189,136975,HR,HR
4463,1699646460,1699657320,10860,98150,77151,HR,HR
83297,1699507560,1699511160,3600,176505,128005,GB,GB
52524,1699358460,1699378020,19560,18413,112520,FR,FR
61861,1700139420,1700176080,36660,150013,123555,MX,MX
152849,1699588860,1699610280,21420,64489,189347,FR,BE
171135,1699048740,1699055460,6720,39079,32047,GB,GB
53222,1699411680,1699445640,33960,54076,62162,TR,TR
172986,1698967380,1698981060,13680,25618,48587,US,US
80283,1699904940,1699916520,11580,187566,14416,US,US
163211,1699773960,1699789380,15420,43852,117416,US,US
86176,1699069680,1699091940,22260,132935,149328,CH,IT
171781,1699675380,1699708620,33240,163133,57667,MX,MX
81088,1699556160,1699571640,15480,122132,119127,FR,FR
191600,1699173180,1699207440,34260,192161,25196,TR,TR
38290,1699120680,1699124280,3600,80973,124869,GB,GB
95268,1699972200,1700002080,29880,18668,127455,TR,TR
111152,1699310100,1699339080,28980,155067,64802,TR,TR
166721,1700133360,1700145240,11880,117478,81227,US,CA
172190,1699852380,1699855980,3600,13003,133855,NL,NL
57094,1700627100,1700638920,11820,36948,130064,CZ,NL
93405,1699094160,1699112100,17940,67246,193014,CA,CA
53969,1699367160,1699370760,3600,66194,131874,NL,BE
5902,1699740660,1699770720,30060,18905,127876,TR,TR
70170,1699850100,1699881420,31320,47553,141536,TR,TR
66708,1700080500,1700094600,14100,3583,103695,IT,IT
44945,1698829080,1698864420,35340,42227,196328,TR,TR
29112,1700778720,1700809020,30300,78008,142103,TR,TR
150630,1699384800,1699399800,15000,17185,13084,US,US
71363,1700019120,1700052000,32880,53847,94177,TR,TR
74875,1700561760,1700579280,17520,198040,64072,US,US
143927,1699549140,1699562820,13680,10979,31914,US,US
78325,1699897500,1699901100,3600,196294,190777,GB,GB
100342,1700420220,1700476020,55800,84794,121812,BG,DE
120993,1700841000,1700844600,3600,150962,78999,GB,GB
53751,1699788780,1699818300,29520,3431,67898,TR,TR
30547,1699040100,1699043700,3600,159874,135728,NL,NL
175752,1699824900,1699841700,16800,35922,77082,US,US
73017,1700181480,1700194440,12960,129963,185180,US,US
87209,1699563540,1699570500,6960,164082,12347,GB,GB
199342,1700215260,1700229240,13980,92099,25540,PT,PT
104361,1699720560,1699729140,8580,134214,96948,IT,IT
169606,1700246700,1700250300,3600,23986,116670,GB,GB
160782,1698910800,1698914400,3600,171853,67328,NL,DE
174734,1699997040,1700000880,3840,59107,64459,GB,GB
131843,1700796000,1700851320,55320,36072,191954,BG,DE
75543,1700320920,1700356080,35160,167411,7331,TR,TR
122708,1699802220,1699832700,30480,119863,170109,TR,TR
21811,1700142120,1700146980,4860,97274,179198,NL,NL
128299,1698906360,1698916140,9780,28582,28163,IT,IT
151146,1698934320,1698960660,26340,178650,166441,DE,DE
48774,1699021920,1699036200,14280,184606,162486,ES,DE
25155,1700203260,1700234700,31440,108425,39639,TR,TR
86172,1700438580,1700474340,35760,37240,49990,TR,TR
37508,1700388360,1700393340,4980,398,148270,NL,NL
108567,1700130960,1700138760,7800,170890,177426,HR,HR
71967,1700204040,1700237460,33420,73544,5559,TR,TR
71084,1700554680,1700589420,34740,152610,45434,MX,US
56145,1700609820,1700626560,16740,30301,141759,AT,PL
141885,1699679760,1699696680,16920,71102,125682,AT,CZ
123626,1700140200,1700174700,34500,178974,145622,TR,TR
6934,1698973140,1699002960,29820,169208,75928,TR,TR
93421,1699079700,1699083300,3600,39933,124608,NL,NL
1355,1699457820,1699488540,30720,10496,114342,TR,TR
75899,1700038560,1700073120,34560,119878,191436,TR,TR
140071,1699152060,1699155660,3600,6777,146941,GB,GB
172434,1698972960,1699005120,32160,131060,97957,TR,TR
7844,1700672340,1700678880,6540,186949,72739,GB,GB
133456,1699367880,1699390680,22800,121672,172826,RO,RO
20422,1700477760,1700513700,35940,113564,208,TR,TR
145105,1699507200,1699540740,33540,23372,89625,TR,TR
198138,1699413960,1699417560,3600,104276,67184,NL,NL
151104,1699765800,1699799340,33540,26028,41372,TR,TR
35992,1700334180,1700365800,31620,180161,88198,TR,TR
8897,1699003800,1699008420,4620,198801,34481,NL,NL
68528,1699992300,1700002680,10380,45915,58433,IT,IT
158693,1700673660,1700707140,33480,73376,17571,TR,TR
123419,1698873900,1698910980,37080,29581,41222,MX,MX
132389,1700180520,1700189520,9000,27230,108804,IT,IT
6057,1699168200,1699197600,29400,191138,97932,TR,TR
89098,1699145640,1699153740,8100,105409,182259,IT,IT
19896,1699048320,1699077720,29400,179306,67469,TR,TR
179689,1700725740,1700738880,13140,27537,18002,US,US
148762,1700714580,1700745900,31320,163829,188126,TR,TR
15900,1699256460,1699295820,39360,26480,4408,MX,MX
62808,1700320380,1700352420,32040,82199,157170,TR,TR
55808,1699641180,1699654020,12840,121854,79523,IT,IT
151615,1700475060,1700510760,35700,45930,113773,TR,TR
72008,1699482600,1699491120,8520,112184,58107,IT,IT
162824,1699946400,1699958760,12360,29900,4099,IT,IT
149305,1699612140,1699629000,16860,116211,156993,US,US
84045,1699585140,1699620420,35280,142418,152741,TR,TR
154213,1700680380,1700687820,7440,123008,26255,ES,ES
73782,1700539080,1700571300,32220,81995,70515,TR,TR
63931,1700701920,1700730660,28740,85712,153516,DE,DE
26693,1700124840,1700154660,29820,126583,188524,TR,TR
57964,1699531500,1699558380,26880,34277,197411,PL,PL
5266,1699698300,1699732080,33780,106481,193124,TR,TR
122929,1699493640,1699504980,11340,135139,87602,IT,FR
73152,1700218140,1700222220,4080,39274,120307,EE,EE
180644,1700794500,1700801640,7140,96182,63338,GB,GB
34919,1699849980,1699874400,24420,33346,175173,BR,BR
83307,1699315020,1699341660,26640,34354,83324,DE,DE
65978,1698880620,1698912840,32220,151313,189037,TR,TR
168114,1700528820,1700562360,33540,7107,135851,TR,TR
12844,1698899400,1698912240,12840,104017,4772,US,US
55347,1700807280,1700838780,31500,114743,178686,TR,TR
160475,1699264020,1699277640,13620,93909,189002,US,MX
148242,1700741400,1700751840,10440,77515,74482,IT,IT
32787,1698896940,1698917880,20940,164081,59802,FR,FR
45008,1699669800,1699704180,34380,60449,90558,TR,TR
25751,1698913320,1698927480,14160,97763,110702,HR,HR
25688,1699632300,1699664880,32580,53878,153052,TR,TR
91524,1700075580,1700089320,13740,187061,95473,US,US
104517,1698867840,1698900960,33120,21235,70709,TR,TR
13093,1700021580,1700054400,32820,76898,4276,TR,TR
92269,1700510520,1700522640,12120,129602,91189,US,US
102481,1700608920,1700641440,32520,196312,111037,TR,TR
132207,1700473920,1700509740,35820,129320,61177,TR,TR
178179,1700624220,1700640720,16500,41078,48253,FR,FR
122657,1698866160,1698869760,3600,186151,101302,GB,GB
184133,1699543740,1699549560,5820,172339,6191,NL,NL
30221,1700734200,1700760900,26700,58046,38337,DE,DE
48856,1698850260,1698862260,12000,52011,102493,US,CA
146527,1699011060,1699044720,33660,175737,25453,TR,TR
47824,1700225700,1700259660,33960,88008,120336,TR,TR
84074,1699489140,1699492740,3600,15100,95316,GB,GB
57922,1698941460,1698947640,6180,3568,173112,GB,GB
154021,1700737980,1700741580,3600,28474,132389,NL,NL
138840,1698861780,1698892140,30360,96359,181192,TR,TR
80290,1698867120,1698872100,4980,137186,112930,NL,NL
105122,1700536920,1700540520,3600,149193,146509,NL,BE
130959,1700173140,1700178000,4860,105929,93395,GB,GB
179260,1700146200,1700160000,13800,113008,190311,IT,IT
140041,1700644260,1700647860,3600,75955,69763,NL,NL
195479,1700861760,1700865360,3600,141497,31170,GB,GB
193782,1699439160,1699454640,15480,140334,121222,CZ,CZ
161354,1699254900,1699288920,34020,153144,20901,TR,TR
105434,1699648440,1699655100,6660,79859,129469,GB,GB
51170,1699768740,1699783620,14880,149524,105758,CA,CA
76977,1699852560,1699883220,30660,3589,171144,TR,TR
160889,1700017740,1700032080,14340,160424,191862,US,US
191791,1700242260,1700269380,27120,81125,156939,DE,DE
174914,1700424960,1700432640,7680,125355,53225,IT,FR
188387,1700230740,1700244120,13380,57435,142527,US,US
130819,1699203240,1699226220,22980,80,45268,CH,FR
99603,1698893400,1698897000,3600,157757,124537,GB,GB
19421,1699571340,1699602900,31560,20153,42373,TR,TR
196681,1700196840,1700208480,11640,135400,169881,US,US
81262,1700399400,1700429340,29940,112517,11153,TR,TR
36176,1699130040,1699161900,31860,74666,42070,TR,TR
5474,1699572600,1699588260,15660,149858,126748,US,US
192246,1700557080,1700560680,3600,159488,45763,GB,GB
185060,1700555880,1700572200,16320,135207,98282,BE,FR
115925,1699891260,1699902780,11520,33647,149277,HR,BA
164938,1700409060,1700415720,6660,150250,1704,GB,GB
67332,1700004420,1700008020,3600,100166,190495,GB,GB
141262,1699742400,1699766760,24360,170152,162553,DE,IT
199855,1699281480,1699288020,6540,180225,160045,GB,GB
23154,1698794040,1698799260,5220,185050,113557,GB,GB
82869,1699967640,1699974660,7020,199620,111571,GB,GB
141497,1698821760,1698850920,29160,86207,118242,TR,TR
33345,1699204260,1699216140,11880,14401,191039,US,US
94851,1699764780,1699775280,10500,128959,144888,HR,HR
93702,1700370000,1700384280,14280,115905,108345,IT,IT
166451,1700356140,1700359740,3600,49411,140053,GB,GB
109491,1700846820,1700879340,32520,149591,999,MX,MX
143149,1700259300,1700293440,34140,176363,5548,TR,TR
141427,1700337420,1700350200,12780,150076,195690,AT,AT
111229,1700542560,1700555820,13260,189231,42674,US,US
175366,1700531940,1700543100,11160,87620,135300,HR,HR
100126,1699198800,1699214820,16020,192958,36963,FR,NL
178469,1700068740,1700082600,13860,182206,121623,RS,RS
42898,1700659020,1700673540,14520,76747,56492,US,US
156642,1699026360,1699039560,13200,112947,127906,CA,US
148833,1700199120,1700210460,11340,161059,113119,HR,DE
106918,1699378260,1699394280,16020,149390,98237,CZ,CZ
174119,1699159080,1699193100,34020,88295,83201,TR,TR
195298,1700643840,1700647440,3600,64394,96865,GB,GB
184928,1700117760,1700153040,35280,3150,197909,TR,TR
63946,1698936300,1698966720,30420,191599,126982,TR,TR
186248,1700384940,1700399040,14100,161834,101476,CZ,CZ
29445,1700666580,1700684100,17520,175576,160706,AT,DE
84098,1700510100,1700523960,13860,11680,10806,IT,IT
24698,1700038860,1700053620,14760,129612,91513,FR,FR
118261,1698991680,1699003320,11640,159741,155993,CA,US
147362,1699601700,1699633020,31320,168736,155925,BA,HR
27146,1699682160,1699694220,12060,193481,111588,IT,IT
171887,1698901260,1698904860,3600,98752,115592,NL,NL
151548,1699750200,1699787700,37500,193303,21241,MX,MX
144717,1700314620,1700323140,8520,57451,180549,CL,CL
192874,1699879080,1699909920,30840,90646,104306,TR,TR
100003,1699534020,1699567800,33780,170620,102040,TR,TR
78309,1699203120,1699235520,32400,153643,159088,TR,TR
129718,1699699920,1699714200,14280,152483,156304,US,MX
135243,1699843560,1699851540,7980,61836,140936,IT,IT
180172,1699546620,1699554720,8100,162430,27318,IT,IT
119841,1700707080,1700739600,32520,39689,9782,TR,TR
169979,1700553420,1700563560,10140,155,78942,HR,HR
141863,1700547720,1700565540,17820,178182,67683,US,US
71078,1699032180,1699054620,22440,35226,188279,DE,DE
143996,1699035900,1699049220,13320,161478,97561,US,US
35997,1700209800,1700231580,21780,184258,38062,DE,BG
83847,1699607760,1699620300,12540,143080,76183,US,US
76728,1700170740,1700206260,35520,125905,155160,MX,MX
42759,1699624320,1699658100,33780,129346,149738,TR,TR
29317,1698991020,1698997860,6840,34534,21490,GB,GB
136787,1699163760,1699195560,31800,168436,82141,TR,TR
105780,1699491060,1699495380,4320,133419,69137,GB,GB
172206,1700591940,1700622840,30900,41519,21294,TR,TR
10103,1698816360,1698823620,7260,141194,118663,IT,IT
167267,1699282680,1699300920,18240,87061,83739,FR,BE
59244,1700316180,1700326080,9900,146000,118343,IT,IT
135576,1699724700,1699757160,32460,161010,149201,TR,TR
107627,1700653860,1700689020,35160,49376,159004,TR,TR
87176,1698872100,1698875700,3600,178081,74129,NL,NL
8559,1699247940,1699273740,25800,154717,36285,BR,BR
178594,1700043120,1700056620,13500,141,181549,PT,PT
48793,1699574880,1699582200,7320,3358,164243,IT,IT
23158,1700127960,1700131560,3600,164946,110679,GB,GB
159464,1699108560,1699137660,29100,72573,163840,TR,TR
73968,1699708560,1699725480,16920,170862,181622,FR,GB
69634,1700366640,1700382060,15420,151607,4958,FR,FR
47543,1698849780,1698865920,16140,153303,70403,AT,AT
76307,1700764380,1700767980,3600,143234,162057,GB,GB
21624,1699116600,1699150320,33720,110588,95264,TR,TR
47095,1700104380,1700135640,31260,16537,182478,TR,TR
101655,1699991760,1700030520,38760,41326,51061,MX,MX
134617,1700667420,1700681880,14460,41201,27819,AT,AT
97080,1699168380,1699195320,26940,190875,16504,CH,DE
150931,1699996260,1700019240,22980,138132,172214,PL,PL
31849,1700579760,1700612160,32400,9788,107409,TR,TR
67815,1700730480,1700742960,12480,172297,129251,IT,IT
99734,1700568600,1700572200,3600,63612,190557,NL,NL
132056,1698873540,1698895380,21840,113598,30962,RO,RO
50251,1700478180,1700490480,12300,139565,7712,IT,IT
28631,1698806640,1698814680,8040,168343,82110,HR,HR
144780,1700321580,1700325180,3600,148854,7222,GB,GB
16408,1699445100,1699475820,30720,195789,42248,TR,TR
183353,1699243560,1699253100,9540,182785,164375,SK,SK
158536,1698949800,1698979440,29640,19268,103803,TR,TR
136940,1699109520,1699113660,4140,104804,184080,GB,GB
196029,1699906680,1699917000,10320,157964,4609,HR,HR
151590,1698889260,1698917400,28140,24253,87507,BR,BR
59971,1699542540,1699571820,29280,11608,31798,TR,TR
73731,1698891420,1698923400,31980,38976,144992,TR,TR
155939,1699765260,1699788300,23040,172973,178983,PL,PL
23614,1700799720,1700827260,27540,46618,92383,DE,RS
715,1699564980,1699597380,32400,104645,81764,TR,TR
143250,1700190180,1700200920,10740,181990,185028,IT,IT
138068,1700397960,1700413080,15120,100530,30495,AT,UA
140128,1699450080,1699484340,34260,84414,53694,TR,TR
21890,1699346040,1699375980,29940,88462,109978,TR,TR
79963,1699915920,1699921140,5220,62843,64483,NL,NL
151573,1699799040,1699833300,34260,122963,13452,TR,TR
31770,1700859720,1700884620,24900,131705,70296,DE,NL
37602,1698870540,1698875940,5400,98018,2446,NL,NL
49470,1699476780,1699502700,25920,111758,124704,BA,AL
176803,1700569440,1700581080,11640,35860,173071,ES,FR
10804,1699327560,1699340220,12660,89371,110707,US,US
59388,1700687520,1700719800,32280,25452,131676,TR,TR
85039,1700837520,1700870760,33240,95869,84086,TR,TR
136254,1700409780,1700442120,32340,130383,163904,TR,TR
14655,1699299480,1699312620,13140,115253,148580,US,US
144868,1698889260,1698901260,12000,75162,17061,US,US
143003,1699433280,1699447320,14040,69830,15385,PT,PT
59146,1700173560,1700208060,34500,21119,172591,MX,MX
118595,1699574160,1699601340,27180,23973,117582,DE,BA
168923,1700470560,1700485260,14700,112369,186408,US,US
64574,1699039200,1699052400,13200,140573,72275,US,US
45539,1698902400,1698936360,33960,96401,123363,MX,MX
197012,1700572680,1700582520,9840,157432,30281,HR,HR
77250,1699684500,1699714800,30300,193300,106089,TR,TR
86708,1699552200,1699571220,19020,73628,132326,FR,FR
80885,1699371240,1699381260,10020,161045,40282,IT,IT
84593,1700821800,1700831580,9780,54607,161514,PT,PT
45888,1698865500,1698891060,25560,96202,164130,PL,PL
67444,1699285680,1699292880,7200,167409,10019,PT,FR
123035,1698991440,1699026480,35040,73687,150205,TR,TR
137188,1699163460,1699174620,11160,61609,51546,US,US
5625,1700373900,1700398560,24660,132824,164333,DK,SE
91698,1699454100,1699467360,13260,103512,182706,IT,IT
102777,1699312560,1699346700,34140,182938,57167,TR,TR
177560,1699863420,1699870200,6780,98239,8369,CL,CL
70477,1700492700,1700496300,3600,189765,137751,GB,GB
133504,1699680780,1699712820,32040,169006,141901,TR,TR
136758,1699103160,1699128480,25320,79525,46575,PL,DE
90504,1700741100,1700745420,4320,80563,108583,GB,GB
107725,1699392000,1699418400,26400,175827,58773,RO,SE
150750,1698970380,1698983340,12960,105099,173501,IT,IT
94601,1699077300,1699111080,33780,144174,181663,TR,TR
29225,1700534760,1700565180,30420,177683,87343,TR,TR
116604,1700023800,1700036580,12780,114018,39091,US,US
42313,1700414340,1700444100,29760,66058,109017,TR,TR
35,1700502180,1700537100,34920,45184,91897,TR,TR
198132,1700743920,1700752680,8760,91347,138553,HR,IT
101377,1700511780,1700533860,22080,129273,1880,DE,PL
11921,1698874440,1698903360,28920,145494,116928,TR,TR
111568,1699707780,1699713540,5760,194579,169477,GB,GB
82486,1700782140,1700812860,30720,137008,108004,TR,TR
91777,1700153640,1700169180,15540,149312,146326,RS,RS
47349,1700109900,1700139060,29160,46626,98786,TR,TR
50948,1699937400,1699954380,16980,174431,106020,US,US
21134,1699789800,1699795860,6060,40446,199815,NL,NL
80994,1699862760,1699866360,3600,85117,98978,GB,GB
52887,1699848840,1699855020,6180,196958,170473,GB,GB
98051,1699898640,1699902240,3600,35276,11427,GB,GB
8692,1700685480,1700715960,30480,67486,84499,TR,TR
146754,1699855620,1699861020,5400,139259,151666,NL,NL
134249,1699750620,1699774860,24240,70122,12870,RO,RO
8927,1699279320,1699282920,3600,181378,173149,NL,NL
4871,1700223960,1700256660,32700,154674,107043,TR,TR
128497,1698841620,1698847740,6120,2067,178876,AD,ES
101125,1700734860,1700764380,29520,7983,113633,TR,TR
10299,1700697480,1700730120,32640,175625,120479,TR,TR
117630,1700244600,1700271960,27360,87060,177982,DE,DE
139349,1700173920,1700205780,31860,52506,145314,TR,TR
128914,1698969300,1698979800,10500,195618,182628,IT,IT
79694,1700240040,1700247240,7200,27625,100403,IT,IT
19634,1699632180,1699639980,7800,40242,192677,IT,IT
96402,1700660340,1700696100,35760,99256,16288,TR,TR
22902,1699940340,1699949160,8820,48370,62183,HR,HR
134070,1700544960,1700550720,5760,127597,177308,GB,GB
182402,1700553360,1700556960,3600,72019,137176,GB,GB
163790,1700078220,1700110980,32760,140869,84097,TR,TR
34918,1699731180,1699742760,11580,159775,199035,US,US
30513,1699080780,1699098540,17760,93729,88493,AT,AT
125526,1700208120,1700241660,33540,136293,98986,TR,TR
105908,1700369520,1700380380,10860,195808,106134,IT,IT
84692,1700336160,1700339760,3600,165548,92084,GB,GB
167856,1700654280,1700657880,3600,99426,20123,NL,NL
22030,1699737360,1699756320,18960,126468,128052,FR,FR
47501,1700842920,1700872860,29940,70454,174875,TR,TR
30250,1698910560,1698943740,33180,77017,32321,TR,TR
5348,1699922220,1699938480,16260,186314,20177,CZ,PL
15163,1700214780,1700226780,12000,154180,32440,SK,CZ
6318,1698925620,1698957900,32280,53277,172468,TR,TR
12652,1699206480,1699210320,3840,22874,67967,NL,NL
64251,1700351880,1700358660,6780,173824,41573,GB,GB
26100,1700288880,1700324160,35280,116496,145918,MX,MX
166881,1699844820,1699858140,13320,159317,71725,US,MX
150627,1700671080,1700709960,38880,69330,4456,MX,MX
156717,1700506920,1700517300,10380,132116,119887,AD,ES
106428,1700116140,1700144100,27960,21656,178400,DE,AT
164988,1699248900,1699261140,12240,57057,11565,US,US
73136,1699933740,1699964160,30420,21839,96473,TR,TR
140431,1700638140,1700651580,13440,80828,124602,PT,PT
141103,1700737920,1700750160,12240,64193,91192,AT,AT
70667,1700506500,1700520840,14340,146810,11703,US,US
61062,1699410600,1699434960,24360,111668,23169,RO,MD
190179,1699903980,1699911360,7380,65206,28699,IT,IT
161386,1699112880,1699128480,15600,164288,56023,US,US
132503,1699479360,1699484100,4740,131585,167850,NL,NL
15664,1699182300,1699204320,22020,155445,184772,PL,EE
138118,1700199360,1700229780,30420,117084,25416,TR,TR
34347,1698940320,1698963240,22920,12375,122491,DE,DE
51378,1698952140,1698957300,5160,150084,34279,NL,NL
17088,1700416980,1700449380,32400,183864,54357,MX,US
100461,1700184060,1700216640,32580,167632,44747,TR,TR
26392,1700316540,1700325180,8640,134007,106466,ES,ES
5488,1699458000,1699472280,14280,18942,78601,IT,IT
31316,1699771500,1699806840,35340,162570,189572,TR,TR
92054,1699025880,1699049040,23160,43806,124581,DE,NL
117961,1699506660,1699518720,12060,187138,108880,IT,IT
6070,1699831320,1699839840,8520,195503,155754,ES,PT
157740,1698947520,1698961740,14220,127161,179473,IT,IT
57914,1699414200,1699446240,32040,115953,186328,TR,TR
35797,1699135620,1699139220,3600,148153,9153,GB,GB
181264,1700098620,1700117760,19140,191337,101728,FR,FR
104417,1700121600,1700150940,29340,85268,83854,TR,TR
34029,1698857760,1698872040,14280,47218,73214,PT,PT
68470,1699618800,1699655940,37140,25385,8915,MX,MX
194406,1699345560,1699379100,33540,125714,17462,TR,TR
83485,1699053420,1699088280,34860,119210,94172,TR,TR
103399,1700108040,1700112360,4320,146123,180691,NL,NL
75248,1699625700,1699636560,10860,107750,107679,ES,ES
19236,1700720340,1700728080,7740,148012,54581,PT,PT
7524,1699061760,1699095060,33300,167806,196777,TR,TR
180121,1700332800,1700336400,3600,39125,99913,NL,NL
104615,1700670840,1700687520,16680,96696,39049,RS,RS
61211,1700476140,1700506080,29940,183471,190223,TR,TR
49129,1700516160,1700520960,4800,122178,48252,EE,LT
176216,1699537620,1699546860,9240,151964,12517,IT,IT
192194,1700531580,1700562000,30420,115457,95150,TR,TR
55257,1699776180,1699806780,30600,30747,4979,TR,TR
33459,1700533020,1700541180,8160,144447,126007,IT,IT
197503,1700583180,1700590440,7260,59369,26577,IT,IT
115701,1700394900,1700398500,3600,163983,35400,GB,GB
141701,1700259720,1700267280,7560,20356,94520,IT,IT
82894,1698919620,1698954360,34740,181002,147268,TR,TR
173404,1699907340,1699939440,32100,116840,118782,TR,TR
85603,1699740240,1699762740,22500,94391,165003,DE,DE
67603,1700525580,1700532960,7380,189318,62041,IT,IT
90479,1700052780,1700088240,35460,117908,40935,TR,TR
149168,1699768140,1699797240,29100,122487,92949,TR,TR
117619,1700679960,1700694120,14160,17726,162631,IT,IT
31786,1699450560,1699463100,12540,160704,181846,US,US
36139,1699838400,1699873920,35520,152980,47489,TR,TR
140515,1699731420,1699741800,10380,144129,110705,HR,HR
156760,1699818600,1699825680,7080,35557,117539,NL,NL
17265,1699500720,1699518240,17520,166259,161195,CZ,CZ
140660,1699890360,1699902000,11640,142334,89230,US,US
24163,1700564640,1700597700,33060,168999,44456,TR,TR
137123,1700559960,1700593440,33480,34244,123482,TR,TR
49619,1700788200,1700818740,30540,80304,38463,TR,TR
198258,1699665480,1699680480,15000,13650,155666,US,US
59907,1700309520,1700313120,3600,160719,156538,GB,GB
91989,1700186460,1700203260,16800,112055,121785,US,US
191781,1699814280,1699844340,30060,22762,155893,TR,TR
144421,1699874460,1699908420,33960,153949,94844,TR,TR
193321,1700546040,1700549640,3600,68015,135678,GB,GB
40262,1700788320,1700791920,3600,189026,25489,GB,GB
67490,1699087260,1699109460,22200,164840,131001,BR,BR
26139,1700199420,1700234700,35280,102660,171776,TR,TR
18006,1699436220,1699465380,29160,15382,114802,TR,TR
125487,1700708520,1700712120,3600,78492,155959,GB,GB
195213,1699707420,1699727880,20460,174356,134389,FR,FR
33114,1699559340,1699564920,5580,135780,137960,GB,GB
81322,1700630040,1700664960,34920,103166,28384,TR,TR
199934,1700772420,1700801700,29280,177879,115772,TR,TR
196752,1698877080,1698912780,35700,49053,100239,TR,TR
47088,1700545560,1700574480,28920,138411,20632,TR,TR
178551,1699747980,1699775100,27120,198370,73025,PL,CZ
131515,1699313580,1699341540,27960,146158,47634,DE,PL
178164,1700193060,1700227920,34860,112342,69040,TR,TR
53296,1699809360,1699838820,29460,76200,190367,TR,TR
5550,1699426560,1699430460,3900,64269,15939,EE,EE
38266,1699195320,1699215060,19740,192219,48449,FR,FR
114364,1700537160,1700540760,3600,91318,132250,GB,GB
68477,1699004460,1699008060,3600,73110,89389,GB,GB
17918,1700859660,1700871060,11400,111917,28453,US,US
111793,1698892260,1698921120,28860,32948,125989,TR,TR
98845,1700340840,1700369520,28680,156574,116772,HU,CZ
26863,1700795280,1700828940,33660,195634,117973,TR,TR
61753,1699156980,1699160580,3600,120069,156600,GB,GB
86907,1700015880,1700024580,8700,139025,182265,IT,IT
16766,1700027220,1700046900,19680,29985,82248,IN,IN
108810,1700595780,1700627340,31560,73564,45167,TR,TR
175992,1700293620,1700331120,37500,103531,154774,MX,MX
135473,1699305780,1699325940,20160,44823,5684,SE,SE
92796,1699511640,1699543080,31440,104385,175135,TR,TR
12016,1700428920,1700441640,12720,53549,191547,US,US
48051,1700715540,1700728020,12480,66427,16268,US,US
25656,1699908420,1699943040,34620,106746,192508,TR,TR
131524,1700784540,1700815140,30600,51326,85902,TR,TR
117714,1700337720,1700358360,20640,96188,91056,FR,FR
8609,1699800900,1699827060,26160,151233,86217,RO,RO
109423,1700462580,1700473320,10740,110725,115589,IT,IT
118329,1700046060,1700079060,33000,88173,60331,TR,TR
83033,1700789640,1700820060,30420,42945,64248,TR,TR
170301,1700236920,1700254260,17340,175137,85626,FR,FR
82868,1700424660,1700446320,21660,101865,99904,DE,NL
40302,1700184240,1700197800,13560,44231,82197,ES,FR
126680,1700827320,1700832000,4680,4059,89583,GB,GB
109560,1700169660,1700200140,30480,117218,151120,TR,TR
103518,1700325600,1700338020,12420,99334,35037,US,US
58489,1698884400,1698916980,32580,138377,41442,TR,TR
79134,1699312920,1699327740,14820,12490,5196,US,US
73420,1700497080,1700505840,8760,83521,143879,IT,IT
198068,1700036340,1700068080,31740,166290,124757,TR,TR
53025,1699651740,1699675860,24120,161669,138493,DE,BE
103922,1700436360,1700447160,10800,172565,30104,IT,IT
183853,1699103640,1699161480,57840,57893,171925,UA,DE
52804,1700392320,1700408580,16260,68405,165185,US,US
73283,1699356540,1699391340,34800,27123,160167,TR,TR
8682,1700080080,1700113140,33060,58086,130604,MX,MX
147085,1700861520,1700896800,35280,167346,54611,TR,TR
87334,1700557860,1700590920,33060,118021,171979,TR,TR
113480,1699709160,1699725240,16080,47062,78412,FR,FR
159212,1700675520,1700710020,34500,92500,124028,TR,TR
167624,1700111100,1700136060,24960,145088,108559,RO,RO
101443,1699598640,1699634580,35940,118449,168719,TR,TR
6718,1699322820,1699326420,3600,7535,970,GB,GB
163505,1700050800,1700080260,29460,102939,63334,TR,TR
48698,1699065240,1699075500,10260,194550,138068,AD,FR
145184,1700086620,1700114880,28260,80794,37123,PL,AT
167451,1700292060,1700324520,32460,124783,21373,MK,DE
64375,1698841200,1698874620,33420,171404,199680,TR,TR
86648,1700725320,1700758140,32820,60120,107942,TR,TR
134492,1699762500,1699798440,35940,178639,79930,TR,TR
70812,1699192740,1699227120,34380,195261,137333,TR,TR
25711,1700581680,1700610840,29160,16448,19667,TR,TR
166399,1699907820,1699944300,36480,165921,71333,MX,US
17627,1699534860,1699569000,34140,131280,50112,TR,TR
22172,1700169480,1700195040,25560,157651,4214,ME,RS
144551,1700600280,1700612640,12360,131626,36440,HR,HR
154671,1699579680,1699606140,26460,1066,25809,DE,PL
101099,1699455660,1699465620,9960,183504,11156,ES,CH
131030,1699912260,1699916160,3900,16173,2033,NL,NL
39488,1700731740,1700764920,33180,190222,193706,TR,TR
57722,1699477680,1699481280,3600,122390,150132,NL,NL
99720,1700483820,1700487420,3600,29853,43050,NL,NL
75578,1699951320,1699990380,39060,84161,78356,MX,MX
124585,1699193280,1699227000,33720,99229,162958,TR,TR
15880,1699596180,1699602060,5880,40936,99868,NL,NL
182557,1699638240,1699666800,28560,60015,1925,BR,BR
119653,1699098180,1699121220,23040,77601,193878,BR,BR
156354,1700585700,1700594100,8400,142843,154394,ES,ES
167925,1699838940,1699843860,4920,63995,177578,GB,GB
2664,1698943800,1698977880,34080,46220,192083,MX,US
66976,1700338140,1700369160,31020,34408,68811,TR,TR
79338,1699875900,1699879500,3600,37114,3637,GB,GB
38688,1700227680,1700260740,33060,100849,143445,TR,TR
121082,1699793580,1699826220,32640,84964,74774,TR,TR
16472,1699305000,1699339380,34380,113896,26096,TR,TR
101248,1698989700,1699022400,32700,192758,138228,TR,TR
184169,1700176620,1700206140,29520,182684,33765,TR,TR
128736,1699084140,1699113840,29700,120402,190677,TR,TR
51674,1698966960,1698995820,28860,53714,31219,TR,TR
190960,1700812020,1700822940,10920,174867,67540,US,US
108123,1700795220,1700812440,17220,10590,155859,CA,US
94882,1699227300,1699241400,14100,61276,125977,US,US
106166,1699043040,1699057740,14700,140361,129390,US,US
107991,1700764080,1700796600,32520,126909,158020,TR,TR
192397,1699636200,1699668900,32700,148058,30642,TR,TR
9907,1700753340,1700787900,34560,162009,147161,TR,TR
149806,1699561740,1699596120,34380,80345,29598,TR,TR
170672,1699757760,1699781460,23700,55172,103551,DE,DE
14096,1700059320,1700076180,16860,159418,181039,US,US
133180,1698894060,1698907560,13500,131886,119897,ES,ES
33972,1700500140,1700525280,25140,5338,75038,PL,PL
41717,1700340600,1700357460,16860,37064,61549,CZ,CZ
196509,1700424120,1700441520,17400,159936,191192,US,US
70238,1699021860,1699042320,20460,115242,89646,FR,ES
107419,1698832560,1698841020,8460,55856,38320,IT,IT
40952,1700498220,1700523780,25560,121112,864,CH,DE
74887,1699764660,1699770840,6180,121532,26086,GB,GB
76631,1700048940,1700058900,9960,119346,114227,SK,SK
164429,1700706540,1700739240,32700,176421,77035,TR,TR
27933,1700375640,1700412300,36660,186976,161710,MX,MX
155985,1699407960,1699422540,14580,25563,101858,CA,CA
126627,1700780280,1700791740,11460,14860,111006,US,US
98538,1699715040,1699723500,8460,187356,146634,PT,PT
99743,1700105280,1700137440,32160,55906,50460,TR,TR
117032,1700283480,1700300220,16740,5154,65045,US,US
73609,1700212680,1700244240,31560,118722,70741,TR,TR
7334,1700053380,1700064420,11040,51488,17935,HR,HR
29368,1700334720,1700364060,29340,100066,49459,TR,TR
112709,1699902900,1699915260,12360,183908,92289,US,US
46673,1700710920,1700722920,12000,109327,161481,US,US
87253,1699571460,1699578480,7020,180910,12737,NL,NL
131842,1699422840,1699438020,15180,35633,187961,US,US
6938,1699527660,1699531260,3600,189682,72954,GB,GB
130216,1700107620,1700137680,30060,27916,106606,TR,TR
193622,1699542960,1699550520,7560,112501,141388,IT,IT
124403,1699573140,1699576740,3600,110336,50389,GB,GB
92737,1700272740,1700285100,12360,82926,143743,AT,AT
65301,1700845500,1700858160,12660,175770,71759,HR,HR
42100,1700766240,1700784000,17760,65609,144746,RS,RS
177383,1699000800,1699004400,3600,178304,80072,GB,GB
115869,1700346780,1700352600,5820,178985,51206,GB,GB
20775,1700507340,1700541300,33960,120813,83874,TR,TR
144825,1700353620,1700362620,9000,57416,77042,IT,IT
8481,1700491560,1700495160,3600,98566,182844,NL,PL
174904,1699674540,1699708860,34320,199926,37484,TR,TR
62038,1699807320,1699823880,16560,170738,140672,CZ,CZ
113529,1699768740,1699785060,16320,50119,198576,US,US
135398,1699631220,1699666440,35220,111021,73520,TR,TR
120036,1699297260,1699327680,30420,154937,153818,TR,TR
12040,1700773800,1700783160,9360,113412,31109,AD,ES
37519,1699624020,1699633080,9060,95099,161505,IT,IT
74075,1699373460,1699404480,31020,91185,29179,TR,TR
171444,1699952040,1699955640,3600,91419,70664,NL,NL
112797,1700666400,1700694540,28140,60726,85247,DE,FR
55047,1699369680,1699385520,15840,18796,159248,US,US
36731,1700157420,1700192220,34800,102282,153943,TR,TR
167869,1698850080,1698869520,19440,64114,47144,SI,RS
117720,1699367700,1699374600,6900,147676,6161,NL,BE
163980,1700472840,1700490540,17700,140459,141465,US,US
160426,1699644240,1699659180,14940,36143,55774,US,US
82837,1699571100,1699603980,32880,100933,194357,TR,TR
136232,1700125500,1700136780,11280,105893,182392,IT,CH
145162,1700585580,1700618940,33360,157814,146906,TR,TR
158074,1698842760,1698875700,32940,176751,190182,TR,TR
121459,1700552460,1700560800,8340,24841,74415,IT,IT
123279,1700497800,1700525400,27600,129403,198636,DE,DE
49716,1700133000,1700162700,29700,51951,183077,TR,TR
111107,1699908540,1699923840,15300,118663,152297,US,US
178727,1700449320,1700487720,38400,110549,164391,MX,MX
48469,1700544360,1700574960,30600,138069,179867,TR,TR
30377,1698869820,1698873840,4020,63462,10269,GB,GB
134682,1700584320,1700590380,6060,138123,34958,GB,GB
173074,1698941220,1698945060,3840,37764,89083,NL,NL
107639,1699064160,1699098420,34260,60474,157451,TR,TR
72915,1699956360,1699980660,24300,145176,41628,DE,DE
67206,1700261880,1700275860,13980,17002,189598,US,US
88793,1700115780,1700142300,26520,41591,89727,DE,CH
55533,1698960900,1698996120,35220,105086,165731,TR,TR
21723,1698956160,1698985500,29340,87505,98320,TR,TR
143005,1699051740,1699081140,29400,100561,178702,TR,TR
123550,1700354280,1700387280,33000,56442,70007,TR,TR
124807,1699750800,1699754400,3600,125880,175298,GB,GB
39293,1700383260,1700387700,4440,193582,57153,GB,GB
190915,1700647860,1700654760,6900,83923,69959,GB,GB
77062,1699510080,1699543020,32940,169713,193110,TR,TR
13620,1698815340,1698819180,3840,58678,112513,GB,GB
167008,1699071240,1699079700,8460,51688,48003,IT,IT
188259,1699302780,1699328160,25380,1926,186676,DE,DE
157906,1700403480,1700433120,29640,52956,65456,TR,TR
90707,1699276620,1699308180,31560,148766,49959,TR,TR
81279,1700493060,1700509620,16560,113276,2588,US,US
171480,1700659260,1700691660,32400,74527,85224,TR,TR
180214,1699544940,1699574760,29820,37179,108342,TR,TR
145740,1699444260,1699471200,26940,197811,59024,BA,HR
192119,1700325840,1700357520,31680,68189,49726,TR,TR
154229,1699327080,1699351560,24480,60603,7699,ME,BA
167140,1700319780,1700351700,31920,50118,133372,TR,TR
54423,1700085600,1700095020,9420,61545,70760,IT,IT
48674,1700650020,1700653920,3900,176923,89965,GB,GB
144003,1699337220,1699370220,33000,22590,43554,TR,TR
28762,1700595840,1700625960,30120,94152,22021,TR,TR
178597,1699586220,1699600500,14280,24606,59056,IT,IT
199991,1699027200,1699039980,12780,82899,153204,AT,AT
91233,1699136700,1699150560,13860,186218,155972,IT,IT
150081,1700840520,1700855760,15240,187193,22032,AT,AT
103969,1698818520,1698847020,28500,4578,32693,RO,MD
39126,1699057980,1699070520,12540,113397,49890,US,US
97486,1699029900,1699044600,14700,64438,58698,US,US
41904,1699748220,1699782240,34020,98471,31357,TR,TR
163725,1699900380,1699929180,28800,175009,88475,TR,TR
304,1699840980,1699858200,17220,8626,158630,US,US
13490,1699026900,1699037640,10740,181262,11375,ES,ES
115980,1698822720,1698826320,3600,84763,49637,NL,NL
125320,1700556540,1700568780,12240,132797,511,US,US
94477,1699100400,1699117140,16740,310,142588,US,CA
79919,1700505120,1700508720,3600,74800,189853,NL,DE
119657,1699514100,1699529760,15660,36463,147317,FR,NL
531,1700242320,1700253960,11640,35945,139940,US,US
134121,1700223840,1700254800,30960,122709,73133,TR,TR
197989,1699987860,1700000040,12180,68534,6189,US,US
53546,1700617260,1700643000,25740,142132,179728,DE,UA
146931,1700213100,1700244660,31560,113803,142008,TR,TR
168554,1700190960,1700194560,3600,37549,98917,GB,GB
157888,1700048400,1700075400,27000,147419,62445,DE,DE
141166,1699435260,1699439040,3780,54622,86735,GB,GB
193947,1700626560,1700657940,31380,116312,49341,TR,TR
167004,1699976580,1699983180,6600,58553,174745,NL,NL
99592,1699883460,1699894140,10680,184761,146898,HR,HR
168476,1699076340,1699088640,12300,5555,123137,US,US
175156,1700040660,1700071980,31320,75564,155387,TR,TR
104539,1699413780,1699448880,35100,67338,144831,MX,MX
87643,1699933980,1699948440,14460,14273,9063,US,US
142063,1699601160,1699610100,8940,78485,62656,IT,IT
189505,1699469220,1699499460,30240,36799,13884,TR,TR
101174,1698971940,1698996240,24300,41083,41343,BR,BR
74546,1699733520,1699766760,33240,84693,40396,TR,TR
54594,1699954440,1699963980,9540,90313,183237,PT,PT
15081,1700315880,1700348640,32760,16863,61884,TR,TR
52500,1699099260,1699142460,43200,85650,111587,LU,NL
118005,1699200000,1699208520,8520,180966,96921,IT,IT
37199,1700673360,1700705460,32100,49397,35841,TR,TR
167391,1699609200,1699612800,3600,160845,21359,GB,GB
53262,1699904400,1699916820,12420,8907,104431,IT,DE
25624,1699221060,1699247760,26700,187743,173316,BR,BR
163258,1698844920,1698860220,15300,199930,17895,AT,AT
166940,1698793800,1698809100,15300,38741,91643,RS,DE
162664,1699126740,1699136160,9420,167067,102104,IT,IT
38776,1699375800,1699414800,39000,104470,35123,MX,MX
119406,1699594740,1699629180,34440,32093,579,TR,TR
15643,1699496940,1699513560,16620,162908,179640,US,US
124356,1700507520,1700521140,13620,27616,127966,AT,AT
77090,1700576160,1700592300,16140,3639,137911,US,US
167882,1699439700,1699455240,15540,133899,89682,US,US
46714,1699566600,1699599120,32520,91499,63404,TR,TR
186271,1700302200,1700333820,31620,19913,81499,TR,TR
107793,1700556300,1700590260,33960,134942,157730,TR,TR
92466,1699791960,1699796220,4260,167726,105442,GB,GB
192797,1700465940,1700496000,30060,156111,105252,TR,TR
113658,1700533080,1700568000,34920,82895,184180,TR,TR
99435,1699171920,1699205100,33180,153247,143771,TR,TR
186767,1699420320,1699452180,31860,171788,31532,TR,TR
158146,1699810140,1699813740,3600,20465,199927,GB,GB
29132,1699112520,1699125840,13320,186840,24003,CZ,UA
28861,1700048040,1700060640,12600,8261,3567,IT,IT
40274,1700461020,1700470680,9660,132843,131466,SK,SK
22067,1700016660,1700020260,3600,127386,174344,GB,GB
19205,1700433480,1700465160,31680,7099,79313,TR,TR
32549,1699298880,1699306200,7320,190101,138679,SK,SK
153964,1700450400,1700486160,35760,180,109717,TR,TR
27903,1699591860,1699595460,3600,92243,54370,NL,NL
149994,1700381640,1700412240,30600,39204,38994,TR,TR
162442,1700117220,1700146200,28980,133911,10408,TR,TR
103461,1699104780,1699108860,4080,156282,39125,GB,GB
97055,1699461000,1699469640,8640,88175,188559,IT,IT
31704,1699146660,1699169700,23040,132578,173547,DE,DE
191920,1699964760,1699978140,13380,151798,103962,US,US
119877,1699645920,1699675260,29340,165648,146084,TR,TR
196770,1700075580,1700106420,30840,55973,182112,TR,TR
64212,1699813680,1699817280,3600,119815,151527,GB,GB
19030,1699838700,1699849320,10620,11722,190973,IT,IT
33492,1700073960,1700085840,11880,186127,42194,US,US
176023,1700278740,1700284800,6060,128998,195168,GB,GB
114218,1699117440,1699150860,33420,154814,31126,TR,TR
186027,1700249820,1700276400,26580,106297,68153,BR,BR
100839,1699674300,1699681860,7560,144479,44646,IT,BE
2108,1700506800,1700515620,8820,192670,17540,PT,FR
27915,1700863500,1700895480,31980,124681,83327,TR,TR
75991,1699480860,1699494180,13320,48461,30649,IT,IT
79878,1699202400,1699209180,6780,135370,55167,NL,NL
183146,1700398860,1700420040,21180,159202,3752,FR,CH
182540,1700840280,1700848980,8700,140048,126281,HR,HR
91343,1698866100,1698877260,11160,115701,199372,US,US
172300,1699317900,1699330380,12480,71912,162105,US,US
171483,1698842340,1698876360,34020,150523,65594,TR,TR
166928,1698847740,1698854400,6660,36281,48663,NL,NL
79081,1698969540,1698976500,6960,59947,173546,GB,GB
120717,1700204760,1700234400,29640,109558,140101,TR,TR
72166,1700224020,1700232480,8460,195130,128694,PT,PT
170650,1700431380,1700466480,35100,104297,25889,TR,TR
106425,1699573980,1699578480,4500,137868,96855,NL,NL
158431,1699329240,1699332840,3600,123367,1331,GB,GB
20955,1698926340,1698947820,21480,195811,77664,FR,FR
41637,1699905900,1699937700,31800,181241,89366,TR,TR
71408,1700227320,1700260560,33240,174139,12528,TR,TR
168456,1698958320,1698969240,10920,80653,79278,US,US
183296,1699720140,1699747200,27060,190680,16573,DE,DE
12760,1700815380,1700848920,33540,186634,184243,TR,TR
46494,1699680120,1699712940,32820,2312,4472,TR,TR
52042,1700067240,1700072700,5460,106606,56552,NL,NL
137721,1698963900,1698999000,35100,80542,9669,TR,TR
20540,1700168520,1700186400,17880,109231,24610,US,US
185056,1700823360,1700835420,12060,112499,120262,PT,PT
160700,1700190840,1700225700,34860,128661,61842,TR,TR
8776,1700141700,1700179500,37800,105778,84032,MX,MX
87042,1700273940,1700279040,5100,12883,74089,GB,GB
70693,1700522040,1700533560,11520,22175,106550,IT,IT
125548,1700323860,1700357280,33420,26664,191055,TR,TR
165930,1700426520,1700430120,3600,106956,124981,NL,NL
126848,1698832500,1698846540,14040,189986,196406,US,US
166187,1700535780,1700539380,3600,160157,80034,GB,GB
108782,1699911360,1699922580,11220,96414,125007,PT,PT
190280,1699265700,1699280700,15000,4185,112507,FR,FR
31963,1700422200,1700454480,32280,189250,189686,TR,TR
80298,1700694480,1700728140,33660,142106,133751,TR,TR
76891,1700373000,1700381520,8520,189864,127034,IT,IT
152203,1699414800,1699449960,35160,198888,147837,TR,TR
4216,1700029860,1700064840,34980,13616,105914,TR,TR
32340,1698928740,1698932340,3600,90679,49523,NL,FR
110813,1699139700,1699174740,35040,59190,72381,TR,TR
22835,1700565300,1700592540,27240,154234,76657,BR,BR
131712,1699347540,1699379400,31860,140370,118452,TR,TR
179297,1700555400,1700570220,14820,75150,197780,FR,FR
8960,1700685060,1700695140,10080,38682,83450,IT,IT
5956,1700074440,1700078040,3600,100881,6517,NL,NL
188684,1700144940,1700150460,5520,130787,106174,NL,NL
30693,1700598840,1700602440,3600,125805,40157,GB,GB
93013,1699331880,1699335480,3600,143785,35991,GB,GB
177511,1699460100,1699493280,33180,97276,93774,TR,TR
41500,1699608240,1699619760,11520,60531,100399,IT,IT
56120,1700468460,1700498760,30300,182821,122142,TR,TR
129404,1699875120,1699878720,3600,25185,38232,NL,NL
76620,1700122740,1700151300,28560,118417,176140,RO,MD
34231,1699887240,1699897680,10440,10891,105489,IT,IT
189748,1699009920,1699013520,3600,113946,43108,GB,GB
178429,1699802700,1699831560,28860,16039,61729,TR,TR
4456,1700571180,1700584260,13080,75432,14252,HR,ME
65190,1699126740,1699144560,17820,185898,110040,FR,FR
51490,1700138820,1700143320,4500,92163,101267,EE,EE
166599,1700045160,1700080200,35040,154951,22984,TR,TR
11848,1699839120,1699873980,34860,178903,197370,TR,TR
113461,1699261140,1699276560,15420,69932,40191,AT,AT
58079,1699966380,1699977600,11220,189423,191173,HR,DE
182021,1698968280,1699003320,35040,50056,18605,TR,TR
13165,1699406640,1699426920,20280,27220,31514,FR,BE
168144,1700425500,1700431140,5640,17296,67905,GB,GB
186435,1699665300,1699679880,14580,114664,150376,US,US
124914,1698929520,1698951600,22080,123043,113093,BR,BR
176717,1699427520,1699443720,16200,54208,9609,US,US
69319,1700531460,1700582580,51120,39745,182134,BG,HU
67209,1700227980,1700233920,5940,34536,141013,AD,ES
64383,1700407440,1700441760,34320,139793,123800,TR,TR
178071,1700377500,1700408340,30840,2616,48383,TR,TR
97691,1698900000,1698905400,5400,36668,39700,GB,GB
162559,1700751840,1700766120,14280,8887,27152,PT,PT
189658,1699805580,1699840740,35160,44722,182657,TR,TR
102642,1700056200,1700059800,3600,32941,130325,NL,NL
42473,1698939600,1698948180,8580,37293,5966,IT,IT
198773,1699784580,1699823280,38700,76369,159069,MX,MX
13758,1700137980,1700141580,3600,123188,159617,GB,GB
107068,1699376220,1699379820,3600,37043,174382,GB,GB
12749,1699593240,1699625700,32460,32788,177342,TR,TR
26881,1700338860,1700349720,10860,103348,69416,US,US
52728,1698883140,1698886740,3600,103869,172792,GB,GB
177903,1700253480,1700277780,24300,154333,89135,BR,BR
64772,1700376960,1700409540,32580,9963,150016,TR,TR
172917,1700713080,1700716680,3600,23210,108198,GB,GB
96055,1699267680,1699290360,22680,97677,98620,BR,BR
196758,1699268580,1699304100,35520,112800,129968,TR,TR
191206,1699224480,1699255920,31440,186054,44476,TR,TR
36328,1699339140,1699342740,3600,50216,67745,NL,NL
187185,1699736580,1699748880,12300,169221,148310,US,US
42980,1700479620,1700508720,29100,75403,89129,TR,TR
88844,1700783340,1700801400,18060,106130,22007,FR,PL
191724,1699273860,1699292040,18180,192860,72873,FR,CZ
173859,1699733700,1699744260,10560,41023,88265,IT,IT
186112,1700564820,1700577060,12240,48132,195494,AT,AT
121046,1699376160,1699405980,29820,60157,43929,TR,TR
149573,1699858080,1699892880,34800,28228,131027,TR,TR
80527,1700229900,1700261400,31500,61004,24066,TR,TR
6947,1700759280,1700772480,13200,100051,183240,US,US
83857,1700459340,1700464800,5460,151598,130815,GB,GB
165497,1700000400,1700036100,35700,69616,66942,TR,TR
146136,1699850880,1699864740,13860,155825,93989,US,US
157766,1699646700,1699657020,10320,140238,142274,IT,IT
11441,1699488720,1699521120,32400,144957,197663,TR,TR
138572,1699074180,1699109040,34860,100353,112283,TR,TR
3285,1700846280,1700857560,11280,29289,39844,IT,IT
47326,1698879840,1698892860,13020,37688,66882,US,US
120540,1699017240,1699050840,33600,136566,176365,TR,TR
11483,1700541600,1700545200,3600,150095,142200,NL,NL
51743,1700255340,1700264040,8700,108241,171864,IT,IT
57717,1699483020,1699487220,4200,53113,115787,NL,NL
114560,1698886260,1698916740,30480,156289,122461,TR,TR
37475,1700741940,1700754120,12180,150159,58407,IT,IT
122236,1700181240,1700212200,30960,71105,173206,TR,TR
51128,1700733960,1700739480,5520,128696,157097,NL,NL
101768,1700461020,1700474520,13500,85063,80585,AT,NL
157332,1698858480,1698862080,3600,175239,12337,GB,GB
33775,1699724580,1699738860,14280,71953,113639,US,US
161793,1700667840,1700674440,6600,71618,44229,GB,GB
96676,1700840880,1700852640,11760,199361,114099,RS,SI
63145,1698936300,1698939900,3600,162227,22972,GB,GB
88993,1699461300,1699481340,20040,117824,167195,FR,ES
143010,1699837140,1699866000,28860,55782,109528,TR,TR
167039,1700705340,1700715180,9840,15829,2511,IT,IT
136987,1699493940,1699503180,9240,180421,177220,HR,CZ
85886,1700663160,1700693160,30000,123225,127941,TR,TR
28399,1700820240,1700854860,34620,127363,195491,TR,TR
82210,1699268760,1699285800,17040,71237,173550,US,US
71298,1699950060,1699962120,12060,102384,102597,US,US
27696,1700777160,1700790420,13260,96798,149724,HR,DE
143948,1700618160,1700635980,17820,40895,120129,US,US
152314,1700592540,1700622000,29460,142639,12277,TR,TR
163139,1699738020,1699741620,3600,76586,162615,NL,NL
26514,1700458500,1700488920,30420,16122,145340,TR,TR
192840,1700504160,1700539260,35100,176018,34198,TR,TR
149104,1700063040,1700080980,17940,160854,149624,FR,FR
172933,1700863260,1700891880,28620,114825,106644,PL,DE
180476,1699920480,1699954260,33780,90577,19918,TR,TR
7261,1700860500,1700872740,12240,130989,42598,AT,DE
124417,1700043600,1700065200,21600,144851,99417,DE,DE
150762,1699602960,1699614480,11520,25659,13971,SK,SK
21492,1700750940,1700780760,29820,168036,132033,TR,TR
180168,1700411040,1700426280,15240,126545,104113,FR,FR
47292,1699165020,1699200660,35640,191745,41693,TR,TR
58887,1700295300,1700299560,4260,159443,128297,GB,GB
56878,1699954860,1699959180,4320,81564,49493,NL,NL
86196,1698966180,1698995640,29460,164102,3906,TR,TR
56055,1700602620,1700606220,3600,14807,15689,NL,NL
109737,1699073820,1699108800,34980,57700,19815,TR,TR
4174,1699107300,1699161780,54480,29259,147800,UA,PL
102228,1698982560,1698989940,7380,93898,195228,PT,PT
182873,1700083440,1700092620,9180,137376,72341,IT,IT
100661,1700422680,1700451840,29160,130770,40140,TR,TR
7915,1700620260,1700652480,32220,34078,57437,TR,TR
198807,1699598520,1699629960,31440,135622,39737,TR,TR
168901,1700458980,1700490120,31140,180827,25978,TR,TR
176997,1700775540,1700793600,18060,101635,199013,FR,FR
133298,1699090560,1699097220,6660,130973,141495,EE,EE
185214,1699176480,1699185360,8880,36550,63726,PT,PT
160933,1700288160,1700302740,14580,143608,165232,US,US
146865,1699174020,1699186920,12900,108706,181863,IT,IT
110415,1700584020,1700587620,3600,59417,30296,NL,NL
136526,1700653320,1700682360,29040,27721,6256,TR,TR
181440,1699617480,1699633620,16140,154497,181807,BE,NL
56446,1700685840,1700710560,24720,87745,187906,PL,UA
102064,1699378740,1699412400,33660,12574,24144,TR,TR
126603,1700494320,1700511000,16680,14644,195472,US,US
53057,1699544580,1699578000,33420,127015,90179,TR,TR
15678,1699175700,1699207980,32280,93988,25539,TR,TR
175282,1699971120,1700003040,31920,145268,22668,TR,TR
194629,1699997880,1700001480,3600,86603,61470,NL,NL
103226,1699355820,1699390020,34200,49738,182087,TR,TR
82799,1700185320,1700217300,31980,152707,51584,TR,TR
142069,1699396500,1699430400,33900,81128,161990,TR,TR
131719,1699809600,1699825620,16020,88533,168193,US,US
17401,1698959460,1698969600,10140,37233,17741,IT,IT
25636,1700456220,1700471340,15120,98459,109897,US,US
145229,1699265280,1699272120,6840,79659,110108,NL,NL
3236,1700385300,1700388900,3600,40975,174235,GB,GB
43785,1699259880,1699298700,38820,50212,111927,MX,MX
80234,1699649040,1699652640,3600,2498,188607,NL,NL
95500,1699618020,1699650480,32460,133978,130825,TR,TR
157424,1699589460,1699593660,4200,130444,144351,GB,GB
49457,1700525100,1700559720,34620,149670,22926,TR,TR
4081,1698922740,1698949140,26400,196817,145506,RO,RO
168178,1699213920,1699226220,12300,173989,77087,CZ,UA
164664,1699032360,1699039200,6840,37793,106658,GB,GB
116425,1699058820,1699088220,29400,157137,156904,TR,TR
26058,1699748760,1699766040,17280,5914,165258,US,US
42585,1699539660,1699558260,18600,1070,154047,FR,FR
148344,1698928080,1698933300,5220,172949,113399,GB,GB
19300,1699536480,1699567740,31260,77252,81844,TR,TR
158050,1699267680,1699302960,35280,193276,194942,TR,TR
53290,1700728620,1700764500,35880,13165,123431,TR,TR
114791,1700278980,1700309700,30720,69691,120962,TR,TR
6349,1699107840,1699126320,18480,112536,131181,FR,FR
181196,1699036800,1699052340,15540,156107,103174,BE,NL
43981,1700276400,1700300520,24120,16452,76326,RO,MD
72211,1699706400,1699732980,26580,35920,129424,PL,DE
124355,1699091940,1699122420,30480,116036,11914,BA,HR
12800,1700420760,1700424360,3600,180908,193771,NL,NL
160064,1699378800,1699382400,3600,158141,134549,GB,GB
66607,1700748180,1700755620,7440,181652,117082,IT,IT
121986,1700207460,1700231340,23880,42232,44652,DE,DE
96505,1700723580,1700756820,33240,44558,42984,TR,TR
41164,1700590620,1700621760,31140,58477,32979,TR,TR
82263,1699832820,1699852860,20040,54680,113337,BE,FR
50307,1700301120,1700336700,35580,166146,170719,TR,TR
80919,1698965580,1698990660,25080,1883,176167,PL,PL
176687,1699520460,1699554000,33540,112455,7479,MX,MX
144000,1700846940,1700862480,15540,109862,157702,FR,IT
962,1700262660,1700274720,12060,163871,160987,RS,RS
63161,1700041200,1700050500,9300,1175,101469,IT,IT
92920,1699964640,1699995900,31260,150380,183357,TR,TR
169871,1700046240,1700052960,6720,145016,101418,GB,GB
57574,1699449660,1699453260,3600,115695,75031,GB,GB
148975,1699605420,1699638120,32700,95885,128191,TR,BG
20002,1698874260,1698891000,16740,69623,121855,RS,RS
194711,1700591880,1700617320,25440,124209,7973,PL,PL
189022,1700442480,1700455080,12600,189841,149428,IT,IT
42998,1700140560,1700152020,11460,124773,154644,RS,RS
112143,1700419680,1700439780,20100,109059,56436,FR,FR
164613,1700748360,1700752320,3960,93688,62891,GB,GB
59178,1699497180,1699513680,16500,47993,100370,BE,FR
139521,1699692840,1699707960,15120,142971,178908,US,US
19646,1699911660,1699917060,5400,59965,71099,GB,GB
149087,1699942200,1699954260,12060,149217,8795,US,US
143874,1699107840,1699138020,30180,170989,36246,TR,TR
65592,1700175240,1700209020,33780,184511,141491,TR,TR
81882,1698819360,1698829140,9780,182457,173208,IT,IT
140236,1700789220,1700822880,33660,12304,46329,MX,MX
196282,1699920840,1699933620,12780,137732,75155,IT,IT
22246,1699026120,1699039920,13800,195809,199843,IT,IT
150232,1700189700,1700221740,32040,93451,138022,TR,TR
35705,1699809120,1699821420,12300,172984,15664,US,US
36360,1698826080,1698832440,6360,113640,74872,NL,NL
4143,1699805760,1699817040,11280,65725,174708,US,US
119845,1699267500,1699282260,14760,187393,188045,US,US
183742,1699769280,1699798320,29040,31911,41226,TR,TR
69275,1699930200,1699939380,9180,4119,179852,IT,IT
135664,1700466300,1700500140,33840,48820,182702,TR,TR
111633,1700223720,1700258760,35040,7569,111769,TR,TR
167246,1699294200,1699324200,30000,57023,136304,TR,TR
99065,1699360920,1699378740,17820,110058,116299,SE,SE
99232,1700091480,1700114040,22560,27788,45783,PL,LT
96443,1698830580,1698843540,12960,191686,159148,HR,ME
152989,1700629620,1700662020,32400,145876,117571,TR,TR
45753,1699920480,1699954620,34140,120200,13485,TR,TR
180839,1699399380,1699413360,13980,130533,44907,PT,PT
61492,1698896820,1698927480,30660,148852,132701,TR,TR
9734,1700178300,1700211300,33000,191256,2017,TR,TR
185735,1699075440,1699104600,29160,13372,110152,MK,RS
4948,1700159580,1700191620,32040,42345,102824,TR,TR
22740,1699373640,1699384020,10380,6272,38680,IT,IT
189313,1700385480,1700414760,29280,17889,16498,TR,TR
153614,1699336140,1699369080,32940,107790,53982,TR,TR
81492,1700012220,1700040540,28320,47956,75947,PL,DE
18716,1699926420,1699931580,5160,39611,165852,GB,GB
16914,1700440740,1700444340,3600,21324,130630,NL,CH
153068,1699526160,1699537680,11520,159765,136139,US,US
127121,1700406000,1700437320,31320,111207,31042,TR,BG
14281,1699953360,1699967340,13980,30755,121865,IT,IT
18809,1699355940,1699386840,30900,34451,123149,TR,TR
4747,1699774080,1699799160,25080,177706,95705,AL,MK
164731,1699617960,1699651500,33540,167259,135840,TR,TR
80627,1700766660,1700770260,3600,65418,183126,GB,GB
108800,1700585160,1700591040,5880,124120,163550,GB,GB
174081,1698807360,1698842340,34980,76079,62031,TR,TR
101641,1700327520,1700338200,10680,115644,15528,HR,HR
172583,1699110360,1699113960,3600,147366,193291,GB,GB
133207,1699062360,1699078080,15720,146953,18714,FR,FR
6720,1699264920,1699280220,15300,77084,185017,US,US
104108,1700316420,1700347980,31560,133961,176281,TR,TR
74270,1699514100,1699535880,21780,76524,175082,DE,DK
91321,1699025040,1699041480,16440,41540,132885,US,US
174915,1700055060,1700086620,31560,77184,52930,TR,TR
38414,1699506780,1699518840,12060,43589,122869,US,US
68520,1699416300,1699446180,29880,112876,11460,TR,TR
187762,1699014780,1699072740,57960,42535,45141,UA,DE
134274,1698907080,1698936900,29820,18825,168765,TR,TR
67067,1700437560,1700441160,3600,101308,19626,GB,GB
81683,1700729880,1700742540,12660,69760,16428,US,US
65863,1699100880,1699119720,18840,69883,122714,SE,DK
86524,1699766460,1699774320,7860,88622,137462,IT,IT
85609,1698927720,1698963120,35400,34085,172016,TR,TR
51249,1700187360,1700198160,10800,71213,189439,IT,IT
103298,1699536660,1699565700,29040,34930,167943,TR,TR
186932,1698831240,1698854520,23280,44730,115447,DE,DK
27923,1700036400,1700047320,10920,35657,46812,PT,PT
135147,1700573760,1700585640,11880,184829,80697,HR,NL
38008,1700178300,1700213460,35160,142232,173504,TR,TR
185917,1699490040,1699518480,28440,157390,167323,DE,DE
192360,1700769060,1700803080,34020,76029,9584,TR,TR
3998,1699404360,1699412160,7800,90028,61681,PT,FR
68789,1700194080,1700229300,35220,56595,123881,TR,TR
66899,1699167360,1699189080,21720,19200,184369,DE,CH
171350,1699282500,1699302240,19740,95833,61346,BE,FR
199332,1699602000,1699637040,35040,44884,105313,TR,TR
108548,1699888560,1699902060,13500,85605,129422,HR,HR
174729,1700506740,1700521560,14820,79922,198393,US,US
156440,1700635920,1700662740,26820,113730,110315,PL,FR
136766,1700159640,1700193300,33660,62099,70867,TR,TR
182902,1700010180,1700042460,32280,52486,44729,TR,TR
17810,1700754360,1700765640,11280,138044,8102,ES,ES
49700,1700034540,1700038140,3600,52024,121980,GB,GB
177656,1700586300,1700589900,3600,199153,57725,NL,FR
132089,1699450920,1699479840,28920,25571,55439,TR,TR
130022,1699420980,1699427340,6360,65598,104739,GB,GB
97515,1698978960,1698988020,9060,76908,39932,IT,IT
7967,1699873620,1699884060,10440,140851,6965,IT,IT
42054,1699057200,1699090320,33120,180066,81632,TR,TR
31565,1699182540,1699193100,10560,192049,117411,HR,DE
193179,1700199240,1700210460,11220,8291,92668,US,US
162734,1699537200,1699568700,31500,48321,105422,TR,TR
169921,1698807180,1698817380,10200,60045,134125,SK,AT
130531,1698994020,1699026660,32640,136851,130670,MX,MX
43874,1700800680,1700815920,15240,110995,14897,CZ,CZ
71980,1700645400,1700649000,3600,11108,134141,NL,NL
41970,1699528560,1699533480,4920,29990,117950,NL,NL
22727,1699064340,1699068900,4560,167042,92222,EE,EE
83263,1699482240,1699485960,3720,171118,164444,GB,GB
78955,1700856960,1700894220,37260,140548,81023,MX,MX
175031,1699909440,1699926420,16980,126069,20602,US,US
180643,1700857140,1700888760,31620,91085,187886,TR,TR
176236,1699791060,1699820400,29340,49964,187629,TR,TR
139104,1699310100,1699313700,3600,163278,193247,GB,GB
161712,1700202780,1700238120,35340,104992,44355,MX,MX
142960,1699081800,1699112700,30900,195299,20350,TR,TR
142490,1700308980,1700323140,14160,4089,100352,RS,BG
126292,1700018220,1700028600,10380,44147,371,IT,IT
35304,1700629980,1700643300,13320,155315,81624,US,US
66533,1700590260,1700628660,38400,121910,59209,MX,MX
99536,1700165640,1700172780,7140,85607,77183,NL,NL
38245,1699893600,1699921920,28320,155861,117072,DE,NL
72139,1699164900,1699199280,34380,193367,104789,TR,TR
161824,1699592820,1699622340,29520,21721,131913,TR,TR
114207,1699691940,1699704240,12300,99732,91161,ES,ES
43261,1700718540,1700752200,33660,182719,160771,TR,TR
164800,1698984360,1698991680,7320,11552,112187,IT,IT
12397,1699357500,1699374420,16920,148697,79865,US,US
35321,1699040460,1699075320,34860,56601,87870,TR,TR
176944,1698945300,1698948900,3600,166741,126175,GB,GB
69225,1699758420,1699791720,33300,165470,49625,TR,TR
150856,1700606100,1700631780,25680,152155,66263,DE,DE
3889,1700209740,1700213760,4020,171643,51656,NL,NL
174560,1699691400,1699704000,12600,87016,147586,US,MX
1978,1699815000,1699825140,10140,192578,106156,HR,HR
4087,1699746300,1699780920,34620,10715,126285,TR,TR
28283,1699958580,1699972560,13980,196293,133870,IT,IT
76040,1699810920,1699814520,3600,16848,13248,GB,GB
1379,1698920700,1698936360,15660,126674,119874,US,US
172182,1699828980,1699859100,30120,183589,47992,TR,TR
188863,1698808920,1698812520,3600,41805,84594,GB,GB
28952,1699874400,1699909740,35340,25426,8141,TR,TR
17910,1699639860,1699656540,16680,26603,110448,US,US
183358,1700430660,1700464920,34260,133710,91222,TR,TR
166523,1699296480,1699300080,3600,169685,55253,NL,NL
110935,1700497800,1700531280,33480,104309,42358,TR,TR
103356,1700710140,1700745420,35280,194821,48379,TR,TR
83613,1700278740,1700282340,3600,171390,47065,GB,GB
93313,1700603880,1700637360,33480,107493,127276,TR,TR
3459,1700332320,1700338260,5940,26278,34721,GB,GB
80944,1700130360,1700133960,3600,22618,110557,GB,GB
103330,1700178000,1700189460,11460,194571,119070,US,US
98298,1700509020,1700514480,5460,55765,2720,NL,NL
10081,1700391360,1700442660,51300,119093,7229,BG,AT
45597,1699739820,1699746900,7080,24032,158880,NL,NL
185609,1699501200,1699535160,33960,73498,48436,TR,TR
133755,1699369140,1699399680,30540,124501,173835,TR,TR
69917,1699991760,1700003460,11700,98709,29501,HR,HR
14530,1699818000,1699829760,11760,19448,154441,US,US
65084,1699280940,1699314780,33840,71085,77810,MX,MX
66315,1700473920,1700508000,34080,141573,143913,TR,TR
112394,1700218560,1700251740,33180,37821,116521,TR,TR
36644,1699987380,1700003280,15900,80184,52476,US,US
6252,1699996560,1700032020,35460,114682,14350,MX,MX
169412,1699414680,1699425000,10320,38475,91828,EE,FI
66733,1699575060,1699605000,29940,35706,1893,TR,TR
80382,1700486640,1700516340,29700,163866,178789,TR,TR
84559,1699599720,1699612440,12720,181276,126503,US,US
195390,1700285820,1700312400,26580,109499,158026,DE,SK
25454,1700052000,1700069880,17880,30331,32027,US,US
91945,1698828780,1698854460,25680,97138,135124,RO,DK
21616,1700773380,1700807760,34380,128305,122534,TR,TR
99035,1699585620,1699589640,4020,118043,143690,NL,NL
190093,1700230800,1700265840,35040,190982,172236,TR,TR
30151,1699706040,1699717500,11460,97702,54260,US,US
157618,1700608440,1700625540,17100,62583,61338,US,US
5235,1699934880,1699946940,12060,46160,159117,IT,IT
128166,1699827420,1699843500,16080,44988,89466,US,US
137602,1700445840,1700475600,29760,8034,154113,TR,TR
27766,1700627880,1700661900,34020,109896,137917,TR,TR
70137,1700767140,1700796300,29160,88204,114377,TR,TR
83382,1699475640,1699479240,3600,36483,125035,GB,GB
125353,1699016220,1699028220,12000,107226,43089,AT,DE
5376,1699386300,1699398240,11940,108200,161944,IT,IT
49162,1699897020,1699900620,3600,16463,143458,NL,NL
157861,1699142520,1699175100,32580,75302,68759,TR,TR
162441,1700258100,1700293980,35880,19594,179538,TR,TR
176849,1700707860,1700734740,26880,53379,1780,NO,SE
14857,1699505820,1699509420,3600,153782,80731,GB,GB
194103,1700648040,1700651640,3600,51088,84219,NL,NL
145449,1699909980,1699925340,15360,113873,147974,US,US
170635,1699986540,1699999500,12960,112957,141617,ES,AD
128335,1698908460,1698940140,31680,97059,65341,TR,TR
148462,1699048140,1699060020,11880,97484,96850,US,US
83072,1700395080,1700417280,22200,25510,18009,PL,PL
106868,1699873500,1699897020,23520,57862,100224,DE,BE
129319,1699950000,1699960800,10800,153151,193164,IT,IT
75635,1699809060,1699819860,10800,85097,23270,AT,DE
93441,1699068420,1699072020,3600,198607,10628,GB,GB
199538,1699548780,1699579980,31200,126678,122831,TR,TR
106326,1699896840,1699908180,11340,136415,136525,HR,HR
188926,1700586840,1700621400,34560,26794,137078,TR,TR
89441,1700385540,1700420520,34980,56700,31781,TR,TR
96551,1700485140,1700495940,10800,150051,196023,US,CA
187772,1699153320,1699160280,6960,113193,138738,EE,EE
148506,1699902540,1699957380,54840,35969,110156,BG,BG
118751,1700600160,1700607840,7680,185925,154516,HR,HR
183770,1699418100,1699430400,12300,144551,155628,US,US
78544,1700119560,1700162520,42960,65622,117921,LV,AT
116266,1700729820,1700735340,5520,44160,157154,GB,GB
183509,1699678680,1699690560,11880,194144,9505,IT,IT
197396,1699358640,1699373940,15300,177252,155992,US,US
75891,1700614800,1700653860,39060,151914,96273,MX,MX
97708,1699081980,1699106460,24480,56143,155383,NO,DK
34173,1699150020,1699179780,29760,173463,26262,TR,TR
32722,1700799060,1700823420,24360,43555,9589,DE,BG
34551,1700452380,1700460180,7800,64577,17918,PT,PT
53249,1699367100,1699370700,3600,78938,61183,NL,NL
57265,1700557380,1700589420,32040,68412,190169,TR,TR
106641,1699676940,1699710900,33960,124920,81460,TR,TR
138561,1700056200,1700091480,35280,94219,172810,TR,TR
159985,1699139340,1699154760,15420,182197,49086,US,US
119077,1700605860,1700612580,6720,82499,48351,GB,GB
83171,1699395000,1699430700,35700,39717,169749,TR,TR
128473,1700347140,1700378280,31140,62346,27262,TR,TR
65589,1700175960,1700207940,31980,168238,133417,TR,TR
95848,1699735020,1699773900,38880,49966,115676,MX,MX
18280,1699435500,1699451880,16380,41320,122739,US,US
191283,1699760520,1699771620,11100,136082,64938,HR,BA
2041,1700652300,1700669640,17340,46474,118028,US,US
154630,1700350380,1700358300,7920,100888,198856,IT,IT
16235,1700045340,1700075160,29820,106717,129210,TR,TR
176714,1700153220,1700182560,29340,109964,138431,TR,TR
34095,1699286940,1699312680,25740,42837,72864,DE,DE
99010,1699987800,1700001960,14160,62223,66760,ES,BE
119334,1700453100,1700457900,4800,74922,69253,EE,EE
101687,1700516160,1700549280,33120,189263,121162,TR,TR
127659,1700638380,1700642760,4380,110084,169889,NL,NL
120137,1699933800,1699946160,12360,158774,173785,US,US
35883,1700229300,1700249340,20040,135162,29040,FR,RO
116657,1700149320,1700158140,8820,164362,136087,IT,IT
130992,1700089320,1700092920,3600,53222,110770,GB,GB
169665,1698839760,1698854580,14820,23385,188767,US,US
193077,1700216940,1700249100,32160,85233,32302,TR,TR
185000,1700346060,1700380140,34080,49967,167732,TR,TR
132508,1699733280,1699743600,10320,48379,160148,IT,IT
47023,1700332500,1700393040,60540,713,60040,UA,PL
172675,1700590080,1700593680,3600,155265,172947,NL,PL
78505,1699219860,1699223460,3600,114022,125564,GB,GB
147365,1699610400,1699616400,6000,66580,48139,GB,GB
16036,1700159640,1700195760,36120,126896,194382,MX,MX
117390,1698835500,1698842100,6600,171539,88005,NL,NL
99770,1700234640,1700248800,14160,158511,29250,IT,IT
197004,1700484780,1700502960,18180,72156,69588,FR,BE
80540,1699481040,1699486860,5820,198344,176994,GB,GB
138464,1698828840,1698851160,22320,3713,175732,DE,DE
58188,1698965640,1698969240,3600,169202,138557,NL,NL
3636,1700347080,1700382240,35160,84305,159209,TR,TR
71814,1699094280,1699100880,6600,90674,76554,GB,GB
129651,1699844460,1699848060,3600,587,63965,GB,GB
10259,1699813080,1699817280,4200,180809,59183,NL,NL
169500,1699455300,1699485600,30300,148269,97875,TR,TR
154310,1700866440,1700889780,23340,152491,22917,DE,DE
134602,1700067240,1700072820,5580,69632,111922,NL,NL
9979,1699129020,1699134600,5580,38294,1965,GB,GB
59182,1699061760,1699079520,17760,104782,195968,FR,ES
49929,1699477260,1699484460,7200,62712,90448,PT,PT
76761,1700376660,1700389980,13320,1766,156498,US,US
36246,1700808540,1700812140,3600,81384,168469,GB,GB
154676,1698875100,1698904320,29220,32592,27949,TR,TR
1916,1699859220,1699886580,27360,45272,58935,DE,DE
164076,1700065860,1700069520,3660,141185,99853,NL,NL
32924,1699151040,1699162860,11820,47759,113136,HR,HR
199889,1699849020,1699862580,13560,105706,132097,US,US
116998,1699214520,1699221060,6540,68845,126341,NL,NL
64608,1700594580,1700607240,12660,1781,118582,SK,SK
22227,1699205280,1699215360,10080,29529,117392,IT,IT
141898,1699481160,1699493880,12720,1269,138730,US,US
124209,1700232960,1700250660,17700,29826,187403,FR,FR
149992,1700067600,1700072760,5160,140673,182077,GB,GB
34082,1699223460,1699248420,24960,16548,169343,PL,FR
66338,1700807640,1700840160,32520,18123,104017,TR,TR
47058,1699466100,1699501320,35220,191693,160120,TR,TR
90948,1699215120,1699248420,33300,157060,169467,TR,TR
32405,1699164480,1699170420,5940,123172,18651,GB,GB
51167,1700538960,1700542620,3660,127204,39638,NL,NL
66878,1699561560,1699565160,3600,85504,133127,GB,GB
141736,1699209060,1699227900,18840,31757,67827,FR,BE
98015,1699924800,1699938000,13200,158338,9020,US,US
75698,1700278860,1700288940,10080,64628,149496,SK,AT
140890,1700560140,1700567520,7380,63876,33178,IT,IT
168127,1700379900,1700414460,34560,187803,120008,TR,TR
171164,1699729140,1699740780,11640,131013,73838,PT,PT
107448,1699626240,1699630800,4560,83350,154078,GB,GB
95529,1699404780,1699415760,10980,48369,83917,US,US
66036,1700031960,1700063040,31080,138005,24007,TR,TR
156169,1699828200,1699834200,6000,71263,30054,GB,GB
178916,1700847240,1700878440,31200,54919,72068,TR,TR
115335,1700849520,1700883780,34260,67155,44285,TR,TR
95089,1698801660,1698818640,16980,162462,185396,CZ,CZ
101048,1700256840,1700260440,3600,108125,99304,NL,NL
128940,1699023060,1699042200,19140,79809,81757,FR,FR
170955,1699366980,1699373520,6540,115990,49660,GB,GB
92036,1700657880,1700684580,26700,188872,35913,PL,CZ
77440,1700154360,1700186340,31980,80532,29390,TR,TR
153002,1699389540,1699416240,26700,92763,162672,DE,DE
192949,1700224320,1700257200,32880,104485,81514,TR,TR
76702,1699120500,1699131480,10980,37844,99888,IT,IT
22796,1699851420,1699857000,5580,24089,178564,GB,GB
185770,1699789740,1699795800,6060,20579,114203,NL,NL
199906,1700395380,1700406480,11100,161466,181918,IT,IT
34767,1700520420,1700532420,12000,60887,12828,US,US
54512,1700455080,1700466720,11640,154393,33075,CZ,FR
184216,1699982460,1700007240,24780,54226,47719,DE,DE
119067,1700717340,1700724360,7020,148302,170882,GB,GB
182227,1699155420,1699168320,12900,27179,114938,AT,AT
33284,1698834780,1698861900,27120,102316,122571,RO,ES
195698,1699877220,1699889100,11880,791,97874,IT,IT
118148,1700675880,1700709420,33540,54512,79652,TR,TR
21705,1699392120,1699421040,28920,115444,97025,TR,TR
176376,1699561620,1699592340,30720,13090,136243,TR,TR
196612,1699645380,1699679760,34380,180978,123644,TR,TR
149294,1698872940,1698880140,7200,159664,52161,IT,IT
54915,1699045680,1699080780,35100,57689,12263,TR,TR
195321,1699105440,1699117920,12480,196072,25624,US,US
157020,1699609740,1699644060,34320,107601,194376,TR,TR
162099,1699347720,1699377120,29400,157608,137005,TR,TR
186267,1700497260,1700510880,13620,109489,104577,IT,IT
177181,1700719080,1700732280,13200,123331,11498,US,US
43074,1700707980,1700731980,24000,188494,88395,RO,RO
73190,1700583840,1700605140,21300,79651,138736,FR,FR
114406,1699420740,1699454160,33420,85533,5036,TR,TR
97165,1700849220,1700883360,34140,125131,78991,TR,TR
142631,1699066860,1699102740,35880,187651,187083,TR,TR
126638,1698979860,1698983460,3600,97938,58863,GB,GB
20347,1700369040,1700377500,8460,169322,25089,ES,ES
25946,1699033860,1699069260,35400,116034,123332,TR,TR
2164,1700741940,1700745540,3600,189788,174148,NL,NL
189414,1699494000,1699497600,3600,105335,18363,GB,GB
110501,1700057580,1700062740,5160,22621,105965,GB,BE
56625,1700510100,1700516160,6060,105580,63676,GB,GB
54356,1700851500,1700882880,31380,24459,21771,TR,TR
103113,1699664880,1699679580,14700,3377,22335,US,US
54587,1699897200,1699902000,4800,89438,30486,GB,GB
96085,1699884300,1699909380,25080,177590,61515,BR,BR
113954,1698822780,1698846180,23400,192497,53175,DE,AT
192180,1699498200,1699527780,29580,12418,103247,TR,TR
88041,1699617480,1699648740,31260,191530,74575,TR,TR
97441,1700665680,1700700720,35040,68451,26155,TR,TR
21096,1698898980,1698932460,33480,87072,86552,TR,TR
193331,1700653260,1700670000,16740,93647,8251,BE,FR
142357,1700127600,1700145360,17760,159543,102324,US,US
151339,1700618220,1700652420,34200,62495,126841,TR,TR
109614,1699013820,1699021320,7500,197574,108974,IT,IT
115338,1699164300,1699197360,33060,98252,178955,MX,MX
123965,1700607840,1700625480,17640,78239,93137,BE,NL
171616,1700640240,1700652540,12300,160460,36577,US,US
11140,1700743020,1700775000,31980,126809,137757,TR,TR
72022,1700855760,1700892120,36360,85285,112704,MX,MX
57617,1699017360,1699029420,12060,115077,62316,US,US
168471,1700823780,1700858040,34260,73696,127270,TR,TR
196925,1700001900,1700008080,6180,44953,146070,NL,NL
74680,1699610460,1699615980,5520,173573,96470,AD,ES
73255,1698806760,1698841320,34560,115223,165667,MX,MX
158158,1699775280,1699792920,17640,142741,180298,US,US
17658,1698799500,1698803100,3600,10724,100952,NL,NL
16143,1700429700,1700446140,16440,166709,145939,FR,FR
141702,1700456760,1700494020,37260,189625,169376,MX,MX
190299,1699861020,1699892340,31320,19053,37749,TR,TR
35796,1699594020,1699602900,8880,143584,89165,HR,HR
50012,1699271460,1699275060,3600,132813,123435,NL,NL
101853,1698826740,1698833280,6540,68467,56256,GB,GB
91267,1698930900,1698969720,38820,74555,176113,MX,MX
99389,1700328720,1700339760,11040,103000,83217,US,US
150734,1699387620,1699399980,12360,41893,26295,US,US
70267,1699259760,1699273680,13920,91469,142353,HR,AT
38423,1699217700,1699248720,31020,137978,81787,TR,TR
132455,1700345700,1700356980,11280,21765,196541,IT,IT
92127,1699053480,1699087860,34380,174072,97279,TR,TR
79002,1699558620,1699571100,12480,3242,32534,HR,HR
866,1700832360,1700847960,15600,170882,122996,US,US
2110,1699221960,1699255860,33900,70495,29364,TR,TR
38363,1699474380,1699500780,26400,55839,3242,DE,BG
184614,1700241600,1700247360,5760,151373,91527,GB,GB
145926,1699142820,1699159440,16620,77130,122208,AT,BG
107079,1699329720,1699354440,24720,5492,60826,PL,DE
106482,1700765280,1700792640,27360,70350,189038,RO,RO
108851,1699563240,1699581300,18060,125032,40088,FR,FR
17976,1700105040,1700140440,35400,106132,58073,TR,TR
175998,1699300920,1699331880,30960,172410,100516,TR,TR
127600,1699286580,1699291800,5220,121033,140665,GB,GB
48039,1699162140,1699177320,15180,23052,77286,CZ,CZ
133483,1699730100,1699762260,32160,2935,52900,TR,TR
81435,1700013060,1700035320,22260,85508,43389,DE,BE
105409,1700866440,1700882100,15660,80534,197777,US,US
172828,1699353840,1699362960,9120,148048,53859,IT,IT
169769,1699334340,1699348380,14040,44055,43385,US,US
163639,1699818060,1699823040,4980,178920,100493,NL,NL
113624,1700552760,1700562900,10140,40484,189996,IT,IT
161947,1699546800,1699551960,5160,198041,55438,NL,NL
7941,1699255200,1699266840,11640,198582,8937,PT,PT
179670,1699687140,1699713780,26640,146343,10990,DE,DE
39478,1700431320,1700461620,30300,42214,107133,TR,TR
24754,1698813240,1698827460,14220,167570,161722,IT,IT
192079,1699730520,1699736220,5700,91517,160397,NL,NL
162510,1699955760,1699959360,3600,83234,65355,GB,GB
91589,1699996320,1700026260,29940,150257,75378,TR,TR
106255,1700528520,1700541240,12720,8226,95181,IT,IT
183444,1700575440,1700592900,17460,108112,102972,US,US
105701,1700694780,1700707980,13200,192370,192744,ES,FR
155822,1699002600,1699017000,14400,93672,189708,US,US
142066,1700193660,1700227740,34080,169614,29661,TR,TR
54396,1699732320,1699769400,37080,196680,36870,MX,MX
41917,1699530960,1699566540,35580,97397,151601,TR,TR
156493,1699227420,1699262280,34860,31275,90628,TR,TR
142727,1700250960,1700285460,34500,6034,127192,TR,TR
29346,1700530080,1700545080,15000,86514,73108,AT,SK
25513,1699758600,1699762200,3600,82970,146391,GB,GB
136590,1700720820,1700750400,29580,186282,101334,TR,TR
64344,1698871680,1698901080,29400,144418,155838,TR,TR
90659,1700396460,1700400060,3600,28042,103617,GB,GB
150978,1699533900,1699545660,11760,167095,196689,RS,DE
41466,1698978600,1699012500,33900,141426,110563,TR,TR
24669,1700856240,1700891160,34920,55677,187510,TR,TR
154008,1699120680,1699153140,32460,114086,108604,TR,TR
6770,1698930540,1698939720,9180,125395,81819,SK,CZ
86242,1698972120,1698994740,22620,11777,44318,DE,HR
152026,1700783280,1700810220,26940,145863,43633,PL,BE
134027,1700618460,1700642940,24480,147355,96347,DE,PL
95524,1699070700,1699076100,5400,152580,75124,NL,NL
25893,1700775000,1700780340,5340,182721,129570,GB,GB
26576,1699222920,1699258500,35580,100616,102185,TR,TR
167067,1699606440,1699639320,32880,197917,68930,TR,TR
39690,1700502660,1700508060,5400,30703,121229,NL,NL
9927,1700140500,1700171220,30720,124871,67953,TR,TR
95754,1700823660,1700834160,10500,82178,93527,SK,SK
170804,1700854800,1700883840,29040,139997,179552,TR,TR
80801,1699925160,1699958160,33000,39674,175913,TR,TR
44348,1700360100,1700368200,8100,8719,76375,IT,IT
152807,1699675680,1699710600,34920,163398,145404,TR,TR
631,1699283280,1699313640,30360,28087,156309,TR,TR
124425,1700647200,1700650800,3600,59608,68396,GB,GB
150174,1699810980,1699815720,4740,150609,196869,NL,NL
131382,1699582980,1699604160,21180,194652,27013,FR,FR
49324,1699870080,1699876380,6300,118942,43095,NL,NL
1461,1700304720,1700336580,31860,119816,178626,TR,TR
138682,1699279320,1699309020,29700,179644,38640,TR,TR
77657,1698806400,1698820680,14280,137619,181667,US,US
104780,1700095260,1700127180,31920,121507,198239,TR,TR
161196,1699047600,1699076760,29160,191771,74787,TR,TR
17665,1699871340,1699884840,13500,160663,124369,PT,PT
193714,1699866300,1699899720,33420,135188,42604,TR,TR
196656,1699889160,1699918620,29460,156885,166676,TR,TR
171820,1699637400,1699654920,17520,66962,18915,US,US
186079,1699222440,1699239660,17220,140421,178926,FR,IT
5673,1699711440,1699718940,7500,140353,104779,IT,IT
186895,1699157820,1699172340,14520,121174,107555,FR,FR
88668,1700587020,1700598660,11640,130380,190263,IT,FR
33437,1699433400,1699443360,9960,136375,94857,IT,IT
451,1699749000,1699757040,8040,113543,105435,PT,PT
135826,1700442540,1700452920,10380,110474,162430,IT,IT
60900,1699247280,1699253220,5940,4589,128269,NL,NL
178996,1699576020,1699608720,32700,53528,66853,TR,TR
86497,1699828920,1699860540,31620,59047,24686,TR,TR
173990,1700469420,1700492760,23340,116995,178961,BR,BR
33846,1699726320,1699741560,15240,147323,126243,US,US
124149,1699608420,1699612680,4260,95715,194324,GB,GB
156347,1700155740,1700190780,35040,165789,39406,TR,TR
156238,1699599300,1699606140,6840,141018,156938,GB,GB
131762,1700044380,1700078220,33840,119187,136643,TR,TR
55168,1699416120,1699431900,15780,76030,93327,RS,DE
62880,1699697340,1699729920,32580,184481,106650,TR,TR
139657,1698927240,1698956340,29100,121699,156342,TR,TR
101267,1700524020,1700528520,4500,177702,143237,GB,GB
195283,1700097000,1700128140,31140,137740,76110,TR,TR
149326,1699438140,1699470960,32820,97013,144668,TR,TR
61127,1699606800,1699636200,29400,1783,37435,TR,TR
29997,1699935120,1699990440,55320,156769,6778,BG,AT
73901,1700587620,1700623620,36000,127507,122820,MX,MX
21035,1700613060,1700625600,12540,151413,3384,US,US
129900,1700569140,1700572740,3600,151039,141600,GB,GB
104744,1700805840,1700810460,4620,163138,54837,NL,NL
171411,1698944640,1698973500,28860,177991,48490,TR,TR
15226,1699150320,1699181460,31140,126030,60129,TR,TR
140122,1700231880,1700248620,16740,95949,80894,FR,FR
171425,1698824400,1698860220,35820,158037,174520,TR,TR
74763,1699197660,1699235100,37440,67629,58577,MX,US
30036,1699228560,1699239540,10980,161808,109967,US,US
17475,1699044540,1699048140,3600,164075,174285,NL,NL
123071,1700832600,1700850480,17880,108405,79316,FR,ES
26057,1700753820,1700786280,32460,154173,173085,TR,TR
128388,1700440920,1700472180,31260,42897,2324,TR,TR
80320,1699056600,1699067280,10680,66390,79907,ES,ES
75475,1700277960,1700309220,31260,27062,188429,TR,TR
2080,1699620120,1699630560,10440,5107,180702,IT,IT
33715,1699845480,1699877040,31560,152467,140829,TR,TR
67661,1700032860,1700036460,3600,142006,199579,GB,GB
174981,1699255440,1699263780,8340,143363,55665,PT,PT
35135,1699784580,1699811160,26580,28164,188110,RO,RO
177896,1700031180,1700065020,33840,157332,198107,TR,TR
153289,1699622280,1699636800,14520,38474,189500,US,US
6901,1699831860,1699854540,22680,64876,27800,CH,IT
1788,1699883280,1699898880,15600,96919,158862,US,US
26399,1700207820,1700236200,28380,117977,131665,BR,BR
116980,1699738020,1699746960,8940,81402,58404,HR,HR
100068,1699994640,1700006820,12180,19121,87413,HR,HR
67750,1699209180,1699238760,29580,4099,90580,TR,TR
183494,1699765980,1699795800,29820,195994,156031,TR,TR
12221,1699643460,1699649640,6180,72878,199712,EE,EE
121832,1700784300,1700813280,28980,107356,57000,TR,TR
192675,1700062500,1700080380,17880,178088,39875,US,US
39268,1700385240,1700413140,27900,130698,49249,NO,SE
121423,1699928400,1699958520,30120,132746,14278,TR,TR
182014,1699451100,1699486800,35700,51937,93006,TR,TR
59315,1700759940,1700776320,16380,59557,92421,US,US
112348,1698981960,1698986700,4740,24488,28634,GB,GB
122977,1699079940,1699091760,11820,121877,168512,AT,DE
130780,1700073000,1700082540,9540,15422,156872,IT,IT
195915,1699308840,1699318560,9720,148820,132465,IT,IT
19063,1699242960,1699279620,36660,154159,22751,MX,US
158358,1698882480,1698913080,30600,184584,149707,TR,TR
115030,1700806800,1700810400,3600,60236,78946,NL,FR
92942,1699686720,1699720980,34260,110418,156903,TR,TR
165553,1700289060,1700301000,11940,58750,11407,IT,IT
147292,1699322220,1699349580,27360,55014,59454,DE,DE
146996,1699035000,1699062780,27780,78669,21926,HU,AT
95295,1699054620,1699078140,23520,29988,187932,DE,HU
148420,1700064900,1700068500,3600,55268,31846,NL,BE
60476,1700858460,1700862060,3600,32125,165966,GB,GB
100859,1700180520,1700215320,34800,17161,81486,TR,TR
8725,1698887580,1698898500,10920,184616,66333,AT,AT
168663,1698894180,1698929940,35760,158918,168245,TR,TR
36571,1700467680,1700502540,34860,99544,10618,TR,TR
152436,1699470180,1699504860,34680,74415,86674,TR,TR
183759,1700513580,1700548500,34920,62430,17206,TR,TR
52948,1699124400,1699136160,11760,38666,69485,PT,PT
62107,1699093440,1699123140,29700,138211,94935,TR,TR
35114,1699093080,1699097340,4260,116084,119859,NL,GB
25623,1700463600,1700467200,3600,14066,161604,NL,NL
59686,1700073300,1700081100,7800,68541,65627,PT,PT
76187,1699335300,1699365000,29700,41343,173233,TR,TR
163302,1699281120,1699294620,13500,85872,187424,AT,HU
132017,1699427400,1699436640,9240,102696,100884,IT,IT
104080,1699341540,1699355280,13740,143518,183314,CZ,UA
69033,1698897120,1698931500,34380,198706,93782,TR,TR
128209,1699869600,1699895820,26220,65926,32028,DE,DE
185658,1699891920,1699908120,16200,47435,193389,CZ,CZ
175892,1699250760,1699283460,32700,51905,67758,TR,TR
111562,1699482780,1699496280,13500,18152,61831,HR,HR
130301,1699146780,1699164540,17760,154990,135097,US,US
195604,1700223840,1700227440,3600,147019,62420,GB,GB
128857,1699959480,1699976640,17160,45351,123502,CZ,NL
44292,1700273400,1700277000,3600,68828,57196,GB,GB
192409,1700687160,1700701260,14100,108949,90180,PT,PT
97227,1700844960,1700856180,11220,130783,159551,IT,IT
179774,1699726380,1699729980,3600,148285,61760,GB,GB
23125,1698999960,1699028520,28560,75999,67823,BR,BR
95958,1699533540,1699570680,37140,16514,191278,MX,MX
194890,1699341780,1699353120,11340,146007,1754,HR,HR
135628,1699801380,1699807500,6120,71600,129180,NL,CZ
99291,1700840220,1700870940,30720,158509,2493,TR,TR
47422,1700073360,1700098080,24720,35055,149630,HU,AT
138277,1699496880,1699514220,17340,156749,175765,US,US
143251,1699183920,1699218660,34740,114586,147879,TR,TR
179924,1700095380,1700128140,32760,157630,123668,TR,TR
45284,1699187040,1699210560,23520,193679,165373,PL,PL
156601,1699601940,1699635000,33060,138310,80694,TR,TR
145884,1699260900,1699283280,22380,15338,7087,PL,CZ
33121,1700370060,1700376120,6060,145906,4530,GB,GB
174082,1699681260,1699690200,8940,23046,63635,PT,PT
125106,1700056680,1700080140,23460,167303,131408,ME,RS
140841,1698844080,1698868440,24360,32032,183022,DE,RS
95896,1698893640,1698909660,16020,133820,139904,SE,SE
39496,1700719980,1700734260,14280,101071,172834,US,US
19051,1700135640,1700153220,17580,104153,146037,US,US
55788,1699809240,1699821840,12600,38472,35818,ES,FR
5444,1699787220,1699822680,35460,80567,13697,TR,TR
169711,1700845020,1700879640,34620,30710,19226,TR,TR
72304,1699061160,1699075560,14400,189016,91515,US,US
44677,1698942120,1698977280,35160,198241,8260,TR,TR
129876,1699484520,1699489260,4740,147294,81112,NL,NL
57298,1700603520,1700614500,10980,90706,194607,PT,PT
112830,1699945200,1699962180,16980,165156,92515,US,US
130149,1699322280,1699325880,3600,51457,57743,GB,GB
96065,1699405740,1699440660,34920,138393,141208,TR,TR
181653,1700668380,1700671980,3600,155523,31346,GB,GB
14032,1700464260,1700509740,45480,7442,21801,LU,IT
149073,1699107180,1699116840,9660,193454,127447,ES,ES
122240,1699866180,1699896180,30000,70932,83632,TR,TR
130722,1700533560,1700566020,32460,134283,33778,TR,TR
42581,1700643540,1700653380,9840,77503,52512,IT,IT
80683,1699829220,1699851720,22500,125198,83885,CH,DE
31387,1699375740,1699404600,28860,171942,17925,TR,TR
20454,1699018620,1699022220,3600,47127,25565,GB,GB
91294,1700579280,1700582880,3600,63036,140022,NL,NL
113318,1700250780,1700257740,6960,103541,158236,GB,GB
133732,1700803920,1700818680,14760,8414,21024,US,US
24370,1699544340,1699579020,34680,182030,4804,TR,TR
97123,1699736400,1699769940,33540,26932,142742,TR,TR
75993,1699558440,1699588920,30480,106836,145555,TR,TR
11855,1699213440,1699217040,3600,192477,119798,GB,GB
31617,1700202540,1700224320,21780,25058,101665,PL,DE
142516,1700061120,1700078460,17340,154698,163206,US,US
137895,1698946380,1698955680,9300,29248,42572,SK,SK
65784,1700039640,1700052000,12360,15767,110184,CA,CA
62717,1698924300,1698935520,11220,193298,47927,US,US
190045,1698809280,1698831900,22620,156639,195475,NO,DK
98502,1700220780,1700232000,11220,99114,165105,US,US
165582,1700251920,1700263440,11520,180590,3947,IT,IT
27198,1700386380,1700422020,35640,19564,191156,TR,TR
179894,1699521240,1699534500,13260,179579,60723,IT,DE
133747,1698971640,1699003020,31380,193811,172178,TR,TR
69948,1700534640,1700560500,25860,57411,17812,RO,RO
51990,1699235520,1699262940,27420,11159,160714,DE,SE
8128,1700243940,1700261340,17400,88395,137987,BE,FR
162600,1700441580,1700463840,22260,59264,62450,PL,DE
145494,1699526040,1699535160,9120,14416,88297,PT,PT
112521,1699783980,1699793520,9540,4095,190240,PT,PT
131925,1699785840,1699818240,32400,187223,23676,TR,TR
136355,1698953280,1698987960,34680,102733,129663,TR,TR
144629,1700726640,1700756700,30060,48186,35458,TR,TR
131583,1699699260,1699727160,27900,162664,126541,DE,DE
108226,1699304820,1699319040,14220,138917,176132,US,US
53407,1699893720,1699931820,38100,63359,147603,MX,MX
31305,1700072880,1700086560,13680,191684,22161,IT,IT
136115,1700637420,1700666460,29040,97708,67539,TR,TR
100818,1698929820,1698955200,25380,148847,67753,PL,PL
30273,1699990200,1700023500,33300,185276,145867,TR,TR
48687,1700250180,1700256540,6360,13954,33709,GB,GB
20451,1699627800,1699631400,3600,70697,152149,NL,NL
14889,1699766040,1699797780,31740,555,89511,TR,TR
149588,1700035260,1700047680,12420,128388,194055,US,US
34410,1699813860,1699844580,30720,182508,29936,TR,TR
91457,1698834480,1698848700,14220,155190,133509,ES,ES
154759,1699518660,1699533780,15120,24725,48523,US,US
150819,1700571600,1700584620,13020,63556,52370,ES,ES
47352,1700411940,1700436180,24240,76225,197058,DE,DE
116908,1700542320,1700569140,26820,95868,145695,BA,BA
138399,1700024640,1700058300,33660,174581,72608,TR,TR
117574,1699021740,1699057560,35820,156535,170110,TR,TR
35794,1699809300,1699837980,28680,54602,178113,PL,NL
146966,1699492740,1699497660,4920,178979,189455,GB,GB
189733,1699393800,1699424880,31080,143236,168479,TR,TR
58055,1699433820,1699467720,33900,178747,110861,TR,TR
151597,1699120920,1699138800,17880,96495,162340,FR,FR
184937,1699242480,1699252800,10320,134999,12709,HR,DE
125669,1698864960,1698876660,11700,8174,121092,IT,IT
40873,1700590380,1700596800,6420,133345,135993,GB,GB
199028,1700764140,1700776440,12300,175973,170116,ES,ES
102760,1700405040,1700414160,9120,139831,140231,PT,PT
136042,1698949080,1698960540,11460,43248,35269,CZ,CZ
19295,1699772700,1699776420,3720,172924,23960,NL,NL
180167,1700207880,1700243700,35820,68569,171041,TR,TR
125480,1700170560,1700205420,34860,4711,124374,TR,TR
131578,1698984180,1699000020,15840,59131,185775,BE,DE
150506,1700310660,1700322480,11820,151110,173535,IT,IT
104805,1700314500,1700321340,6840,21932,38939,GB,GB
100066,1700212800,1700234700,21900,141098,158257,PL,PL
182778,1699169760,1699173360,3600,97730,171343,NL,NL
136737,1700496780,1700508720,11940,68750,26383,IT,IT
97936,1699460640,1699494420,33780,46186,3367,TR,TR
33269,1699328040,1699352280,24240,196566,120933,PL,PL
1343,1699607820,1699617360,9540,192746,178660,IT,IT
114893,1700056740,1700065920,9180,166937,127066,PT,PT
11064,1700444580,1700476560,31980,197918,109716,TR,TR
58383,1699602720,1699620300,17580,188226,39099,US,US
95712,1699026120,1699033140,7020,72523,1113,GB,GB
29817,1700487360,1700509740,22380,81189,154502,DE,PL
39036,1699400820,1699434180,33360,20361,26177,TR,TR
51861,1700198520,1700214840,16320,10899,183232,FR,FR
69973,1699174860,1699209300,34440,189853,135259,TR,TR
172119,1700185140,1700191020,5880,102981,156587,GB,GB
89703,1699226460,1699254300,27840,181144,104824,PL,DE
138506,1699145400,1699181100,35700,159164,35957,TR,TR
158125,1699223520,1699228560,5040,98075,157975,NL,BE
11439,1699800780,1699815600,14820,165214,59763,US,US
19036,1698908280,1698914040,5760,11695,137264,NL,NL
21268,1700717340,1700755440,38100,18849,150324,MX,US
60123,1698956460,1698979800,23340,76203,133121,RO,RO
185015,1700218140,1700227200,9060,76625,109390,IT,IT
33174,1700220300,1700223900,3600,67061,46510,GB,GB
106229,1699233180,1699284900,51720,100985,351,BG,AT
190008,1699065180,1699084320,19140,99832,40190,FR,PT
33999,1700794140,1700797980,3840,161452,107026,GB,GB
129258,1700087640,1700123160,35520,79760,139619,TR,TR
87517,1700267100,1700271960,4860,21084,56071,NL,NL
89922,1699706340,1699738200,31860,150889,85196,TR,TR
192464,1699629300,1699634940,5640,27377,96669,GB,GB
170891,1700512260,1700571900,59640,39663,20525,UA,PL
15160,1699474380,1699506900,32520,77269,118390,TR,TR
23600,1700275260,1700289600,14340,104710,172506,IT,IT
12201,1699789020,1699824840,35820,140194,31428,TR,TR
173900,1700542620,1700547000,4380,171750,195134,GB,GB
151985,1700487660,1700498760,11100,174418,129068,PT,PT
40444,1700591580,1700603820,12240,154278,101328,US,US
131144,1699711080,1699715640,4560,5,179916,GB,GB
111902,1699423800,1699427400,3600,175495,141464,GB,GB
127758,1700721840,1700751780,29940,81466,130741,TR,TR
159972,1700382240,1700385840,3600,50027,153030,GB,GB
130570,1699450200,1699459140,8940,138510,82850,IT,IT
116925,1699793700,1699807200,13500,31506,44895,HR,BA
27674,1700155260,1700184600,29340,2658,173750,TR,TR
120005,1699184580,1699197120,12540,19384,177293,IT,IT
160820,1700183460,1700214540,31080,74484,184464,TR,TR
13823,1700054940,1700058540,3600,176553,137589,GB,GB
191247,1698840660,1698852720,12060,77822,60010,ES,ES
187842,1699188420,1699217700,29280,86216,164109,TR,TR
108506,1698995160,1699008780,13620,39958,122398,US,US
60254,1699344060,1699355640,11580,119315,86414,CZ,CZ
24810,1699465860,1699472040,6180,154885,48620,EE,EE
168548,1699536360,1699570680,34320,198815,162827,TR,TR
115724,1699771800,1699785840,14040,53397,77199,CA,US
38706,1699232100,1699264140,32040,55845,20478,TR,TR
4243,1699016460,1699020060,3600,149925,114975,NL,NL
123210,1700763360,1700794740,31380,107003,189330,TR,TR
190656,1699696080,1699723200,27120,96296,8152,HU,AT
135065,1699302600,1699318560,15960,160518,128989,AT,PL
73785,1700081880,1700094900,13020,178865,102855,US,US
38072,1700498400,1700506140,7740,72825,85212,IT,IT
81963,1698848160,1698879540,31380,98847,150031,TR,TR
99012,1700269980,1700287320,17340,23230,50974,US,US
5082,1700610840,1700615520,4680,192167,138263,NL,NL
154154,1700371920,1700387640,15720,146746,152877,FR,BE
180550,1699645020,1699676820,31800,165130,83122,TR,TR
51906,1699560360,1699564800,4440,139277,135940,NL,NL
96330,1699768680,1699786440,17760,57395,74179,US,US
67208,1700604120,1700636340,32220,4386,99080,TR,TR
34685,1699199340,1699213980,14640,197207,134063,US,US
179489,1699979460,1700013840,34380,69756,196992,TR,TR
77937,1698998880,1699019160,20280,45728,152455,SE,PL
145276,1699211940,1699245240,33300,144719,132243,MX,MX
176635,1700100840,1700115660,14820,94438,155492,AT,BA
64009,1698968880,1699000380,31500,194239,99713,TR,TR
47021,1700718480,1700722080,3600,95534,139875,NL,NL
30770,1698940440,1698970980,30540,158576,89323,TR,TR
30705,1700403240,1700417460,14220,64073,12757,IT,IT
8584,1698996480,1699006440,9960,27341,57627,ES,ES
169620,1700711520,1700741760,30240,98902,179046,TR,TR
172826,1700457060,1700470020,12960,153818,100277,IT,IT
42646,1698955500,1698961500,6000,165270,157608,NL,BE
10500,1699264740,1699298160,33420,14200,191206,TR,TR
195536,1700536740,1700569140,32400,28940,117935,TR,TR
131413,1700741040,1700769840,28800,119003,119442,TR,TR
164926,1699684020,1699695840,11820,41539,145429,PT,PT
52442,1699902360,1699931520,29160,168192,184301,TR,TR
79962,1699173840,1699207440,33600,199556,121934,TR,TR
194299,1700724000,1700755140,31140,21147,172770,TR,TR
151537,1700692920,1700702820,9900,78298,161080,HR,HR
49984,1699289820,1699296900,7080,178554,8458,GB,GB
117774,1700431260,1700463240,31980,32892,31657,TR,TR
138358,1699240200,1699246800,6600,122315,49351,GB,GB
133922,1699662060,1699693020,30960,105020,49909,TR,TR
118706,1700494740,1700498340,3600,117071,126904,NL,NL
26345,1700183100,1700195640,12540,114918,45174,HR,HR
60457,1699677720,1699692240,14520,4936,84429,RS,RS
67167,1700133300,1700138820,5520,171776,114040,GB,GB
25147,1700253300,1700265720,12420,12763,35242,US,US
58863,1699828500,1699862460,33960,191197,105949,TR,TR
142205,1700856180,1700891340,35160,118424,112726,TR,TR
16778,1699045800,1699075260,29460,29993,145812,TR,TR
6778,1699466460,1699488660,22200,60889,76437,HU,IT
163800,1698847620,1698883020,35400,158384,141915,TR,TR
134160,1698849960,1698853560,3600,85200,78426,NL,NL
40230,1700706060,1700709660,3600,97640,114261,GB,GB
24723,1700116920,1700134800,17880,49945,41770,AT,AT
71429,1700643660,1700651340,7680,115555,97065,IT,IT
108935,1700463900,1700493360,29460,178841,106945,TR,TR
142341,1700135880,1700161920,26040,53837,4901,DE,PL
70806,1699495260,1699518120,22860,145270,161809,RO,RO
163246,1700362200,1700377980,15780,190852,144674,US,MX
163080,1700852520,1700868420,15900,20512,36715,FR,FR
96190,1699568700,1699584900,16200,81029,146512,US,US
128572,1699193280,1699208640,15360,137582,8377,US,US
107841,1700523960,1700535960,12000,196083,85805,IT,IT
107535,1699571640,1699586640,15000,156945,60924,CZ,PL
42468,1700313720,1700317320,3600,55086,36595,NL,BE
124053,1700658780,1700682240,23460,194263,88232,DE,DE
39873,1700170800,1700181540,10740,55308,20416,IT,IT
97048,1699748640,1699783140,34500,142064,163594,MX,MX
147326,1699013340,1699027620,14280,132415,189629,PT,PT
174931,1699672620,1699682460,9840,26237,40386,PT,PT
159536,1698900120,1698935520,35400,37249,122777,MK,RS
47507,1698848520,1698878340,29820,147245,103279,TR,TR
42120,1699140960,1699154400,13440,8963,59190,IT,DE
68907,1699143180,1699161000,17820,44628,60059,FR,FR
158877,1699461600,1699494540,32940,32275,134492,TR,TR
55277,1699672500,1699686420,13920,39618,33169,RS,RS
10569,1700804100,1700810340,6240,150460,84357,GB,GB
31984,1699263960,1699277520,13560,63128,132883,CA,CA
43681,1700758560,1700794500,35940,69631,159812,TR,TR
179319,1700267820,1700291160,23340,119173,22785,CH,IT
112801,1699230240,1699244940,14700,107167,187468,CA,CA
12212,1699153080,1699188540,35460,146635,145435,TR,TR
102475,1700288760,1700304120,15360,192168,41147,US,US
108016,1699070220,1699106040,35820,88654,145660,TR,TR
160445,1699459080,1699492140,33060,110812,130731,TR,TR
117583,1698921840,1698955260,33420,156903,194736,TR,TR
156515,1699378080,1699382820,4740,115482,160583,GB,GB
153407,1700838840,1700873760,34920,138788,99031,TR,TR
20511,1699254180,1699285380,31200,175236,28217,TR,TR
40527,1700029560,1700046900,17340,169215,44952,CZ,UA
96845,1700565300,1700597400,32100,166545,29258,TR,TR
171435,1700823960,1700848260,24300,35971,119584,DE,DE
63453,1700011380,1700038560,27180,132012,50952,PL,AT
190149,1699715400,1699727220,11820,63775,132173,US,US
137758,1699189320,1699224300,34980,84712,187057,TR,TR
49366,1700115840,1700119440,3600,31488,28642,GB,GB
27367,1699446480,1699477020,30540,171786,26468,TR,TR
49070,1700044140,1700052780,8640,66801,74357,HR,HR
1471,1700286120,1700295300,9180,62692,67911,IT,IT
196116,1700363400,1700394360,30960,19728,21712,MK,AL
184535,1699539540,1699553280,13740,75773,146510,US,US
182193,1700287380,1700318640,31260,100860,53900,TR,TR
41418,1699430100,1699451100,21000,114525,41189,FR,FR
50990,1699404780,1699438140,33360,64202,45427,TR,TR
162232,1699345620,1699376340,30720,47651,165088,TR,TR
80776,1699686660,1699724160,37500,186906,83791,MX,MX
131350,1700351340,1700384280,32940,155822,64722,TR,TR
105346,1699855080,1699866300,11220,91527,81019,PT,PT
191860,1700337600,1700357880,20280,130045,108478,FR,FR
172865,1699202160,1699231860,29700,18998,64858,TR,TR
146505,1699997460,1700031600,34140,88254,124042,TR,TR
95599,1699200480,1699206480,6000,148274,167723,GB,GB
89292,1699144200,1699177800,33600,89242,65604,TR,TR
177139,1700642520,1700646120,3600,88714,30159,NL,NL
145439,1699265220,1699300560,35340,135364,33284,TR,TR
93352,1700632320,1700670540,38220,175052,42431,MX,MX
25393,1699836360,1699873500,37140,145026,107047,MX,MX
120601,1700705100,1700708700,3600,84766,148184,NL,FR
140404,1699807440,1699820520,13080,4624,134480,RS,ME
94024,1700139120,1700174100,34980,186147,79294,TR,TR
164358,1698801480,1698815520,14040,63663,16118,AT,AT
111983,1699502460,1699508580,6120,120605,146043,GB,GB
22693,1699734360,1699768320,33960,80726,132521,TR,TR
185268,1699708380,1699740000,31620,61769,20533,TR,TR
154408,1700834340,1700845800,11460,7504,49022,IT,IT
43843,1699871340,1699885980,14640,11366,94653,US,US
31111,1700157960,1700170680,12720,85090,198387,US,US
106286,1699915560,1699919160,3600,76330,187851,NL,NL
75503,1699397340,1699407840,10500,6357,30570,HR,BA
67139,1699208820,1699266300,57480,13555,49038,BG,DE
99796,1700471880,1700499720,27840,169963,37157,DE,DE
80995,1700210580,1700229420,18840,133789,191668,FR,ES
177284,1699463700,1699476060,12360,12988,192502,US,US
141661,1700844300,1700879580,35280,260,68330,TR,TR
196181,1700352660,1700391960,39300,147514,168707,MX,MX
116196,1699455240,1699460700,5460,68446,90638,NL,NL
39657,1698943020,1698974220,31200,123786,93684,TR,TR
66273,1700606940,1700624400,17460,68814,191405,AT,BG
184044,1700158800,1700162400,3600,71185,168547,NL,NL
9601,1699049940,1699060440,10500,78648,87877,IT,IT
134960,1699616160,1699633680,17520,72016,3052,BE,NL
191167,1700367900,1700372100,4200,6658,106037,GB,GB
63075,1699740960,1699744560,3600,115154,109637,GB,GB
196052,1700357460,1700365800,8340,116072,82245,IT,IT
168164,1699778220,1699811220,33000,124748,183883,MX,MX
132911,1699299120,1699331940,32820,158594,49792,TR,TR
172105,1700034600,1700038680,4080,93095,29308,GB,GB
31785,1698927840,1698952800,24960,55826,56853,DE,RS
91939,1700520300,1700527800,7500,65330,179868,IT,HR
139787,1699333860,1699365420,31560,163070,192589,TR,TR
14683,1700852760,1700866080,13320,148945,139061,PT,PT
173397,1699352820,1699364940,12120,164738,90870,IT,IT
55456,1699735740,1699745700,9960,60565,89696,IT,IT
64909,1698911880,1698940680,28800,128717,166036,TR,TR
181930,1700401620,1700411760,10140,54496,54704,IT,IT
26443,1700161440,1700190660,29220,174157,58608,TR,TR
127461,1699910580,1699945080,34500,48542,196058,TR,TR
55918,1700807220,1700838480,31260,137447,110763,TR,TR
68806,1700461800,1700465400,3600,129734,4721,NL,NL
103764,1700628300,1700639940,11640,166653,117015,PT,PT
87843,1700739420,1700773440,34020,96804,28388,TR,TR
195610,1700815620,1700849940,34320,118226,72478,TR,TR
103190,1699733100,1699768200,35100,155717,156142,TR,TR
143977,1698964680,1698978540,13860,185965,21297,US,US
26832,1699147920,1699177140,29220,167777,167304,TR,TR
21125,1700644980,1700671020,26040,196181,1836,DE,DE
87078,1698810660,1698841740,31080,105820,124611,TR,TR
88727,1699202340,1699221360,19020,111557,114373,BE,NL
157341,1699924080,1699937520,13440,167649,90129,IT,IT
54858,1699930080,1699963320,33240,56887,83809,TR,TR
101753,1699802400,1699806900,4500,129737,117475,GB,GB
64484,1699870200,1699882020,11820,97930,113784,IT,IT
171299,1699350060,1699380120,30060,90837,142565,TR,TR
39661,1699264620,1699299540,34920,38613,164639,TR,TR
178659,1699891020,1699903680,12660,47107,9434,CZ,UA
132896,1699456980,1699487940,30960,185410,165113,TR,TR
157254,1699407300,1699442700,35400,63862,8997,TR,TR
21877,1700697000,1700729820,32820,100606,136313,MX,MX
40494,1698951960,1698972660,20700,23155,74876,SI,RS
104637,1700230680,1700262000,31320,76506,7553,TR,TR
2361,1700398260,1700412480,14220,44493,13364,PT,PT
175384,1700341680,1700362440,20760,38852,137052,FR,FR
31923,1699315320,1699323180,7860,143951,105987,PT,PT
58585,1700108280,1700130780,22500,59256,158434,BR,BR
62929,1700339220,1700367840,28620,199667,65175,DE,BG
40044,1700540280,1700575080,34800,93897,177817,TR,TR
63762,1700711160,1700716800,5640,104273,57110,NL,NL
190733,1700357400,1700373240,15840,156191,88189,FR,ES
117506,1698976740,1699003380,26640,125636,155746,DE,FR
76922,1699948140,1699970880,22740,62600,105200,DE,AT
121199,1700469360,1700498280,28920,179127,41179,TR,TR
136112,1700468400,1700473680,5280,105363,71259,NL,NL
148075,1699327380,1699353420,26040,194547,89012,ME,RS
103722,1699495500,1699515780,20280,93202,69847,FR,FR
155800,1699807500,1699838100,30600,168051,66013,TR,TR
77023,1699423500,1699455420,31920,174655,150428,TR,TR
38277,1699861320,1699864920,3600,150872,106183,GB,GB
174075,1699291080,1699321620,30540,61196,80500,TR,TR
186155,1699230960,1699243080,12120,174679,179106,US,US
189904,1700114100,1700126580,12480,55523,160260,IT,IT
91452,1700242200,1700257260,15060,93292,182196,US,US
148620,1699278300,1699300440,22140,82121,126500,CH,IT
20852,1700827560,1700839020,11460,69267,137395,US,US
6239,1700081820,1700111640,29820,19256,70836,TR,TR
2122,1699015680,1699027800,12120,162209,46135,IT,IT
99605,1700469240,1700473260,4020,135288,165919,GB,GB
147173,1699942080,1699946580,4500,158672,176761,GB,GB
64413,1699806480,1699838940,32460,31374,65900,TR,TR
15285,1700625540,1700645040,19500,91566,199838,FR,GB
161068,1698968040,1699002480,34440,123776,35778,TR,TR
81495,1699639140,1699673940,34800,78994,102414,TR,TR
77157,1699143660,1699175400,31740,67319,15279,TR,TR
27429,1700851200,1700865120,13920,5905,57203,US,US
23058,1699961520,1699992480,30960,25701,138091,TR,TR
186940,1700836620,1700852460,15840,91073,88020,AT,AT
162047,1700486220,1700518620,32400,32366,106363,TR,TR
36233,1700754300,1700788680,34380,145865,33119,MX,MX
76505,1700355780,1700372460,16680,51190,198090,CA,CA
187326,1699640640,1699675440,34800,122304,85809,TR,TR
99042,1700287500,1700294220,6720,194332,3777,NL,NL
143465,1699823580,1699842600,19020,154273,159184,FR,IT
4664,1698925620,1698958080,32460,63961,115207,TR,TR
140748,1699421940,1699434900,12960,71296,70236,HR,HR
186911,1700769120,1700772720,3600,8123,118630,GB,GB
90832,1699481280,1699486740,5460,49229,127368,GB,GB
155241,1699658400,1699689540,31140,59857,9830,TR,TR
112690,1700377560,1700391600,14040,109362,12899,CA,US
138556,1699285920,1699308420,22500,40062,67689,RO,RO
101343,1700436840,1700454660,17820,75953,191722,CA,CA
13256,1699984920,1699995600,10680,87748,117853,IT,IT
50648,1700419560,1700454540,34980,106282,18582,TR,TR
43336,1699464240,1699467840,3600,145805,176508,GB,GB
71142,1699924260,1699956480,32220,16166,80205,TR,TR
126363,1700357760,1700370840,13080,44479,45817,IT,IT
82656,1700480760,1700486940,6180,170675,104251,GB,GB
194134,1699161180,1699193100,31920,53975,31190,TR,TR
31700,1700762640,1700772000,9360,60049,55301,SK,SK
56951,1700197740,1700201340,3600,40086,69576,NL,NL
61088,1699452780,1699484400,31620,172517,7898,TR,TR
73822,1699892100,1699909620,17520,34088,14754,US,US
68655,1699844280,1699847880,3600,176049,152996,GB,GB
60574,1698847680,1698852300,4620,192620,195938,GB,GB
23949,1699485720,1699497060,11340,136134,197137,US,US
141292,1698810240,1698821220,10980,139443,140893,ES,ES
44802,1699415640,1699449120,33480,150997,170232,TR,TR
15281,1698858360,1698889980,31620,170763,143590,TR,TR
193131,1699684620,1699688220,3600,90068,39019,GB,GB
135682,1700129460,1700147280,17820,134748,15659,CZ,CZ
133422,1699616460,1699640220,23760,34332,52337,MD,RO
61670,1698982260,1699015320,33060,86416,152042,TR,TR
158235,1699924440,1699958400,33960,2957,165194,TR,TR
17324,1699707300,1699741140,33840,54141,1567,TR,TR
13068,1699816980,1699854360,37380,180330,77819,MX,MX
195847,1700600700,1700635620,34920,177223,29591,MX,US
9652,1699712160,1699722960,10800,111408,121523,US,US
55948,1699584840,1699594080,9240,177399,8114,HR,HR
150950,1699645080,1699662960,17880,51901,123673,AT,AT
116866,1700708520,1700713560,5040,190052,5388,GB,GB
55771,1700682240,1700687580,5340,36358,119878,GB,GB
155479,1700526240,1700540160,13920,40405,98324,PT,PT
129669,1699202520,1699220400,17880,176154,33187,US,US
83926,1698873900,1698891000,17100,102601,84177,US,US
83052,1700799420,1700806200,6780,143612,30264,GB,GB
122635,1699016940,1699045740,28800,79361,50244,TR,TR
83467,1700377500,1700381100,3600,67535,197967,GB,GB
192278,1700336640,1700348220,11580,75992,33445,US,US
84507,1699987680,1699995540,7860,145301,107114,PT,PT
199166,1699794540,1699815420,20880,169279,21560,FR,FR
127564,1699387200,1699416420,29220,84620,14857,TR,TR
127779,1700636220,1700640780,4560,73971,196780,GB,GB
1021,1699506840,1699522380,15540,54442,2586,US,US
178394,1699677240,1699693560,16320,37940,107578,RS,HR
63254,1699820400,1699831740,11340,108222,68323,IT,IT
130028,1699408800,1699419480,10680,151361,74310,IT,IT
184962,1699177920,1699209480,31560,183124,105539,TR,TR
98367,1699136460,1699140060,3600,91584,168881,GB,GB
40185,1699874640,1699878240,3600,131059,65078,GB,GB
135047,1700864160,1700878140,13980,47037,150452,CA,US
109912,1700459280,1700494140,34860,92366,14127,TR,TR
39023,1699547340,1699559700,12360,140658,144033,IT,IT
117229,1700602860,1700633280,30420,29683,67082,TR,TR
63874,1699913160,1699927020,13860,78081,12823,IT,IT
56916,1699147080,1699180020,32940,16679,165958,TR,TR
124706,1700664480,1700675940,11460,116892,7201,CZ,CZ
74368,1698866160,1698879060,12900,63740,112570,PT,PT
177766,1699182300,1699213260,30960,78729,107359,TR,TR
70058,1699646940,1699681260,34320,128678,99288,TR,TR
104357,1699291140,1699299840,8700,149097,23207,IT,IT
184182,1699920660,1699955100,34440,120222,167055,TR,TR
177053,1700300880,1700314860,13980,12644,50385,AT,AT
80617,1699208880,1699220040,11160,20402,43419,IT,IT
4899,1699850460,1699856400,5940,32355,94620,GB,GB
198636,1699804260,1699816440,12180,159287,66261,IT,FR
116227,1700253840,1700264940,11100,92737,75467,IT,IT
8447,1699043640,1699049100,5460,183348,125446,NL,DE
194460,1700614500,1700635380,20880,103771,144125,DK,PL
92465,1700532840,1700545560,12720,98033,3889,IT,IT
44888,1700840460,1700853300,12840,163194,136354,IT,IT
174693,1700135940,1700170920,34980,2861,64089,TR,TR
191951,1699874280,1699877880,3600,96326,160480,NL,NL
177967,1700787960,1700820300,32340,34400,158363,TR,TR
37106,1700185020,1700224560,39540,165712,115468,LV,PL
190135,1698851040,1698854640,3600,102656,198345,GB,GB
121488,1699107060,1699141140,34080,17104,146389,TR,TR
4007,1699707840,1699741140,33300,92120,137290,TR,TR
136259,1700182200,1700193240,11040,48994,86993,IT,IT
151372,1700138100,1700171520,33420,50617,136348,TR,TR
56991,1699912620,1699947960,35340,140736,154533,TR,TR
21813,1699801680,1699817820,16140,98901,103775,US,US
131685,1699945920,1699961040,15120,158002,87595,FR,PL
164767,1699338720,1699353660,14940,95532,149541,US,US
26362,1700077980,1700111040,33060,72674,179141,TR,TR
31552,1698823260,1698852720,29460,185377,122424,TR,TR
167534,1698950820,1698981060,30240,156048,158965,TR,TR
111965,1699035360,1699065660,30300,95609,126770,TR,TR
164536,1700276280,1700306280,30000,169439,141052,TR,TR
161603,1699410480,1699434360,23880,148166,111654,DE,FR
68761,1700402040,1700435760,33720,136689,160910,TR,TR
88265,1700368920,1700401140,32220,10981,199118,TR,TR
44090,1700438100,1700468760,30660,89444,139995,TR,TR
19711,1700628840,1700662680,33840,71012,160610,TR,TR
180442,1699067100,1699096200,29100,122730,75196,TR,TR
50183,1700631420,1700661660,30240,83948,58879,TR,TR
13695,1699685760,1699718520,32760,179985,185051,MX,MX
134231,1700000340,1700013120,12780,55143,87390,IT,IT
171209,1699041180,1699071900,30720,161089,73232,TR,TR
42277,1700645340,1700676480,31140,168867,263,TR,TR
40603,1700841480,1700871120,29640,40992,46286,TR,TR
61172,1700056920,1700092320,35400,38428,182513,TR,TR
182486,1699598040,1699622640,24600,187390,137624,DK,DK
161513,1700834520,1700864340,29820,70839,34829,TR,TR
94148,1699842480,1699848180,5700,142619,177782,GB,GB
93165,1699915080,1699945860,30780,106362,192574,TR,TR
135817,1699627140,1699660140,33000,122746,190809,TR,TR
74655,1699475640,1699484400,8760,118831,13737,IT,IT
186553,1699918200,1699947480,29280,98029,125671,TR,TR
187955,1700562240,1700565840,3600,161643,169840,NL,NL
155886,1699991820,1700025240,33420,79590,153613,TR,TR
183557,1699095060,1699101480,6420,130269,107882,GB,GB
73327,1699101780,1699126560,24780,32664,178234,DE,DE
56714,1700057340,1700091720,34380,47775,85168,MX,MX
57901,1700232960,1700262600,29640,165863,33494,TR,TR
92403,1699691040,1699725300,34260,28223,166181,TR,TR
120668,1700022360,1700040240,17880,64498,44361,AT,AT
146773,1700216700,1700231220,14520,96573,73063,US,US
157914,1700338500,1700345820,7320,114745,50207,IT,IT
127584,1700406060,1700435100,29040,190846,98693,TR,TR
58982,1700440740,1700444340,3600,21261,157315,GB,GB
13847,1699497780,1699527900,30120,94340,184174,TR,TR
46800,1700079180,1700111760,32580,46458,62639,TR,TR
130790,1699335180,1699369320,34140,135123,52553,TR,TR
9781,1699955400,1699965000,9600,51300,25589,ES,ES
26638,1699886580,1699917600,31020,3398,43507,TR,TR
71686,1699285920,1699294860,8940,35172,124119,IT,IT
140125,1699449240,1699459020,9780,26129,139052,ES,RO
55169,1700073780,1700107020,33240,22776,90832,TR,TR
40443,1699604580,1699621680,17100,193561,62978,AT,BG
61917,1700228220,1700236260,8040,58255,195191,PT,PT
156564,1699240380,1699260360,19980,112359,166209,FR,IT
173312,1699306440,1699337340,30900,91170,85043,TR,TR
56454,1699893420,1699924080,30660,147434,143838,TR,TR
150973,1699317540,1699346640,29100,181102,177282,TR,TR
128081,1699542300,1699552620,10320,111549,7303,ES,ES
40997,1699479120,1699515000,35880,75313,192546,TR,TR
160739,1700241420,1700258220,16800,53390,101438,CA,US
11124,1700222460,1700256120,33660,199692,165581,TR,TR
106053,1699375380,1699387380,12000,14700,51984,IT,IT
137713,1698954240,1698983340,29100,46862,28623,TR,TR
172236,1700707380,1700733480,26100,116165,76687,RO,RO
22877,1699222560,1699239900,17340,145224,178752,US,US
65057,1699999260,1700017740,18480,69283,139155,DK,DK
181972,1699448220,1699477440,29220,78629,16459,TR,TR
2596,1699912680,1699943160,30480,48042,34492,TR,TR
53607,1700804340,1700835540,31200,85701,40122,TR,TR
180401,1699892580,1699903620,11040,140446,68131,SK,SK
63673,1699885860,1699919760,33900,70392,76502,TR,TR
49179,1699124460,1699128060,3600,82894,157863,GB,GB
69660,1700655000,1700668020,13020,15917,176185,US,US
4121,1699095540,1699109460,13920,117510,10950,RS,RS
90319,1700842380,1700875140,32760,3453,118204,TR,TR
134488,1700392500,1700424420,31920,2195,45863,TR,TR
52845,1700781600,1700793780,12180,195477,176618,SK,CZ
151090,1699265460,1699276800,11340,177153,107903,IT,IT
112911,1700030640,1700061000,30360,96340,74718,TR,TR
36824,1699442700,1699467480,24780,49312,134989,DE,IT
50546,1699200000,1699227720,27720,54650,198975,PL,DE
120143,1700739480,1700747640,8160,30489,69339,HR,HR
158168,1699606500,1699639500,33000,99910,189889,TR,TR
76344,1698966120,1698982860,16740,129933,25643,FR,CH
190853,1699471800,1699505580,33780,67628,22073,TR,TR
5386,1700033640,1700047260,13620,199626,89124,US,US
83606,1700071860,1700099640,27780,21653,47407,DE,DE
138827,1700066640,1700072100,5460,182877,160770,GB,GB
35392,1699543560,1699586760,43200,94912,6317,LU,IT
136156,1699521840,1699535940,14100,24519,123323,HR,HR
165665,1700174220,1700203740,29520,127965,82709,TR,TR
154463,1699203240,1699209720,6480,44062,99460,NL,PL
74389,1700194140,1700210820,16680,148561,89530,CZ,CZ
174511,1699900800,1699912860,12060,176560,91664,PT,PT
18153,1700303520,1700332740,29220,187456,107712,TR,TR
148306,1699926780,1699955580,28800,147520,199951,TR,TR
15055,1700153040,1700164860,11820,169749,80831,US,US
157356,1700122260,1700126040,3780,49910,41691,GB,GB
144561,1700666700,1700674020,7320,66825,126990,IT,IT
148007,1700118480,1700124780,6300,192122,3885,NL,NL
119140,1700494800,1700525520,30720,36588,161584,TR,TR
81309,1700181540,1700213160,31620,17247,191864,TR,TR
50794,1700680020,1700689920,9900,115837,44773,IT,IT
83539,1700055420,1700069100,13680,161242,135453,IT,NL
101952,1699783740,1699812060,28320,17209,23062,DE,NL
161788,1699470540,1699500480,29940,164880,11383,TR,TR
107952,1699060140,1699083600,23460,194048,61646,DE,BG
177113,1699752540,1699756140,3600,147907,13861,GB,GB
59396,1700673600,1700677200,3600,146374,104850,GB,GB
30008,1698866400,1698896280,29880,184178,141641,TR,TR
15018,1698795840,1698817260,21420,88438,139170,FR,FR
189943,1700623140,1700657520,34380,57788,69526,TR,TR
148270,1698950040,1698972060,22020,75262,49209,DE,DK
73143,1699168980,1699200420,31440,36684,185231,TR,TR
196814,1700118780,1700125740,6960,129773,106,GB,GB
191717,1700542560,1700576460,33900,93629,116546,TR,TR
140652,1699763940,1699777680,13740,119577,160712,IT,IT
1214,1700510760,1700514360,3600,51605,92850,GB,GB
54673,1700235660,1700245440,9780,80285,166320,IT,IT
185653,1699177020,1699180620,3600,178732,176933,GB,GB
145139,1699150200,1699181460,31260,173564,175407,TR,TR
43014,1699711860,1699740960,29100,18875,74189,TR,TR
53807,1700156340,1700164140,7800,133520,12553,HR,HR
5469,1699792560,1699798560,6000,108677,7152,GB,GB
167094,1700503680,1700535420,31740,103980,8763,TR,TR
105265,1700309940,1700339820,29880,176349,187763,TR,TR
72191,1700122140,1700151540,29400,73395,27470,TR,TR
90101,1700190900,1700195040,4140,31068,33665,GB,GB
167604,1700520000,1700529720,9720,55586,118695,IT,DE
178319,1699479420,1699501680,22260,4456,160099,DE,DE
151414,1699356840,1699383600,26760,123704,119776,RO,RO
73001,1700501340,1700536740,35400,76220,147218,TR,TR
4608,1700273340,1700286600,13260,199022,10150,US,US
96157,1699921680,1699925340,3660,42580,195707,GB,GB
138386,1699889040,1699920240,31200,79607,63754,TR,TR
27338,1699611420,1699616820,5400,36503,137990,GB,GB
185634,1700651220,1700657700,6480,47334,107363,NL,NL
35496,1700252040,1700260260,8220,144668,159332,EE,EE
1396,1700277540,1700290920,13380,21933,165856,US,US
3913,1699461120,1699493340,32220,118150,121220,TR,TR
89679,1700224140,1700236680,12540,4292,108060,US,US
178762,1699686120,1699717740,31620,154737,175658,TR,TR
150318,1700159940,1700192700,32760,84011,145933,TR,TR
167491,1700296380,1700330760,34380,27186,161643,TR,TR
146316,1699345740,1699359600,13860,127497,71281,IT,IT
167524,1700403000,1700414340,11340,109602,196377,IT,IT
142422,1699176600,1699205640,29040,139582,65471,TR,TR
85250,1700585820,1700589420,3600,45747,196998,GB,GB
76398,1700790780,1700801220,10440,168209,7346,CL,CL
98560,1699639860,1699647120,7260,52631,159760,FI,EE
28133,1700409420,1700421000,11580,75871,81131,US,US
70888,1699824660,1699836060,11400,75269,136371,IT,IT
193955,1700127540,1700144160,16620,147611,170818,US,US
105396,1699308540,1699330860,22320,132217,13923,DE,DE
25811,1700643900,1700654820,10920,5094,15165,US,US
120981,1699478940,1699496880,17940,15781,96960,US,US
129380,1700646240,1700659980,13740,136950,36220,US,US
50850,1700308260,1700338020,29760,141815,103959,TR,TR
149951,1700337180,1700354700,17520,8694,97647,US,US
118361,1700230080,1700269560,39480,174752,85606,MX,MX
98916,1699795200,1699798800,3600,37542,169186,GB,DE
193463,1699690920,1699697520,6600,112529,148805,NL,NL
49697,1698902460,1698911640,9180,73458,101905,IT,IT
183114,1699226160,1699238580,12420,31192,167513,US,US
178437,1700636640,1700644200,7560,27615,155450,HR,HR
113838,1699940820,1699964880,24060,179138,188363,PL,PL
13474,1698929400,1698942240,12840,173458,158448,US,US
5375,1699020240,1699053540,33300,13175,108991,TR,TR
161007,1699022400,1699034040,11640,14417,84379,US,US
187792,1699422240,1699446660,24420,104400,115087,DE,DE
194412,1700239200,1700253060,13860,86014,125828,US,US
138012,1698871860,1698905040,33180,34977,121973,TR,TR
97282,1700361420,1700395380,33960,133765,107564,TR,TR
148629,1700074080,1700087160,13080,126824,45633,US,US
147712,1699411500,1699422180,10680,2134,25873,IT,IT
104123,1700102220,1700112060,9840,79694,48718,IT,IT
100473,1700164140,1700169780,5640,181283,40593,EE,EE
28482,1699109820,1699143180,33360,180079,31284,MX,MX
156384,1700341980,1700345580,3600,94156,104514,GB,GB
86988,1699830240,1699859580,29340,177285,75077,TR,TR
130845,1700429460,1700438220,8760,124149,46888,IT,IT
185193,1700195820,1700212320,16500,36730,3980,AT,PL
134146,1700089320,1700105760,16440,193782,118991,US,US
43640,1700847660,1700859240,11580,157236,81152,HR,HR
160540,1699286220,1699317780,31560,105616,1344,TR,TR
104293,1700602740,1700611740,9000,170360,154229,IT,IT
198870,1698884220,1698887820,3600,91364,98414,GB,GB
7347,1700679900,1700684160,4260,199965,85142,NL,NL
154382,1699062540,1699066140,3600,78490,10271,NL,NL
14910,1699408740,1699414260,5520,143886,65070,GB,GB
9457,1700377440,1700410500,33060,181880,136920,TR,TR
9177,1699324440,1699334580,10140,78317,178000,IT,IT
29182,1700065080,1700082600,17520,585,134986,FR,BE
193091,1699297740,1699329720,31980,154268,61096,TR,TR
95661,1700265000,1700281800,16800,92284,157335,RS,BA
139162,1700623740,1700654940,31200,67512,104777,TR,TR
50830,1700254560,1700263680,9120,112847,104479,EE,EE
35204,1698810540,1698820380,9840,9196,34680,HR,HR
89151,1700759640,1700793300,33660,59599,33823,MX,MX
21305,1699965840,1699989360,23520,4540,95784,DE,BG
150617,1700464620,1700468220,3600,99865,42968,NL,NL
145045,1699942980,1699977900,34920,172531,194727,TR,TR
132861,1699073640,1699112700,39060,66967,141486,MX,MX
6754,1698958200,1698990660,32460,91013,168000,TR,TR
38578,1700322780,1700356860,34080,50088,80947,TR,TR
105579,1699146000,1699180080,34080,114276,167815,TR,TR
102460,1699299000,1699331100,32100,169700,106604,TR,TR
70624,1699876920,1699897980,21060,140584,66869,FR,FR
168770,1700846100,1700872860,26760,156897,108385,DE,DE
36211,1700075880,1700079480,3600,162849,18028,GB,GB
100345,1699584540,1699606380,21840,35617,102797,DE,DE
97431,1700413800,1700436120,22320,39860,166880,PL,FI
174025,1699190280,1699206360,16080,42181,135744,US,US
160736,1700460480,1700482320,21840,159498,68320,PL,PL
29898,1698828360,1698834480,6120,168021,150079,NL,AT
82184,1700469480,1700483040,13560,6655,132502,HR,HR
175405,1700359620,1700367660,8040,38808,106173,ES,ES
84007,1699828200,1699831800,3600,115281,107365,GB,GB
128639,1699497900,1699529340,31440,166014,121678,TR,TR
164318,1700622240,1700630520,8280,160718,90660,AD,FR
109943,1699202940,1699237860,34920,127894,58607,TR,TR
57156,1699562640,1699591440,28800,57718,162763,TR,TR
338,1700228280,1700258820,30540,104217,72453,TR,TR
178714,1699569900,1699583040,13140,85864,194577,US,US
177717,1700642040,1700673180,31140,107076,164396,TR,TR
51818,1700129220,1700132820,3600,65205,133174,GB,GB
6761,1700679480,1700708760,29280,107061,92276,TR,TR
191225,1699773660,1699777260,3600,37107,78231,GB,GB
32686,1700197620,1700214180,16560,9287,32727,FR,FR
199790,1700144940,1700170800,25860,6012,168295,BR,BR
84056,1700205780,1700217240,11460,199030,116029,US,US
114251,1700450940,1700463240,12300,18718,107247,HR,HR
110733,1699762800,1699766400,3600,189976,65333,GB,GB
98642,1699838640,1699855320,16680,62436,169285,SE,SE
162446,1698888300,1698911520,23220,176357,17460,DE,DE
124459,1700528880,1700534460,5580,23024,108356,GB,GB
94449,1700399460,1700432280,32820,5380,60022,TR,TR
129494,1698932820,1698936420,3600,3505,100192,GB,GB
195697,1699484940,1699498860,13920,11095,110035,US,US
93294,1700784780,1700796480,11700,44574,167509,ES,FR
132452,1700485680,1700520660,34980,74547,84527,TR,TR
83843,1700412300,1700423160,10860,89579,25949,US,US
37723,1699116180,1699150620,34440,106626,37614,TR,TR
143212,1699663500,1699695000,31500,143678,187891,TR,TR
113995,1699154940,1699171500,16560,90045,133709,US,US
39595,1699708740,1699723020,14280,162600,75666,ES,FR
54262,1698999900,1699032180,32280,45966,64911,TR,TR
92396,1699053120,1699064100,10980,5844,193860,PT,PT
51018,1700803560,1700834460,30900,87599,113175,TR,TR
179261,1699146240,1699175820,29580,167449,111995,TR,TR
182362,1700809920,1700833380,23460,186882,192985,BR,BR
15316,1700553900,1700567100,13200,111329,28196,CZ,BE
83745,1700759400,1700792880,33480,112155,117329,TR,TR
196826,1699485120,1699514460,29340,90472,91954,TR,TR
14931,1699325400,1699355880,30480,39781,131145,TR,TR
147521,1699203060,1699218900,15840,185434,36339,AT,BA
123786,1699418520,1699428720,10200,163447,81412,IT,IT
72589,1700622000,1700637480,15480,54807,63215,US,US
96928,1700139420,1700147040,7620,118597,180099,ES,ES
43630,1700625840,1700637480,11640,58674,160090,US,US
76762,1699844100,1699858260,14160,61605,9348,US,US
63779,1698810240,1698839760,29520,199202,84575,TR,TR
41894,1700332320,1700335920,3600,113196,132402,GB,GB
155153,1699680120,1699708980,28860,174113,140976,TR,TR
39090,1700294760,1700300460,5700,146058,34161,NL,NL
153968,1700768340,1700803380,35040,162536,96954,TR,TR
11625,1699265460,1699282320,16860,135384,80451,US,US
132852,1700162340,1700169780,7440,122980,67243,PT,PT
45685,1700236140,1700251800,15660,120422,164328,US,US
87964,1699610820,1699641720,30900,5743,55115,TR,TR
124992,1698844680,1698848280,3600,147394,154143,GB,GB
162283,1700553840,1700585040,31200,119710,53236,TR,TR
131118,1698798780,1698830820,32040,32853,156975,TR,TR
9458,1699785480,1699821300,35820,59043,22839,TR,TR
112767,1699605660,1699640100,34440,30758,46945,MX,MX
85632,1699367640,1699382880,15240,163702,103181,US,US
130820,1700509860,1700541840,31980,54487,88019,TR,TR
123008,1700019840,1700023560,3720,18139,33481,GB,GB
3119,1699064400,1699093320,28920,9601,170095,TR,TR
108517,1700517300,1700524200,6900,11403,115285,GB,GB
2446,1700805000,1700832360,27360,34556,159806,PL,PL
65149,1699846260,1699849860,3600,133837,154342,NL,NL
30742,1700099160,1700110500,11340,30794,197986,PT,PT
114817,1699101540,1699111080,9540,26718,70287,HR,HR
44020,1699518180,1699552740,34560,85155,52644,TR,TR
114142,1698812580,1698848700,36120,147819,30552,MX,US
112811,1700248800,1700274480,25680,164672,181182,ME,RS
99056,1700359320,1700362920,3600,4865,140516,NL,DE
133739,1699299000,1699332720,33720,60957,115527,TR,TR
41188,1699494600,1699510560,15960,62160,19574,AT,AT
180780,1699874280,1699906680,32400,36576,187611,TR,TR
111717,1700755680,1700760360,4680,67737,8290,GB,GB
124518,1698906060,1698921720,15660,123419,30974,US,US
14511,1700036940,1700048760,11820,188388,27978,IT,IT
104649,1699467540,1699483380,15840,176578,56493,US,US
46774,1700012160,1700036280,24120,89561,156378,RO,RO
51039,1700462940,1700486640,23700,1517,199564,RO,RO
173808,1699212300,1699221240,8940,84775,145746,HR,HR
185747,1700303520,1700335680,32160,142927,102877,TR,TR
36941,1699298640,1699332180,33540,128261,34557,TR,TR
97427,1700251320,1700284020,32700,3456,156060,TR,TR
24760,1698991320,1699021920,30600,135390,175425,TR,TR
153016,1699695420,1699699020,3600,22122,154244,GB,GB
25200,1699916340,1699924800,8460,18677,33487,HR,HR
54762,1699786440,1699800960,14520,23108,86921,AT,AT
131803,1699948740,1699978920,30180,194533,132134,TR,TR
149282,1700314020,1700331540,17520,48170,125246,FR,BE
49008,1700218560,1700222160,3600,42183,164848,GB,GB
5245,1699581480,1699585080,3600,110946,95476,GB,GB
21072,1699983840,1700013900,30060,113352,84700,TR,TR
148189,1699694880,1699705980,11100,8914,188127,PT,PT
178761,1698899820,1698905820,6000,116710,62936,GB,GB
176756,1698879900,1698914400,34500,8173,164635,TR,TR
509,1699500780,1699539240,38460,104435,80609,MX,MX
37831,1698834420,1698850440,16020,30000,123698,US,US
70684,1699243500,1699277040,33540,134272,61606,TR,TR
150085,1699409640,1699465860,56220,123436,153473,UA,PL
58077,1700328120,1700345580,17460,39479,58300,US,US
33566,1699627680,1699631280,3600,108478,128850,NL,NL
175930,1699904280,1699936920,32640,119564,163050,TR,TR
149252,1700632500,1700664720,32220,84661,104710,TR,TR
144632,1699228380,1699240080,11700,142897,125879,PT,PT
181780,1699070340,1699104060,33720,40771,32970,TR,TR
90028,1700608500,1700637600,29100,140945,190046,TR,TR
183748,1699250940,1699266900,15960,38523,149263,FR,NL
1631,1700340060,1700357520,17460,157532,112242,US,US
156159,1699749420,1699769160,19740,185911,62601,FR,FR
119267,1700527740,1700541300,13560,102988,88249,US,US
126670,1699405860,1699440060,34200,193778,27285,TR,TR
130382,1700332260,1700364960,32700,193602,163447,TR,TR
158524,1699548660,1699556820,8160,195664,96442,PT,PT
28150,1700778240,1700812560,34320,172102,39290,TR,TR
8577,1698811980,1698866700,54720,7489,163262,BG,BG
118433,1700582880,1700617860,34980,60084,140429,TR,TR
110060,1699426620,1699458180,31560,198045,154432,TR,TR
105934,1700724300,1700735580,11280,18448,46645,US,US
26902,1700733120,1700749560,16440,61172,108554,US,US
65341,1699926060,1699932000,5940,96612,173236,GB,GB
112008,1700481000,1700496660,15660,50197,185375,US,US
69062,1699200960,1699205520,4560,179830,77737,NL,FR
95424,1699119240,1699127760,8520,38777,168109,ES,FR
14649,1699431060,1699463040,31980,83499,10624,TR,TR
178901,1699618080,1699653660,35580,18578,151768,TR,TR
106743,1699621320,1699632180,10860,81093,166780,IT,IT
143866,1700724180,1700735940,11760,62852,91066,IT,IT
194858,1700179200,1700182800,3600,47060,78873,NL,NL
106869,1699921080,1699945320,24240,147338,74669,CH,DE
64238,1700360760,1700367720,6960,77851,72553,NL,NL
19875,1699343400,1699374420,31020,50895,97036,TR,TR
25445,1699181220,1699208160,26940,32863,171824,DE,CZ
118225,1699910220,1699941480,31260,189424,81900,TR,TR
3607,1699938000,1699950480,12480,91768,155727,HR,HR
54464,1700616300,1700633460,17160,11651,152749,US,US
120611,1699155720,1699162500,6780,81859,75715,NL,NL
19581,1699605240,1699638120,32880,147870,185488,TR,TR
15301,1699334580,1699365060,30480,131721,90363,TR,TR
70736,1699692840,1699726200,33360,8658,156441,TR,TR
68318,1700843880,1700877840,33960,123071,124946,TR,TR
187412,1700724120,1700757360,33240,17192,90430,TR,TR
3785,1700208060,1700236140,28080,120729,170638,DE,NL
139624,1698951900,1698955500,3600,35738,191893,NL,NL
88382,1699513680,1699524240,10560,171237,5836,IT,IT
131647,1699596000,1699613880,17880,125229,69446,AT,SK
32883,1700574420,1700604720,30300,111436,84927,TR,TR
125737,1700253240,1700260320,7080,17969,140155,GB,GB
187534,1700044620,1700080560,35940,90932,65351,TR,TR
179540,1699886580,1699915980,29400,20947,41812,TR,TR
119424,1699234920,1699256220,21300,128950,32156,FR,FR
104275,1698922200,1698935340,13140,115229,199158,IT,IT
177658,1700672700,1700707860,35160,129386,144037,TR,TR
36631,1699505280,1699521060,15780,91643,59276,US,US
171007,1698836040,1698845400,9360,114518,175615,EE,EE
71944,1699074240,1699110000,35760,112608,93701,TR,TR
162983,1700088240,1700092500,4260,27760,53792,GB,GB
31324,1699178340,1699194120,15780,102393,86542,US,US
122799,1699428420,1699432200,3780,64429,172580,NL,NL
3900,1699533000,1699566840,33840,46229,149694,TR,TR
44401,1699458900,1699493580,34680,148174,55128,TR,TR
174050,1700414820,1700422800,7980,117638,110435,SK,SK
26951,1699911360,1699943760,32400,105606,151314,TR,TR
172008,1699645560,1699681440,35880,120742,129255,TR,TR
2256,1700860980,1700889000,28020,191159,117039,DE,PL
121289,1700690280,1700699520,9240,52773,123703,IT,IT
199873,1700723580,1700733840,10260,186299,144100,IT,IT
180830,1700693160,1700698080,4920,176852,5420,GB,GB
143561,1700115300,1700142720,27420,177104,56565,HU,AT
119528,1699848660,1699852260,3600,189792,194363,GB,GB
198302,1699856460,1699891980,35520,112115,118241,TR,TR
163170,1699842060,1699855080,13020,93679,90567,PT,PT
14037,1699478700,1699508760,30060,115904,178186,TR,TR
170374,1698805320,1698836940,31620,20589,30000,TR,TR
100166,1699939620,1699954680,15060,31916,148768,AT,PL
119695,1700177880,1700191200,13320,82170,12133,HR,BA
7807,1700592420,1700597880,5460,179882,29084,GB,GB
85923,1700146680,1700197860,51180,15357,50114,BG,BG
171200,1698872040,1698879600,7560,120394,136406,IT,IT
16254,1700500860,1700534400,33540,199113,155379,TR,TR
168778,1700283900,1700310360,26460,58403,66350,PL,AT
90270,1698841320,1698849120,7800,89937,1998,IT,IT
105249,1698795600,1698799200,3600,164186,107432,NL,NL
198268,1700319060,1700348820,29760,94468,28258,TR,TR
66088,1700160120,1700195820,35700,26136,96357,TR,TR
139897,1699442580,1699449060,6480,8950,24707,NL,NL
67901,1698945000,1698948600,3600,30083,4993,GB,GB
141364,1698883500,1698917760,34260,27599,174266,TR,TR
127262,1699335420,1699341900,6480,69217,153577,GB,GB
29009,1699108980,1699124820,15840,9530,145263,US,US
197240,1700212380,1700228100,15720,98303,89983,US,US
124994,1700626860,1700637960,11100,43751,143473,IT,IT
157994,1699123140,1699156920,33780,153126,57763,TR,TR
37706,1698811020,1698821100,10080,69510,148156,IT,IT
71350,1699287000,1699300980,13980,135240,27035,IT,IT
28474,1700810100,1700840100,30000,87140,125313,TR,TR
96102,1699006680,1699037460,30780,50409,95889,TR,TR
123485,1699524960,1699533240,8280,144350,132943,HR,HR
717,1700357400,1700394360,36960,27989,8362,MX,MX
48297,1698827700,1698831660,3960,135536,167433,GB,GB
68942,1699410420,1699433100,22680,74477,149441,DE,DE
2821,1699491000,1699501620,10620,47403,135355,IT,IT
71206,1700318820,1700348880,30060,137773,102294,TR,TR
15332,1698823080,1698853500,30420,50428,85991,TR,TR
99236,1699715700,1699726440,10740,14321,94483,EE,EE
168999,1699347660,1699384800,37140,9517,116897,MX,US
169767,1699563300,1699599000,35700,23505,34850,TR,TR
96056,1700321820,1700329800,7980,87422,3379,IT,FR
67600,1700850840,1700854440,3600,305,81902,GB,GB
31371,1699531080,1699540380,9300,135989,130149,IT,IT
109540,1699104240,1699138380,34140,82704,27192,TR,TR
128648,1700425200,1700459400,34200,125340,193413,TR,TR
132332,1699772400,1699801440,29040,48842,176493,TR,TR
158219,1699781280,1699785420,4140,39782,176414,NL,NL
122392,1699672080,1699686180,14100,3577,174895,US,US
54096,1699370700,1699401780,31080,199935,141736,TR,TR
9147,1699077120,1699090740,13620,138844,104981,US,US
562,1698963060,1698973140,10080,56823,36412,IT,IT
124537,1700181660,1700185800,4140,193739,65636,GB,GB
189004,1699192140,1699221780,29640,173367,109467,TR,TR
26288,1700004060,1700035620,31560,108412,61239,TR,TR
106728,1700356020,1700360700,4680,104531,99551,GB,GB
54482,1699109760,1699136100,26340,71055,49969,DE,DE
170853,1700487180,1700491140,3960,105603,85929,GB,GB
193653,1699002600,1699033560,30960,195116,102865,TR,TR
42555,1699682400,1699713480,31080,122112,66349,TR,TR
68502,1700635740,1700650200,14460,44138,93450,SE,SE
37242,1699872120,1699902300,30180,24427,53206,TR,TR
49731,1699800480,1699835880,35400,132627,179491,TR,TR
198323,1700792160,1700848980,56820,161171,21409,BG,DE
76412,1699496100,1699504560,8460,68688,117820,IT,IT
163890,1700219700,1700226840,7140,70508,49417,NL,FR
112654,1698796860,1698803040,6180,137882,78004,NL,NL
89963,1700387160,1700416140,28980,148305,168214,TR,TR
41006,1699266780,1699290660,23880,41222,27014,BR,BR
24170,1700412660,1700426280,13620,94995,45361,CZ,CZ
117760,1699418940,1699433400,14460,107139,145142,US,US
65500,1698951720,1698981960,30240,101604,131777,TR,TR
93080,1700140200,1700173320,33120,88373,57845,TR,TR
100385,1700628300,1700645400,17100,194348,22404,FR,FR
123742,1700490180,1700544600,54420,134360,130337,BG,BG
10844,1700495880,1700506860,10980,177873,113329,PT,FR
80642,1700468100,1700489820,21720,159163,156731,LT,EE
1481,1700151600,1700167020,15420,27753,127561,FR,FR
74913,1700830020,1700862300,32280,94511,111578,TR,TR
7725,1698983160,1698994740,11580,28260,34404,US,US
32964,1700719800,1700737200,17400,57418,150519,US,US
168946,1699746720,1699779360,32640,74646,168364,TR,TR
66774,1699294620,1699303800,9180,64534,163615,EE,EE
147248,1698918720,1698951900,33180,181969,60204,TR,TR
152469,1699168020,1699180560,12540,41097,37578,HR,HR
195042,1700528760,1700538780,10020,92874,26054,EE,EE
135441,1700554740,1700567700,12960,102484,171313,AT,AT
118087,1699624800,1699657200,32400,95241,51967,TR,TR
31885,1699069020,1699102500,33480,156782,11404,TR,TR
198315,1699216800,1699251420,34620,163593,54613,TR,TR
72543,1699989840,1699994220,4380,123276,156437,GB,GB
161882,1699633800,1699663080,29280,153848,32908,TR,TR
61197,1699355100,1699383180,28080,147936,52596,CH,DE
41814,1699178460,1699183020,4560,18609,13968,GB,GB
23241,1699327560,1699339440,11880,156935,118267,CZ,CZ
37153,1699793460,1699807200,13740,185837,138138,ES,AD
62917,1700801520,1700815800,14280,102515,176261,IT,IT
28271,1699285740,1699290120,4380,113895,24861,NL,NL
38691,1698922980,1698949080,26100,20753,127171,RO,RO
3687,1700316240,1700333820,17580,1948,119714,US,US
64833,1699849800,1699880040,30240,131844,138030,TR,TR
36528,1699994640,1700029560,34920,38519,101588,TR,TR
182282,1699012380,1699019760,7380,84668,54264,PT,PT
124687,1698951900,1698977280,25380,158001,15238,BR,BR
85291,1700714940,1700718540,3600,190539,26802,GB,GB
185072,1699014900,1699018500,3600,87914,179931,GB,GB
122271,1698903840,1698935700,31860,21173,903,TR,TR
42257,1700785020,1700794380,9360,52452,44535,HR,HR
120877,1700266920,1700270520,3600,57898,141402,NL,NL
130065,1699200060,1699215840,15780,10384,170709,RS,RS
41653,1699197480,1699201080,3600,161542,142865,NL,NL
64665,1699423260,1699452720,29460,193174,119188,TR,TR
191244,1700460480,1700476860,16380,134805,55136,US,US
164974,1700095440,1700108940,13500,18734,157374,IT,IT
129467,1700515500,1700526540,11040,145217,152432,US,US
40123,1700372280,1700394000,21720,88478,151870,BR,BR
33755,1700060160,1700094660,34500,109266,14818,TR,TR
164867,1699834680,1699843140,8460,114979,127477,HR,HR
42735,1700219340,1700234160,14820,91558,198499,AT,HU
199219,1699911060,1699924320,13260,130159,87091,CZ,PL
31761,1699110420,1699121580,11160,27523,150801,IT,IT
61541,1699047480,1699081260,33780,156081,32005,TR,TR
21640,1699326480,1699357140,30660,172674,2403,TR,TR
10849,1699744260,1699776660,32400,80023,77003,MX,MX
145640,1700521020,1700530440,9420,157650,34834,PT,FR
145496,1700173980,1700205960,31980,29367,176927,TR,TR
40046,1699932360,1699960260,27900,175555,26062,DE,BG
163529,1699910160,1699941420,31260,141001,149640,TR,TR
108942,1700775600,1700806500,30900,60869,98077,TR,TR
15622,1700759220,1700762820,3600,185123,70292,GB,GB
176566,1699666140,1699721040,54900,109139,88414,BG,IT
37806,1699823940,1699858140,34200,21458,79774,TR,TR
97126,1699207680,1699211880,4200,137127,6785,NL,DE
180483,1700789100,1700801460,12360,71357,143099,HR,HU
49871,1699162140,1699179840,17700,188090,64894,US,US
154470,1699242180,1699272900,30720,177678,167426,TR,TR
55210,1700723160,1700732160,9000,121694,75368,HR,HR
114295,1699097580,1699117560,19980,83364,193105,FR,NL
124493,1699473120,1699501440,28320,88488,89123,PL,FR
44790,1700089620,1700101140,11520,18853,101479,ES,PT
23017,1698818340,1698822420,4080,56081,39960,GB,GB
68394,1700340540,1700344440,3900,22760,111576,NL,NL
109801,1700018100,1700051220,33120,119499,100414,TR,TR
155068,1699596000,1699631040,35040,196752,32814,TR,TR
25298,1699787400,1699818180,30780,72483,135281,TR,TR
147517,1700209140,1700244360,35220,135130,184270,TR,TR
53912,1699757100,1699768080,10980,76638,177729,US,US
168531,1699833240,1699867380,34140,174394,84620,TR,TR
34428,1699069140,1699076820,7680,139917,70905,IT,IT
76766,1699884480,1699897440,12960,117632,28824,AT,DE
58865,1699316160,1699319760,3600,176582,90161,NL,PL
114198,1700503620,1700538360,34740,68576,1730,TR,TR
1912,1699509420,1699519200,9780,4508,147699,HR,HR
121669,1698800160,1698803760,3600,29211,181601,GB,GB
162176,1700709480,1700736180,26700,97472,96636,BR,BR
7150,1700759160,1700762760,3600,170481,7394,GB,GB
94762,1700075700,1700090940,15240,113326,62984,US,US
99791,1700177100,1700180700,3600,185949,95466,GB,GB
50803,1700435640,1700470860,35220,157701,49149,TR,TR
135786,1700702880,1700706480,3600,27759,128229,GB,GB
113017,1700057820,1700090100,32280,106972,106554,TR,TR
53844,1699177320,1699210080,32760,140841,139757,TR,TR
59324,1699249080,1699284960,35880,100476,78318,TR,TR
154778,1700058660,1700095260,36600,146684,171948,MX,MX
76991,1700429280,1700443380,14100,147272,168412,HR,HR
123243,1699685700,1699721640,35940,179159,195172,TR,TR
196155,1700364660,1700374020,9360,77906,78321,CL,CL
39992,1699097880,1699129740,31860,16111,119085,TR,TR
107916,1700294580,1700307540,12960,164278,121861,US,US
3815,1700267700,1700271300,3600,160431,188152,NL,NL
504,1699187580,1699193100,5520,68448,54587,GB,GB
45937,1699728720,1699759620,30900,145957,148557,TR,TR
131943,1700656680,1700670660,13980,24863,81661,US,US
126800,1700343600,1700376300,32700,76848,92563,TR,TR
104433,1699095780,1699130640,34860,159598,197602,TR,TR
199341,1699631580,1699661880,30300,123870,136343,TR,TR
123929,1699526340,1699530060,3720,175925,34454,GB,GB
151004,1700624640,1700651280,26640,167317,144550,BR,BR
155248,1699139580,1699151640,12060,22308,84763,HR,HR
81252,1699908300,1699942200,33900,199258,28476,TR,TR
171852,1698959340,1698972300,12960,152100,85095,US,US
45886,1700032140,1700061360,29220,56833,11428,TR,TR
165182,1699595580,1699618800,23220,46900,17056,DE,BA
172340,1700698200,1700731560,33360,148619,78146,TR,TR
43323,1699921680,1699925280,3600,125293,122450,GB,GB
7455,1698919980,1698955560,35580,47879,140325,TR,TR
179986,1700832840,1700868240,35400,39182,145558,MK,RS
92122,1700727540,1700737380,9840,116322,169743,IT,IT
5975,1699473060,1699478520,5460,139875,186421,GB,GB
154405,1700615340,1700642100,26760,187324,165470,DE,DE
41141,1699520760,1699530300,9540,85030,132412,IT,IT
174732,1699142160,1699145760,3600,194304,124799,GB,GB
33139,1699203540,1699234620,31080,192304,96592,TR,TR
73141,1700101140,1700113800,12660,18851,48368,US,US
165722,1699080420,1699090200,9780,19390,49488,IT,IT
135263,1699316100,1699348200,32100,81252,61100,TR,TR
130448,1700341140,1700378760,37620,51931,165900,MX,MX
181145,1700225340,1700259480,34140,46748,2274,TR,TR
154997,1700583840,1700614080,30240,114346,82296,TR,TR
141908,1700000700,1700004300,3600,154087,69160,NL,NL
43399,1699283100,1699299000,15900,38061,65771,CZ,CZ
65395,1699856820,1699873440,16620,95004,24986,US,US
139166,1698803040,1698806640,3600,32231,97789,GB,GB
87103,1698992640,1698997920,5280,9102,199945,AD,FR
184367,1700072640,1700085720,13080,22395,32950,US,US
86489,1700605260,1700624580,19320,138116,136168,FR,NL
109719,1700384040,1700414220,30180,27421,85311,TR,TR
160638,1699343700,1699374360,30660,95535,57517,TR,TR
21755,1698810000,1698839760,29760,133618,158355,TR,TR
127119,1699262760,1699294800,32040,192959,187439,TR,TR
94697,1699400220,1699435080,34860,155222,87333,TR,TR
70378,1699042740,1699074600,31860,174339,160983,TR,TR
111098,1700184000,1700187600,3600,199537,20964,NL,NL
195049,1699488360,1699518420,30060,3416,159893,TR,TR
71272,1699659660,1699672080,12420,3905,70058,PT,PT
117267,1700170500,1700178900,8400,21996,103838,IT,LU
100051,1700096280,1700099880,3600,190765,140778,NL,NL
46134,1699058460,1699076340,17880,107814,52912,US,US
48325,1700545140,1700552520,7380,28873,46621,IT,CH
169627,1698946200,1698980700,34500,165198,81799,TR,TR
6705,1700835180,1700854380,19200,131409,30211,FR,FR
60752,1700638440,1700673420,34980,51506,4467,TR,TR
173904,1700165520,1700201280,35760,37486,118566,TR,TR
153664,1700749320,1700758740,9420,103459,152698,PT,PT
168555,1698861900,1698893160,31260,31043,144160,TR,TR
194033,1699626660,1699660920,34260,27161,137399,TR,TR
33965,1699536420,1699566180,29760,61668,83357,TR,TR
196119,1700534640,1700548560,13920,147098,39137,US,US
78610,1699557840,1699574100,16260,91190,108359,SE,SE
58093,1699040640,1699044240,3600,156940,109187,GB,GB
61061,1700219640,1700232420,12780,649,38057,IT,IT
101226,1698821940,1698833820,11880,76143,99132,IT,IT
192130,1699444140,1699454880,10740,110982,144126,PT,PT
69544,1699414740,1699445100,30360,93061,110279,TR,TR
55162,1699218060,1699221660,3600,77415,67142,GB,GB
125523,1700547120,1700581080,33960,122655,178096,TR,TR
74820,1699507440,1699512480,5040,74656,82411,GB,GB
5693,1699932240,1699942560,10320,48216,191411,HR,HR
139789,1699650600,1699665300,14700,191810,157744,US,US
76299,1700513460,1700523240,9780,70742,13821,HR,HR
4005,1699407360,1699417020,9660,169141,143824,IT,IT
108332,1700851380,1700882520,31140,84653,28888,TR,TR
65487,1699937160,1699968060,30900,48573,77665,TR,TR
89003,1700339640,1700343240,3600,63526,129074,NL,NL
121600,1699157640,1699186740,29100,19699,65876,TR,TR
109607,1700859120,1700894100,34980,102390,95583,TR,TR
115477,1699695600,1699724040,28440,8201,95474,RO,RO
76666,1699661340,1699670340,9000,72130,44912,IT,IT
137536,1699319580,1699330980,11400,7774,70309,IT,IT
193257,1699908420,1699917420,9000,65852,40352,IT,IT
129779,1700264700,1700277660,12960,87017,71656,RS,HR
198216,1699633020,1699686720,53700,55148,4653,BG,DE
1690,1698801540,1698817620,16080,148253,159922,US,US
88627,1699426980,1699441680,14700,34719,147324,FR,FR
18187,1699993620,1700024100,30480,82560,141498,TR,TR
96667,1700670420,1700678820,8400,164445,50097,ES,ES
10529,1699344360,1699347960,3600,186824,14217,NL,NL
9273,1699860720,1699887600,26880,71547,21133,BR,BR
86564,1699642260,1699676340,34080,23250,140470,TR,TR
2387,1699266480,1699301580,35100,89449,8817,TR,TR
30794,1699136460,1699145940,9480,31311,44414,EE,EE
27302,1700118540,1700127240,8700,86850,184190,PT,PT
18589,1698858840,1698866880,8040,14282,65480,IT,IT
41363,1699043760,1699051380,7620,13741,73373,ES,ES
20682,1698813900,1698827340,13440,45375,194522,ES,ES
159063,1700706300,1700733060,26760,162411,119239,BR,BR
27673,1700564760,1700594460,29700,43030,66914,TR,TR
5251,1700227200,1700250120,22920,31598,79341,PL,PL
27187,1699064280,1699075260,10980,39543,23735,IT,IT
139034,1700409600,1700442840,33240,167190,100335,TR,TR
83185,1699334880,1699368060,33180,103345,159573,TR,TR
164876,1700729940,1700764440,34500,194070,103357,TR,TR
54355,1700856360,1700889900,33540,181243,28663,TR,TR
94177,1698970680,1699003020,32340,122821,99846,TR,TR
76416,1700470560,1700483700,13140,147129,123557,US,US
63301,1699406520,1699434420,27900,78372,131125,RO,RO
142170,1700454600,1700485860,31260,76686,17983,TR,TR
141820,1699253580,1699257180,3600,139423,151907,GB,GB
110238,1700334720,1700366220,31500,139655,116518,TR,TR
70099,1700399820,1700430660,30840,60441,6929,TR,TR
105091,1699492800,1699507320,14520,68354,67008,CZ,HU
121361,1700357100,1700373420,16320,45517,153288,AT,SK
23920,1699429740,1699434360,4620,117468,18177,EE,FI
29874,1699288980,1699297620,8640,384,134659,IT,IT
144600,1700281860,1700293920,12060,25672,6151,US,US
72181,1699360080,1699382100,22020,97237,151036,DE,DE
93290,1699421580,1699453260,31680,70268,8911,TR,TR
33336,1699618200,1699634820,16620,193798,94241,RS,RS
134320,1699359660,1699395060,35400,32767,3365,TR,TR
24569,1698862800,1698877440,14640,120483,199102,US,US
46099,1699235040,1699267320,32280,30803,161326,TR,TR
39241,1700079360,1700096160,16800,165751,89900,US,CA
122252,1699098360,1699112880,14520,192280,199960,US,US
177431,1699118640,1699152960,34320,150493,132911,TR,TR
98499,1699354800,1699358400,3600,77887,14376,GB,GB
41858,1700795520,1700803080,7560,183950,119743,IT,IT
29271,1700522700,1700541900,19200,79486,31010,FR,GB
128960,1699112460,1699147560,35100,34454,28686,TR,TR
80194,1699470720,1699495560,24840,88467,96663,BR,BR
48476,1700628480,1700659440,30960,140558,163140,TR,TR
165348,1700822580,1700852040,29460,67272,11324,TR,TR
4788,1698822840,1698834060,11220,75863,166530,AT,PL
113844,1699612440,1699648200,35760,124052,30313,TR,TR
123502,1700358000,1700388480,30480,51466,130130,TR,TR
105309,1700639460,1700670960,31500,66063,72026,TR,TR
122165,1700167860,1700177700,9840,112205,40010,HR,HR
152895,1700635080,1700638680,3600,127132,42927,GB,GB
53381,1699691340,1699725780,34440,163341,26219,TR,TR
182628,1700177940,1700212920,34980,20485,123235,TR,TR
190896,1700152320,1700165460,13140,171913,104380,IT,IT
11649,1699564740,1699599840,35100,62481,91431,TR,TR
117294,1699629420,1699656420,27000,24091,6347,DE,DE
98553,1699244880,1699263240,18360,73332,151360,FR,FR
55330,1700237700,1700271540,33840,89545,95731,TR,TR
43500,1699731540,1699763220,31680,3018,149668,TR,TR
124820,1700396940,1700428680,31740,123184,1326,TR,TR
99872,1700213820,1700249400,35580,63532,29253,TR,TR
52465,1700277300,1700312700,35400,104292,53434,TR,TR
72079,1699504800,1699511220,6420,116695,104771,GB,GB
62850,1700786220,1700814540,28320,141909,128231,DE,CH
151352,1699063860,1699095960,32100,24723,120308,TR,TR
5802,1699188540,1699222440,33900,5311,130214,TR,TR
119273,1699649640,1699656720,7080,166386,197208,FI,EE
61453,1700654100,1700665140,11040,91794,69483,IT,IT
150842,1698913680,1698932640,18960,130092,11759,FR,BE
31259,1698949680,1698955140,5460,120851,149343,GB,GB
87003,1699070040,1699076160,6120,101797,170428,GB,GB
96949,1698821280,1698827100,5820,123414,173155,GB,GB
73145,1698981720,1698997020,15300,93177,42803,FR,FR
14537,1700039280,1700069580,30300,146495,193119,TR,TR
101716,1700331480,1700360580,29100,150077,47495,TR,TR
169614,1699835400,1699844340,8940,71490,22787,IT,IT
65075,1699049760,1699062900,13140,20304,46832,AT,AT
30321,1700453100,1700462520,9420,77010,138239,IT,IT
93118,1700633160,1700662740,29580,54685,94492,TR,TR
89306,1698858360,1698873300,14940,25137,61308,CZ,CZ
132385,1700684820,1700720460,35640,165349,68414,TR,TR
8565,1700007180,1700010780,3600,7528,77978,NL,NL
107917,1699834860,1699865820,30960,26131,38542,TR,TR
70481,1699537020,1699566240,29220,95429,129206,TR,TR
145717,1699948500,1699982880,34380,115945,18564,TR,TR
70080,1699598280,1699649400,51120,64357,164862,BG,RO
191306,1699496700,1699526880,30180,99043,184591,TR,TR
129928,1700561160,1700573580,12420,62543,21790,IT,HU
40729,1699086840,1699101720,14880,108912,164889,AT,DE
183756,1700009100,1700012700,3600,166503,68607,NL,FR
13445,1700714760,1700726940,12180,92981,188447,US,US
57791,1699393980,1699425360,31380,77247,171216,TR,TR
185647,1699184880,1699192200,7320,11290,24593,IT,IT
182864,1700556540,1700564400,7860,166060,150959,ES,ES
168197,1699886940,1699909980,23040,152856,11445,DK,DK
168210,1700673360,1700690520,17160,100027,87456,US,US
49722,1699242360,1699253700,11340,66948,112689,US,US
192599,1700188200,1700202660,14460,138817,96876,CZ,AT
181880,1699825440,1699833600,8160,59412,9369,PT,PT
95191,1699195680,1699229340,33660,55141,69435,TR,TR
93626,1700594100,1700609700,15600,48561,98633,AT,DE
45599,1700268600,1700299140,30540,36843,125042,TR,TR
143267,1699819200,1699851540,32340,41247,184414,TR,TR
142265,1700523720,1700553300,29580,55564,149304,TR,TR
70981,1700596260,1700603400,7140,137762,106564,NL,NL
168860,1700663940,1700697360,33420,156062,175146,TR,TR
79888,1700291280,1700314260,22980,190548,152091,DE,IT
4561,1699960980,1699964580,3600,78079,191261,GB,GB
35054,1699750680,1699754280,3600,118033,63499,GB,GB
144833,1700408580,1700434920,26340,103528,151452,DE,DE
69438,1700226840,1700230620,3780,49735,136104,GB,GB
172969,1699356840,1699389420,32580,137999,134606,TR,TR
157556,1699935180,1699938780,3600,150926,90860,GB,GB
65483,1700327880,1700362200,34320,173320,157131,TR,TR
30666,1699775880,1699793460,17580,39908,86817,AT,AT
95279,1700597340,1700615040,17700,27238,72089,RS,BG
9767,1699954800,1699982160,27360,121061,162248,DE,AT
89722,1700350440,1700355180,4740,110414,153781,GB,GB
8425,1700251080,1700282820,31740,141390,111379,TR,TR
65514,1698888840,1698922380,33540,127746,68427,TR,TR
166095,1699507380,1699520040,12660,143294,19120,ES,ES
41304,1699843200,1699878300,35100,170947,93103,TR,TR
139440,1699606980,1699611660,4680,159866,151109,GB,GB
170061,1700090100,1700094420,4320,30399,64923,GB,GB
138939,1699985280,1700014980,29700,1232,94725,TR,TR
182310,1700781600,1700808480,26880,27002,20258,DE,SK
83489,1700297400,1700309820,12420,177933,119915,US,US
13618,1700156280,1700192160,35880,2478,29618,TR,TR
27925,1699764720,1699798980,34260,127538,135464,MX,MX
127063,1700692740,1700709000,16260,112504,174963,US,US
143477,1700734500,1700765100,30600,156900,142263,TR,TR
87260,1699863900,1699867500,3600,93192,49579,GB,GB
162058,1699471560,1699483680,12120,29867,32076,AT,AT
117184,1700650800,1700686680,35880,189485,55519,TR,TR
127614,1700221920,1700252640,30720,44846,105429,TR,TR
106020,1700357340,1700368920,11580,17791,110425,US,US
31826,1699536960,1699541400,4440,68010,117010,GB,GB
119729,1699241940,1699262760,20820,158136,167471,BE,NL
105427,1700651880,1700686560,34680,100900,54765,TR,TR
28798,1700857200,1700860800,3600,198354,125495,NL,NL
180349,1699397100,1699424400,27300,5095,158921,PL,UA
68782,1698991680,1699005540,13860,63197,39096,HR,RS
155253,1700402160,1700433840,31680,132326,158710,TR,TR
18384,1700053920,1700083980,30060,53247,69698,TR,TR
52375,1699738680,1699768140,29460,167394,80911,TR,TR
165724,1699856520,1699868040,11520,48992,145241,US,US
172977,1699298280,1699330020,31740,40470,19957,TR,TR
127927,1699235340,1699265160,29820,39819,102562,TR,TR
76952,1699305720,1699338240,32520,53780,110892,TR,TR
146002,1698888960,1698908640,19680,58724,79870,FR,DE
171245,1699777080,1699786860,9780,199904,76155,IT,IT
16291,1699406220,1699417620,11400,94538,79819,US,US
117153,1700766720,1700799060,32340,189338,149221,TR,TR
21734,1699043760,1699047360,3600,185932,76868,GB,GB
150242,1699455300,1699491240,35940,196146,54793,TR,TR
119824,1698870240,1698896940,26700,110681,180228,CH,IT
199937,1698973080,1698987240,14160,37121,158413,US,US
127991,1700834940,1700851860,16920,180888,67693,US,US
155516,1699321920,1699337220,15300,191838,25376,AT,AT
63442,1700440620,1700472300,31680,186365,61451,TR,TR
56920,1699044480,1699068000,23520,154766,24426,PL,CZ
182182,1699929180,1699944780,15600,155002,107989,US,US
64177,1700400660,1700404260,3600,109173,115402,GB,GB
98852,1700641980,1700664360,22380,164703,186355,DE,DE
87770,1699612860,1699635480,22620,197577,191976,RO,SE
79020,1698960360,1698991620,31260,133761,47734,TR,TR
75342,1698923700,1698935400,11700,94835,111535,IT,IT
19737,1700281620,1700306280,24660,191166,81077,RO,TR
199437,1699452720,1699474260,21540,170945,67319,FR,FR
166093,1700703480,1700716320,12840,26578,38618,RS,RS
150152,1699392780,1699423200,30420,131363,165992,TR,TR
62685,1700510760,1700514360,3600,172042,119338,GB,GB
52360,1699674240,1699704480,30240,14564,165133,TR,TR
91646,1699281660,1699294980,13320,8281,63816,RS,RS
83348,1698987180,1699011180,24000,103775,138826,CH,NL
128686,1699075980,1699108680,32700,6102,174392,TR,TR
139061,1700186700,1700222400,35700,125678,174226,TR,TR
136611,1699777140,1699789020,11880,199879,21086,PT,PT
176090,1699347060,1699376160,29100,185098,23146,TR,TR
129420,1698968100,1698971700,3600,107956,25771,NL,NL
110578,1700383980,1700421120,37140,197768,189197,MX,MX
88606,1700269920,1700273520,3600,169928,196913,NL,NL
124782,1698881160,1698913740,32580,32930,89593,TR,TR
2114,1699551300,1699555380,4080,148395,195517,GB,GB
28603,1698942180,1698973380,31200,31131,35700,TR,TR
149817,1700463120,1700476380,13260,19160,97708,PT,PT
88309,1700297340,1700329980,32640,174747,93380,TR,TR
82491,1699819620,1699858980,39360,28055,100682,MX,MX
171076,1700626380,1700649300,22920,185921,154792,DE,PL
191132,1700037060,1700050020,12960,181119,110177,ES,BE
7432,1699946040,1699977240,31200,157726,54630,TR,TR
187690,1699625340,1699639740,14400,23727,168406,FR,BE
48873,1700562840,1700598120,35280,190506,127854,TR,TR
44784,1700749440,1700782620,33180,128706,155952,TR,TR
84828,1699276920,1699290840,13920,80014,77549,PT,PT
194893,1698930720,1698934320,3600,171250,101217,NL,NL
52064,1700548620,1700560080,11460,178264,197604,US,US
141413,1700336580,1700341380,4800,148265,102243,GB,GB
57039,1700453940,1700478900,24960,128705,183683,CH,FR
131525,1700824440,1700836140,11700,54221,152599,RS,RS
26084,1700750160,1700764380,14220,7961,49348,RS,HU
120533,1699339800,1699349520,9720,35281,103951,HR,CZ
87131,1698814500,1698835920,21420,31398,10729,AL,MK
6218,1699809780,1699813800,4020,129060,38416,GB,GB
19772,1700004900,1700017020,12120,170582,190650,US,US
167263,1699998840,1700030400,31560,38802,120607,TR,TR
186655,1700096580,1700100180,3600,153030,72609,GB,GB
167456,1699776720,1699807740,31020,44898,84583,TR,TR
25791,1700815080,1700828640,13560,26560,115090,IT,IT
152140,1700288820,1700321040,32220,119600,89088,TR,TR
123595,1699968780,1699979220,10440,144518,1717,IT,IT
102955,1700736660,1700740260,3600,56547,53714,NL,NL
92447,1699260360,1699272420,12060,85432,64467,IT,CH
25285,1698926520,1698933420,6900,121545,70272,GB,FR
122423,1698887340,1698923220,35880,94809,167409,TR,TR
23179,1700244360,1700261220,16860,181219,70439,BE,FR
151859,1700443320,1700456400,13080,49975,159685,IT,IT
148531,1699730700,1699762920,32220,51403,71753,TR,TR
134515,1700211480,1700217480,6000,104649,93316,GB,GB
46310,1699193880,1699228980,35100,189145,145043,TR,TR
153436,1700482440,1700488680,6240,148913,58641,NL,NL
75756,1699079100,1699095540,16440,178760,12685,US,CA
173620,1700665260,1700677200,11940,170799,8067,US,US
169904,1699202460,1699210380,7920,60588,168532,HR,HR
18144,1699395000,1699400340,5340,46874,643,GB,GB
111295,1700443080,1700473440,30360,82024,54946,TR,TR
65530,1699771500,1699804800,33300,96667,143282,TR,TR
46864,1700125800,1700135580,9780,51813,70692,HR,HR
87915,1699143720,1699154220,10500,188503,47920,IT,IT
182617,1699955520,1699987380,31860,75455,87951,TR,TR
110364,1699262820,1699266720,3900,104042,36583,GB,GB
127813,1699248120,1699264320,16200,49654,129936,AT,AT
184529,1699590120,1699625100,34980,16405,195141,TR,TR
11594,1699482660,1699486260,3600,93399,98227,GB,GB
82284,1699358760,1699374480,15720,49911,95420,US,US
181626,1699653720,1699685700,31980,65662,136856,TR,TR
123167,1699513080,1699547700,34620,165891,56505,TR,TR
81311,1700317680,1700351220,33540,73064,189063,MX,MX
126278,1700580180,1700596980,16800,166321,81892,US,US
175789,1698909480,1698967440,57960,178369,179307,UA,DE
134758,1699621140,1699656360,35220,123474,4152,TR,TR
148446,1699963980,1699978560,14580,199390,141220,US,US
136429,1700753280,1700756880,3600,82831,77794,GB,GB
81484,1699026360,1699033020,6660,32147,97051,GB,GB
105659,1699814640,1699845180,30540,150971,96621,TR,TR
51682,1699673040,1699688280,15240,94948,80600,FR,FR
56857,1700595480,1700599080,3600,32573,139056,GB,GB
138263,1699980720,1700011560,30840,61032,24670,TR,TR
54349,1699182780,1699206600,23820,195496,71565,DE,CZ
79594,1700772420,1700776020,3600,67064,7054,NL,BE
76255,1699335900,1699343400,7500,91407,132220,IT,IT
125176,1700641260,1700674980,33720,109808,40081,TR,TR
172255,1699826400,1699836420,10020,124754,182140,IT,IT
4245,1700184060,1700192940,8880,176413,77859,IT,IT
124098,1700255340,1700287560,32220,52522,38834,TR,TR
73849,1699152900,1699167840,14940,27202,132165,US,US
93845,1700333400,1700363280,29880,133197,95157,TR,TR
107473,1700734200,1700741700,7500,51681,106402,HR,HR
4490,1699816740,1699820460,3720,50943,90825,GB,GB
62462,1700013120,1700029860,16740,44833,53656,FR,FR
28810,1699703700,1699731300,27600,68155,84993,DE,DE
160073,1700659440,1700676660,17220,137229,182072,US,US
80543,1699368780,1699403400,34620,124786,34519,TR,TR
118602,1699213320,1699241940,28620,68243,155804,DE,FR
55910,1698954540,1698967020,12480,127617,43255,HR,HR
120037,1698797700,1698802800,5100,88815,116132,GB,GB
76023,1699128660,1699132260,3600,181050,181678,NL,NL
184294,1698987780,1699020180,32400,97996,31742,TR,TR
3790,1698899820,1698913860,14040,39496,71812,US,US
70343,1699922340,1699939980,17640,61037,96103,US,US
164948,1698971100,1698994500,23400,88280,192233,DK,DK
58072,1699979400,1700009520,30120,140576,87556,TR,TR
85326,1698944160,1698976440,32280,178937,75137,TR,TR
126547,1699864560,1699873500,8940,171078,149007,ES,ES
98733,1699165500,1699169580,4080,83463,94957,NL,NL
165252,1700126220,1700159400,33180,47162,144292,TR,TR
115095,1699585080,1699600380,15300,71831,192293,FR,FR
71519,1699703760,1699739340,35580,148122,73902,TR,TR
60240,1699054800,1699085760,30960,70556,36157,TR,TR
113159,1700491740,1700499960,8220,170552,172586,SK,SK
21781,1700842320,1700846520,4200,22480,169109,GB,GB
17664,1699572420,1699586940,14520,98121,83083,US,US
34365,1699811760,1699825620,13860,197927,143545,ES,ES
185631,1700672760,1700686620,13860,46899,163412,US,US
11928,1699183320,1699187640,4320,184743,83216,NL,NL
87384,1700530740,1700534340,3600,127974,161605,GB,GB
70020,1700382180,1700402400,20220,195686,63191,FR,FR
132617,1700293500,1700323380,29880,157504,168711,TR,TR
136189,1699481100,1699485240,4140,68830,162799,GB,GB
109714,1699342620,1699375740,33120,111828,25327,TR,TR
9693,1699065480,1699077360,11880,38168,29826,US,US
93584,1699146720,1699160640,13920,2318,10155,IT,IT
21895,1699808640,1699815540,6900,92292,35751,NL,NL
60815,1699671720,1699680000,8280,119051,191106,EE,EE
80524,1700406420,1700410020,3600,47174,25140,NL,NL
163062,1700674320,1700690040,15720,134249,146761,FR,BE
37027,1699235580,1699270020,34440,36242,15206,TR,TR
156478,1700597640,1700630160,32520,55716,173794,TR,TR
180466,1698964680,1698975840,11160,245,19453,US,US
28073,1700173260,1700191500,18240,124548,108233,DK,DE
146577,1699247340,1699250940,3600,72777,8409,NL,NL
46810,1699293660,1699326540,32880,103522,45312,MX,MX
23355,1699202340,1699207020,4680,157111,11016,NL,NL
104111,1699965300,1699990860,25560,34794,147694,CH,FR
84117,1699761720,1699772700,10980,127049,66591,US,US
66526,1699059540,1699078020,18480,182744,15355,BE,FR
65737,1699854840,1699872660,17820,180103,83988,SE,NO
89531,1700331420,1700362440,31020,27826,57192,TR,TR
69732,1699123140,1699155720,32580,168087,35702,TR,TR
191589,1699677660,1699693980,16320,159051,4746,CZ,CZ
20058,1700811000,1700846580,35580,7631,73033,TR,TR
59621,1700195040,1700229480,34440,48077,176930,TR,TR
133518,1699519800,1699545060,25260,171480,177497,DE,AT
132784,1700677200,1700685420,8220,130099,165247,IT,IT
13278,1699469280,1699504440,35160,169172,55166,TR,TR
81107,1700166780,1700180040,13260,136225,110332,RS,RS
1613,1700208960,1700216160,7200,109755,4153,IT,IT
171669,1699743480,1699769940,26460,161547,16905,DE,HR
101493,1699844220,1699880160,35940,9542,12237,TR,TR
153448,1698962640,1698974280,11640,87730,115792,IT,IT
21084,1700496780,1700511660,14880,44915,135662,US,CA
34404,1699021680,1699055340,33660,116300,177952,TR,TR
190436,1699941180,1699972260,31080,24236,164663,TR,TR
28186,1700256840,1700262000,5160,82284,180006,NL,NL
20601,1700707320,1700766600,59280,116493,152867,UA,PL
146815,1700622660,1700627280,4620,119988,106960,NL,FR
192292,1700201880,1700236560,34680,115200,164295,MX,MX
36646,1698952860,1698956460,3600,128103,65257,GB,GB
178573,1700134860,1700147580,12720,42711,69197,US,US
50076,1699395000,1699426020,31020,195355,198900,TR,TR
145579,1700542740,1700577480,34740,156103,54961,TR,TR
97831,1699555500,1699564320,8820,76403,156962,IT,IT
18888,1700692260,1700724900,32640,33507,91546,TR,TR
110682,1698983820,1698993900,10080,99194,164193,IT,IT
120340,1700355480,1700389560,34080,126955,118468,TR,TR
93682,1699764540,1699794900,30360,81242,176562,TR,TR
109381,1700145180,1700181360,36180,183647,114484,MX,MX
144152,1699474800,1699483620,8820,128462,164610,IT,IT
122374,1698895920,1698913140,17220,161617,161750,FR,FR
197152,1700328060,1700331660,3600,121486,49226,NL,NL
89934,1699471680,1699483140,11460,124274,22296,HR,HR
147571,1699979280,1699990920,11640,159746,44420,IT,IT
143221,1700352900,1700356500,3600,191069,104450,NL,NL
114477,1699549980,1699565820,15840,113075,118760,US,US
118396,1700107200,1700124720,17520,127611,101266,BE,HR
7048,1699079340,1699112400,33060,115554,153303,TR,TR
73932,1699811400,1699844220,32820,70020,188037,TR,TR
47633,1700394840,1700402100,7260,126772,114987,HR,HR
118362,1699375860,1699410720,34860,48257,81355,TR,TR
94950,1700591580,1700595180,3600,105146,169429,GB,GB
15318,1700074320,1700108340,34020,43860,186538,TR,TR
165620,1700001120,1700031900,30780,10051,62790,TR,TR
13319,1700793420,1700800080,6660,62986,194003,GB,GB
19836,1700030100,1700036580,6480,149559,39357,EE,EE
80514,1700159880,1700163480,3600,69064,57728,GB,GB
137461,1699920120,1699954620,34500,132346,93789,TR,TR
5566,1700394180,1700426940,32760,37460,54599,TR,TR
133301,1699098600,1699129800,31200,178421,152008,TR,TR
37722,1699533060,1699549200,16140,127790,70184,US,US
193654,1699495140,1699527600,32460,187899,73028,TR,TR
3603,1700178420,1700182020,3600,70104,84311,NL,NL
188701,1700280540,1700312100,31560,75850,194805,TR,TR
53039,1699708080,1699719480,11400,155440,192617,ES,FR
71869,1700250000,1700267520,17520,184847,163674,US,US
29745,1699402320,1699418580,16260,9026,143331,BE,FR
61278,1700576340,1700579940,3600,25755,100197,GB,GB
76256,1700700480,1700714760,14280,5778,23683,RS,SI
70335,1699631640,1699664400,32760,63089,70468,TR,TR
84652,1700201820,1700205900,4080,76507,42026,GB,GB
352,1700790960,1700821860,30900,50999,138992,TR,TR
144223,1700143380,1700155860,12480,37628,62322,IT,IT
1721,1699507680,1699539120,31440,80306,30176,TR,TR
191461,1700622540,1700655240,32700,101121,131624,TR,TR
102005,1700062440,1700079960,17520,184566,175186,US,US
24201,1700331720,1700342640,10920,129310,12159,US,US
123070,1700850600,1700861400,10800,99636,179247,IT,IT
124066,1699081140,1699089540,8400,14497,124668,IT,IT
129383,1698872100,1698908340,36240,16690,175917,MX,MX
88922,1699386540,1699414320,27780,152666,120745,DE,HR
70405,1700026800,1700040180,13380,39175,182521,IT,IT
30340,1698949020,1698979080,30060,17279,134413,TR,TR
59263,1700821860,1700828460,6600,194363,70834,NL,NL
98105,1700778720,1700784240,5520,3820,115825,GB,GB
129091,1698894540,1698899220,4680,179254,53305,NL,BE
167425,1700032380,1700066100,33720,148062,80246,TR,TR
133789,1700271840,1700326620,54780,167629,156266,UA,MD
61722,1698956760,1698960360,3600,154208,57278,GB,GB
12206,1699560300,1699563900,3600,11588,36183,GB,GB
90192,1699952040,1699986000,33960,110542,125994,TR,TR
78765,1699926360,1699952760,26400,9234,71406,DE,CZ
119320,1700538060,1700555340,17280,95328,46390,US,MX
73514,1700715420,1700728260,12840,68918,186825,RS,FR
145495,1700702040,1700730900,28860,161695,193241,TR,TR
107618,1699567020,1699600800,33780,149681,114643,TR,TR
64445,1700027100,1700043900,16800,171133,107299,BE,FR
11733,1699572660,1699577880,5220,94405,197316,GB,GB
177273,1699333260,1699350780,17520,135314,69084,RS,RS
103704,1700806740,1700810340,3600,36603,90090,GB,GB
169707,1700500980,1700516100,15120,60635,108324,US,US
105414,1700344860,1700358900,14040,144501,88407,US,US
164347,1700774280,1700777880,3600,176494,144255,NL,NL
6001,1699631520,1699637100,5580,79983,67183,NL,NL
50618,1700362620,1700392920,30300,144118,94600,TR,TR
59015,1699167300,1699179720,12420,107428,140202,US,US
57754,1699087560,1699091160,3600,21178,132661,GB,GB
169994,1699203240,1699232040,28800,3206,59346,TR,TR
29853,1700188380,1700213400,25020,182483,165854,PL,DE
127273,1699645560,1699682040,36480,128960,56371,MX,MX
3387,1700493060,1700524860,31800,178460,8734,TR,TR
13171,1700603820,1700607420,3600,175558,3686,GB,GB
182126,1699381440,1699392420,10980,171023,180310,IT,IT
172879,1700057640,1700072280,14640,99686,59469,FR,IT
117983,1700296680,1700300460,3780,102920,80537,GB,GB
159340,1699811700,1699847520,35820,63456,96528,TR,TR
58940,1699428360,1699443840,15480,145878,183074,US,US
70439,1699944360,1699954920,10560,197620,64952,ES,ES
190385,1698910920,1698916740,5820,41216,197834,GB,GB
130276,1700012760,1700047740,34980,30564,81464,TR,TR
151316,1700670060,1700701740,31680,129007,44673,TR,TR
37104,1700025000,1700039760,14760,163786,38654,FR,PT
83366,1699065540,1699078440,12900,181610,54091,US,US
15983,1699963560,1699999200,35640,42465,38826,TR,TR
183828,1700190420,1700194020,3600,5584,22398,GB,GB
191769,1700139360,1700142960,3600,75853,96629,GB,GB
126041,1699835160,1699868040,32880,16623,138937,TR,TR
134631,1700142420,1700179020,36600,103127,97124,MX,MX
192654,1698971400,1698984060,12660,73559,142799,HR,HR
142858,1699863720,1699872240,8520,171923,138417,HR,HR
59916,1699423380,1699460460,37080,58147,75675,MX,MX
6362,1700613960,1700642820,28860,47806,147309,TR,TR
93506,1698838080,1698871200,33120,189406,190358,TR,TR
1937,1700081760,1700097240,15480,18206,139543,US,US
175561,1699924800,1699942500,17700,33768,177714,FR,FR
111223,1698793680,1698805980,12300,158808,180023,US,US
51327,1700864280,1700896020,31740,55745,47556,TR,TR
46418,1700474880,1700501460,26580,32911,185031,DE,ES
8157,1700818320,1700851440,33120,48391,73411,TR,TR
6507,1698997500,1699018020,20520,22560,71599,SI,RS
175147,1699450680,1699456440,5760,3769,184579,NL,NL
128456,1699780080,1699793340,13260,192341,190104,IT,IT
72806,1698933120,1698944580,11460,104687,152572,CA,US
113229,1700144100,1700178360,34260,156644,180819,TR,TR
195198,1700378280,1700411580,33300,153904,46102,TR,TR
146841,1699042740,1699064820,22080,94747,61897,DE,DE
61313,1699227480,1699257120,29640,162383,167664,TR,TR
75500,1700197140,1700232060,34920,135621,22014,TR,TR
44266,1698876300,1698905700,29400,18453,144366,TR,TR
80181,1699806540,1699838340,31800,152019,106253,TR,TR
157588,1700618100,1700632620,14520,145164,12053,US,US
74615,1699629420,1699640280,10860,166455,140744,HR,HR
41697,1699612020,1699646580,34560,64110,183445,TR,TR
53574,1700275800,1700304720,28920,112937,54148,TR,TR
156106,1699490280,1699505340,15060,118599,82330,FR,FR
178155,1699230780,1699264800,34020,150781,22991,TR,TR
75139,1700122740,1700126340,3600,177511,39448,GB,DE
38744,1699548060,1699577520,29460,187063,187733,TR,TR
59903,1699363980,1699396200,32220,160179,18648,TR,TR
197659,1700559240,1700594220,34980,141705,71845,TR,TR
13363,1699071060,1699075620,4560,114608,146379,GB,GB
42156,1700743620,1700778540,34920,112871,5230,TR,TR
108450,1699270260,1699281360,11100,162979,42779,IT,IT
56386,1699849500,1699884540,35040,98092,20976,MX,MX
150236,1700243280,1700255700,12420,117152,5150,IT,IT
53758,1700146140,1700173620,27480,14159,135647,DE,FR
19936,1699727580,1699737600,10020,84234,77954,IT,IT
103587,1699354800,1699358400,3600,194156,145108,NL,NL
187981,1700458140,1700461740,3600,63008,144996,NL,NL
13587,1700001780,1700005380,3600,16409,194870,GB,GB
185261,1699436940,1699448580,11640,122513,133596,ES,FR
119556,1700483220,1700516100,32880,183499,178185,TR,TR
135727,1699857420,1699872240,14820,43232,4395,US,US
68812,1700206200,1700241300,35100,132017,83669,TR,TR
61066,1700089140,1700097780,8640,42095,153723,EE,EE
118430,1699952520,1699964280,11760,72266,179131,US,US
4787,1699769460,1699801380,31920,133237,13759,TR,TR
64841,1699233960,1699262880,28920,132725,65796,TR,TR
59224,1699465800,1699478700,12900,121348,63265,PT,FR
181317,1699715400,1699719000,3600,94427,76114,GB,GB
173521,1699910700,1699914300,3600,56600,186027,NL,NL
100314,1699139880,1699147680,7800,56739,196220,PT,PT
71294,1698973980,1698978420,4440,16223,165736,GB,GB
140066,1700368560,1700403900,35340,183962,159964,TR,TR
76727,1699210020,1699237500,27480,29088,166686,DE,BG
141999,1698946680,1698963540,16860,16230,108370,US,US
71119,1699303860,1699327140,23280,120139,165489,PL,DE
161379,1700823120,1700857980,34860,86420,95724,TR,TR
7656,1699459740,1699492860,33120,92277,126818,TR,TR
102640,1699960740,1699983840,23100,4503,124724,BR,BR
71817,1699591200,1699605120,13920,27555,122800,IT,IT
115552,1699022580,1699026180,3600,147929,116967,GB,GB
11591,1699849980,1699885920,35940,155876,129659,MX,MX
28669,1699980240,1700006400,26160,111610,190684,HU,BG
119448,1700082240,1700112780,30540,191452,39179,TR,TR
182390,1699720380,1699723980,3600,5511,95454,NL,NL
34276,1700467380,1700500800,33420,110028,184258,TR,TR
37993,1699213500,1699243980,30480,20455,104313,TR,TR
166234,1699524120,1699555020,30900,2761,63332,TR,TR
91204,1699876320,1699911180,34860,70888,178825,TR,TR
74926,1699487640,1699519860,32220,40241,169927,TR,TR
145159,1699654860,1699689480,34620,167551,120247,TR,TR
65576,1699495320,1699504980,9660,4392,54789,FI,PL
149609,1700342580,1700349360,6780,53974,121578,NL,NL
23858,1700686500,1700702160,15660,20975,97774,US,US
90155,1700467800,1700476860,9060,167016,8053,HR,HR
11542,1699149780,1699167720,17940,59227,138444,AT,AT
185998,1699883220,1699898400,15180,76177,4788,US,US
180507,1700225700,1700236500,10800,178007,108362,US,US
162111,1700530620,1700540040,9420,35158,151190,IT,IT
53711,1699747920,1699755060,7140,117476,41475,NL,NL
155436,1700786460,1700796840,10380,192890,16741,HR,HR
157774,1699306980,1699341060,34080,32719,123218,TR,TR
18135,1700587140,1700593560,6420,137611,187006,GB,GB
10853,1699225380,1699243740,18360,116913,145074,FR,FR
46434,1699251240,1699285560,34320,174143,80843,TR,TR
167753,1699296900,1699310700,13800,114344,3211,AT,DE
103267,1699309980,1699347180,37200,175969,116085,MX,MX
133826,1699991580,1699995180,3600,189477,51710,NL,RS
91595,1699388340,1699418520,30180,151947,44826,TR,TR
46101,1700555760,1700585640,29880,188426,175437,TR,TR
64838,1698864840,1698891780,26940,98318,169301,DE,DE
171822,1698991740,1699028340,36600,53531,152643,MX,MX
127726,1699579680,1699594680,15000,110471,46426,US,US
39265,1700790960,1700817420,26460,3880,13713,DE,DE
21352,1700308260,1700314380,6120,55360,78461,GB,GB
166443,1699871820,1699882800,10980,44981,140416,US,US
55837,1700297040,1700327040,30000,595,111214,TR,TR
151896,1700726220,1700730180,3960,25733,23951,NL,NL
175494,1698834420,1698869520,35100,167298,183322,TR,TR
155461,1699353540,1699388940,35400,191368,123749,TR,TR
1158,1700396880,1700401440,4560,118257,24642,GB,GB
154482,1700020980,1700053860,32880,135684,2045,TR,TR
180386,1699312500,1699343280,30780,35508,25036,TR,TR
179037,1699261500,1699293600,32100,166179,25639,TR,TR
111628,1700306640,1700318820,12180,79973,111149,RS,SI
151579,1699581360,1699615680,34320,2756,181471,TR,TR
129312,1699503480,1699521420,17940,147499,51137,FR,DE
62844,1700292240,1700324820,32580,91748,98455,TR,TR
102883,1698836160,1698844620,8460,152692,64747,IT,IT
69318,1699882740,1699906140,23400,120767,110586,DE,BG
45587,1700494800,1700515680,20880,104743,186915,SE,SE
59833,1699198560,1699229820,31260,4787,161062,TR,TR
26590,1699784100,1699819380,35280,106135,8338,TR,TR
23471,1699425540,1699448220,22680,142947,49517,HU,PL
11239,1700282580,1700315100,32520,142991,104222,TR,TR
134766,1698954300,1698989400,35100,75860,6657,TR,TR
186763,1698899160,1698920940,21780,48455,179571,RO,RO
188492,1700157420,1700162160,4740,107138,125537,NL,NL
72275,1700388120,1700423700,35580,149721,132585,MX,MX
159150,1700150400,1700160360,9960,74716,80237,IT,IT
8390,1700023380,1700058900,35520,59458,64116,TR,TR
74394,1699745220,1699781040,35820,86973,61851,MX,MX
37759,1699695780,1699699380,3600,141898,89053,GB,GB
84230,1699781520,1699807560,26040,166875,24309,DE,DE
70755,1700542080,1700575980,33900,74019,60546,TR,TR
113879,1699025460,1699036740,11280,182006,157861,HR,HR
129676,1699631040,1699634640,3600,101537,182463,GB,GB
26767,1699571160,1699606620,35460,84300,8691,TR,TR
175719,1700225700,1700234400,8700,89742,8085,IT,FR
164372,1699781460,1699809420,27960,181384,27688,PL,PL
94731,1699460820,1699492320,31500,18096,97191,TR,TR
154641,1700681160,1700692980,11820,88284,158656,AT,AT
89523,1699949520,1699963200,13680,118795,106813,SK,SK
107452,1700758260,1700766120,7860,117439,22275,PT,PT
64491,1699607400,1699615620,8220,21035,102281,IT,IT
10907,1698852900,1698868560,15660,90039,53815,CZ,DE
84681,1699506000,1699519560,13560,16394,48102,SK,SK
38335,1699677720,1699694640,16920,44120,127942,US,US
75647,1699261920,1699294500,32580,94028,18600,MX,MX
43841,1699399800,1699436820,37020,72343,111366,MX,MX
80856,1700506080,1700532720,26640,149384,113105,ME,RS
120605,1699974180,1700012580,38400,40675,30177,MX,MX
173236,1698972180,1698986100,13920,32024,64931,CZ,CZ
109257,1700753040,1700777760,24720,9171,123100,CH,FR
198300,1700080380,1700116200,35820,75309,136663,TR,TR
189750,1700440620,1700454780,14160,108666,139482,PT,PT
196882,1699104060,1699110720,6660,102325,108947,GB,GB
80693,1700383200,1700415540,32340,179123,127113,TR,TR
164604,1698906840,1698918900,12060,139892,195221,IT,PL
34998,1698852720,1698887640,34920,157775,11519,TR,TR
196608,1698947460,1698974760,27300,80564,98724,PL,AT
190406,1699569600,1699601880,32280,184387,188560,TR,TR
138372,1700847780,1700858820,11040,58794,15324,ES,ES
144273,1699178280,1699184100,5820,59497,147251,NL,NL
26034,1699076100,1699108200,32100,142932,151389,TR,TR
16094,1699708200,1699734660,26460,54169,116914,BA,DE
189358,1699717320,1699749240,31920,125923,119140,TR,TR
126685,1699347900,1699355940,8040,156120,143533,PT,PT
83099,1700740440,1700744040,3600,35219,189547,GB,GB
129598,1700486880,1700492220,5340,133274,6716,GB,GB
77044,1700073420,1700086500,13080,32584,46068,US,US
174636,1699457040,1699487760,30720,181033,186765,TR,TR
112315,1699654080,1699665840,11760,43249,93387,US,US
185742,1699658940,1699685820,26880,127686,67180,PL,DE
140106,1698990120,1698993720,3600,170334,30252,GB,GB
52225,1700159340,1700166300,6960,175373,41369,GB,GB
46489,1700685420,1700698380,12960,67635,179733,IT,IT
198081,1700786280,1700819940,33660,157098,172435,TR,TR
84130,1700843760,1700875080,31320,139973,190854,TR,TR
67718,1698900840,1698918660,17820,86948,95854,CZ,CZ
93824,1699121820,1699131720,9900,169426,105653,HR,HR
124487,1700088180,1700122680,34500,94138,132963,MX,US
86331,1700044260,1700055780,11520,127602,141444,IT,BE
34218,1699802160,1699822260,20100,144071,198816,FR,FR
194978,1699944660,1699977960,33300,75818,124472,TR,TR
80000,1699834080,1699848300,14220,41316,112144,AT,BG
135798,1699719780,1699733880,14100,48454,113966,IT,IT
128410,1698800460,1698832200,31740,76759,48366,TR,TR
117312,1699008660,1699036140,27480,106091,48626,BR,BR
137692,1699546980,1699560300,13320,80470,48388,AT,SK
56228,1700673900,1700707680,33780,141803,112298,TR,TR
128006,1699841940,1699877040,35100,63107,187930,TR,TR
135717,1699454100,1699457700,3600,162226,173492,GB,GB
82772,1700332080,1700350320,18240,88604,133422,MD,RO
113788,1699202700,1699219800,17100,120085,127110,US,US
105115,1700789160,1700822280,33120,40008,186501,TR,TR
59611,1700081940,1700095080,13140,156267,46342,CZ,CZ
53608,1700263020,1700301120,38100,90164,176705,MX,MX
86278,1699334700,1699352220,17520,103917,138128,SE,SE
114795,1700253360,1700274660,21300,153758,110118,FR,FR
100905,1699284060,1699317240,33180,41375,94925,TR,TR
126968,1699059840,1699095240,35400,71474,26311,TR,TR
33949,1699917600,1699931580,13980,130655,173338,PT,PT
101324,1699996260,1700013000,16740,149848,97992,US,US
198889,1700793480,1700810280,16800,88492,139686,US,US
197505,1700689740,1700696340,6600,50868,98257,GB,GB
190629,1700163060,1700168340,5280,7327,79065,GB,GB
193334,1700656380,1700695380,39000,10332,4831,MX,MX
18445,1699954080,1699960560,6480,164263,181125,NL,NL
21226,1700277360,1700302140,24780,112035,1514,RO,RO
15935,1699184820,1699197480,12660,69188,86428,HR,HR
44582,1700415240,1700429340,14100,124893,65387,CZ,HR
104409,1699562520,1699575540,13020,146081,115543,PT,PT
95188,1699940400,1699945320,4920,190511,107810,GB,GB
149891,1700218500,1700253840,35340,44746,166903,TR,TR
122733,1699572240,1699604400,32160,173821,136720,TR,TR
109778,1699295820,1699305780,9960,17659,196158,HR,PL
45088,1698973920,1698985260,11340,35289,39155,IT,IT
148768,1699131900,1699165080,33180,144586,81011,TR,TR
69042,1698798780,1698821340,22560,94877,137191,RO,RO
154039,1700622420,1700635260,12840,63996,179895,US,US
102678,1698970980,1698985860,14880,51117,144684,US,MX
174750,1700211780,1700225040,13260,34893,121573,US,US
149645,1699709880,1699739700,29820,163992,95005,TR,TR
161851,1700122560,1700133300,10740,129195,162152,IT,IT
140068,1698799320,1698802920,3600,31537,17191,GB,GB
76370,1699721160,1699756800,35640,48283,63923,TR,TR
128240,1700377200,1700388600,11400,119984,171955,IT,IT
170501,1700696280,1700703480,7200,45127,97422,IT,IT
2238,1699954440,1699980120,25680,145963,160663,DE,DE
92338,1700395560,1700430780,35220,99100,39204,TR,TR
135877,1699821480,1699826940,5460,175748,25178,NL,NL
44581,1698900300,1698911580,11280,81228,76838,IT,IT
34782,1700706480,1700737500,31020,160738,89601,TR,TR
90273,1699722480,1699740900,18420,105367,198949,DK,DK
138175,1700375640,1700379240,3600,156054,123208,GB,GB
143786,1699276020,1699279620,3600,13948,54866,NL,NL
77131,1699528500,1699558260,29760,191490,8779,TR,TR
151825,1700558580,1700562180,3600,115129,160293,NL,NL
139984,1699709760,1699720080,10320,54471,23751,IT,IT
149615,1699407960,1699420080,12120,143054,124623,IT,IT
83699,1700030220,1700062020,31800,101653,32288,TR,TR
174180,1699542840,1699574640,31800,163641,41521,TR,TR
93370,1699839960,1699850880,10920,152507,120695,IT,IT
63261,1700564760,1700568360,3600,108147,101177,GB,GB
59613,1699416720,1699447200,30480,48043,26004,TR,TR
153486,1699024440,1699059240,34800,152999,174122,TR,TR
108501,1700751600,1700786640,35040,36206,164806,MX,US
170981,1699645560,1699669320,23760,125793,175373,ME,BA
64403,1698829380,1698853620,24240,197257,106400,BR,BR
48040,1699370760,1699402500,31740,14762,175514,TR,TR
192644,1700346420,1700357940,11520,4792,192428,US,US
154658,1699363200,1699384860,21660,119277,159065,DE,DE
54103,1700605140,1700640480,35340,28017,61786,TR,TR
41311,1699492560,1699496220,3660,67957,59182,NL,NL
29414,1700672460,1700682840,10380,46055,167781,PT,PT
95158,1700648460,1700667840,19380,33746,132298,FR,PT
128216,1700221500,1700237700,16200,146361,87055,US,US
107619,1699909020,1699920780,11760,119197,30806,IT,IT
118601,1699539900,1699556460,16560,104583,110782,US,MX
102404,1699254360,1699258320,3960,84449,144893,NL,BE
130553,1699457760,1699469400,11640,76477,182028,US,US
120363,1699133700,1699151280,17580,163237,155185,US,US
41542,1699586700,1699595700,9000,69867,15582,IT,IT
180180,1700696340,1700727480,31140,2475,127526,TR,TR
89265,1699952640,1699966680,14040,157660,4828,US,US
65365,1700354640,1700411880,57240,93022,88148,BG,BG
185593,1699083780,1699093980,10200,99788,166639,HR,HR
42858,1699662900,1699692780,29880,141951,41795,TR,TR
127812,1700255820,1700267880,12060,138781,61803,US,US
77812,1699996620,1700011320,14700,85929,138384,US,US
5749,1698866280,1698899280,33000,118096,168757,TR,TR
21287,1700646360,1700649960,3600,105729,40640,GB,GB
139621,1699524480,1699533900,9420,172612,9902,EE,EE
188025,1699845180,1699875600,30420,27674,60003,TR,TR
31240,1700678040,1700713500,35460,95613,60738,TR,TR
112554,1700795880,1700804640,8760,171859,170445,HR,RS
4946,1699087800,1699117740,29940,150911,172198,TR,TR
173083,1699613760,1699637280,23520,20067,56532,CH,FR
55714,1699970280,1700006220,35940,130176,26251,TR,TR
66208,1700361720,1700396220,34500,32660,27678,TR,TR
40649,1700444760,1700478720,33960,47364,38050,TR,TR
83332,1699117620,1699128060,10440,84226,169729,IT,IT
76424,1700059920,1700092920,33000,148588,102843,TR,TR
162343,1699196460,1699213200,16740,178135,143642,US,US
75600,1700759520,1700789760,30240,110997,70646,TR,TR
173139,1699669860,1699703280,33420,119522,162454,TR,TR
60538,1700781480,1700785860,4380,177172,80709,NL,NL
57976,1699670340,1699682940,12600,130589,98666,US,US
123031,1700022420,1700030340,7920,28996,89563,HR,HR
183056,1699719000,1699733520,14520,117374,92629,FR,PL
87114,1699973400,1700003940,30540,36919,94798,TR,TR
40596,1700403960,1700411940,7980,54082,183159,HR,FR
1685,1700246340,1700274180,27840,182564,9325,BA,HR
147598,1699921380,1699934280,12900,141162,113442,CZ,AT
123421,1699465380,1699476900,11520,13564,170674,HR,HR
196591,1699119780,1699153920,34140,48852,10674,TR,TR
106887,1699581000,1699592880,11880,5217,58250,IT,CH
23789,1699991160,1700022480,31320,1721,96696,TR,TR
120161,1700079960,1700115420,35460,74426,147815,TR,TR
81785,1699103520,1699137180,33660,147605,157824,TR,TR
7217,1698815940,1698844860,28920,21754,127767,MK,GR
81135,1700477160,1700508060,30900,155060,111420,TR,TR
2177,1698829080,1698861780,32700,156033,55455,TR,TR
155760,1699612140,1699615740,3600,16937,115121,GB,GB
133433,1699111020,1699141320,30300,181686,188519,TR,TR
38923,1700088720,1700092320,3600,32640,27370,GB,GB
69807,1698979920,1698984120,4200,62085,5483,GB,GB
139398,1699156320,1699170420,14100,7554,102200,PT,PT
106671,1699956600,1699986540,29940,192333,55597,TR,TR
185534,1700670900,1700682060,11160,160579,50807,US,US
91886,1699236660,1699240260,3600,61350,191114,GB,GB
25556,1699890120,1699893720,3600,34514,154026,GB,GB
158445,1699752060,1699759680,7620,51640,195759,ES,ES
74388,1699766160,1699799580,33420,136074,20629,MX,MX
76316,1700269920,1700282940,13020,114590,43804,US,US
134730,1700295360,1700313180,17820,15924,59814,US,US
12611,1698884580,1698914400,29820,38102,49533,TR,TR
122915,1699603560,1699625400,21840,4732,126039,DE,DE
186141,1700653440,1700670300,16860,71984,179125,US,US
179626,1699876440,1699885200,8760,3252,179216,ES,ES
181641,1699782540,1699815900,33360,161057,46976,TR,TR
196185,1700453760,1700477520,23760,31517,7341,PL,DE
177219,1699961160,1699988640,27480,174073,135535,DE,PL
37456,1700625000,1700628600,3600,97584,141169,GB,GB
166107,1700235900,1700265420,29520,12382,139986,TR,TR
33082,1699125600,1699158480,32880,16556,82149,TR,TR
131837,1698796080,1698805980,9900,199310,49126,SK,AT
2617,1699862880,1699875480,12600,151796,95773,PT,PT
76005,1700718840,1700727720,8880,119457,39683,IT,IT
156959,1699151940,1699169760,17820,29944,64705,CZ,HU
195195,1699072740,1699076340,3600,85645,189107,NL,ES
63796,1698983640,1699013520,29880,134967,151200,TR,TR
64515,1699580640,1699593240,12600,107625,4215,US,US
87437,1700757780,1700787240,29460,156487,14777,TR,TR
95155,1699222320,1699235640,13320,119350,157586,PT,PT
159508,1699066200,1699098780,32580,138400,90550,TR,TR
155851,1699182540,1699194060,11520,115045,63169,ES,ES
71659,1698856500,1698891660,35160,31895,108023,TR,TR
47845,1698995100,1699026360,31260,36739,113188,TR,TR
3977,1699420560,1699424160,3600,10946,157497,GB,GB
75128,1698904920,1698908520,3600,166029,6190,GB,GB
140053,1700214180,1700245860,31680,23060,79126,TR,TR
33668,1700762700,1700786160,23460,115872,117403,DE,DE
118052,1700387700,1700422980,35280,115536,51078,MX,MX
123679,1700581500,1700606880,25380,174617,126068,DE,NL
81108,1699385220,1699388820,3600,122533,133528,GB,GB
130413,1699590420,1699597500,7080,136021,108730,GB,GB
95850,1700798280,1700805240,6960,90033,155485,CL,CL
73508,1699090380,1699122120,31740,176778,57568,TR,TR
42392,1698831660,1698864600,32940,68667,145617,TR,TR
29377,1699254480,1699258740,4260,31278,185390,GB,GB
145961,1700123640,1700147760,24120,126959,115404,RO,RO
181957,1700424300,1700454720,30420,8809,28435,TR,TR
111454,1700690460,1700703900,13440,21486,4868,IT,IT
36134,1700517540,1700534160,16620,76162,111550,US,US
34956,1700157240,1700170680,13440,63833,53732,US,MX
46659,1700284560,1700316720,32160,35242,69477,BA,AT
20178,1700499780,1700528760,28980,191144,3576,TR,TR
129698,1700631060,1700650320,19260,77705,179589,FR,FR
133691,1699742640,1699753860,11220,160809,131651,US,US
156950,1699345440,1699375260,29820,25127,11004,TR,TR
113449,1699035840,1699047420,11580,169573,118606,US,US
198435,1699126200,1699141140,14940,138009,9282,AT,AT
171961,1700216940,1700223660,6720,51151,72317,NL,NL
76523,1700458440,1700469900,11460,182608,31343,CA,CA
53261,1699444080,1699475640,31560,104022,174692,TR,TR
34232,1699712100,1699724700,12600,158297,73030,IT,IT
97717,1699973580,1699988340,14760,84908,153714,SE,SE
84182,1700751960,1700786760,34800,45526,36814,MX,MX
89898,1699150680,1699174680,24000,70344,15214,PL,PL
166547,1700831400,1700856420,25020,17800,186346,DE,SE
143094,1700076900,1700091960,15060,12077,191946,US,US
186003,1700619360,1700650440,31080,19045,136069,TR,TR
167791,1699256160,1699259760,3600,142574,36504,GB,GB
146188,1699391340,1699394940,3600,180078,151069,GB,GB
31564,1700037420,1700054760,17340,20849,65581,CZ,CZ
23785,1699109400,1699135320,25920,14208,77497,DE,CZ
189424,1699989660,1700000280,10620,146188,9365,AD,ES
99278,1700750340,1700762700,12360,29113,19249,US,US
114296,1700189580,1700201520,11940,197937,137848,US,US
35859,1699546380,1699601640,55260,69555,75338,UA,CZ
126087,1698978600,1698989640,11040,4260,1304,IT,IT
13344,1700748660,1700752260,3600,91398,111631,GB,GB
189352,1700330460,1700342880,12420,123019,168703,US,US
150501,1699749480,1699763820,14340,49497,89684,IT,IT
92644,1699898400,1699932660,34260,185570,167151,TR,TR
53368,1700719380,1700748900,29520,143008,28293,TR,TR
57711,1699722360,1699750140,27780,100198,196904,PL,PL
10344,1699492980,1699498920,5940,57598,100766,GB,GB
21294,1699415760,1699442580,26820,53430,4845,BR,BR
35885,1700527800,1700562900,35100,69959,4459,TR,TR
150965,1700359080,1700362680,3600,68941,146780,GB,GB
131250,1700468580,1700477280,8700,1801,72987,HR,HR
120694,1699604340,1699607940,3600,187648,14357,GB,GB
57280,1699482180,1699510380,28200,176635,123412,PL,CZ
195531,1700782800,1700817060,34260,27919,161140,MX,MX
4999,1700004180,1700022720,18540,20693,101998,SE,SE
67830,1699173300,1699177260,3960,26423,163219,GB,GB
115496,1699879440,1699898700,19260,26849,4496,SE,NO
62927,1700430180,1700444280,14100,45902,146562,HR,DE
105861,1699172220,1699207440,35220,42414,91741,TR,TR
120090,1700752440,1700787180,34740,21111,56263,TR,TR
186790,1699563300,1699567800,4500,177394,34731,NL,BE
119724,1699144980,1699149840,4860,165653,9065,GB,GB
122647,1699607340,1699641000,33660,109634,124451,TR,TR
182341,1699397220,1699427700,30480,151043,142072,TR,TR
187489,1698984900,1698991380,6480,104529,15934,NL,NL
110378,1699825920,1699847580,21660,119968,108204,PL,PL
171878,1700030220,1700035800,5580,92796,120894,GB,GB
75493,1698984900,1699006200,21300,150407,45826,FR,DE
76039,1699782420,1699802160,19740,76780,75662,FR,FR
196327,1699286880,1699297680,10800,136817,107795,US,US
172,1699444740,1699477860,33120,195247,34027,TR,TR
81280,1700722080,1700757600,35520,126699,4469,TR,TR
188017,1699036560,1699050300,13740,186735,198184,US,US
113889,1699359300,1699370340,11040,68515,29346,US,US
89667,1699005420,1699019100,13680,118317,156297,CA,US
163651,1698910200,1698939780,29580,147637,132785,TR,TR
185149,1699792380,1699801380,9000,78704,106238,IT,DE
188204,1700739780,1700754660,14880,179085,112399,US,US
14242,1700762340,1700769480,7140,97345,152147,EE,FI
32767,1700328120,1700360640,32520,65950,128732,TR,TR
196726,1699227120,1699231680,4560,185339,53886,NL,NL
87688,1699510860,1699540080,29220,77956,137134,TR,TR
33641,1700381160,1700414760,33600,40015,139847,TR,TR
148669,1699266060,1699291140,25080,73881,135906,PL,PL
141216,1699221720,1699234200,12480,89997,19528,IT,IT
39731,1700375340,1700402580,27240,114760,110084,HU,AT
174165,1700219040,1700250540,31500,112413,157472,TR,TR
152549,1699085280,1699088880,3600,16677,22713,GB,GB
1446,1699232340,1699240320,7980,26783,17492,PT,PT
148980,1700160660,1700195580,34920,114684,72802,TR,TR
107763,1700705520,1700709120,3600,97026,9662,GB,GB
190068,1699420020,1699424400,4380,114624,181831,GB,GB
188389,1699620420,1699650540,30120,110899,7734,TR,TR
43849,1699252500,1699264080,11580,169809,168739,US,US
16170,1700233320,1700245320,12000,195948,160144,IT,IT
47931,1699123200,1699133580,10380,38844,82701,HR,HR
1271,1699294500,1699306320,11820,20388,133046,IT,IT
152521,1698850140,1698880860,30720,182332,114079,TR,TR
148710,1699242000,1699245600,3600,187571,56520,GB,GB
71446,1699481040,1699497120,16080,72949,67108,RS,RS
89486,1699953780,1699977660,23880,19661,42583,DK,SE
24162,1699381260,1699400580,19320,97669,56289,FR,FR
47371,1699047240,1699081140,33900,17357,56681,TR,TR
87020,1699232160,1699250040,17880,188390,69904,AT,AT
47693,1699871520,1699895820,24300,114098,131768,AL,MK
10395,1700380800,1700394240,13440,59800,136896,US,US
189238,1699698660,1699714440,15780,22279,40039,FR,BE
122101,1699438980,1699472100,33120,191042,151911,TR,TR
143452,1699502880,1699534500,31620,46047,123284,TR,TR
110359,1699071600,1699105020,33420,64951,142679,TR,TR
82410,1700340900,1700357940,17040,8673,38277,US,US
11697,1700153040,1700208540,55500,17751,29034,UA,DE
96428,1699524780,1699534260,9480,96936,185248,IT,IT
193888,1700856840,1700885760,28920,65485,45730,TR,TR
28165,1700473560,1700505000,31440,58276,110268,TR,TR
148685,1699463760,1699484280,20520,32593,8604,DK,DK
296,1699094100,1699127700,33600,183995,129925,TR,TR
98008,1699062300,1699096440,34140,12800,181737,TR,TR
79246,1700361300,1700381100,19800,86568,27054,FR,HR
152560,1700685780,1700719080,33300,78756,62895,TR,TR
117970,1699357440,1699361040,3600,54834,194063,NL,NL
126604,1700762340,1700766900,4560,57220,160702,GB,GB
46469,1699605780,1699635180,29400,148940,35857,TR,TR
153181,1700095620,1700133720,38100,137228,16665,MX,MX
157523,1699177020,1699193820,16800,4852,145908,US,US
175688,1699502760,1699537380,34620,128750,51515,TR,TR
105271,1698893940,1698923100,29160,34524,97256,TR,TR
145165,1699052040,1699105620,53580,109187,53869,BG,DE
178256,1700283360,1700299200,15840,62654,154400,US,US
95927,1700018820,1700030040,11220,153681,24875,PT,PT
181373,1699285980,1699319880,33900,1235,162874,TR,TR
46582,1700544660,1700554320,9660,40602,25862,EE,FI
553,1700065620,1700078400,12780,134551,28070,IT,IT
143536,1699113000,1699130400,17400,195438,67350,US,US
174267,1699709220,1699732380,23160,112732,9427,CH,DE
27102,1699067640,1699098420,30780,97881,18711,TR,TR
28180,1699488480,1699494120,5640,170601,125257,NL,NL
61788,1700858940,1700875380,16440,152231,4940,US,US
113849,1700671440,1700701140,29700,149403,82812,TR,TR
70112,1699515960,1699524240,8280,184096,144025,IT,IT
158934,1699347240,1699372560,25320,94929,3709,DE,DE
50284,1699929180,1699959180,30000,172756,156200,TR,TR
114432,1699355340,1699373100,17760,43403,142524,US,US
171584,1699937280,1699940880,3600,114584,2216,NL,NL
132133,1699435620,1699439220,3600,81769,191087,NL,NL
118960,1700340120,1700375700,35580,43649,14682,TR,TR
186569,1700060520,1700097900,37380,162230,135621,MX,MX
23255,1699971480,1700006040,34560,127535,22848,TR,TR
167374,1699333020,1699363020,30000,189927,136318,TR,TR
100115,1699376520,1699405860,29340,11418,112437,TR,TR
4010,1699289280,1699319220,29940,167386,36422,TR,TR
160652,1700098620,1700133120,34500,118396,155622,TR,TR
68781,1700449500,1700484780,35280,196296,182121,TR,TR
117358,1699155600,1699191780,36180,47783,135882,MX,MX
98201,1699840740,1699875000,34260,184412,129043,TR,TR
138624,1698983340,1699007520,24180,181287,129937,DE,DE
2351,1699444260,1699459140,14880,149662,70714,US,US
185276,1699102500,1699132320,29820,84293,39710,TR,TR
148917,1699427160,1699462980,35820,31332,44147,TR,TR
37870,1700095680,1700110860,15180,23177,11492,US,US
51607,1699732980,1699747860,14880,172593,153941,AT,PL
115556,1699519440,1699531080,11640,147032,82556,US,US
145764,1700765100,1700769000,3900,34643,97618,NL,NL
50976,1699669800,1699688760,18960,32086,143880,FR,FR
109227,1699835040,1699855020,19980,109348,193086,FR,FR
40535,1700473020,1700486580,13560,96043,83366,US,US
138187,1699449960,1699462560,12600,62183,88126,ES,ES
142945,1700207880,1700214720,6840,113702,61471,GB,GB
7926,1699773840,1699803600,29760,59213,60049,TR,TR
64062,1699149300,1699184880,35580,37938,167575,TR,TR
122783,1700745900,1700775480,29580,123199,131808,TR,TR
161518,1700523120,1700530200,7080,107562,108391,GB,GB
138720,1698927840,1698960540,32700,105735,98504,TR,TR
59890,1698973620,1699009140,35520,39136,76389,TR,TR
117638,1700568120,1700576760,8640,157558,185022,PT,PT
118727,1699497720,1699527120,29400,34765,88054,TR,TR
142409,1699473780,1699510680,36900,63944,147414,MX,MX
82866,1699172700,1699206660,33960,49790,140824,MX,MX
167705,1700145900,1700161500,15600,163795,97701,FR,BE
166590,1700070840,1700075160,4320,121404,52107,EE,FI
184750,1699565580,1699578840,13260,112311,32880,US,US
61338,1700658120,1700666220,8100,69463,151019,PT,PT
164520,1699046580,1699052100,5520,99169,178724,NL,DE
54879,1698913380,1698926520,13140,129794,36506,US,US
157477,1700732820,1700748900,16080,45777,111335,US,US
161652,1699760880,1699795080,34200,52828,61291,TR,TR
169859,1700752620,1700762400,9780,107425,76302,PT,PT
7075,1699788060,1699799460,11400,76118,5536,US,US
179412,1699549680,1699579380,29700,119429,150145,TR,TR
178754,1699905420,1699909020,3600,3848,43146,NL,NL
112953,1700639400,1700670240,30840,196197,8055,TR,TR
124178,1700444940,1700475480,30540,154958,103286,TR,TR
162922,1700471880,1700475480,3600,20847,125199,GB,GB
98438,1699310340,1699327260,16920,89943,93027,FR,RS
158639,1699616520,1699623480,6960,96602,37585,NL,NL
8016,1700337600,1700352480,14880,166640,57582,CZ,RS
161676,1700598120,1700601720,3600,175351,185246,NL,FR
141966,1700700660,1700730960,30300,23791,123641,TR,TR
24272,1700704800,1700721120,16320,107044,164417,US,US
110291,1699833060,1699867380,34320,170768,94782,TR,TR
46131,1700320740,1700350080,29340,159606,146243,TR,TR
115202,1699233840,1699268820,34980,100354,167637,TR,TR
21750,1698821100,1698857040,35940,9466,86875,TR,TR
87459,1699205580,1699221600,16020,59499,175627,US,US
150019,1699614240,1699649400,35160,160284,2888,TR,TR
192635,1699990200,1700023380,33180,108071,28308,TR,TR
26220,1700771340,1700802180,30840,146028,63799,TR,TR
63436,1700139000,1700153940,14940,85028,199249,FR,IT
37898,1698980700,1698984300,3600,115267,160333,GB,GB
108351,1699510440,1699525440,15000,186971,21225,US,US
40426,1700358000,1700379420,21420,157037,9725,FR,FR
185963,1700187000,1700220960,33960,190273,89743,TR,TR
93630,1699581360,1699593660,12300,122418,193883,US,US
132647,1699531920,1699548060,16140,110984,92095,US,US
86831,1698887580,1698912000,24420,107751,22011,PL,FI
140809,1700022540,1700026140,3600,9656,145195,GB,GB
186307,1699039320,1699046520,7200,191986,102827,IT,IT
34298,1700566920,1700595840,28920,171320,22153,TR,TR
170412,1699101600,1699134540,32940,16947,127303,TR,TR
4150,1700726160,1700736960,10800,189786,121238,IT,IT
174085,1699527600,1699536060,8460,78430,91407,IT,IT
26201,1699024860,1699029420,4560,114102,177619,GB,GB
62007,1699663380,1699695300,31920,77463,6057,TR,TR
78324,1699908360,1699938360,30000,162789,176206,TR,TR
174690,1699242240,1699264200,21960,21990,130070,PL,PL
41180,1699720920,1699724520,3600,104505,80932,GB,GB
159193,1700371680,1700375280,3600,105065,86305,GB,GB
117927,1699543740,1699573560,29820,49367,91304,TR,TR
23589,1699531080,1699545180,14100,111255,107665,US,US
101236,1699567980,1699596540,28560,67195,131830,DE,HR
6027,1700744760,1700765040,20280,86215,69278,BE,FR
64281,1700443620,1700476920,33300,173339,190765,TR,TR
74484,1699165620,1699194660,29040,167492,78812,TR,TR
194362,1700440020,1700470440,30420,133673,162648,TR,TR
171486,1699430160,1699433760,3600,102299,48736,GB,GB
161403,1699892520,1699909020,16500,37907,139069,CZ,DE
93894,1700288040,1700314740,26700,122970,61087,RO,RO
68549,1700574180,1700577780,3600,41727,45677,GB,GB
100035,1699130340,1699162200,31860,113434,170344,TR,TR
105782,1700800080,1700807220,7140,185358,28837,NL,NL
192145,1699925460,1699930920,5460,138669,187551,GB,GB
120958,1700719620,1700754180,34560,20865,55238,TR,TR
165323,1699829760,1699863120,33360,62710,193010,MX,MX
1275,1699237620,1699270800,33180,131975,174145,TR,TR
55006,1699867140,1699884780,17640,188040,29549,US,US
94151,1698948420,1698978480,30060,156087,75019,TR,TR
186364,1700138700,1700173200,34500,194284,131162,TR,TR
181923,1699537200,1699540800,3600,65062,105070,NL,NL
66585,1700844900,1700860980,16080,47668,87630,US,US
185739,1700070420,1700081100,10680,145106,76225,IT,IT
136024,1699598340,1699632780,34440,58315,2102,TR,TR
108365,1699325100,1699329540,4440,40488,6557,GB,GB
147550,1698900660,1698904260,3600,24463,95404,GB,GB
135403,1699708500,1699721760,13260,37944,32526,US,US
80073,1699541160,1699554540,13380,118930,78651,ES,ES
157117,1699632240,1699647000,14760,180217,2448,US,US
180089,1699225800,1699229400,3600,6547,171814,GB,GB
68003,1698914940,1698932520,17580,102471,167191,US,US
30525,1699030920,1699046940,16020,175131,143007,AT,AT
92128,1699005120,1699038480,33360,132720,3529,TR,TR
2300,1699748040,1699780680,32640,85993,8424,TR,TR
48114,1700336520,1700360940,24420,179870,41600,PL,PL
12312,1700001480,1700005800,4320,146976,44963,NL,NL
436,1700186760,1700244540,57780,16614,111756,UA,DE
149124,1699132380,1699162320,29940,145407,58198,TR,TR
99545,1699114800,1699118400,3600,181824,44693,GB,GB
121665,1700839740,1700868840,29100,5297,27989,TR,TR
121741,1699009920,1699027800,17880,137833,148318,US,US
117479,1700083740,1700139060,55320,150561,116909,BG,BG
147262,1698845640,1698879720,34080,63396,94481,TR,TR
119710,1700413200,1700420940,7740,67164,37766,ES,ES
45186,1699153200,1699186320,33120,78162,178739,TR,TR
2251,1700427360,1700460600,33240,169493,50808,TR,TR
9499,1698944040,1698977040,33000,161920,148419,TR,TR
98385,1699918920,1699927500,8580,91655,134645,IT,IT
84124,1699738140,1699758780,20640,18380,63200,FR,IT
175092,1700644980,1700657040,12060,163924,35042,ES,ES
65173,1699909020,1699918620,9600,103123,42062,IT,IT
34339,1699075440,1699106700,31260,72981,49356,TR,TR
114514,1699998180,1700003220,5040,60333,46415,GB,GB
124886,1700071800,1700103540,31740,118826,119728,TR,TR
25731,1699374000,1699384380,10380,39375,177931,PT,PT
81175,1699371420,1699401180,29760,185775,162653,TR,TR
69507,1699941120,1699946460,5340,162892,36041,NL,GB
166328,1699238640,1699250220,11580,77051,52617,IT,IT
164471,1700308320,1700340840,32520,18989,1008,TR,TR
44885,1699824840,1699838580,13740,95089,178512,US,US
99170,1699800180,1699804080,3900,74219,189502,NL,DE
94215,1699338180,1699353780,15600,177131,120300,FR,FR
141160,1700282940,1700299260,16320,156669,155315,US,US
67476,1699113660,1699120860,7200,46628,179370,ES,ES
896,1699694820,1699698420,3600,16151,118550,NL,BE
118449,1699876020,1699911540,35520,101784,131586,TR,TR
148262,1699681440,1699698840,17400,197094,91386,US,US
54842,1700161620,1700191080,29460,75092,66978,TR,TR
77468,1699713180,1699724940,11760,125067,10780,IT,IT
46998,1699152840,1699157520,4680,62644,96244,GB,GB
129863,1700410680,1700425440,14760,14926,58187,US,US
85212,1699616820,1699650780,33960,92232,158961,TR,TR
163425,1698996480,1699013400,16920,41974,30134,US,US
79524,1698847080,1698882000,34920,167706,22143,TR,TR
48205,1699305480,1699319400,13920,84647,23333,US,US
120465,1700037180,1700043120,5940,165862,105366,NL,NL
193145,1699393860,1699397460,3600,165372,107137,NL,NL
165187,1699792620,1699825980,33360,143564,173361,TR,TR
134752,1700784840,1700788440,3600,130777,181315,GB,GB
190718,1698900600,1698931980,31380,128200,110803,TR,TR
116325,1700636400,1700649420,13020,123943,105591,IT,IT
136288,1699645680,1699670640,24960,178881,171369,PL,DE
43879,1699843560,1699849200,5640,151152,118849,GB,GB
25225,1700128620,1700163660,35040,75910,84733,TR,TR
156757,1700637480,1700641080,3600,48999,191421,GB,GB
4746,1698900000,1698919620,19620,95470,3404,FR,FR
118216,1699090380,1699114380,24000,9449,17555,BR,BR
68243,1700724060,1700727660,3600,152834,28180,NL,NL
112508,1699593660,1699605900,12240,184097,140732,IT,IT
160773,1699730220,1699765680,35460,42009,199740,TR,TR
98850,1699198200,1699214700,16500,119537,156497,FR,FR
137266,1700627160,1700644260,17100,178041,147614,US,CA
195464,1699266780,1699270380,3600,10344,52227,NL,NL
74372,1699044360,1699078080,33720,8661,168658,TR,TR
45168,1699906560,1699919940,13380,55291,94822,RS,RS
90176,1700322600,1700351460,28860,120279,84352,TR,TR
146526,1699830540,1699853880,23340,110650,90920,PL,PL
22375,1700469000,1700500920,31920,119669,4616,TR,TR
158092,1700653740,1700683740,30000,117286,108001,TR,TR
4451,1699318560,1699349100,30540,5327,145325,TR,TR
156561,1699743120,1699759260,16140,143502,147484,FR,HR
182246,1700261520,1700295480,33960,116642,36468,TR,TR
109638,1698937740,1698943260,5520,182634,49176,NL,NL
149519,1700671560,1700684760,13200,190248,150728,IT,IT
119270,1700074380,1700099880,25500,11637,82338,BR,BR
189002,1700024160,1700035380,11220,79663,184540,PT,FR
120841,1698953340,1698956940,3600,17811,51679,GB,GB
178500,1698903180,1698921120,17940,40958,46532,US,US
100168,1698866460,1698882900,16440,188257,150164,US,US
71083,1700494140,1700503860,9720,183051,41706,ES,ES
12795,1700547420,1700576460,29040,66213,38657,TR,TR
161006,1699348500,1699354560,6060,24989,138476,GB,GB
29791,1700772300,1700806680,34380,10480,117457,TR,TR
50899,1700642520,1700654100,11580,56376,196445,IT,IT
120998,1700750640,1700754360,3720,122426,142835,NL,NL
67826,1699693440,1699709880,16440,190882,159915,SE,SE
25435,1699188360,1699191960,3600,149259,28438,NL,NL
131908,1699217040,1699221060,4020,35326,73935,NL,NL
109800,1699333860,1699365780,31920,37399,1197,TR,TR
1454,1700596260,1700610180,13920,147186,15289,AT,AT
32169,1700721360,1700736480,15120,153181,124327,US,US
63415,1700619720,1700654940,35220,74411,147021,TR,TR
143409,1700451120,1700484840,33720,191397,9715,TR,TR
195241,1700763960,1700782860,18900,81805,143793,FR,FR
138719,1699083240,1699115880,32640,16539,98617,TR,TR
2719,1699645080,1699651620,6540,186818,51520,GB,GB
116188,1700788320,1700822640,34320,22785,134823,TR,TR
126626,1700088360,1700122380,34020,151763,82458,TR,TR
59547,1700670180,1700702220,32040,198058,81380,TR,TR
192228,1700361900,1700365500,3600,118351,21415,GB,GB
40812,1700032140,1700043960,11820,179568,111097,HR,HR
185813,1700694120,1700705340,11220,181892,90769,HR,HR
40565,1699291680,1699295280,3600,85726,197437,GB,GB
62012,1700192460,1700207280,14820,82504,17833,FR,FR
110228,1700580900,1700589060,8160,35530,187709,IT,IT
101023,1699918620,1699947660,29040,87740,173291,TR,TR
132522,1699298400,1699311300,12900,47460,185030,US,US
88571,1699608360,1699638060,29700,79591,45492,TR,TR
58115,1699782780,1699794060,11280,60136,9070,IT,MK
77935,1700401320,1700408700,7380,132710,118282,ES,ES
39839,1699776780,1699787640,10860,191542,133300,CA,US
55688,1699647660,1699682220,34560,192136,48221,TR,TR
27047,1700561700,1700594280,32580,30787,82520,TR,TR
6268,1700693760,1700703660,9900,43938,125305,IT,IT
82616,1700725020,1700741400,16380,37716,28845,RS,RS
38252,1700606700,1700610300,3600,44167,134484,NL,NL
102950,1699808280,1699811880,3600,93816,47433,NL,RS
125460,1700091480,1700101560,10080,135266,192475,IT,IT
35931,1700781600,1700812800,31200,81209,115606,TR,TR
113795,1699429860,1699462860,33000,196355,61918,TR,TR
59782,1699469580,1699493940,24360,13107,146302,DE,NL
180400,1700046780,1700051280,4500,80359,137660,NL,NL
38580,1699881120,1699916820,35700,149638,54720,TR,TR
104514,1699495560,1699504800,9240,48205,102580,IT,IT
142577,1700239560,1700253240,13680,198419,178472,US,US
177622,1700742540,1700747940,5400,68951,67726,NL,NL
135952,1699757760,1699789860,32100,139138,134928,TR,TR
105483,1698802140,1698805740,3600,107889,115082,NL,NL
32350,1699925040,1699959540,34500,80243,122019,TR,TR
35848,1699412400,1699429620,17220,90998,188282,FR,GB
142303,1699893480,1699928700,35220,50598,152237,TR,TR
2787,1699782840,1699812000,29160,59069,116752,TR,TR
176339,1699105080,1699108680,3600,38335,50985,GB,GB
92651,1700165760,1700169600,3840,109417,176782,NL,NL
26843,1700052720,1700064720,12000,26264,151869,IT,IT
27748,1699464960,1699497000,32040,59366,68611,TR,TR
50241,1699038540,1699069500,30960,54550,123735,TR,TR
150071,1699611240,1699621560,10320,151266,125211,IT,IT
136811,1699468020,1699501260,33240,80537,146160,TR,TR
6863,1700203320,1700220240,16920,85138,9415,CZ,DE
26739,1699994340,1700029560,35220,91691,148667,TR,TR
157824,1699451220,1699464300,13080,47406,196703,IT,IT
74069,1700775900,1700801580,25680,37680,137355,CH,FR
171471,1700779320,1700808780,29460,91009,56748,TR,TR
50829,1699566900,1699598280,31380,153450,43602,TR,TR
5282,1699225260,1699260780,35520,189906,113691,TR,TR
147828,1700342040,1700347620,5580,80919,72410,NL,NL
136533,1699077540,1699081140,3600,85393,37696,NL,NL
139775,1700859720,1700889240,29520,199107,173527,TR,TR
185092,1700390760,1700407380,16620,149129,113486,US,US
45499,1700850720,1700886240,35520,1603,21740,TR,TR
47770,1699672380,1699676460,4080,6025,140642,GB,GB
85254,1699644300,1699677000,32700,150401,39354,TR,TR
70735,1699328760,1699361220,32460,949,190872,TR,TR
94701,1699058280,1699061880,3600,41298,109162,GB,GB
125938,1699662960,1699674960,12000,71303,64259,HR,HR
182008,1699079520,1699083120,3600,52890,195248,GB,GB
126479,1700277660,1700308560,30900,113105,120019,TR,TR
110780,1700199060,1700215380,16320,167008,4095,US,US
62158,1699672320,1699689960,17640,181983,128085,CZ,DE
82372,1699352700,1699382520,29820,81650,35592,TR,TR
112615,1700765760,1700770380,4620,96341,159694,GB,GB
50114,1699137960,1699153200,15240,178260,83348,FR,FR
44667,1700850840,1700886480,35640,95657,26805,TR,TR
21662,1700215020,1700223480,8460,164283,132308,IT,IT
165811,1699664040,1699693380,29340,68005,37362,TR,TR
66095,1700050920,1700084880,33960,30893,69168,TR,TR
55756,1699041900,1699058880,16980,3902,182033,US,US
111832,1699006860,1699040280,33420,62200,89385,TR,TR
153931,1699552380,1699589220,36840,809,108775,MX,MX
174524,1700392500,1700427720,35220,76909,109435,TR,TR
24748,1699295160,1699327800,32640,97348,171472,TR,TR
13650,1699932600,1699966320,33720,113928,61143,MX,MX
99339,1699246560,1699255440,8880,168244,59408,IT,IT
28037,1698955920,1698990120,34200,147397,5846,TR,TR
39712,1700186880,1700221680,34800,167981,137350,TR,TR
105936,1699696740,1699757340,60600,122889,14011,UA,PL
167257,1700016180,1700049840,33660,42388,12392,TR,TR
100292,1699816020,1699826400,10380,30810,93453,IT,IT
49856,1700710440,1700743620,33180,26286,186617,TR,TR
60907,1698989760,1699023180,33420,150803,82534,TR,TR
162603,1699841700,1699847100,5400,149903,49966,NL,NL
100507,1700232720,1700243220,10500,137057,102914,AD,ES
147488,1699417260,1699451160,33900,115334,71680,TR,TR
169349,1699767840,1699771440,3600,72942,42839,GB,GB
79001,1698981240,1699013760,32520,189767,6675,TR,TR
136604,1700409900,1700438940,29040,156526,43606,TR,TR
113613,1700513400,1700544000,30600,112990,67392,TR,TR
76178,1699123920,1699157760,33840,151877,2617,TR,TR
170268,1698966360,1698980220,13860,75542,45322,CZ,CZ
133771,1699286160,1699319400,33240,72329,153643,TR,BG
167735,1700560260,1700595180,34920,78516,94236,TR,TR
154825,1700323440,1700353380,29940,50707,130743,TR,TR
11000,1698955080,1698958680,3600,65729,94880,NL,NL
190059,1700554800,1700583960,29160,39947,167984,TR,TR
44748,1700238840,1700260920,22080,176919,180833,PL,UA
154158,1700042340,1700071680,29340,51588,153794,TR,TR
19089,1699179300,1699192080,12780,88314,151631,AT,BG
179623,1700580960,1700587800,6840,88703,152350,GB,GB
116945,1699171500,1699175100,3600,27017,170121,GB,GB
30406,1700208420,1700212020,3600,138196,135184,NL,BE
191618,1700569260,1700573340,4080,150012,113790,NL,NL
137648,1700840220,1700843820,3600,56844,168089,GB,GB
78327,1699508160,1699522560,14400,36662,119972,AT,AT
162665,1700715480,1700736360,20880,172492,174173,FR,FR
120582,1699734540,1699756980,22440,30654,17172,RO,RO
138245,1699858380,1699861980,3600,153336,35416,NL,NL
158900,1698873300,1698903600,30300,134693,83943,TR,TR
101461,1700047560,1700052420,4860,169830,181021,NL,NL
75524,1700267040,1700281620,14580,62842,36185,US,US
115712,1700101920,1700105520,3600,36669,121115,GB,GB
168131,1700007540,1700020020,12480,150726,6242,US,US
112703,1699757220,1699786680,29460,183790,140783,TR,TR
184604,1699974900,1699985700,10800,1216,6930,AT,HR
80499,1700646120,1700659020,12900,190844,23228,HR,HR
19181,1699166280,1699174020,7740,109270,137743,IT,IT
168891,1699658400,1699688580,30180,87578,183123,TR,TR
199187,1699765680,1699770540,4860,99547,156589,NL,BE
105110,1699363560,1699392900,29340,179511,98983,TR,TR
84195,1699640340,1699665000,24660,166461,1810,RO,RO
81499,1699574280,1699585320,11040,52284,66685,IT,IT
28774,1699051320,1699112040,60720,176988,198613,UA,PL
158897,1699502340,1699532040,29700,158192,23986,TR,TR
166150,1700432340,1700466540,34200,125553,108460,TR,TR
102251,1699421580,1699450980,29400,115297,167306,TR,TR
198423,1699390320,1699393920,3600,84307,7897,GB,GB
75426,1699215960,1699245720,29760,163419,89538,TR,TR
183309,1699834140,1699846800,12660,105317,166123,US,US
185159,1700037180,1700060100,22920,115565,158610,DE,DE
154570,1699208700,1699237140,28440,50366,38632,BA,HR
127509,1699256580,1699266600,10020,192706,79464,HR,HR
145319,1699969800,1699974960,5160,172320,8437,GB,GB
69006,1700482620,1700515380,32760,34346,78339,TR,TR
123385,1699070460,1699082340,11880,101853,54817,HR,HR
30262,1699037700,1699051980,14280,123521,37337,PT,PT
118478,1698977160,1698990960,13800,115628,62652,US,US
13432,1700176440,1700211000,34560,55648,171740,TR,TR
192011,1699330680,1699345620,14940,107353,79951,US,US
115276,1700341380,1700351700,10320,168650,177612,ES,ES
14150,1700503020,1700540640,37620,65183,7030,MX,MX
15125,1700333520,1700363100,29580,112807,19797,TR,TR
86811,1699468680,1699481100,12420,89920,79683,AT,AT
125656,1700398020,1700413620,15600,36983,126145,US,US
30389,1699653480,1699669800,16320,80282,104176,US,MX
128025,1698930840,1698948780,17940,136825,3795,AT,DE
43028,1699607820,1699641360,33540,13127,185850,TR,TR
137210,1699388760,1699421400,32640,49249,14621,TR,TR
25206,1700186760,1700197320,10560,142938,98838,ES,ES
157084,1699825860,1699860600,34740,14906,77755,TR,TR
163329,1699945080,1699949640,4560,139104,48093,GB,GB
87823,1699548120,1699586220,38100,97279,112949,MX,MX
78699,1699267620,1699300740,33120,21824,69475,TR,TR
53046,1699283220,1699315500,32280,45729,68285,TR,TR
34793,1700449080,1700455320,6240,160641,23194,GB,GB
75450,1698854160,1698859440,5280,176588,155486,NL,NL
173604,1700819400,1700853240,33840,175095,141574,TR,TR
6833,1700593860,1700603280,9420,195600,21399,PT,PT
76737,1698805500,1698840000,34500,44786,65527,TR,TR
88129,1700238840,1700271120,32280,76503,192518,TR,TR
147887,1700180820,1700192460,11640,157841,150003,AT,AT
181918,1699117680,1699150380,32700,9415,186553,TR,TR
15136,1700449020,1700462820,13800,58457,179353,IT,IT
12865,1699370700,1699398120,27420,39535,17282,DE,DE
172634,1699630500,1699663920,33420,49209,194763,TR,TR
32986,1699992480,1700004240,11760,190267,174608,US,US
138623,1699301280,1699330440,29160,140714,44171,TR,TR
154707,1698906180,1698941280,35100,143910,180962,TR,TR
60780,1699738320,1699751340,13020,124780,170175,IT,IT
49824,1700248380,1700278320,29940,195972,30409,TR,TR
59189,1698915660,1698944520,28860,59159,133231,TR,TR
186377,1700193540,1700224260,30720,170692,96242,TR,TR
50902,1700157960,1700161560,3600,45246,168955,NL,NL
76908,1700390040,1700407920,17880,105127,69686,FR,FR
60887,1698944160,1698978540,34380,78368,102045,TR,TR
12593,1699493460,1699509960,16500,115505,50225,RS,RS
56332,1699792980,1699808460,15480,193007,155819,FR,ES
62461,1698838260,1698871320,33060,144508,114677,TR,TR
137704,1700149800,1700180460,30660,147783,133230,TR,TR
3469,1698993360,1699027620,34260,42785,76471,TR,TR
176917,1700247900,1700253960,6060,106574,149261,GB,GB
35460,1700099760,1700133180,33420,185781,151969,TR,TR
187249,1699170540,1699182540,12000,171470,182449,CZ,CZ
142052,1699170660,1699199400,28740,118029,45947,PL,PL
53984,1699902840,1699932180,29340,77665,376,TR,TR
161374,1700443860,1700477700,33840,25969,32390,TR,TR
56073,1700278980,1700292300,13320,33158,132793,IT,IT
64848,1699093920,1699107300,13380,131645,150288,ES,ES
55542,1700383980,1700401680,17700,157709,127642,US,US
184238,1698885540,1698889140,3600,5892,150243,NL,NL
2207,1700607000,1700613360,6360,7794,168625,GB,GB
174332,1700828940,1700882760,53820,82519,81698,BG,DE
88895,1699528680,1699559100,30420,50283,56248,TR,TR
89345,1700005620,1700022780,17160,80586,199112,FR,FR
195180,1699581600,1699614060,32460,90904,117215,TR,TR
43280,1700866680,1700901000,34320,33625,177979,TR,TR
16612,1700286480,1700317440,30960,85382,139198,TR,TR
17718,1699083600,1699087200,3600,92963,172311,NL,NL
122475,1699045020,1699048620,3600,57166,73555,GB,GB
104449,1699443300,1699475280,31980,110520,18843,TR,TR
150858,1699991040,1700003880,12840,146071,8109,RS,RS
184862,1699547820,1699579200,31380,116863,127187,TR,TR
194917,1699341000,1699353360,12360,166106,151651,US,US
121782,1699388880,1699392480,3600,8517,125243,NL,NL
81740,1699693200,1699724820,31620,57811,105010,TR,TR
30585,1700199540,1700204640,5100,187367,993,GB,GB
60386,1700141160,1700174640,33480,184260,5759,TR,TR
117367,1700086860,1700115720,28860,115183,69442,TR,TR
170307,1700665320,1700676300,10980,65372,106454,US,US
106120,1698941880,1698959220,17340,98971,20831,US,US
10136,1700120880,1700143140,22260,188047,46877,DE,FR
24230,1700656620,1700662020,5400,128684,195884,GB,GB
54420,1700853360,1700865900,12540,34676,148136,AT,AT
35117,1700771040,1700791620,20580,76430,190081,FR,FR
113290,1700303340,1700335980,32640,95977,88819,TR,TR
139723,1699111200,1699141620,30420,55955,138893,TR,TR
146718,1699012800,1699018080,5280,152548,9319,GB,GB
171885,1700691780,1700708220,16440,69020,4739,FR,BE
50910,1699200360,1699205940,5580,137693,140333,GB,GB
24668,1699339620,1699344780,5160,1349,30792,GB,GB
150595,1699618740,1699647060,28320,186561,53444,BA,BA
87797,1699780440,1699814220,33780,113375,147043,TR,TR
193280,1699521360,1699552320,30960,77351,87509,TR,TR
132171,1699128420,1699162260,33840,85418,54356,TR,TR
113112,1700588580,1700622300,33720,28301,2312,TR,TR
79138,1699101000,1699104600,3600,565,140978,NL,NL
95847,1699605840,1699621140,15300,175895,103999,US,US
97280,1699394400,1699405800,11400,148861,14332,US,US
3044,1699908360,1699924200,15840,172234,82900,AT,AT
94105,1698815100,1698830280,15180,47665,80814,US,US
153057,1700192340,1700222160,29820,10916,69687,TR,TR
57134,1699762260,1699776540,14280,142089,1617,AT,AT
130657,1699112040,1699124220,12180,117147,83774,AT,CZ
85306,1700141940,1700173860,31920,152971,865,TR,TR
161677,1699930140,1699939740,9600,126135,21260,PT,PT
195149,1700212980,1700237760,24780,37138,30493,PL,UA
59084,1699888080,1699919880,31800,21386,96123,TR,TR
179421,1699139580,1699148940,9360,173487,177306,EE,EE
21714,1699309080,1699341120,32040,159398,2616,TR,TR
21342,1699135260,1699158720,23460,6481,133804,HU,DE
187272,1699705560,1699736700,31140,105768,65120,TR,TR
5726,1699984620,1700004420,19800,89710,59483,DK,CZ
52654,1700492280,1700507160,14880,127935,22971,US,US
198273,1699114920,1699146600,31680,39477,58225,TR,TR
6848,1698974760,1698978960,4200,136595,187362,NL,NL
186131,1700807820,1700811420,3600,183009,181612,GB,GB
73392,1698928320,1698947220,18900,162765,125307,FR,FR
21752,1699700460,1699726140,25680,13682,130999,PL,PL
99528,1699739220,1699768200,28980,184572,72956,TR,TR
57600,1699751580,1699760820,9240,78424,83902,IT,IT
171729,1699063860,1699099080,35220,59791,175800,TR,TR
80744,1699773180,1699789380,16200,119067,147139,US,US
134933,1700662740,1700677500,14760,130417,46124,RS,RS
174189,1700415420,1700436540,21120,40586,32709,BE,FR
31533,1698968160,1698981060,12900,84696,58051,CA,US
25407,1699984320,1699987920,3600,186479,185612,GB,GB
136642,1698871320,1698879900,8580,66706,192149,IT,IT
76713,1698901980,1698932640,30660,135463,185173,TR,TR
30203,1700767920,1700803140,35220,30629,146699,TR,TR
55933,1699368780,1699381800,13020,112790,172278,IT,IT
181433,1700597460,1700632740,35280,54068,151167,TR,TR
113904,1699839240,1699842840,3600,85788,75745,NL,NL
159980,1700090400,1700097120,6720,97040,181398,GB,GB
12949,1699798380,1699810440,12060,5299,30551,US,US
159079,1699390800,1699423380,32580,168634,184450,TR,TR
174832,1699450380,1699460340,9960,130181,176124,IT,HR
38960,1700013000,1700043300,30300,125451,89068,TR,TR
179439,1699703280,1699714920,11640,1818,87264,PT,PT
176410,1700584680,1700620200,35520,80636,152924,TR,TR
167651,1700298660,1700334420,35760,40122,14202,TR,TR
77494,1700482200,1700511840,29640,82262,155822,TR,TR
89011,1699543440,1699577280,33840,181649,49628,TR,TR
44647,1699709100,1699713600,4500,11604,3278,GB,GB
91885,1699384320,1699394340,10020,184894,133222,IT,IT
12188,1700674320,1700709960,35640,86590,35265,MX,MX
28083,1699630320,1699664160,33840,104295,136682,TR,TR
14324,1700176320,1700206380,30060,66964,36421,TR,TR
59708,1699658220,1699689900,31680,74188,59885,TR,TR
77019,1699770240,1699773840,3600,182268,84284,GB,GB
113851,1699836360,1699866600,30240,99147,37916,TR,TR
119988,1699104120,1699109580,5460,33589,9136,GB,GB
148092,1699066740,1699091640,24900,28674,43311,DE,DE
24785,1700316060,1700329620,13560,124300,69288,US,US
118384,1698863940,1698867540,3600,165323,81434,GB,GB
137408,1699960260,1699963860,3600,107574,177720,GB,GB
113918,1698843960,1698850080,6120,21400,196982,NL,NL
58698,1699515180,1699549740,34560,136615,57533,TR,TR
69043,1699303200,1699315140,11940,195625,31314,IT,IT
34559,1700508480,1700531580,23100,49181,16946,DE,HR
135936,1700064120,1700097840,33720,140239,45472,TR,TR
15500,1699917180,1699945500,28320,187537,58466,DE,DE
100382,1699861800,1699877280,15480,27077,148807,US,US
178145,1699519860,1699554840,34980,52466,36455,TR,TR
150791,1699889700,1699901820,12120,128568,125312,US,US
34244,1699429140,1699458300,29160,29586,178121,TR,TR
96274,1700714520,1700728020,13500,190264,123143,US,US
121113,1699913100,1699920180,7080,51155,112426,GB,GB
118096,1699978260,1699991820,13560,47475,198699,SK,SK
101097,1700633160,1700639580,6420,115026,138644,GB,GB
109189,1699568520,1699596900,28380,16557,41604,HU,CZ
1686,1700805540,1700820180,14640,31159,99019,FR,FR
107850,1699354140,1699357740,3600,111673,159823,GB,GB
69821,1700138580,1700151600,13020,104469,5602,US,US
90710,1698923100,1698958860,35760,195551,182285,TR,TR
130133,1699128660,1699134540,5880,48610,98474,GB,GB
35561,1698944700,1698976920,32220,5022,137684,TR,TR
189252,1700161380,1700170260,8880,70700,127812,IT,IT
187252,1700173920,1700230440,56520,114176,57194,BG,BG
53228,1700148540,1700161560,13020,67318,145739,US,US
165968,1700214120,1700230080,15960,94602,12697,US,US
43331,1699836660,1699852440,15780,117672,33750,AT,SK
129852,1699900080,1699903980,3900,2242,141636,NL,NL
150878,1700676540,1700680140,3600,32081,196034,GB,GB
30562,1700314920,1700349660,34740,7877,191302,TR,TR
150310,1700311440,1700344620,33180,99061,167543,TR,TR
148154,1699703520,1699707780,4260,172405,160822,NL,NL
191689,1699057920,1699071420,13500,9840,181955,US,US
94049,1700060280,1700089560,29280,77817,72362,TR,TR
151080,1699873260,1699903560,30300,119615,163324,TR,TR
72690,1700130120,1700137980,7860,124319,84986,IT,IT
21857,1699961520,1699997040,35520,78396,25362,TR,TR
66902,1700027220,1700040360,13140,131966,48719,US,US
189732,1699489380,1699494060,4680,127905,132507,NL,NL
47071,1699149180,1699171500,22320,93120,109910,RO,MD
71803,1700758080,1700777040,18960,112272,163770,BE,DK
13252,1700627880,1700631480,3600,55985,161533,NL,NL
742,1700280900,1700300700,19800,22186,139609,FR,BE
174405,1699746600,1699762200,15600,115571,55854,US,US
76233,1700460960,1700494680,33720,25636,66135,TR,TR
82407,1700659140,1700692140,33000,22487,63984,MX,MX
103725,1700494920,1700498520,3600,17411,59979,GB,GB
69871,1698983220,1699017240,34020,72484,184775,TR,TR
149815,1698832200,1698848220,16020,96836,90708,CZ,CZ
21366,1700434320,1700464020,29700,158207,13645,TR,TR
7977,1698982620,1699001700,19080,152866,68672,FR,FR
5410,1699627260,1699640940,13680,92889,116748,CZ,CZ
75792,1699800300,1699805640,5340,159834,33449,GB,GB
190534,1700852340,1700863680,11340,97724,54197,US,US
139994,1700836500,1700864460,27960,198030,104846,BR,BR
168705,1699983240,1700017860,34620,159669,40467,TR,TR
136771,1699071900,1699086540,14640,36369,138640,CA,US
135056,1699497300,1699552260,54960,69315,163746,BG,DE
69979,1700168340,1700200320,31980,43601,9504,TR,TR
53189,1699439700,1699452780,13080,120369,43001,HR,HR
26920,1700475300,1700509440,34140,117612,151150,TR,TR
132732,1700458800,1700479920,21120,18634,30340,FR,PL
27190,1699020000,1699057020,37020,199736,159726,MX,MX
108624,1700098440,1700111100,12660,156360,179869,IT,IT
79622,1700206380,1700209980,3600,58050,166536,GB,GB
55564,1700459280,1700489340,30060,108914,34571,TR,TR
121753,1700808120,1700825100,16980,83678,192,US,US
171715,1699446960,1699453260,6300,152599,65035,EE,EE
13313,1700383320,1700388000,4680,118457,133103,NL,NL
162010,1699498620,1699528440,29820,157124,30823,TR,TR
2057,1700803260,1700818620,15360,172167,169915,AT,CZ
85028,1699992960,1700007600,14640,44215,97534,FR,FR
140595,1700016720,1700032380,15660,32493,133776,US,US
172676,1699490640,1699503780,13140,185782,10439,IT,IT
28196,1699809600,1699813200,3600,50869,37266,NL,NL
17845,1699303560,1699317120,13560,122952,81189,IT,IT
191930,1699732200,1699765980,33780,162505,66609,TR,TR
122916,1699360380,1699374840,14460,36703,24466,FR,FR
5351,1700540880,1700553000,12120,103703,13985,PT,PT
105314,1699094760,1699130640,35880,29530,162637,TR,TR
8958,1700423820,1700447640,23820,162538,113559,DE,HU
1453,1700293140,1700323020,29880,123793,43063,TR,TR
58409,1700500500,1700535780,35280,185768,47564,TR,TR
11930,1698916680,1698948960,32280,191082,71872,TR,TR
80408,1699370160,1699383840,13680,55201,86936,RS,RS
88121,1699900320,1699918200,17880,122519,33984,US,US
158976,1700641980,1700654100,12120,84312,80748,IT,IT
115195,1699762500,1699776840,14340,114239,72425,RS,AT
18120,1699839960,1699848360,8400,72371,86892,HR,HR
105518,1700755920,1700785260,29340,29265,39386,TR,TR
24096,1699836840,1699843080,6240,31872,48136,GB,GB
159974,1699734420,1699768080,33660,31577,160254,TR,TR
99531,1699269660,1699273260,3600,53190,87307,GB,GB
16379,1700431860,1700451240,19380,162947,85272,BE,NL
185812,1699771140,1699793040,21900,29223,127002,DE,DE
147553,1700422320,1700452560,30240,34580,127393,TR,TR
46256,1699083840,1699091220,7380,92159,124213,IT,IT
12723,1699268880,1699298220,29340,86570,131188,TR,TR
148783,1699705440,1699739940,34500,162998,138769,TR,TR
108604,1700731020,1700735760,4740,93933,325,NL,NL
183794,1700024040,1700060340,36300,172153,39585,MX,MX
38447,1699158900,1699192740,33840,87702,45244,TR,TR
179180,1699659780,1699684440,24660,147656,113585,BR,BR
180934,1700610060,1700641500,31440,113001,82168,TR,TR
150097,1699075980,1699110840,34860,14269,110728,TR,TR
87148,1700322780,1700348280,25500,28980,68072,RO,RO
80564,1699371060,1699404300,33240,139869,199287,TR,TR
86866,1700578500,1700589840,11340,17505,150291,US,US
31805,1700271840,1700289000,17160,24441,89557,RS,BA
120518,1699299120,1699305180,6060,120794,119810,GB,GB
169624,1699677720,1699709880,32160,147617,90592,TR,TR
24485,1699354560,1699358160,3600,156529,136534,NL,FR
1595,1699009200,1699024080,14880,188077,136977,FR,FR
165784,1699928760,1699932360,3600,89858,116667,NL,NL
184487,1700342940,1700372940,30000,120861,78629,TR,TR
34047,1699173840,1699205940,32100,156109,81423,TR,TR
10974,1700269440,1700305200,35760,105187,117437,TR,TR
187258,1699801260,1699836360,35100,23456,101350,TR,TR
134222,1700092620,1700143260,50640,135565,47583,BG,RO
116065,1699852500,1699856100,3600,147107,97102,GB,GB
124671,1700540940,1700548920,7980,174130,25717,HR,HR
132569,1698983520,1699015920,32400,119871,100706,MX,MX
132258,1700292360,1700315340,22980,190245,33770,DE,PL
161943,1700476440,1700480040,3600,12612,151685,GB,GB
41412,1699355760,1699363500,7740,121215,114336,HR,HR
37421,1700550060,1700583420,33360,25002,72248,TR,TR
108205,1699977600,1699988520,10920,139529,15798,IT,IT
114399,1700117880,1700151720,33840,71372,104838,TR,TR
40818,1699216380,1699223940,7560,77433,96785,IT,IT
148550,1699988160,1699998540,10380,111176,186829,IT,IT
171436,1700317440,1700329740,12300,17239,192658,IT,IT
71180,1700619180,1700650860,31680,104272,156243,TR,TR
77158,1699210200,1699221720,11520,122856,63534,US,US
87108,1699613700,1699633260,19560,120143,118216,SE,SE
186044,1699867140,1699899300,32160,79351,135972,TR,TR
47461,1699677540,1699709280,31740,20399,110883,TR,TR
13622,1699392720,1699428180,35460,46125,60460,TR,TR
166679,1700176680,1700209020,32340,86722,174110,TR,TR
48452,1700048820,1700059860,11040,97919,197128,AT,DE
90160,1700215620,1700249400,33780,111522,7231,TR,TR
70794,1699010160,1699014540,4380,110731,172394,GB,GB
74052,1700339640,1700351820,12180,185383,5798,IT,CH
35230,1700810580,1700839560,28980,40952,12354,TR,TR
38568,1699900620,1699904220,3600,5006,90756,NL,NL
195495,1699586940,1699604700,17760,18319,9981,RS,MK
112062,1698902340,1698936900,34560,74020,196733,TR,TR
108323,1700642880,1700669580,26700,81255,59745,DE,IT
42080,1700492580,1700502780,10200,133614,78048,IT,IT
197420,1700106000,1700109600,3600,40164,194899,NL,NL
59050,1699154040,1699175820,21780,3354,185165,BR,BR
182294,1698839160,1698849180,10020,54971,193363,IT,IT
131475,1700571480,1700606580,35100,22660,98516,TR,TR
82554,1700236620,1700270040,33420,98861,193163,TR,TR
67783,1699387980,1699420680,32700,82936,70734,TR,TR
71839,1700786280,1700817060,30780,64752,24097,TR,TR
56959,1699108500,1699124880,16380,18708,158243,US,US
106405,1699242180,1699272780,30600,91779,60780,TR,TR
191309,1699404900,1699422780,17880,29171,129792,US,US
105203,1699595460,1699611660,16200,141821,27413,US,US
11122,1700747580,1700774640,27060,6373,192828,DE,DE
31142,1699081260,1699116840,35580,172090,196997,TR,TR
194220,1699870260,1699904040,33780,198526,100267,TR,TR
49450,1699411560,1699440600,29040,79421,61473,TR,TR
130075,1700432760,1700459640,26880,154998,136662,DE,RS
120246,1699306320,1699318140,11820,199975,181367,PT,PT
184914,1699225380,1699237680,12300,118653,49056,US,US
90613,1699904580,1699929900,25320,15493,14448,DE,BG
17158,1699365060,1699394040,28980,139096,81222,TR,TR
130112,1698960240,1698976020,15780,47965,50319,US,US
20694,1699730580,1699747140,16560,105966,43016,AT,AT
138600,1699434300,1699446000,11700,191680,159510,US,US
104402,1700199300,1700207460,8160,89329,99176,IT,IT
81438,1699049580,1699063680,14100,141924,38110,HR,HR
74520,1698911400,1698946680,35280,161827,34283,MX,MX
182056,1698865560,1698869160,3600,119087,35603,NL,NL
134785,1698894900,1698926460,31560,188210,41061,TR,TR
169494,1700572680,1700608080,35400,8492,8976,TR,TR
7883,1700438940,1700474220,35280,110428,183660,TR,TR
38689,1699028280,1699060500,32220,99801,138759,TR,TR
39716,1699356360,1699395720,39360,132625,37878,MX,MX
26877,1699773840,1699794060,20220,192286,14744,SE,PL
58707,1700609820,1700619060,9240,31223,141342,IT,IT
38470,1699450860,1699482240,31380,191049,75793,TR,TR
51354,1700074200,1700107680,33480,186125,113873,TR,TR
75830,1698876840,1698883560,6720,9623,66559,NL,NL
47983,1699647000,1699679880,32880,186876,156775,TR,TR
36334,1700224380,1700246460,22080,121380,123553,MD,RO
24423,1700234160,1700267700,33540,165827,138015,TR,TR
173078,1700444700,1700457240,12540,165817,36812,PT,PT
191115,1700167920,1700182200,14280,27649,118317,US,US
32328,1700763420,1700788320,24900,61683,143446,PL,DE
46894,1700588940,1700593380,4440,163408,38169,GB,GB
61973,1700401440,1700433840,32400,183455,45710,TR,TR
126139,1699269600,1699293240,23640,125655,43140,DE,NL
69328,1699408440,1699435740,27300,124728,11157,RO,RO
137884,1700354400,1700366100,11700,142669,138912,US,US
189480,1700122500,1700139720,17220,1351,171674,US,US
133689,1699477380,1699512420,35040,99284,196219,TR,TR
147732,1700676720,1700688540,11820,58534,104005,US,US
110022,1699886940,1699922760,35820,143256,60830,TR,TR
41803,1700200800,1700204820,4020,141569,145029,GB,GB
152103,1699858800,1699865340,6540,47703,20628,NL,PL
107036,1700602440,1700614020,11580,72614,177527,AT,PL
148590,1699592880,1699602840,9960,128222,10510,HR,HR
128574,1700669400,1700677740,8340,161601,139318,IT,DE
42954,1699025100,1699056360,31260,74012,34238,TR,TR
109219,1699970820,1700001360,30540,198664,196941,TR,TR
155910,1700331660,1700360460,28800,30579,71421,TR,TR
141563,1700224980,1700256720,31740,97293,61254,TR,TR
178136,1700622600,1700632680,10080,95480,89863,PT,PT
161372,1699835040,1699850340,15300,53216,170694,FR,AD
138144,1700299080,1700313240,14160,175125,75446,RS,RS
169708,1699508700,1699540080,31380,30557,73327,TR,TR
196366,1699394700,1699398300,3600,101869,61881,GB,GB
68006,1700185080,1700217900,32820,41647,40312,TR,TR
148342,1699185000,1699189200,4200,50471,60767,NL,NL
59323,1699063200,1699066800,3600,153003,106453,NL,NL
29078,1699496820,1699530360,33540,198067,190796,TR,TR
29276,1700274660,1700285160,10500,193677,25966,IT,IT
9801,1698869160,1698924960,55800,48457,52502,UA,PL
38494,1700252940,1700256540,3600,8094,193204,GB,GB
86108,1700790960,1700794560,3600,54614,49014,GB,GB
96546,1700349360,1700353500,4140,74628,71611,NL,NL
19710,1700672280,1700707080,34800,54075,142725,TR,TR
87211,1699512600,1699527660,15060,196833,80006,US,US
120134,1699784040,1699804020,19980,177162,3782,FR,FR
159702,1699190940,1699194540,3600,179220,137121,GB,GB
83124,1699268940,1699280100,11160,3442,83250,CZ,CZ
186721,1700625360,1700628960,3600,102283,57455,GB,GB
151396,1699271280,1699274880,3600,60254,111521,GB,GB
188375,1700708400,1700742360,33960,119337,175202,TR,TR
63659,1700346540,1700384160,37620,76712,4393,MX,MX
23040,1699728660,1699757820,29160,195542,130119,TR,TR
101800,1699438680,1699442280,3600,45398,43233,GB,GB
36522,1699159200,1699162800,3600,196757,192391,NL,NL
118439,1699086540,1699119780,33240,107262,94145,TR,TR
148229,1700278200,1700308320,30120,105221,128761,TR,TR
131476,1699687020,1699701060,14040,47922,2978,US,US
34794,1699591560,1699623960,32400,129591,80961,TR,TR
107457,1700338500,1700369100,30600,129150,182699,TR,TR
116349,1700308500,1700336400,27900,151640,191760,DE,DE
169167,1700862300,1700878260,15960,27165,15401,AT,AT
17656,1698869880,1698901140,31260,121242,91151,TR,TR
197202,1700790180,1700794200,4020,14749,97636,GB,GB
48974,1699228680,1699232280,3600,179687,131983,GB,GB
176645,1699997760,1700032800,35040,15032,56818,TR,TR
119681,1700722740,1700730600,7860,10261,36045,IT,FR
184753,1699086840,1699101120,14280,46863,79918,RS,AT
181601,1700696460,1700708880,12420,25030,127527,US,US
26666,1699037520,1699052400,14880,189234,108839,AT,AT
64582,1700553060,1700584320,31260,175050,119370,TR,TR
66515,1700844420,1700858520,14100,158787,140918,AT,AT
41721,1699696380,1699707180,10800,157121,53670,HR,DE
93064,1699656720,1699669200,12480,117256,147140,US,US
98407,1699123380,1699144080,20700,160282,46765,FR,FR
78579,1700593920,1700623320,29400,24011,57082,TR,TR
185840,1699751220,1699764180,12960,171588,152561,PT,PT
70396,1699547520,1699552500,4980,144683,113045,GB,GB
96923,1700699280,1700711820,12540,169661,42265,US,US
85139,1700703300,1700723460,20160,27918,41052,FR,FR
104848,1700719980,1700737500,17520,14538,31878,US,US
159904,1699145700,1699160400,14700,101584,32432,US,US
187192,1699757880,1699761780,3900,168793,98960,NL,NL
155295,1699195320,1699198920,3600,105697,199942,GB,GB
176094,1698875040,1698892800,17760,180700,51344,US,US
110178,1698973440,1699003500,30060,82973,138326,TR,TR
188944,1699006980,1699010880,3900,177876,163882,NL,NL
158042,1699449540,1699466400,16860,195854,305,US,CA
16760,1698851880,1698855480,3600,41417,166178,GB,GB
121404,1699219080,1699253820,34740,173274,17055,TR,TR
199921,1699470540,1699474140,3600,33699,148529,GB,GB
41259,1699162020,1699168740,6720,181145,33864,NL,NL
62313,1700435280,1700457300,22020,18415,64111,RO,RO
111039,1700239620,1700251800,12180,163316,26655,IT,IT
11814,1700262600,1700292900,30300,17671,131930,TR,TR
102024,1699289220,1699307940,18720,123503,65919,BE,FR
63048,1700205600,1700217960,12360,132620,167786,US,US
56094,1700520060,1700526960,6900,145671,120650,GB,GB
173197,1699108560,1699141260,32700,10792,33138,TR,TR
191599,1699136460,1699165500,29040,145775,181242,TR,TR
155401,1700566020,1700599320,33300,120088,5957,TR,TR
93303,1700345640,1700351820,6180,120389,6640,GB,GB
30000,1700101980,1700135820,33840,63175,114611,TR,TR
127318,1700389320,1700421060,31740,22426,10843,TR,TR
8099,1700797800,1700806500,8700,64283,126107,IT,IT
67650,1700186640,1700217780,31140,3569,187409,TR,TR
35276,1699273800,1699278480,4680,35542,80660,NL,BE
17865,1699681260,1699684860,3600,184693,187971,NL,NL
88775,1700046540,1700073300,26760,37086,62100,DE,DE
187327,1698862980,1698892140,29160,16231,6488,TR,TR
91728,1699559940,1699568340,8400,157806,95372,ES,ES
15893,1700071320,1700085420,14100,89318,173666,IT,IT
192921,1699312920,1699336800,23880,15401,111139,PL,PL
61770,1699023540,1699032360,8820,75870,37456,PT,PT
123755,1700433300,1700464200,30900,138412,199472,TR,TR
142388,1700437140,1700464380,27240,16676,97889,DE,DE
134443,1700655240,1700670180,14940,41284,161457,RS,SI
102820,1700744400,1700752680,8280,20023,30325,IT,IT
180493,1700108820,1700140140,31320,54690,179187,TR,TR
87637,1700274000,1700303340,29340,86668,189537,TR,TR
43070,1699938120,1699953600,15480,154914,136572,US,MX
15309,1699270260,1699277220,6960,17218,870,GB,GB
34920,1699185780,1699216500,30720,45416,117715,TR,TR
167935,1699511520,1699515120,3600,65880,199048,GB,GB
9992,1699491480,1699495080,3600,129824,173021,GB,GB
146221,1699798680,1699813740,15060,160056,31475,US,US
191671,1700129160,1700163360,34200,60859,126187,TR,TR
102031,1700214840,1700220240,5400,149049,91799,NL,FR
118140,1699608120,1699638300,30180,32163,36954,TR,TR
27494,1700669460,1700699760,30300,31594,99932,TR,TR
140563,1699243440,1699251360,7920,93598,71871,PT,PT
5481,1700226720,1700232900,6180,160357,12784,GB,GB
192165,1699181220,1699212240,31020,38107,13226,TR,TR
146022,1700230320,1700245440,15120,46022,27683,US,US
78916,1699967580,1699991160,23580,186419,575,DE,UA
87354,1700597760,1700617320,19560,129955,180276,SE,SE
84459,1700201040,1700234280,33240,176673,172128,TR,TR
45751,1699688880,1699722540,33660,127401,131010,TR,TR
148108,1699159380,1699174500,15120,73233,69665,US,US
148303,1699012380,1699047600,35220,45686,51599,TR,TR
186745,1699140900,1699157280,16380,39634,161189,FR,ES
1997,1699705440,1699734300,28860,100054,180802,TR,TR
52460,1699839300,1699863780,24480,42109,57813,DE,PL
20171,1699512780,1699517220,4440,47519,63321,NL,NL
199715,1700656380,1700663460,7080,174489,25766,NL,NL
183169,1698837300,1698867000,29700,60256,145151,TR,TR
109080,1700141820,1700178900,37080,157850,93171,MX,MX
33173,1700387940,1700394420,6480,56661,74828,NL,NL
34806,1700279820,1700304240,24420,154470,30869,DE,HU
83535,1700521440,1700540580,19140,68570,82527,FR,FR
114994,1700627940,1700638080,10140,160442,184081,IT,IT
113134,1700334840,1700367480,32640,5684,183188,TR,TR
109118,1700864940,1700877960,13020,13215,137829,AT,NL
168268,1700714580,1700723040,8460,100248,121122,IT,IT
49313,1700675760,1700685540,9780,80288,62595,IT,IT
144135,1700067180,1700081640,14460,121368,198135,FR,AD
89957,1700497020,1700509980,12960,25560,40243,AT,AT
178650,1699579800,1699583400,3600,68606,148722,NL,NL
189637,1700619300,1700654760,35460,160383,23495,TR,TR
80660,1699163520,1699169160,5640,80598,73311,GB,GB
191945,1700359560,1700372940,13380,178548,51718,US,US
82538,1700742660,1700756820,14160,30177,120119,IT,IT
3819,1699426020,1699456740,30720,6784,89104,TR,TR
45619,1700430720,1700434380,3660,78631,55200,NL,NL
74420,1700401080,1700434860,33780,181932,66743,TR,TR
40126,1699905480,1699937520,32040,14880,196478,TR,TR
104993,1700231700,1700245080,13380,90732,188546,IT,IT
85811,1698914340,1698943860,29520,74023,168123,TR,TR
182837,1700331960,1700337000,5040,66936,81119,GB,GB
4107,1698966360,1698978660,12300,67712,150680,US,US
23057,1699971360,1700006700,35340,101274,21671,TR,TR
197090,1699525620,1699551780,26160,166261,84645,RO,MD
134599,1699731900,1699737120,5220,45208,37623,NL,NL
167654,1699946940,1699982220,35280,105497,12551,MK,AT
159634,1699364580,1699375440,10860,163306,119310,RS,NL
197582,1699623540,1699627140,3600,29355,166008,GB,GB
110345,1698821820,1698837300,15480,92594,161522,US,US
112328,1699248120,1699282200,34080,198227,198150,TR,TR
199540,1699262220,1699266660,4440,157694,126787,GB,GB
80835,1700126940,1700130540,3600,20052,160098,GB,GB
173094,1699082280,1699098600,16320,47653,82770,CZ,CZ
53637,1699342260,1699375920,33660,104696,193036,TR,TR
141566,1699118340,1699153200,34860,114148,21075,TR,TR
99332,1699931400,1699935000,3600,94562,43635,NL,NL
146971,1700288160,1700299920,11760,125993,139990,HR,HR
39966,1699620420,1699649040,28620,18706,43846,DE,DE
67065,1700052120,1700086080,33960,104766,191648,MX,MX
47517,1700076540,1700105700,29160,142998,155948,TR,TR
26432,1698818700,1698832020,13320,134097,91620,IT,IT
198205,1699418340,1699430460,12120,23124,121516,US,CA
44254,1700423160,1700436300,13140,28763,27620,PT,PT
169071,1700801280,1700828400,27120,197195,13019,BR,BR
86662,1700439480,1700445540,6060,95449,18311,NL,NL
160190,1699611060,1699624740,13680,159550,157126,IT,IT
122650,1699748760,1699771740,22980,18917,197345,BR,BR
15757,1700186580,1700190180,3600,196629,76989,NL,NL
34461,1699171560,1699194660,23100,199327,55506,CH,PT
104959,1700476680,1700486040,9360,45418,173489,IT,IT
186732,1699181220,1699187700,6480,151388,98092,NL,NL
26415,1699249440,1699284180,34740,142351,97559,TR,TR
92607,1700285820,1700300460,14640,70657,175521,US,US
8467,1700767380,1700782440,15060,48148,170073,AT,AT
143352,1700706180,1700717400,11220,90887,86338,AT,DE
65979,1700852880,1700883600,30720,168931,35220,TR,TR
27246,1700126580,1700157840,31260,166988,44600,TR,TR
113512,1698957000,1698972540,15540,27542,71423,US,US
193829,1699628460,1699659600,31140,98810,118151,TR,TR
97825,1699194420,1699224300,29880,3177,115655,TR,TR
32006,1700827440,1700862780,35340,153083,55639,MX,US
106990,1700114760,1700118360,3600,68806,76613,NL,BE
190928,1698817320,1698848100,30780,120761,190333,TR,TR
125953,1699266780,1699303920,37140,181357,78662,MX,MX
22747,1699983240,1699991220,7980,193745,3818,IT,IT
12302,1699833480,1699864020,30540,72883,72880,TR,TR
77391,1699836480,1699871460,34980,198218,185065,TR,TR
2890,1700199360,1700202960,3600,121130,102661,NL,NL
183936,1699278660,1699311840,33180,172768,70298,TR,TR
93841,1698874920,1698878520,3600,92886,126207,NL,NL
95024,1700542140,1700576700,34560,24404,141391,TR,TR
115028,1699570440,1699574040,3600,93761,3804,NL,NL
168980,1699517880,1699524600,6720,53579,118314,NL,NL
109318,1700644740,1700659800,15060,107065,109222,US,US
180594,1699904280,1699935300,31020,80226,119688,TR,TR
85902,1699428420,1699438260,9840,96781,124220,ES,ES
31870,1700346780,1700362560,15780,6054,189597,US,US
166165,1700029920,1700042460,12540,25906,110995,IT,IT
167117,1700596380,1700599980,3600,92925,15344,GB,GB
177554,1700629320,1700634720,5400,12031,80599,GB,GB
194391,1699961220,1699970700,9480,72078,85569,IT,CH
95611,1700815380,1700849280,33900,46132,61531,TR,TR
151364,1699708920,1699744620,35700,104664,17746,TR,TR
18469,1700205720,1700213460,7740,41217,35271,ES,ES
122139,1699914240,1699947720,33480,130748,153658,TR,TR
164768,1699872480,1699907640,35160,163501,16337,TR,TR
12069,1699779120,1699792140,13020,59483,40684,IT,IT
23271,1699815180,1699821180,6000,22797,190838,NL,NL
161805,1700281260,1700317920,36660,181888,113325,MX,MX
157857,1700113260,1700131560,18300,158471,28783,FR,FR
148849,1699790700,1699795560,4860,9813,58460,GB,GB
14902,1700699940,1700715600,15660,86910,169281,US,US
175201,1699255140,1699269720,14580,33487,97526,US,US
151740,1700387820,1700417700,29880,139181,125141,TR,TR
44426,1700782080,1700790240,8160,58328,140957,IT,IT
54391,1700817060,1700845920,28860,35416,101749,TR,TR
143549,1699515900,1699524900,9000,45168,23395,IT,IT
34776,1699008840,1699041900,33060,122636,106846,TR,TR
166682,1699484280,1699517460,33180,104855,82085,TR,TR
190746,1699006260,1699017180,10920,58353,44362,IT,IT
102997,1699460460,1699465860,5400,102019,127691,NL,NL
76085,1700812500,1700817000,4500,154133,178115,NL,NL
43327,1699748340,1699751940,3600,155340,73154,NL,NL
155509,1700351760,1700386440,34680,8224,62215,TR,TR
156848,1700776860,1700812080,35220,33092,57678,TR,TR
15116,1699640520,1699669800,29280,136658,66279,TR,TR
189291,1699426800,1699436220,9420,108746,135155,IT,IT
139891,1699086000,1699099440,13440,135803,75542,US,MX
134860,1700785560,1700815200,29640,129974,180785,TR,TR
38667,1700132940,1700166720,33780,75420,50363,TR,TR
38962,1698894180,1698925020,30840,115409,19887,TR,TR
8891,1699521960,1699537620,15660,41397,83712,FR,FR
6791,1700258100,1700272560,14460,112285,165343,AT,HU
184714,1698902820,1698935580,32760,22228,159557,TR,TR
3822,1700617020,1700637840,20820,25472,111583,DK,NO
184513,1699977540,1700003760,26220,116705,23265,RO,RO
46938,1699260360,1699283460,23100,101196,140866,PL,NL
176149,1699143720,1699175040,31320,74234,162333,TR,TR
48009,1699172880,1699181760,8880,145387,108678,IT,IT
93593,1699991220,1699996860,5640,159645,65338,GB,GB
168623,1700223120,1700247540,24420,54871,90880,RO,RO
130886,1699367520,1699371120,3600,42274,166354,GB,GB
104491,1698903540,1698909480,5940,86076,42923,NL,NL
157024,1699066860,1699084260,17400,32299,103425,US,US
2899,1698965340,1698995580,30240,17745,20903,TR,TR
177060,1699229700,1699261440,31740,80271,3966,TR,TR
94585,1699509900,1699532280,22380,77978,38774,CH,IT
58742,1699013340,1699019940,6600,134100,119171,NL,NL
172529,1700526240,1700559480,33240,37667,29955,TR,TR
66405,1699339860,1699352280,12420,131480,94673,PT,PT
108487,1699753020,1699765800,12780,98747,127479,US,US
4179,1698833040,1698858180,25140,21405,50827,ME,RS
188388,1699063080,1699098120,35040,45052,132048,MX,MX
95513,1700474700,1700491500,16800,116566,143495,CA,CA
132301,1700372940,1700384700,11760,86716,179731,IT,IT
78962,1699078440,1699111920,33480,170726,169328,TR,TR
174320,1700508780,1700525280,16500,116254,107711,AT,AT
106976,1700449740,1700466600,16860,34845,59265,US,US
38399,1700220300,1700255700,35400,80882,126640,TR,TR
90991,1699624440,1699677540,53100,38019,115291,BG,BG
114482,1699921860,1699954680,32820,110384,45067,TR,TR
36282,1698922080,1698925680,3600,59866,63488,GB,GB
71871,1700804940,1700817120,12180,156501,160161,US,US
146086,1700104080,1700136480,32400,180114,101516,TR,TR
83273,1700479680,1700510100,30420,75722,189657,TR,TR
4208,1699799040,1699810440,11400,91495,145450,AT,BG
159159,1700020440,1700031240,10800,99523,76855,SK,SK
183479,1699503060,1699536240,33180,127707,128959,TR,TR
139886,1699971660,1699984740,13080,102356,121450,RS,RS
43035,1700185860,1700192880,7020,81922,181837,GB,GB
143312,1699680840,1699714200,33360,9692,173716,TR,TR
155868,1700250420,1700279460,29040,15941,77675,TR,TR
19510,1699714440,1699748220,33780,35430,142624,TR,TR
94709,1700782380,1700805960,23580,16168,40097,DE,NL
184293,1699216500,1699222980,6480,197495,182048,GB,GB
1327,1698930840,1698945660,14820,42855,198354,AT,AT
187899,1699990260,1699994340,4080,24052,61902,CL,CL
77864,1700796060,1700828820,32760,41503,190255,TR,TR
48221,1700854200,1700865180,10980,18428,116650,IT,IT
187832,1699136040,1699165800,29760,106703,158018,TR,TR
40492,1699656240,1699669920,13680,31207,144690,US,US
39874,1699613700,1699631640,17940,141513,23456,FR,BE
102470,1700584500,1700592060,7560,19015,87979,HR,HR
144359,1698833940,1698844920,10980,73785,191571,HR,HR
164804,1699175940,1699207680,31740,83472,163181,TR,TR
39713,1699292100,1699302660,10560,106843,124464,IT,IT
69965,1699268580,1699285740,17160,175688,37894,US,US
175587,1700649600,1700680680,31080,159519,191963,TR,TR
47929,1699609440,1699645080,35640,172905,130125,TR,TR
23034,1698815220,1698821400,6180,121612,64130,NL,NL
95194,1700087460,1700121000,33540,4521,93195,TR,TR
129029,1699115040,1699127160,12120,22370,156636,US,US
32874,1699077960,1699113660,35700,191077,49715,TR,TR
145369,1699198920,1699221720,22800,80237,197469,BR,BR
26463,1699541340,1699576740,35400,61156,89505,TR,TR
198549,1699043520,1699075560,32040,57080,67423,TR,TR
63426,1699342140,1699345740,3600,157446,161618,NL,DE
180153,1700457840,1700488020,30180,94236,179661,TR,TR
94879,1699263060,1699292700,29640,6726,133674,TR,TR
124887,1699264680,1699292460,27780,118216,119655,PL,DE
152684,1698997080,1699009680,12600,153254,46578,IT,IT
97990,1700722380,1700735820,13440,47272,39379,IT,IT
96285,1700549820,1700582640,32820,74606,54237,TR,TR
21337,1700657160,1700689860,32700,26438,93662,TR,TR
64337,1699931400,1699964040,32640,68647,156361,TR,TR
122768,1700157060,1700170380,13320,96629,68949,US,US
127515,1700711760,1700736660,24900,180450,145989,DE,DE
172401,1700071260,1700106840,35580,60834,92828,TR,TR
122693,1699824960,1699831860,6900,146749,118126,NL,NL
199844,1699049520,1699079940,30420,40662,194304,TR,TR
113109,1699167120,1699197720,30600,112771,53261,TR,TR
14130,1699128360,1699131960,3600,51990,108770,GB,GB
197263,1699923480,1699927920,4440,183298,103854,EE,EE
81059,1698819120,1698845340,26220,150632,21807,CH,FR
68659,1700165700,1700198400,32700,117940,14613,TR,BG
17118,1699630500,1699656420,25920,41507,169851,DE,FR
56458,1698804780,1698836280,31500,135913,148614,TR,TR
91243,1699246860,1699278900,32040,37608,90260,TR,TR
156118,1700540220,1700575800,35580,94080,125745,TR,TR
184014,1699727220,1699740840,13620,38447,64939,HR,HR
31026,1699508580,1699525440,16860,121796,191912,US,US
73601,1699832340,1699858380,26040,68481,30713,PL,DK
133238,1699005900,1699016460,10560,36661,168292,HR,HR
99408,1699906560,1699939500,32940,124444,112106,TR,TR
166455,1700582400,1700618940,36540,173209,40238,MX,MX
48535,1700830080,1700842920,12840,137456,191999,RS,RS
145013,1699528680,1699561920,33240,46156,86218,TR,TR
166774,1700038980,1700074260,35280,66127,101189,TR,TR
192793,1700581260,1700591040,9780,170564,11672,PT,PT
15912,1700216100,1700219700,3600,19683,55745,NL,NL
173485,1699705380,1699716780,11400,6467,110456,HR,HR
106377,1699724280,1699733760,9480,49984,20647,PT,PT
100945,1700451000,1700462520,11520,87465,171227,CZ,CZ
172577,1699432500,1699443060,10560,42224,128652,IT,RO
125819,1700483400,1700497260,13860,198757,187694,US,US
41182,1699220280,1699232940,12660,50156,131322,ES,ES
29118,1699366200,1699378680,12480,184093,111094,SK,AT
35681,1699544520,1699578120,33600,105401,61423,TR,TR
98724,1700709000,1700723940,14940,13774,137249,RS,RS
129497,1700355000,1700388420,33420,194825,76508,TR,TR
1131,1700124300,1700159520,35220,137116,151449,TR,TR
89558,1700152260,1700187000,34740,172266,14974,TR,TR
145014,1699446420,1699462920,16500,134193,22832,US,US
194789,1699067460,1699097340,29880,175892,84688,TR,TR
17912,1700560860,1700592180,31320,23778,198529,TR,TR
161797,1699429980,1699445760,15780,145541,63105,FR,AD
52763,1699263300,1699293840,30540,143721,125360,TR,TR
9502,1700265840,1700278320,12480,72908,171056,IT,IT
19613,1699422780,1699436220,13440,94456,19409,US,US
77847,1699704780,1699714080,9300,118077,105630,PT,PT
30561,1699096020,1699101540,5520,3517,61723,GB,GB
57409,1700096820,1700125920,29100,35043,181881,TR,TR
107655,1699925400,1699938480,13080,112666,117027,CZ,UA
94693,1700000400,1700033640,33240,112873,45309,TR,TR
172744,1699392180,1699395780,3600,190186,77520,GB,GB
12268,1700357040,1700372580,15540,187603,111785,US,US
6974,1699945440,1699973760,28320,173368,129711,DE,AT
198056,1699969560,1699999740,30180,152840,134552,TR,TR
162538,1700712060,1700723280,11220,77780,94034,AT,AT
116423,1700015280,1700048940,33660,171868,176366,TR,TR
20883,1698899340,1698930960,31620,160312,51115,TR,TR
123635,1700641500,1700672760,31260,193784,165995,TR,TR
39851,1698926340,1698953880,27540,73427,26649,DE,DE
22234,1698829140,1698840900,11760,59714,60286,US,US
72420,1700643000,1700650500,7500,1086,54711,PT,PT
25807,1699188840,1699220460,31620,58473,26185,TR,TR
33483,1699103880,1699107480,3600,193979,70700,GB,GB
71370,1700042040,1700045640,3600,158247,182849,GB,GB
16128,1699191300,1699200360,9060,145895,29142,PT,PT
159182,1700131020,1700161140,30120,85103,28753,TR,TR
60570,1699386180,1699391400,5220,41961,143260,GB,GB
144086,1700460300,1700490120,29820,196708,161074,TR,TR
160332,1700055420,1700090220,34800,121331,76251,TR,TR
155601,1700463060,1700486520,23460,132587,65047,PL,PL
29049,1699536240,1699539840,3600,149462,58699,GB,GB
18103,1699836660,1699845120,8460,99884,67300,IT,IT
27222,1699387560,1699400760,13200,77752,15470,RS,RS
66335,1699531920,1699564380,32460,38026,29705,TR,TR
153878,1700076780,1700090940,14160,137390,107209,US,US
166624,1700709000,1700719680,10680,140015,149977,ES,ES
103758,1700827380,1700830980,3600,65174,49901,GB,FR
52558,1699018560,1699023540,4980,26210,71260,CL,CL
126230,1699146900,1699178940,32040,120602,173363,TR,TR
141733,1699398240,1699428840,30600,39454,30073,TR,TR
155788,1699546620,1699560300,13680,65999,194880,ES,ES
155208,1700212980,1700226720,13740,133684,30169,SK,SK
127369,1698855660,1698862920,7260,18045,112938,ES,DE
64348,1699265700,1699279620,13920,126887,192141,HR,HR
176639,1699148040,1699159980,11940,189334,69650,AT,AT
135761,1699400460,1699418220,17760,104898,191911,US,US
44878,1699046820,1699058820,12000,140833,180931,US,US
151498,1700803380,1700838720,35340,46139,132053,TR,TR
34724,1699906320,1699942980,36660,119521,67575,MX,MX
134229,1699835340,1699843620,8280,10443,155336,IT,IT
130578,1700767680,1700801520,33840,88092,25463,MX,MX
140279,1699628100,1699662960,34860,12924,73312,TR,TR
1575,1699135140,1699165560,30420,182192,57388,TR,TR
8465,1700226960,1700261640,34680,142279,186222,TR,TR
118386,1700306880,1700318280,11400,150101,114679,ES,ES
136767,1699131900,1699135500,3600,53894,81336,NL,NL
46009,1700460840,1700491200,30360,122719,170397,TR,TR
90514,1699450680,1699454280,3600,78333,50538,NL,NL
155418,1699977420,1699982940,5520,4992,107024,NL,NL
105251,1699900320,1699904040,3720,189971,123491,NL,NL
158785,1700315100,1700332140,17040,184080,99704,US,US
156887,1700298540,1700310660,12120,113435,47182,ES,ES
48621,1700123100,1700140680,17580,185707,52102,AT,DE
79977,1700341260,1700352000,10740,79355,91832,PT,PT
161132,1699345140,1699362660,17520,155667,106346,AT,AT
55352,1699137540,1699172160,34620,102171,90608,TR,TR
105013,1699671780,1699687380,15600,180897,178832,US,US
107505,1699833360,1699868400,35040,104242,22278,TR,TR
58496,1699778280,1699781880,3600,175459,73907,GB,GB
162975,1700549640,1700584560,34920,137120,91067,TR,TR
29673,1699020660,1699053720,33060,123888,97976,TR,TR
49326,1700343960,1700374740,30780,193914,5654,TR,TR
131235,1698981960,1698999900,17940,29280,196949,CZ,CZ
123346,1700490300,1700503320,13020,156317,107715,US,US
93088,1700470620,1700505720,35100,3628,153092,TR,TR
8699,1699898820,1699914420,15600,149783,189810,US,US
58983,1700170260,1700186640,16380,118374,6679,CZ,CZ
140576,1699979820,1700006700,26880,174962,49135,DE,DE
197619,1700453400,1700473320,19920,38211,151027,FR,NL
184523,1700797560,1700814960,17400,180210,74923,FR,FR
4144,1700069760,1700105280,35520,27648,147193,TR,TR
130497,1700798700,1700832240,33540,105786,18506,MX,MX
37525,1700830020,1700839980,9960,71603,192354,HR,HR
119323,1700470200,1700481000,10800,131004,92495,IT,IT
59723,1699768680,1699775340,6660,23441,107732,GB,GB
57480,1698811140,1698829320,18180,187464,183316,FR,FR
31532,1699007100,1699031160,24060,9733,193637,DE,DE
48578,1699936320,1699952100,15780,175404,29458,US,US
96690,1699269300,1699286580,17280,151491,15387,US,US
31844,1699378980,1699390680,11700,53419,68693,IT,IT
56868,1699250220,1699267440,17220,165726,76063,CZ,PL
45022,1699572240,1699604160,31920,109320,166521,TR,TR
68629,1698991140,1699002960,11820,193380,68255,US,US
149166,1699065600,1699073160,7560,93113,1303,HR,HR
141122,1698795540,1698826380,30840,59975,70359,TR,TR
78944,1699228740,1699245360,16620,90420,170019,CZ,CZ
151600,1699528560,1699540020,11460,13589,198548,IT,IT
164281,1699261080,1699271220,10140,1513,21170,HR,HR
184100,1699208340,1699220820,12480,112902,42259,AT,CZ
140955,1699491480,1699504680,13200,127027,64054,ES,ES
185465,1699083540,1699117140,33600,88139,77561,TR,TR
84434,1699520820,1699549500,28680,75397,87238,DE,FR
6739,1700580600,1700586480,5880,173540,150051,GB,GB
187235,1699828380,1699861740,33360,68761,82417,TR,TR
82829,1700029200,1700048580,19380,130539,97078,FR,FR
151431,1700142420,1700152440,10020,121515,79416,SK,SK
122999,1700069880,1700100360,30480,129215,60310,TR,TR
197723,1700140440,1700156340,15900,139155,69740,CZ,CZ
110991,1699761120,1699790160,29040,107331,123934,TR,TR
13686,1699859700,1699881480,21780,1304,80791,DE,PL
176309,1700411280,1700442180,30900,168900,176324,TR,TR
157001,1699068840,1699083120,14280,57658,183281,IT,IT
136330,1700013420,1700017020,3600,194179,184494,NL,NL
112440,1699655520,1699678320,22800,164064,70246,DE,IT
14540,1700775960,1700785260,9300,152573,140725,HR,HR
33744,1700541540,1700554920,13380,92090,44846,AT,BG
48352,1699615620,1699648800,33180,36549,90437,TR,TR
187925,1699596300,1699623180,26880,115745,156439,PL,DE
60172,1700317560,1700329320,11760,186525,86621,IT,NL
143562,1699187100,1699196280,9180,187171,159145,IT,IT
9060,1700598360,1700612280,13920,166641,13335,IT,IT
149518,1698985200,1698989460,4260,134994,80796,NL,FR
119163,1700585940,1700591220,5280,81052,21111,NL,NL
56415,1698966060,1698977640,11580,121977,115674,IT,IT
195105,1700792160,1700824680,32520,5307,145039,TR,TR
3048,1700549100,1700583660,34560,33719,128900,TR,TR
90125,1700376240,1700409240,33000,3378,98117,TR,TR
137860,1699378920,1699409280,30360,84025,115415,TR,TR
63542,1699461120,1699496880,35760,10233,168331,TR,TR
108704,1698959460,1698981840,22380,46096,78274,DK,RO
163039,1699344360,1699358220,13860,95512,127828,ES,FR
80853,1700207880,1700241780,33900,84603,19523,TR,TR
123766,1699347720,1699382760,35040,47442,144251,TR,TR
198224,1700075340,1700109420,34080,27915,83508,TR,TR
107977,1698923580,1698954420,30840,80811,63241,TR,TR
20152,1700020200,1700051340,31140,47061,22698,TR,TR
83941,1699844760,1699878120,33360,113426,175949,TR,TR
168893,1700636220,1700647800,11580,29122,153168,ES,ES
158093,1699419000,1699446540,27540,166351,91020,DE,DE
16779,1698953220,1698960240,7020,89083,33140,GB,GB
181764,1700412300,1700441640,29340,47739,54597,TR,TR
55545,1699344840,1699379820,34980,55781,150880,TR,TR
128806,1700725860,1700739600,13740,5136,187975,IT,IT
96879,1699848240,1699883280,35040,195484,120166,MX,MX
170926,1699543800,1699558380,14580,147505,183035,CZ,CZ
81035,1698892380,1698926520,34140,164182,196841,TR,TR
76473,1700584620,1700615520,30900,68785,62849,TR,TR
147126,1699897920,1699908480,10560,73750,73029,HR,HR
142356,1700021700,1700052240,30540,196510,131862,TR,TR
80347,1699410000,1699436460,26460,73513,125539,DE,DE
67717,1699243260,1699260240,16980,176685,7137,FR,AD
118298,1699026360,1699041900,15540,104408,199706,US,US
14523,1699384680,1699420020,35340,143299,97068,TR,TR
154294,1700508060,1700522340,14280,63951,61698,US,US
52263,1700757780,1700761380,3600,143198,161283,GB,GB
169049,1700626440,1700637300,10860,100459,191446,US,US
19676,1699400160,1699431960,31800,31601,47282,TR,TR
174261,1700328360,1700385720,57360,77192,130856,UA,PL
70440,1699948680,1699960800,12120,52165,145250,IT,DE
52942,1699824480,1699858980,34500,130511,26480,TR,TR
56636,1699164720,1699189740,25020,172397,159173,DE,NL
36088,1699459740,1699487880,28140,148934,120135,BR,BR
116130,1699161420,1699192800,31380,142315,177278,TR,TR
50155,1699316580,1699331760,15180,28009,1190,US,US
67224,1699749720,1699762200,12480,49823,139343,HR,HR
196217,1699401780,1699433940,32160,164902,105631,TR,TR
132757,1700528100,1700540040,11940,44186,26833,SK,SK
20761,1699653780,1699664520,10740,180726,67495,PT,PT
57473,1700022180,1700055780,33600,39719,134331,TR,TR
779,1699691820,1699695420,3600,27622,190895,NL,NL
181628,1699143540,1699147140,3600,89756,40720,GB,GB
5506,1700465760,1700475060,9300,32354,5466,EE,PL
191678,1698930720,1698958140,27420,153500,14710,DE,SK
119150,1700456760,1700477220,20460,152080,172360,MD,RO
32491,1699520940,1699556280,35340,20034,136701,TR,TR
86857,1700701860,1700722560,20700,117503,199544,FR,FR
79765,1699517880,1699539180,21300,69081,82403,FR,AD
190370,1700805240,1700829600,24360,118853,135996,DE,DE
50559,1699463880,1699490160,26280,77907,51330,BA,HR
113635,1700001600,1700026380,24780,174114,63685,DK,DK
4526,1698934020,1698938400,4380,114694,56969,NL,NL
149928,1700179920,1700212980,33060,148032,67430,TR,TR
80687,1700378280,1700382360,4080,162032,177863,NL,NL
100920,1700296080,1700305320,9240,145096,3320,IT,IT
177156,1700534880,1700546400,11520,924,112993,IT,IT
53536,1699359300,1699362900,3600,42401,46472,GB,DE
88461,1699768200,1699797540,29340,179454,77312,TR,TR
115185,1699434660,1699463820,29160,127756,167134,TR,TR
4450,1699433520,1699446720,13200,133518,33633,HR,HR
144702,1700389860,1700403420,13560,14510,123937,IT,IT
158995,1700430840,1700459640,28800,15675,95806,TR,TR
111777,1700822340,1700827980,5640,69663,4946,GB,GB
24551,1700666700,1700670300,3600,54990,89681,GB,GB
157097,1700123940,1700127540,3600,82382,105681,GB,GB
59368,1699230000,1699246800,16800,154672,134917,FR,FR
127751,1698860100,1698865200,5100,55085,61374,CL,CL
61325,1700668260,1700700660,32400,199947,26007,TR,TR
163684,1700465460,1700471220,5760,173164,70875,GB,GB
94817,1700489460,1700520840,31380,172983,133003,TR,TR
125642,1700737380,1700765340,27960,90196,135249,BR,BR
129967,1698874740,1698907680,32940,54513,38187,TR,TR
189130,1698863880,1698869400,5520,174728,173869,GB,GB
8362,1700379240,1700382840,3600,93625,107185,NL,NL
127653,1700372160,1700388780,16620,28153,154050,US,US
83427,1700214780,1700247960,33180,123018,10265,TR,TR
157854,1700156460,1700160060,3600,76737,85693,GB,GB
99180,1699405500,1699437120,31620,6773,173734,TR,TR
65060,1699926000,1699959660,33660,105916,193177,TR,TR
47342,1699771260,1699800240,28980,191658,168970,TR,TR
70979,1698841440,1698853320,11880,51950,196521,HR,HR
126721,1700300160,1700331120,30960,41986,64545,TR,TR
89971,1700215860,1700250420,34560,128515,68070,TR,TR
90363,1699767540,1699784520,16980,37576,37175,US,US
84964,1700297220,1700300820,3600,186003,102419,GB,GB
50305,1699181160,1699211580,30420,124832,118444,TR,TR
51300,1700784120,1700800920,16800,135380,130588,US,US
2887,1699209780,1699213380,3600,26138,198664,NL,NL
165251,1699792980,1699823460,30480,15415,172046,TR,TR
191265,1700180700,1700201100,20400,130485,85608,SE,SE
102705,1699726500,1699739580,13080,137592,135220,CZ,HU
57079,1698848760,1698859440,10680,17367,124140,IT,IT
49062,1700695560,1700727120,31560,74067,118693,TR,TR
173041,1699717920,1699729260,11340,47581,186879,ES,ES
34615,1699985100,1700020920,35820,32110,51064,TR,TR
77652,1700764800,1700781180,16380,92222,70093,US,US
23540,1700178060,1700184480,6420,193806,185333,GB,GB
74421,1700634120,1700667540,33420,189407,174362,TR,TR
61955,1700450340,1700479200,28860,55676,26824,TR,TR
156583,1700474760,1700489220,14460,21248,188976,US,US
32435,1699744680,1699779420,34740,35993,38741,TR,TR
22213,1700476020,1700479980,3960,174609,12783,NL,NL
9182,1700121660,1700133420,11760,18316,21863,ES,RO
26501,1699263960,1699296060,32100,21965,113493,TR,TR
152411,1699399500,1699414800,15300,27673,85426,US,US
193314,1699414680,1699430400,15720,34903,126050,US,US
8990,1699537920,1699567680,29760,198514,481,TR,TR
61980,1699053060,1699056660,3600,183125,70982,NL,NL
46662,1699925700,1699955400,29700,196372,104872,TR,TR
8145,1698858420,1698875940,17520,52286,1394,US,US
157461,1699790040,1699826460,36420,110218,112134,MX,MX
83447,1700495520,1700526240,30720,36924,10802,TR,TR
70796,1700226660,1700243520,16860,161125,20796,CZ,CZ
58029,1700339400,1700349780,10380,22913,102071,HR,HR
5071,1699775280,1699808400,33120,20199,94808,TR,TR
137607,1699123320,1699128600,5280,166648,182020,GB,GB
120691,1699100340,1699111200,10860,43866,142096,IT,IT
46635,1699141560,1699175340,33780,14632,100194,TR,TR
151214,1700260500,1700296380,35880,169616,36939,TR,TR
97662,1700254260,1700266860,12600,127466,155832,RS,RS
82935,1700231040,1700253480,22440,17385,139335,RO,RO
197606,1699504260,1699528980,24720,1648,187498,RO,RO
120378,1699783380,1699798080,14700,172606,90142,US,US
76792,1700336940,1700349420,12480,50939,119890,ES,ES
117907,1700518860,1700532540,13680,92890,17031,US,US
56508,1700645760,1700679540,33780,70280,149292,TR,TR
159248,1699192620,1699201560,8940,63399,39944,FI,PL
77307,1700117820,1700127000,9180,110578,5310,IT,IT
155225,1700048280,1700065560,17280,113291,155049,CZ,CZ
72770,1698837480,1698873360,35880,50479,116200,TR,TR
50294,1699268340,1699301160,32820,41831,122094,TR,TR
134534,1699066740,1699083600,16860,30569,22551,FR,FR
159815,1700193060,1700223600,30540,72181,35583,TR,TR
56788,1699650180,1699685940,35760,26922,113197,TR,TR
37748,1699708860,1699720140,11280,57443,128412,IT,IT
24836,1699233480,1699242360,8880,120473,142794,HR,DE
117437,1698849840,1698866280,16440,197389,120417,CZ,CZ
189785,1700835420,1700851020,15600,59051,125386,US,US
41050,1700129100,1700136840,7740,40074,110235,HR,HR
72538,1699927560,1699937640,10080,171462,63801,HR,HR
107229,1700575200,1700592480,17280,70429,21126,RS,HU
137509,1700546520,1700599020,52500,154112,176663,BG,DE
26910,1699732200,1699735800,3600,175602,198532,GB,GB
172158,1699044480,1699077360,32880,175762,188746,TR,TR
175489,1700377440,1700384880,7440,101817,156680,IT,IT
62568,1700622420,1700627400,4980,143532,87731,GB,GB
133654,1700210100,1700218980,8880,13772,21444,ES,ES
192020,1700705640,1700736780,31140,156577,173389,TR,TR
160653,1700216580,1700220180,3600,177817,160546,NL,NL
109358,1699421340,1699448820,27480,195587,111287,HU,FR
68832,1698876720,1698886740,10020,48343,180468,IT,IT
60518,1699209780,1699245180,35400,186924,158077,TR,TR
158194,1699499700,1699503300,3600,188866,79975,GB,GB
46143,1698992160,1699024440,32280,152567,147260,TR,TR
98401,1698846180,1698868320,22140,167003,158237,BR,BR
100643,1700317620,1700325120,7500,118143,19944,AD,ES
50643,1699604880,1699613100,8220,191597,99848,HR,HR
1928,1700153220,1700188320,35100,141137,114130,TR,TR
5846,1700382360,1700390400,8040,8046,140706,PT,PT
81948,1698801240,1698812580,11340,175761,190893,US,US
44946,1700047920,1700060940,13020,154289,156810,IT,IT
131064,1699573260,1699591200,17940,116728,75490,US,US
101290,1699973580,1700008380,34800,121696,114515,MX,US
141498,1700452800,1700485980,33180,80888,20278,TR,TR
55477,1700405280,1700437020,31740,54992,130658,TR,TR
110537,1699545720,1699575120,29400,84959,117328,TR,TR
107439,1698893340,1698905460,12120,87965,17625,US,US
174740,1699379880,1699411800,31920,160598,109482,TR,TR
63954,1700763600,1700778060,14460,187478,105870,CZ,CZ
100887,1699087620,1699118820,31200,181427,22316,TR,TR
18948,1700757120,1700790000,32880,178936,188772,TR,TR
27249,1700660580,1700675820,15240,152283,177132,US,US
26470,1700584380,1700601180,16800,183572,181716,US,US
152487,1699688640,1699744560,55920,177780,58709,BG,DE
108874,1698982980,1698997140,14160,9183,85728,US,US
69250,1700759700,1700771940,12240,87878,82065,US,CA
122228,1700589300,1700593500,4200,55713,136932,GB,GB
74576,1699283760,1699315680,31920,43087,172385,TR,TR
33813,1699420200,1699456020,35820,183899,28557,TR,TR
193413,1700589180,1700604600,15420,157360,163371,AT,AT
90577,1699839480,1699852380,12900,129888,184247,US,US
163641,1699852740,1699886760,34020,63635,57023,TR,TR
79814,1700792100,1700827500,35400,145859,169924,TR,TR
145522,1698966900,1698978300,11400,197374,157294,US,US
90808,1700508300,1700543400,35100,63217,78654,TR,TR
189394,1698857340,1698889140,31800,26277,58415,TR,TR
22889,1699730220,1699735680,5460,35735,188310,NL,NL
186399,1700654700,1700662920,8220,13674,33767,HR,BA
179971,1699042740,1699080060,37320,91242,6723,MX,MX
173116,1700712540,1700735220,22680,66017,93326,DE,IT
119769,1699453260,1699459740,6480,98609,171200,GB,GB
198419,1700753760,1700766240,12480,174717,187935,PT,PT
28948,1700797980,1700813940,15960,115360,116266,US,US
169076,1700789760,1700795640,5880,100274,78462,GB,GB
160835,1700462940,1700492160,29220,1352,4413,TR,TR
52229,1699964700,1699998900,34200,192870,185453,TR,TR
26740,1700749920,1700770980,21060,185144,121994,DK,DK
66093,1700368080,1700373540,5460,183010,143538,GB,GB
34068,1699264260,1699275480,11220,84614,138622,IT,IT
135230,1699340700,1699367100,26400,124035,113758,RO,AT
129053,1700212500,1700228760,16260,64409,175168,BE,NL
15093,1698963060,1698995520,32460,162048,173419,TR,TR
75130,1699033200,1699055160,21960,172101,33485,PL,PL
31808,1700813820,1700844000,30180,69016,40508,TR,TR
100090,1700475240,1700504700,29460,127649,11094,TR,TR
154973,1700384640,1700416140,31500,77753,11400,TR,TR
152561,1700719260,1700746740,27480,93398,76744,BR,BR
83763,1700461740,1700471880,10140,73812,159939,IT,IT
173553,1700366520,1700398380,31860,55588,113625,TR,TR
84143,1700739480,1700775120,35640,104922,68266,TR,TR
191327,1700174280,1700228580,54300,50723,12317,BG,AT
106706,1699947720,1699951320,3600,170364,65838,GB,GB
122205,1698864240,1698887520,23280,129392,29698,DE,PL
16406,1699346640,1699380840,34200,120478,137548,TR,TR
107804,1700840400,1700860320,19920,5793,183965,FR,IT
178936,1700591760,1700602200,10440,50168,42694,HR,HR
179478,1700130780,1700157360,26580,23082,18247,PL,PL
102398,1699037400,1699051140,13740,43288,93230,US,US
26647,1700328000,1700334480,6480,76353,80411,NL,NL
193816,1699921620,1699925640,4020,82193,101765,GB,GB
87341,1699008300,1699011900,3600,120461,133438,GB,GB
196321,1700260380,1700275860,15480,143148,51553,FR,FR
92230,1699268760,1699282380,13620,167165,111191,IT,CH
41316,1699749240,1699761060,11820,10152,133754,HR,HR
163411,1700175900,1700185080,9180,138619,61734,IT,IT
63207,1699097820,1699130160,32340,95178,198906,TR,TR
116091,1700214840,1700228820,13980,150179,86226,IT,IT
157878,1700617560,1700635500,17940,159671,196808,US,MX
18583,1700613840,1700647920,34080,71594,56128,TR,TR
41329,1700126880,1700134740,7860,136365,81295,PT,PT
110100,1698879780,1698913080,33300,75619,78547,TR,TR
147723,1700231700,1700249460,17760,74871,120453,US,US
21285,1698877260,1698900840,23580,36429,26071,DE,DE
116757,1699904760,1699929240,24480,19690,177290,PL,PL
136938,1700380800,1700394360,13560,30019,23148,CA,CA
101081,1700339880,1700363100,23220,150903,107569,DK,NO
171752,1699581540,1699609620,28080,147683,67508,PL,NL
160404,1699556880,1699571700,14820,57766,39008,US,US
198527,1698988080,1699016880,28800,7973,120175,TR,TR
153568,1699744920,1699777500,32580,41637,101514,TR,TR
187036,1699132200,1699167540,35340,145328,143210,TR,TR
38445,1700013720,1700041800,28080,98893,10878,DE,IT
139902,1700046120,1700050440,4320,91189,44975,GB,GB
128039,1698795780,1698808020,12240,62078,129874,US,US
126566,1700758560,1700789880,31320,75239,112804,TR,TR
177913,1700556720,1700560500,3780,108774,122086,NL,NL
89614,1699240980,1699256700,15720,71080,119050,CZ,CZ
60701,1699396140,1699406520,10380,55528,180535,IT,IT
156639,1699297260,1699332060,34800,120194,143244,TR,TR
3759,1699968000,1699985280,17280,100361,196395,AT,HU
105374,1699854960,1699887900,32940,34420,41725,TR,TR
5297,1700107980,1700140500,32520,37992,98219,TR,TR
132415,1699562400,1699597260,34860,32127,168852,TR,TR
117012,1700581800,1700591520,9720,143267,184164,IT,IT
106010,1699053780,1699083000,29220,84724,99329,TR,TR
49234,1700285700,1700298060,12360,67301,37902,IT,IT
102006,1699946760,1699969620,22860,55054,178249,PL,DK
60203,1700587080,1700600100,13020,50647,7733,US,US
80040,1698959760,1698970680,10920,158484,180621,IT,IT
49851,1699148760,1699168020,19260,88479,109772,FR,FR
17795,1699607640,1699638420,30780,118957,59853,TR,TR
21324,1700683680,1700699580,15900,39111,104781,US,US
192383,1700048100,1700057640,9540,84488,39446,IT,IT
53769,1698807480,1698842040,34560,68829,171417,TR,TR
56109,1698842040,1698871140,29100,170048,49811,TR,TR
196695,1700630520,1700648820,18300,160412,3879,FR,FR
155169,1699733460,1699767720,34260,30907,164896,TR,TR
11913,1699374420,1699406340,31920,165035,190033,TR,TR
37782,1699323960,1699337940,13980,32407,81021,US,US
85317,1699900800,1699908120,7320,53134,84754,IT,IT
154149,1699789680,1699794060,4380,118675,162343,GB,GB
16497,1699387920,1699396800,8880,6689,104562,IT,IT
65493,1699116840,1699147920,31080,35643,80392,TR,TR
79530,1699088520,1699092180,3660,184514,139601,NL,NL
44757,1699782780,1699812540,29760,41616,166252,TR,TR
135890,1699096260,1699126920,30660,108598,85400,TR,TR
79682,1699368480,1699381620,13140,160288,176237,IT,IT
168342,1698952320,1698985560,33240,178418,140266,TR,TR
113614,1698848700,1698862200,13500,177830,76462,IT,IT
143074,1699142580,1699176480,33900,135088,38023,TR,TR
5507,1699764120,1699769820,5700,106368,78061,GB,GB
42273,1700475120,1700492040,16920,136598,110359,FR,FR
193941,1699408800,1699442640,33840,137781,170037,TR,TR
143122,1698969540,1698981780,12240,185732,135416,US,US
14636,1700580600,1700601720,21120,137760,22328,MD,RO
28710,1700374680,1700385840,11160,185844,55787,CZ,CZ
2129,1700116980,1700146140,29160,5942,65015,TR,TR
42755,1700777580,1700781180,3600,174507,182835,NL,NL
37280,1700539980,1700564100,24120,53008,119951,CH,FR
17450,1699923540,1699927140,3600,136211,178158,GB,GB
17403,1699800960,1699831380,30420,163197,112766,TR,TR
47819,1700333040,1700336640,3600,170250,23789,NL,NL
127609,1700802480,1700807280,4800,168265,31861,GB,GB
182245,1700367540,1700377620,10080,15057,99826,SK,SK
199406,1700819940,1700854080,34140,123811,111930,TR,TR
148771,1700279700,1700290080,10380,103764,26626,PT,PT
105929,1699723020,1699738380,15360,193732,196624,US,US
11315,1700328300,1700355480,27180,167241,103549,PL,PL
192563,1700325420,1700349480,24060,83554,38878,DK,DE
26126,1700863560,1700874660,11100,192099,71385,US,US
39370,1699797180,1699809240,12060,60123,150636,US,US
133745,1699332960,1699362360,29400,38358,178885,TR,TR
130466,1699344240,1699376640,32400,35314,140222,TR,TR
104946,1700556240,1700583600,27360,109438,106395,BR,BR
140892,1699804860,1699836600,31740,19855,12760,TR,TR
170533,1699934220,1699946580,12360,172919,42728,US,US
87238,1698918780,1698935280,16500,135889,185937,BE,NL
46837,1699695780,1699728000,32220,173104,107762,TR,TR
92113,1699297620,1699333080,35460,82910,53552,TR,TR
33867,1699638540,1699651680,13140,122706,63605,US,US
35914,1700341200,1700350140,8940,159922,34225,IT,IT
167141,1699904280,1699907880,3600,122564,116865,NL,NL
37745,1699560840,1699572600,11760,149655,136882,IT,IT
58256,1700353380,1700358000,4620,147772,42533,NL,NL
193588,1699741560,1699772700,31140,145655,21579,TR,TR
177921,1699362060,1699365660,3600,93507,6208,NL,NL
172928,1699503720,1699516440,12720,162305,42889,SK,SK
96247,1699701840,1699734480,32640,153462,9952,TR,TR
135432,1699888680,1699920600,31920,109367,156833,TR,TR
101430,1699912800,1699920780,7980,35225,163023,IT,IT
90953,1700252640,1700282580,29940,186215,23308,TR,TR
122368,1700037180,1700069100,31920,121444,144413,TR,TR
81676,1700647920,1700661180,13260,14414,69063,US,US
198383,1700581800,1700587380,5580,91430,97688,NL,NL
78545,1700738100,1700741700,3600,193705,47689,NL,LU
168480,1700753220,1700768820,15600,44077,82873,FR,ES
48598,1700262900,1700294160,31260,20526,49051,TR,TR
164383,1700845080,1700852100,7020,79378,122098,GB,GB
5743,1700353320,1700369340,16020,15130,176292,FR,DE
164669,1700614620,1700618220,3600,127085,193608,GB,GB
15184,1699514940,1699546260,31320,2142,95522,TR,TR
121006,1700826660,1700860500,33840,25060,84905,TR,TR
89449,1699638540,1699654620,16080,44785,73202,RS,RS
123138,1699536120,1699567320,31200,73272,159895,TR,TR
193823,1699482480,1699486140,3660,60497,42655,GB,GB
75930,1700390580,1700416560,25980,144563,163034,BR,BR
56643,1699924800,1699928400,3600,174843,148356,GB,GB
40788,1700170620,1700174220,3600,66019,26329,NL,NL
60777,1699274460,1699292280,17820,156432,56097,US,US
72341,1699566300,1699581840,15540,81327,84073,RS,RS
83931,1700356260,1700373780,17520,54589,30714,CZ,CZ
77512,1700574060,1700604360,30300,79354,67337,TR,TR
181020,1700683200,1700714280,31080,14709,68487,TR,TR
73126,1700198760,1700214840,16080,12608,114655,US,CA
140701,1700810820,1700814420,3600,147874,73139,NL,NL
38731,1699875660,1699906320,30660,104001,58132,TR,TR
141081,1699053060,1699070940,17880,156600,185985,FR,IT
72194,1699675560,1699679160,3600,151509,58667,GB,GB
103838,1698930180,1698942840,12660,195047,91397,HR,HR
54766,1700228820,1700241960,13140,95721,186241,US,US
61259,1700046540,1700071620,25080,22008,172588,DE,DE
88972,1700728380,1700763240,34860,48968,99837,MX,MX
20924,1700597340,1700630640,33300,62518,44910,TR,TR
106046,1700784660,1700789760,5100,35687,44592,GB,GB
170003,1700768040,1700773020,4980,113306,108895,GB,GB
156388,1699312440,1699343580,31140,162528,121098,TR,TR
40838,1699179960,1699193580,13620,3686,144346,IT,IT
3388,1699181640,1699213140,31500,97015,44179,TR,TR
71003,1700639400,1700673600,34200,21485,151783,TR,TR
64534,1699138500,1699155480,16980,78702,158795,CZ,CZ
118649,1699492620,1699522920,30300,43078,26078,TR,TR
52790,1699518000,1699552440,34440,57320,36879,TR,TR
5480,1698834540,1698847860,13320,175259,70455,HR,IT
180329,1699738620,1699752420,13800,78509,43698,US,US
69630,1700425320,1700449920,24600,8946,177447,PL,LV
199741,1700538660,1700574420,35760,15756,127263,TR,TR
161585,1699051920,1699073880,21960,193476,107330,DE,DE
93569,1699192380,1699204380,12000,25080,29617,AT,AT
184103,1700275320,1700278920,3600,157072,81006,NL,NL
194731,1699672920,1699684020,11100,11183,115781,US,US
28510,1698942360,1698972480,30120,74172,30817,TR,TR
52067,1698980760,1698988440,7680,150261,40617,HR,BE
86464,1699732020,1699743960,11940,190704,118135,IT,CH
83977,1698901560,1698912420,10860,3005,167964,US,US
13035,1698827280,1698857880,30600,50403,86011,TR,TR
153942,1700820900,1700873820,52920,10640,77661,BG,DE
71638,1700453220,1700483400,30180,145370,54167,TR,TR
118672,1700622960,1700655900,32940,26648,130414,TR,TR
154499,1699601340,1699613400,12060,17526,8672,IT,IT
35130,1699424580,1699459140,34560,96988,14839,TR,TR
196447,1699791180,1699822440,31260,164037,151531,TR,TR
62532,1698997740,1699008120,10380,129516,136496,SK,PL
196056,1699772220,1699775820,3600,80280,136463,GB,GB
26939,1699660020,1699667700,7680,6928,153932,IT,IT
162143,1700436180,1700449980,13800,157619,155947,IT,IT
72933,1699675680,1699692900,17220,112336,102896,FR,ES
159221,1699919820,1699932600,12780,119885,72809,ES,ES
156676,1700562960,1700586840,23880,103560,147933,RO,RO
44459,1699623840,1699634760,10920,100111,190505,US,US
37266,1700568360,1700598840,30480,194446,69138,TR,TR
63712,1700307720,1700325540,17820,130613,194621,US,US
193306,1699889100,1699923900,34800,178541,194579,TR,TR
129021,1699051200,1699064280,13080,173666,102657,US,US
15113,1699115640,1699119240,3600,198481,94271,NL,NL
63922,1699815900,1699845780,29880,31670,183021,TR,TR
144540,1700178300,1700210520,32220,84260,28391,TR,TR
103841,1700151720,1700180820,29100,139115,120095,TR,TR
82412,1700457180,1700491560,34380,147797,162971,TR,TR
45868,1700312760,1700347980,35220,137383,99479,TR,TR
148170,1700798820,1700821260,22440,140581,5170,PL,FR
112193,1699127700,1699143660,15960,18983,71200,US,US
162351,1699393140,1699424760,31620,33149,176736,TR,TR
121748,1699706100,1699736880,30780,135599,176687,TR,TR
109767,1699848360,1699851960,3600,90626,142069,NL,NL
4324,1699731180,1699737540,6360,177488,93437,NL,NL
65201,1699036260,1699039860,3600,49674,138219,GB,GB
33567,1700466600,1700470200,3600,126930,47844,GB,GB
65553,1698939300,1698949860,10560,104041,182582,IT,IT
37397,1699409580,1699423860,14280,69200,124483,AT,AT
137679,1698976620,1699006440,29820,37705,181005,TR,TR
189590,1700251260,1700265000,13740,103554,21932,IT,IT
128475,1699599000,1699618080,19080,90561,170170,FR,IT
3862,1700365920,1700400060,34140,114040,35898,TR,TR
160612,1698893820,1698907740,13920,194089,21051,PT,PT
121765,1700180580,1700190840,10260,49828,40587,SK,AT
102895,1700232180,1700240460,8280,194609,192443,HR,HR
20032,1698975120,1698980940,5820,112725,66452,GB,GB
109110,1699324860,1699354500,29640,143726,19674,TR,TR
82908,1699042440,1699046040,3600,101608,174117,GB,GB
193628,1700865660,1700904600,38940,164958,107884,MX,MX
10504,1698910320,1698921000,10680,110481,149660,HR,HR
174443,1700390520,1700394120,3600,125003,131421,GB,GB
1979,1700704920,1700715360,10440,28361,31401,HR,HR
67455,1700488920,1700521500,32580,114709,93223,TR,TR
115911,1699755240,1699786920,31680,163286,199410,TR,TR
49956,1700029260,1700035200,5940,80248,61769,NL,NL
159828,1700654220,1700660160,5940,98384,37507,GB,GB
87316,1698908640,1698917100,8460,164399,91086,IT,IT
105725,1698938340,1698952200,13860,70616,38198,US,US
66881,1700077260,1700080860,3600,51961,124993,GB,GB
171056,1699719480,1699751940,32460,156363,108983,TR,TR
94520,1700656740,1700660340,3600,41059,196380,NL,BE
169067,1699749420,1699753020,3600,108399,157008,GB,GB
67230,1698811440,1698842100,30660,105303,129118,TR,TR
82834,1699752360,1699763040,10680,63938,96248,IT,IT
110339,1700384400,1700420280,35880,2734,35018,TR,TR
34233,1698856440,1698891240,34800,71646,108844,TR,TR
174117,1699916880,1699947180,30300,108771,18861,TR,TR
52993,1699922940,1699935720,12780,16367,145900,US,US
96541,1700857140,1700891580,34440,188070,6371,TR,TR
153507,1698896100,1698921000,24900,162882,199512,PL,PL
44369,1699309620,1699313220,3600,97053,136631,GB,GB
112851,1699842780,1699853100,10320,13221,159624,IT,IT
45091,1699668060,1699700400,32340,3258,171775,TR,TR
22474,1700759100,1700792280,33180,76579,167044,TR,TR
2642,1699291560,1699306200,14640,70247,151475,AT,AT
102089,1700520600,1700551500,30900,155750,125615,TR,TR
171043,1700629860,1700663580,33720,132946,43491,TR,TR
154501,1698939600,1698945960,6360,175470,159448,GB,GB
132941,1700822160,1700876340,54180,147984,22877,BG,BG
22176,1700424600,1700460540,35940,97815,62355,TR,TR
59920,1699450260,1699459440,9180,86117,63782,HR,HR
178154,1700771820,1700788980,17160,186979,29155,FR,FR
181322,1699778880,1699795500,16620,178551,160745,BE,FR
122711,1700108880,1700112480,3600,18996,101786,NL,NL
26094,1700571300,1700587740,16440,86999,108457,FR,FR
28176,1700259840,1700289180,29340,184203,122801,TR,TR
187305,1699480320,1699509540,29220,175372,105469,TR,TR
129261,1700570700,1700602860,32160,27430,188270,TR,TR
11224,1699733160,1699747920,14760,161576,8849,SE,DE
127602,1698832860,1698850680,17820,78102,155268,FR,FR
5982,1700410080,1700433900,23820,162680,155224,DE,AT
53256,1700391660,1700396460,4800,174881,69970,GB,GB
51319,1699782720,1699811880,29160,125452,134462,TR,TR
172347,1700853660,1700909940,56280,193981,53824,BG,BG
47601,1699779000,1699808520,29520,35767,55065,TR,TR
137198,1698808500,1698817620,9120,179645,17521,HR,HR
156063,1700282340,1700292720,10380,192468,84638,IT,FR
35493,1700181780,1700185380,3600,78104,17515,GB,GB
132021,1698987540,1699021800,34260,38462,29620,TR,TR
1333,1700738520,1700763480,24960,97327,44248,PL,UA
73226,1699222620,1699256940,34320,102473,141660,TR,TR
4369,1699179780,1699213500,33720,174650,32192,TR,TR
107518,1700337660,1700360160,22500,110615,166090,HU,AT
55415,1699682580,1699693200,10620,178831,94121,HR,HR
75560,1700177880,1700203800,25920,54243,27238,PL,PL
199974,1698997140,1699004100,6960,115622,92759,NL,NL
59664,1700745300,1700758440,13140,31932,162228,IT,IT
5540,1700235600,1700262000,26400,113114,44359,DE,FR
17297,1700525760,1700531220,5460,102173,186411,NL,NL
169611,1700409480,1700422440,12960,187738,158029,IT,IT
185220,1700777100,1700806440,29340,110716,191990,TR,TR
36421,1699218060,1699251120,33060,95380,163131,TR,TR
44093,1699400940,1699433880,32940,159406,152334,TR,TR
128862,1699679940,1699684080,4140,132156,23293,GB,GB
140610,1700514360,1700528940,14580,149588,192066,FR,NL
24839,1700376180,1700388240,12060,152791,138209,US,US
87358,1699943100,1699972800,29700,175181,183284,TR,TR
29683,1700438160,1700451300,13140,117876,98662,AT,AT
135088,1699896420,1699900020,3600,97800,61784,NL,NL
5068,1700163480,1700169180,5700,127994,14878,NL,BE
153745,1700798700,1700805480,6780,29815,108099,GB,GB
179910,1700603640,1700638680,35040,6101,35251,TR,TR
192973,1700360100,1700373660,13560,120433,155022,US,US
54494,1699875300,1699888560,13260,47171,24474,PT,PT
146668,1699174320,1699207320,33000,99029,10401,TR,TR
120645,1700319300,1700350320,31020,65586,109990,TR,TR
186047,1699071180,1699103640,32460,71399,161403,TR,TR
155132,1699505280,1699519020,13740,27208,80377,PT,PT
44314,1700196060,1700207100,11040,140150,6106,US,US
111089,1699104240,1699116720,12480,84093,14820,IT,DE
94261,1699047120,1699060380,13260,148587,75689,US,US
91137,1700791800,1700803140,11340,153811,165461,IT,IT
127857,1699583160,1699617960,34800,80458,25150,TR,TR
30551,1699140480,1699155660,15180,187473,61142,FR,FR
78378,1699137120,1699149780,12660,84165,181442,RS,MK
8346,1699751640,1699786740,35100,87285,87232,TR,TR
86015,1699366260,1699401900,35640,50,161874,TR,TR
73148,1699349100,1699383300,34200,173621,73057,TR,TR
151302,1699888920,1699923120,34200,113122,183880,TR,TR
130428,1699784400,1699808520,24120,76482,196819,RO,RO
7614,1699200180,1699232280,32100,25240,91353,TR,TR
144846,1700332440,1700365680,33240,18366,122286,MX,MX
75847,1699458480,1699466820,8340,150853,47125,ES,ES
48575,1700060280,1700092440,32160,138324,77573,TR,TR
59208,1699093320,1699107600,14280,156926,183009,HR,BA
41566,1699671120,1699697220,26100,172591,91202,ME,BA
67930,1699426080,1699442820,16740,103790,81492,US,US
14197,1698999900,1699017720,17820,63654,55934,AT,BG
125970,1700132100,1700147760,15660,33875,68240,FR,FR
38958,1700177700,1700209560,31860,42065,153593,TR,TR
47629,1700712420,1700726460,14040,43895,92448,US,US
140231,1700185380,1700200320,14940,15189,193746,US,US
1602,1699365240,1699378440,13200,168041,80169,ES,ES
182413,1699250340,1699266960,16620,101102,42504,US,US
42927,1700406360,1700435820,29460,177903,177807,BA,DE
11892,1698928680,1698962520,33840,85322,99841,TR,TR
183096,1699039320,1699071180,31860,40597,171247,TR,TR
33564,1699326960,1699359000,32040,43894,52154,TR,TR
100190,1700424900,1700434740,9840,49232,158722,PT,ES
120811,1700362500,1700389320,26820,84910,11791,DE,DE
47945,1699723020,1699752060,29040,62400,156003,TR,TR
98958,1700196720,1700204280,7560,56112,37046,HR,HR
179327,1700348700,1700365980,17280,196134,83470,CZ,CZ
96846,1699077840,1699111020,33180,108374,191188,TR,TR
10271,1699228440,1699263180,34740,129345,159813,TR,TR
64715,1699196040,1699211280,15240,196371,102522,US,US
64470,1700035620,1700039700,4080,97747,103215,CL,CL
161837,1699600680,1699634520,33840,122109,62565,TR,TR
102940,1700493180,1700503560,10380,84345,191259,IT,IT
56373,1699345860,1699363620,17760,158909,48065,AT,SK
38349,1699884360,1699893960,9600,17813,162538,IT,FR
16900,1700105760,1700113800,8040,53868,168591,IT,IT
58517,1700842260,1700873340,31080,93650,129268,TR,TR
125874,1699471140,1699480560,9420,115375,169882,ES,ES
27853,1699645620,1699661460,15840,76543,36034,US,US
47494,1700575980,1700579580,3600,128068,3069,GB,GB
115517,1700171820,1700186580,14760,55440,149445,FR,FR
25480,1699838820,1699866720,27900,148212,108083,DE,DE
149117,1700099880,1700110860,10980,154310,194435,ES,ES
33509,1699910880,1699917300,6420,113523,52355,GB,GB
49092,1699596960,1699628460,31500,52,168734,TR,TR
6533,1698978840,1699013400,34560,143203,21648,TR,TR
35760,1700414880,1700428980,14100,105661,108572,US,US
88747,1700636280,1700649720,13440,140834,38460,US,US
174255,1700849400,1700865120,15720,56552,122702,US,CA
61903,1700384400,1700388840,4440,99001,107736,GB,GB
158420,1699972500,1700004180,31680,86632,107721,TR,TR
84758,1699392360,1699407780,15420,39691,103514,US,US
19145,1699187160,1699190760,3600,181584,95781,GB,GB
97135,1699350240,1699354980,4740,188510,10608,NL,BE
174535,1699463340,1699497240,33900,149046,104597,TR,TR
140440,1699284000,1699317300,33300,63889,108333,TR,TR
15722,1699942740,1699947300,4560,124284,54731,GB,GB
51904,1698878280,1698912420,34140,52912,12370,MX,MX
49035,1700543580,1700560680,17100,55407,112392,US,US
91888,1700154360,1700165940,11580,174553,48030,US,US
189081,1700813280,1700847120,33840,133490,127929,TR,TR
61858,1700429040,1700460840,31800,69825,88883,TR,TR
169883,1699889760,1699940760,51000,76585,6847,BG,DE
100698,1700755080,1700776080,21000,11330,75988,FR,IT
185743,1698948060,1698962400,14340,5469,92552,IT,IT
59828,1700458140,1700471400,13260,4314,169744,IT,IT
166763,1699957800,1699961400,3600,93385,187328,GB,GB
147260,1699924800,1699940400,15600,47969,140565,FR,FR
165579,1700215620,1700246460,30840,123655,170280,TR,TR
131182,1699188780,1699218900,30120,153285,123634,TR,TR
149600,1699332240,1699354560,22320,14381,2756,DE,FR
58470,1700227620,1700231220,3600,80670,119703,GB,GB
167371,1699648680,1699659480,10800,121365,155424,US,US
34051,1699568040,1699595460,27420,171824,113776,DE,NL
54348,1700558160,1700589660,31500,78834,161424,TR,TR
141899,1699445280,1699448880,3600,30462,9405,NL,NL
81287,1700113020,1700144220,31200,116177,29445,TR,TR
132259,1700764320,1700799660,35340,74621,72017,TR,TR
136612,1700366340,1700397300,30960,60154,6512,TR,TR
135431,1700331480,1700356920,25440,78332,162873,DE,DE
100004,1699627680,1699637160,9480,9906,14786,IT,IT
30592,1700011140,1700041680,30540,95151,71376,TR,TR
8608,1700692380,1700728080,35700,178169,28501,TR,TR
147749,1700775840,1700806320,30480,56673,197291,TR,TR
156272,1699187520,1699191120,3600,157977,73884,GB,GB
119678,1699395360,1699425720,30360,54606,54092,TR,TR
2156,1700523780,1700554320,30540,99874,180390,TR,TR
87583,1700111340,1700143080,31740,41962,170522,TR,TR
118759,1699822980,1699857780,34800,90209,169636,TR,TR
195593,1699499340,1699506780,7440,16123,103630,IT,IT
187845,1699400580,1699426140,25560,68857,4428,PL,DE
46480,1700002140,1700018520,16380,21125,84335,CZ,CZ
89072,1700431200,1700434800,3600,282,19784,GB,GB
38811,1700067840,1700079840,12000,191100,172592,HR,HR
51683,1700316180,1700322720,6540,32253,61044,GB,GB
192831,1699468440,1699478520,10080,41900,135914,PT,PT
90294,1699055280,1699087560,32280,93082,111033,TR,TR
84992,1698993120,1699000440,7320,28594,185909,IT,IT
156190,1700137200,1700141040,3840,161364,43557,GB,GB
6030,1699063740,1699097520,33780,10845,58761,TR,TR
8885,1700391000,1700425020,34020,42310,29632,TR,TR
148510,1700218320,1700251500,33180,189949,104961,TR,TR
115397,1699636560,1699640160,3600,89597,148749,GB,GB
14107,1700396280,1700425800,29520,34729,97381,TR,TR
7627,1698816480,1698832140,15660,180757,26686,FR,FR
13957,1698822540,1698826380,3840,183819,188498,NL,NL
175180,1700112000,1700119320,7320,47484,116386,HR,HR
26054,1699895940,1699905660,9720,110625,152669,ES,ES
80575,1699569960,1699602240,32280,174615,41091,TR,TR
52191,1700273580,1700309520,35940,126323,18687,TR,TR
134568,1700661540,1700696340,34800,17769,172085,TR,TR
120652,1700703720,1700707320,3600,121279,177113,NL,NL
108531,1700065740,1700080620,14880,143635,77766,FR,BE
84102,1700261160,1700272200,11040,172981,122827,US,US
48249,1700192520,1700199360,6840,112222,127887,GB,GB
187740,1699671060,1699682760,11700,66472,171310,IT,IT
109822,1699504140,1699513680,9540,24642,115202,IT,IT
69439,1699789380,1699796820,7440,178411,116254,EE,EE
69349,1699973220,1700000220,27000,15666,82422,DE,SE
22154,1698901680,1698930480,28800,157120,74344,TR,TR
160794,1700423520,1700439120,15600,170238,192731,BE,DE
156702,1699642380,1699645980,3600,188779,191379,GB,GB
19346,1699657440,1699686780,29340,100127,182958,TR,TR
96301,1699929480,1699961880,32400,127761,105677,TR,TR
169822,1699764900,1699796640,31740,148049,152092,TR,TR
126180,1699381980,1699385580,3600,37103,127700,NL,NL
153421,1699117260,1699120860,3600,58398,4973,GB,GB
186938,1699638360,1699666860,28500,114424,163482,RO,RO
9176,1699600020,1699632480,32460,149533,27317,MX,MX
85465,1699546500,1699558200,11700,168545,16830,IT,IT
135418,1699577040,1699590480,13440,2990,1650,IT,IT
92311,1699372500,1699377960,5460,165632,68801,NL,NL
168346,1699156260,1699180860,24600,196118,147023,DE,IT
116817,1699764240,1699794480,30240,156,13619,TR,TR
10787,1700572980,1700576580,3600,172692,170050,NL,NL
99554,1700553180,1700582160,28980,133670,163757,TR,TR
123639,1700497560,1700528640,31080,175731,76523,TR,TR
106653,1700185740,1700189340,3600,151610,161297,NL,NL
18864,1700549580,1700553840,4260,183025,103189,GB,GB
105710,1700117460,1700149200,31740,32861,112496,TR,TR
81056,1700004180,1700038740,34560,192701,28770,TR,TR
41422,1700068200,1700097780,29580,103686,85838,TR,TR
68560,1700203860,1700236200,32340,62398,39376,TR,TR
154286,1700463180,1700497800,34620,99570,135415,TR,TR
93758,1700095200,1700128800,33600,18760,104720,TR,TR
31545,1699709700,1699723860,14160,50520,159299,US,US
69557,1700302080,1700337060,34980,42123,170290,TR,TR
169832,1699765020,1699779060,14040,96345,20873,US,US
9336,1700068080,1700082000,13920,55069,115684,IT,IT
200,1699944840,1699955340,10500,113376,6695,IT,IT
161050,1699065840,1699095840,30000,135494,14050,TR,TR
192683,1699783260,1699817340,34080,71482,103932,TR,TR
92161,1699083480,1699087080,3600,158537,125562,NL,NL
194055,1700616660,1700651100,34440,98254,142364,TR,TR
19893,1700613780,1700630580,16800,144758,154352,US,US
175063,1700007720,1700024820,17100,11977,93196,US,US
84980,1700449680,1700462760,13080,62761,73279,IT,IT
174576,1698939120,1698971520,32400,79336,133057,TR,TR
123815,1698920880,1698932100,11220,149936,69399,US,US
49448,1700168040,1700197500,29460,49929,188807,TR,TR
126512,1699291500,1699318140,26640,30715,46599,PL,PL
25127,1700542860,1700573280,30420,104795,32995,TR,TR
7535,1699862880,1699895340,32460,27922,189818,TR,TR
51457,1699548060,1699560180,12120,119776,190068,US,US
47834,1699994580,1700001540,6960,44882,47789,NL,NL
150557,1699700160,1699733520,33360,8600,66826,TR,TR
189006,1698934440,1698963660,29220,99698,51943,TR,TR
152778,1700036760,1700066400,29640,153614,195896,TR,TR
185283,1699475400,1699507740,32340,14340,121084,TR,TR
25825,1699677540,1699688880,11340,41352,2358,US,US
68040,1699115520,1699119540,4020,122994,18795,CL,CL
84264,1700669220,1700699760,30540,113457,34489,TR,TR
147868,1699309080,1699322520,13440,65117,66986,US,US
175149,1699191780,1699202820,11040,25628,99448,IT,IT
195243,1699663980,1699697880,33900,156269,12164,TR,TR
177536,1700752140,1700755740,3600,188848,68735,GB,GB
189969,1698980040,1698983640,3600,157449,43849,GB,GB
170279,1699014840,1699049820,34980,140336,182371,TR,TR
189498,1700806020,1700811720,5700,117267,14446,EE,EE
66310,1700442840,1700449980,7140,135556,43493,GB,GB
20288,1699087800,1699118100,30300,65925,5629,TR,TR
190891,1699730100,1699761120,31020,176020,66113,TR,TR
64527,1699959060,1699966320,7260,126164,3587,IT,IT
103901,1699249920,1699263960,14040,122290,154225,US,US
160672,1698898080,1698925680,27600,43780,63472,DE,NL
94844,1699584720,1699599180,14460,12451,46790,US,US
131831,1699916040,1699933080,17040,159853,110616,US,US
167135,1700788200,1700821380,33180,166121,25074,TR,TR
4102,1699972560,1699990620,18060,1406,151277,BE,FR
170758,1699569300,1699597200,27900,129750,169785,DE,CZ
125346,1699663020,1699672020,9000,169178,126385,HR,HR
196247,1700443680,1700476980,33300,111457,61342,TR,TR
196685,1699169760,1699193760,24000,80375,31613,PL,PL
147052,1698994500,1699019820,25320,17718,104524,CH,FR
123207,1699572060,1699576500,4440,100058,188039,NL,NL
72533,1699729800,1699763220,33420,1805,197765,TR,TR
52094,1699897680,1699930500,32820,6837,143647,TR,TR
174654,1699785720,1699816500,30780,68975,177874,TR,TR
97299,1700336760,1700354460,17700,1361,13119,FR,BE
80231,1699573380,1699601520,28140,49424,3435,DE,DE
19689,1699945500,1699981320,35820,133757,71521,TR,TR
138684,1699879080,1699885080,6000,54519,103195,GB,GB
25437,1698872940,1698888120,15180,105518,157650,BE,FR
14341,1700141340,1700158020,16680,3908,106714,CZ,CZ
90188,1700665500,1700717460,51960,57534,112051,BG,DE
161559,1698988980,1699001580,12600,21195,73930,US,US
100413,1699314480,1699321020,6540,57393,105466,GB,GB
192759,1700490720,1700523420,32700,24314,197052,TR,TR
199407,1700128980,1700146020,17040,73316,175055,US,US
192473,1699670820,1699700880,30060,186038,137998,TR,TR
122245,1699127820,1699162680,34860,96365,141058,TR,TR
29413,1698941940,1698955860,13920,67360,27481,US,US
162389,1699307700,1699332480,24780,196707,70785,DE,DE
41187,1699197120,1699226400,29280,184596,32196,TR,TR
75805,1699376400,1699382280,5880,6354,11436,EE,EE
61029,1700562540,1700598420,35880,52650,132421,TR,TR
102132,1699388340,1699400400,12060,88626,76955,IT,IT
121731,1700284140,1700294220,10080,13863,170762,IT,CH
164184,1699164780,1699176660,11880,133493,151118,AT,AT
33980,1699929420,1699942680,13260,80391,184521,IT,IT
5659,1699250280,1699284720,34440,119538,58629,MX,MX
10532,1699645680,1699654740,9060,171376,133671,PT,PT
178957,1700647380,1700650980,3600,52128,189279,NL,NL
1849,1699231200,1699261620,30420,2567,3049,TR,TR
198523,1700266680,1700299200,32520,115214,81175,TR,TR
100609,1699907340,1699941000,33660,105006,124539,TR,TR
34234,1698883500,1698917100,33600,16341,188009,TR,TR
183473,1700110020,1700115300,5280,47986,103570,GB,GB
96810,1700796000,1700799600,3600,147650,121216,GB,GB
184771,1698946500,1698968340,21840,194291,111256,RO,RO
151824,1700664000,1700678520,14520,21411,32972,US,US
37828,1699749600,1699761540,11940,59383,165494,IT,IT
150146,1700843820,1700855460,11640,144441,177597,HR,HR
44344,1699397940,1699412100,14160,23026,83124,HR,IT
151947,1700302320,1700312040,9720,6694,8456,IT,IT
107243,1699208580,1699212900,4320,160136,151854,GB,GB
6320,1700809320,1700844540,35220,82393,136985,TR,TR
97244,1698999180,1699012440,13260,120703,199500,US,US
38019,1699136700,1699170540,33840,182153,80820,TR,TR
105360,1699156020,1699189500,33480,132749,148482,TR,TR
142697,1700670660,1700682420,11760,64046,74712,ES,ES
106765,1699372260,1699387140,14880,18575,113208,US,US
92586,1699677600,1699695600,18000,159798,92861,FR,FR
133848,1698821760,1698832680,10920,148466,164000,ES,FR
185763,1699473360,1699497300,23940,161977,60328,BR,BR
106397,1699723560,1699735740,12180,87115,170469,US,CA
96754,1700469240,1700472840,3600,92476,167087,GB,GB
120526,1700526660,1700544840,18180,110927,101250,FR,NL
148791,1699173120,1699203960,30840,73623,128749,TR,TR
75806,1699224180,1699236840,12660,30188,89069,IT,IT
59796,1699474200,1699509120,34920,196254,11512,TR,TR
86820,1699698360,1699712400,14040,145280,96549,ES,AD
7770,1699990680,1700021940,31260,138816,106460,TR,TR
21163,1700343600,1700378340,34740,103422,132022,TR,TR
102147,1700328120,1700344200,16080,111927,183806,US,US
139913,1698862500,1698874320,11820,179354,44949,US,US
101038,1699840680,1699855680,15000,187245,11576,US,US
163817,1698932880,1698959580,26700,153275,134845,DE,DE
103905,1700035380,1700048220,12840,187907,104223,IT,IT
165174,1700294160,1700324520,30360,137372,145997,TR,TR
165603,1700119260,1700143020,23760,120048,93876,RO,DK
153707,1699334220,1699337820,3600,153393,53635,GB,GB
175444,1699759560,1699769640,10080,21199,147869,IT,IT
17498,1698956580,1698990960,34380,47497,34340,TR,TR
149884,1699211640,1699247160,35520,19665,54382,TR,TR
35291,1699284720,1699288320,3600,129610,130009,NL,NL
101858,1700191200,1700200440,9240,181186,79581,PT,PT
26538,1699893360,1699897560,4200,47895,185738,FI,EE
157596,1699966560,1699983480,16920,153504,67607,FR,FR
21915,1699175040,1699187880,12840,167028,161839,US,US
94446,1699569420,1699582740,13320,78166,71530,IT,IT
169831,1700648400,1700679960,31560,127674,89767,TR,TR
1592,1700595840,1700603220,7380,115344,87960,HR,HR
94438,1699649580,1699682220,32640,75129,173025,TR,TR
125135,1699286460,1699290060,3600,62841,151652,NL,DE
172771,1699240140,1699254120,13980,193942,84211,US,US
31394,1700615880,1700646120,30240,93958,165815,TR,TR
16754,1700078100,1700083740,5640,102497,9544,GB,GB
111249,1699736640,1699740540,3900,197686,196351,GB,GB
8543,1698838860,1698852720,13860,105471,88947,US,US
31983,1700324580,1700339040,14460,101863,30059,SE,SE
144656,1699495380,1699528500,33120,122384,103500,TR,TR
89758,1699537980,1699548660,10680,20210,95019,IT,IT
158899,1699723980,1699736520,12540,192536,192831,CZ,SK
59898,1699741740,1699754700,12960,399,69451,IT,IT
184413,1700144100,1700148780,4680,81923,99162,FI,EE
61631,1700549100,1700554440,5340,19297,30358,NL,PL
92873,1699099680,1699104300,4620,5452,147942,GB,GB
143118,1699352940,1699377600,24660,125215,60099,PL,DE
52904,1699363920,1699394640,30720,131688,135225,TR,TR
93611,1699163460,1699171980,8520,76833,55613,IT,NL
141217,1700631720,1700638560,6840,94931,8781,EE,FI
14043,1700194620,1700200920,6300,20306,51678,GB,GB
65947,1699714380,1699745400,31020,13591,160717,TR,TR
70069,1699630980,1699664760,33780,37695,190400,MX,MX
175380,1699766580,1699780560,13980,188458,186778,ES,FR
97346,1699168800,1699181880,13080,199251,186043,RS,RS
142106,1699407780,1699429740,21960,182283,154278,CH,FR
124281,1699015740,1699036680,20940,150528,12820,FR,ES
33158,1700549640,1700562180,12540,91771,60516,IT,IT
105283,1699797300,1699800900,3600,58193,73200,GB,GB
136362,1700282760,1700294880,12120,95345,30609,US,US
49684,1700342280,1700365200,22920,138282,51874,PL,PL
38276,1699627500,1699658460,30960,150738,92409,TR,TR
40835,1699331580,1699364460,32880,149009,137164,TR,TR
138784,1698991500,1699008600,17100,70123,116103,FR,PT
184314,1700363160,1700397240,34080,14863,153451,TR,TR
197206,1699567920,1699597320,29400,125623,169858,TR,TR
145218,1700343120,1700350140,7020,99667,68077,NL,NL
44185,1700700720,1700718660,17940,90031,192253,CZ,CZ
156552,1700483520,1700517840,34320,50250,43184,TR,TR
181890,1699185360,1699194420,9060,100433,21391,IT,IT
125489,1700717760,1700738040,20280,174947,95278,FR,FR
65428,1699645320,1699663080,17760,103133,177062,BE,FR
115590,1699987980,1699995660,7680,197190,89561,IT,IT
167154,1700610240,1700613840,3600,71620,76162,GB,GB
75240,1700200860,1700231640,30780,165551,31191,TR,TR
169546,1698907680,1698911280,3600,11391,24943,GB,GB
89388,1699292040,1699321740,29700,185761,179249,TR,TR
87522,1699680720,1699686660,5940,189989,161816,GB,GB
48704,1700215620,1700227260,11640,196942,155254,IT,IT
172386,1698824460,1698844080,19620,51645,52386,BE,NL
181167,1699592160,1699595760,3600,127410,79665,NL,NL
5495,1699104360,1699107960,3600,63324,88722,GB,GB
195010,1699783860,1699791600,7740,105762,151865,IT,HR
39208,1699013400,1699026420,13020,102958,76138,US,US
180134,1699405380,1699437180,31800,186794,8273,TR,TR
155014,1700377260,1700390640,13380,7393,52433,PT,PT
104589,1699078500,1699111920,33420,63777,151546,TR,TR
190447,1698977460,1699006980,29520,51568,99990,TR,TR
24110,1699221300,1699235160,13860,77797,175288,IT,IT
184569,1698955200,1698968880,13680,167053,136769,AT,AT
100411,1699327020,1699362480,35460,157869,144721,TR,TR
132142,1698810840,1698824460,13620,137278,79607,IT,IT
76339,1698910200,1698926100,15900,96969,90855,US,US
172726,1700365620,1700396220,30600,122740,31618,TR,TR
181900,1699525560,1699541700,16140,88534,4684,US,US
3692,1700109240,1700118120,8880,186512,158674,HR,HR
76919,1699294500,1699324980,30480,101884,53209,TR,TR
134931,1699848420,1699862520,14100,134940,87158,US,US
21224,1699842120,1699858860,16740,181049,118244,US,US
22821,1699461240,1699492560,31320,198599,115959,TR,TR
114403,1698944460,1698970080,25620,39661,111660,RO,RO
95589,1700457000,1700466300,9300,107280,16630,HR,HR
185474,1699300380,1699332480,32100,130893,73638,TR,TR
13217,1700758740,1700788320,29580,171749,52375,TR,TR
92635,1699860600,1699892760,32160,73850,143280,TR,TR
178771,1699420260,1699424880,4620,34409,15539,NL,NL
148637,1699983660,1700001180,17520,130352,79510,US,US
82578,1699900980,1699933860,32880,60201,195214,TR,TR
164708,1700774700,1700801220,26520,93787,168623,PL,PL
142349,1699072500,1699107480,34980,43210,187244,TR,TR
161136,1699750680,1699756920,6240,166564,22529,NL,NL
22991,1699548360,1699560240,11880,184924,67308,IT,IT
38306,1700666700,1700682420,15720,75651,63867,US,US
45796,1700560740,1700564340,3600,32684,32389,NL,NL
87016,1698845820,1698875760,29940,66158,14836,TR,TR
91350,1700085420,1700091900,6480,125377,126293,NL,NL
94936,1699128660,1699159020,30360,94062,188757,TR,TR
50023,1698829740,1698841860,12120,136991,33768,ES,ES
19499,1700422560,1700439300,16740,116668,11389,US,US
99910,1700355300,1700366220,10920,78814,87624,US,US
128491,1700456280,1700490900,34620,175902,68257,TR,TR
68999,1699776480,1699789140,12660,185859,37500,US,US
137106,1699416480,1699452540,36060,177520,106175,MX,MX
62877,1700157180,1700165820,8640,84397,10242,SK,SK
75733,1700176020,1700191020,15000,177918,110916,AT,PL
49557,1700674560,1700696580,22020,146780,54882,HU,DE
110591,1700361060,1700364660,3600,175593,45500,NL,NL
142455,1700414040,1700424720,10680,143074,33983,IT,IT
198376,1700565120,1700598960,33840,187827,181854,TR,TR
81901,1699689180,1699701420,12240,76936,54827,PT,PT
129156,1699026240,1699058880,32640,89631,156976,TR,TR
33589,1699624320,1699631160,6840,164675,149693,GB,GB
13852,1700001780,1700036160,34380,193729,17436,TR,TR
167992,1699080000,1699118580,38580,96276,44160,MX,MX
164149,1699697460,1699732740,35280,69859,175733,TR,TR
49477,1699557180,1699580340,23160,92210,192536,DE,DE
107594,1699815600,1699848360,32760,100665,118728,TR,TR
107262,1699424760,1699459980,35220,194399,71340,TR,TR
49629,1700741220,1700755440,14220,127076,15618,IT,IT
130182,1698961800,1698978180,16380,55442,95588,US,US
15730,1700848380,1700878260,29880,132966,10325,TR,TR
72606,1699622700,1699627440,4740,168666,181337,NL,FR
122551,1700347920,1700381220,33300,43310,152445,TR,TR
138171,1700474040,1700477640,3600,38690,147166,GB,GB
192189,1698948900,1698965040,16140,192667,171652,US,US
60760,1700616120,1700648520,32400,99699,1435,TR,TR
14835,1699773840,1699797780,23940,188726,184649,ME,RS
178947,1700624880,1700657040,32160,62564,108293,TR,TR
79813,1699740720,1699748460,7740,9534,169663,IT,IT
177979,1700089380,1700124720,35340,81344,108441,TR,TR
94720,1699471620,1699484280,12660,136043,39789,US,US
29093,1700290740,1700326620,35880,16190,114330,TR,TR
63368,1698978960,1698990960,12000,105607,144222,US,US
37874,1699666140,1699679100,12960,149773,137903,ES,ES
8046,1698928860,1698962940,34080,7679,103018,TR,TR
169101,1700133660,1700164800,31140,35796,125240,TR,TR
119178,1698958860,1698962460,3600,99131,133981,NL,NL
181363,1700360280,1700376360,16080,54354,114034,US,US
14171,1700369280,1700378700,9420,194059,125462,PT,PT
64813,1700615280,1700644500,29220,110230,137334,BA,HR
13579,1699472820,1699485420,12600,127112,41658,SK,AT
14728,1699655700,1699672620,16920,102612,197623,US,US
60534,1699482480,1699513260,30780,187298,194955,TR,TR
196245,1699013760,1699042980,29220,160523,181890,TR,TR
37211,1700030580,1700063340,32760,28732,72749,TR,TR
55644,1698920580,1698931260,10680,120266,108939,IT,IT
140197,1699013580,1699024560,10980,118741,192914,CA,US
30954,1698796140,1698804120,7980,47584,159168,IT,IT
122535,1699161600,1699195860,34260,24494,178140,TR,TR
37362,1699373220,1699379520,6300,136454,105046,GB,GB
24728,1700121960,1700157060,35100,111388,79635,TR,TR
10230,1700179500,1700188200,8700,114339,173718,IT,IT
74215,1700126160,1700129820,3660,81622,107031,GB,GB
161718,1700561880,1700595960,34080,172196,108066,TR,TR
7098,1700697240,1700726460,29220,172218,120177,TR,TR
132558,1699136940,1699168260,31320,55822,178088,TR,TR
478,1698970620,1698994020,23400,113098,151359,RO,RO
100769,1700096160,1700121240,25080,74286,45333,DE,DE
68979,1699435800,1699446540,10740,85355,108034,ES,FR
18382,1699289520,1699322400,32880,126938,21381,TR,TR
176036,1699513260,1699523520,10260,81731,85118,IT,IT
173787,1699768920,1699772640,3720,37418,140248,GB,GB
108483,1700038500,1700042100,3600,135512,136100,NL,NL
141611,1700093760,1700127360,33600,24245,137648,TR,TR
180159,1698931260,1698936360,5100,39636,33146,GB,GB
154558,1700850600,1700861820,11220,143631,102210,ES,ES
87102,1700693400,1700705880,12480,128166,95990,IT,IT
46994,1700405700,1700438940,33240,192504,173724,TR,TR
20908,1699201800,1699205400,3600,145557,125902,NL,NL
43180,1700719920,1700749920,30000,135307,172840,TR,TR
173825,1700705640,1700709240,3600,84749,132978,GB,GB
32048,1699239060,1699273980,34920,85663,92522,TR,TR
18017,1699029900,1699059300,29400,192829,76810,TR,TR
129220,1699712820,1699716480,3660,17882,19288,GB,GB
79013,1700449920,1700501820,51900,11443,176966,BG,AT
12726,1699029120,1699039020,9900,152372,195433,IT,IT
176233,1699463160,1699471140,7980,87427,79787,IT,IT
93936,1699447860,1699462140,14280,4247,8316,PT,PT
146006,1700165760,1700178600,12840,47713,43369,HR,HR
13194,1700108280,1700137740,29460,166502,26041,TR,TR
96683,1700777400,1700789460,12060,16377,158430,AT,AT
83509,1699654320,1699678740,24420,169752,60126,DE,DE
136886,1700493240,1700505840,12600,112446,157585,US,US
27575,1700783520,1700791020,7500,163469,166518,HR,HR
6885,1700356560,1700392020,35460,166193,2308,TR,TR
191218,1699387080,1699419360,32280,136096,46850,TR,TR
142346,1699333320,1699346940,13620,47336,51358,IT,IT
170919,1700143380,1700178420,35040,155162,134208,MX,MX
55994,1700074020,1700097360,23340,84007,128249,PL,PL
158504,1699999560,1700032500,32940,41514,4518,TR,TR
182747,1700418360,1700432700,14340,84878,79392,SK,CZ
71220,1698933660,1698945900,12240,134429,111417,IT,IT
84511,1699978920,1700014860,35940,197975,25096,TR,TR
60868,1700310000,1700313600,3600,136047,76709,GB,GB
120899,1699729980,1699759140,29160,174779,83408,BA,RS
12960,1699408440,1699440780,32340,154004,10072,TR,TR
156874,1699530960,1699564560,33600,185584,186681,TR,TR
112080,1700030280,1700062560,32280,88123,77899,TR,TR
54562,1699023720,1699057860,34140,76858,124798,TR,TR
75990,1699925820,1699936020,10200,26091,137549,IT,IT
41421,1700464380,1700493180,28800,56897,62218,TR,TR
75522,1699989000,1699995540,6540,148206,56865,GB,GB
125048,1698939120,1698972780,33660,180155,71815,TR,TR
81060,1700486100,1700513520,27420,11790,161794,DE,PL
65280,1699650900,1699663560,12660,68086,48630,US,US
8687,1700242260,1700266560,24300,185402,180581,SI,BA
183033,1699810200,1699843680,33480,16207,77267,TR,TR
133629,1700148900,1700172780,23880,29058,145505,DE,NO
30452,1698930420,1698942120,11700,179154,195369,PT,ES
117310,1699113840,1699117440,3600,127440,165911,NL,DE
30889,1700411940,1700444340,32400,82903,41063,TR,TR
148930,1699136760,1699153620,16860,179729,100746,FR,NL
159385,1700392260,1700424300,32040,71947,170080,TR,TR
64941,1699666800,1699721940,55140,165927,43912,BG,BG
141018,1699704960,1699721400,16440,75656,47756,US,US
114400,1699383180,1699412340,29160,92580,195451,TR,TR
5907,1699773240,1699804080,30840,41977,89594,TR,TR
16785,1700720340,1700746200,25860,142411,194485,DE,AT
176321,1699301520,1699323180,21660,68250,145810,PL,PL
184319,1699925100,1699936920,11820,84773,134888,PT,PT
179463,1699601460,1699632600,31140,68824,42684,TR,TR
156914,1700541180,1700553120,11940,116327,36268,US,US
186495,1699776000,1699807560,31560,44805,82393,TR,TR
130116,1700411880,1700415480,3600,101460,54808,NL,BE
174917,1698971100,1698975840,4740,196706,149096,GB,GB
66886,1700771520,1700803680,32160,64756,119678,TR,TR
145462,1699474680,1699506660,31980,39790,92874,TR,TR
123000,1699689960,1699719540,29580,158586,171031,TR,TR
4403,1699215360,1699222560,7200,46700,141126,HR,HR
55309,1698938040,1698952440,14400,5822,60106,FR,FR
89443,1700090640,1700094240,3600,157016,55151,GB,GB
74980,1699036140,1699065540,29400,46350,163434,TR,TR
70010,1700608380,1700641560,33180,91641,89151,TR,TR
107573,1699364880,1699368480,3600,133116,198240,NL,NL
106830,1699890180,1699893900,3720,25700,188024,GB,GB
11820,1698799560,1698821160,21600,5448,66514,HU,AT
93225,1698837000,1698840840,3840,18932,193888,NL,NL
92739,1700400780,1700417640,16860,19137,22423,US,US
30240,1700279280,1700292600,13320,47931,110576,HR,DE
154122,1699753620,1699768440,14820,18935,40038,CA,CA
927,1699941360,1699944960,3600,192943,141106,NL,NL
99616,1699064100,1699099920,35820,119005,2284,TR,TR
41802,1699937880,1699942200,4320,105894,8084,GB,GB
2280,1699389960,1699420380,30420,176281,113253,TR,TR
38886,1700109600,1700125980,16380,35571,136189,AT,AT
87717,1699935540,1699951260,15720,189261,35380,AT,AT
148750,1700073780,1700104500,30720,42943,151210,TR,TR
11365,1698964080,1698976860,12780,169598,94072,IT,IT
31868,1699360440,1699415160,54720,194260,114184,BG,AT
143031,1700735220,1700742660,7440,118997,144447,IT,IT
92076,1699384140,1699410120,25980,129821,124357,BR,BR
180361,1700546400,1700550000,3600,152756,101897,NL,NL
106252,1699592220,1699626480,34260,160997,149388,TR,TR
94343,1700430360,1700463060,32700,43868,68205,TR,TR
38749,1699949460,1699982640,33180,128110,152425,TR,TR
69339,1700803620,1700814480,10860,159527,106336,AT,AT
39243,1700601900,1700637660,35760,58684,2279,TR,TR
129645,1700727600,1700731620,4020,63161,104607,NL,GB
179636,1699271940,1699288380,16440,78621,93497,US,US
178584,1700117400,1700151240,33840,110747,110336,TR,TR
91822,1698868140,1698876300,8160,143258,49720,PT,PT
191078,1700243040,1700252520,9480,43534,128314,HR,IT
140496,1699733040,1699746720,13680,39715,5474,US,US
195841,1699832100,1699845480,13380,168029,42600,RS,RS
29940,1700382660,1700400180,17520,116685,66392,US,US
58539,1699463280,1699502520,39240,66603,147517,MX,MX
86010,1699051740,1699083720,31980,129402,40825,TR,TR
145171,1699210020,1699227840,17820,42255,117800,AT,SK
89943,1700053380,1700066700,13320,110789,184959,HR,HR
144985,1700298360,1700332020,33660,108524,111858,TR,TR
63952,1700608380,1700629740,21360,53631,69930,FR,AD
168902,1699745460,1699761000,15540,2923,55699,FR,CZ
62424,1699230480,1699261800,31320,37047,86671,TR,TR
74483,1698927720,1698940560,12840,44765,65898,IT,DE
53192,1700167200,1700174280,7080,110737,27534,EE,EE
13327,1699413660,1699441140,27480,97004,129113,DE,RO
125399,1700016780,1700051040,34260,129373,49114,TR,TR
179982,1699489080,1699492680,3600,10103,61443,NL,NL
121462,1700273460,1700304360,30900,66148,52809,TR,TR
13135,1700465340,1700496660,31320,173864,28145,TR,BG
131445,1700199420,1700203020,3600,23899,36393,GB,GB
128788,1699623360,1699655520,32160,46478,59143,TR,TR
89880,1699147500,1699165200,17700,119441,106763,CZ,CZ
70596,1700206260,1700225880,19620,139985,65633,FR,HR
3197,1700483340,1700509920,26580,173706,146759,BA,HR
7495,1699066920,1699074360,7440,154002,68634,IT,IT
99007,1700191860,1700243700,51840,70285,155629,BG,DE
30202,1700684340,1700717700,33360,126191,195196,TR,TR
91368,1700280720,1700306520,25800,50573,10583,DE,AT
160934,1699095960,1699130160,34200,28799,60391,TR,TR
138000,1700818500,1700833080,14580,194923,6204,US,US
62711,1700350860,1700358900,8040,126883,157439,IT,IT
24692,1699721400,1699734240,12840,101558,110124,US,US
168008,1699230180,1699265820,35640,91848,107673,TR,TR
76742,1699741140,1699744740,3600,43890,7230,GB,GB
197767,1699582380,1699612500,30120,160721,64942,TR,TR
102012,1700406120,1700439960,33840,27439,103063,TR,TR
169549,1700847300,1700881440,34140,125598,129161,TR,TR
168894,1700476440,1700482680,6240,131261,47700,NL,NL
66046,1699979520,1699996680,17160,124249,179845,FR,FR
9870,1700839860,1700871840,31980,174340,117828,TR,TR
28878,1698998700,1699024020,25320,184937,123069,PL,UA
63154,1700836380,1700842140,5760,175692,115142,GB,GB
144635,1698853140,1698889080,35940,198283,65300,TR,TR
27564,1699219320,1699222920,3600,22926,74365,GB,GB
75070,1699782660,1699817220,34560,10784,22298,TR,TR
195140,1699986300,1700017440,31140,197683,139001,TR,TR
197326,1699495800,1699525440,29640,145061,135421,TR,TR
97100,1699735560,1699759560,24000,108601,195147,DE,CZ
65013,1699960320,1699989900,29580,119447,38521,TR,TR
108719,1699353780,1699370880,17100,64338,73912,US,MX
107427,1699178100,1699189260,11160,76748,166621,IT,IT
89185,1699426740,1699455900,29160,69452,3294,TR,TR
144381,1698913860,1698917460,3600,181663,112649,GB,GB
157705,1699708140,1699711740,3600,183195,111487,NL,NL
88880,1700055360,1700058960,3600,45504,140628,GB,GB
168220,1699251780,1699272120,20340,22759,8856,FR,FR
126257,1699591800,1699603020,11220,119982,92274,IT,IT
157602,1699613880,1699623000,9120,138264,11928,IT,IT
38772,1699551720,1699582440,30720,170100,28079,TR,TR
119894,1700455860,1700483100,27240,113113,13765,PL,CZ
151121,1699162980,1699174500,11520,34245,134834,PT,PT
76363,1700211660,1700246880,35220,182013,129278,TR,TR
81091,1699327860,1699360500,32640,66261,37625,MX,MX
7776,1699998060,1700001660,3600,155525,169403,GB,GB
110828,1700553420,1700584140,30720,176604,190591,TR,TR
160526,1700451060,1700466660,15600,108943,99759,US,US
87154,1699788060,1699818900,30840,18518,109964,TR,TR
159151,1699373280,1699382040,8760,146939,146387,HR,HR
22742,1699756140,1699765260,9120,122002,94831,PT,PT
130973,1700530200,1700539440,9240,144239,90166,IT,IT
122035,1700593860,1700602020,8160,125724,111520,IT,IT
59682,1700531640,1700563680,32040,20491,110862,TR,TR
30170,1699704360,1699707960,3600,116069,6840,GB,GB
77198,1700238060,1700253660,15600,160991,475,AT,AT
35115,1699778040,1699806960,28920,80514,164544,TR,TR
19971,1699709280,1699717620,8340,179638,90338,HR,HR
175136,1699517760,1699541700,23940,82037,164382,HU,CZ
96238,1700579760,1700614920,35160,38921,59264,TR,TR
193729,1700027160,1700030760,3600,1441,22811,GB,GB
33022,1699201800,1699231080,29280,55322,76851,TR,TR
112333,1699925100,1699935840,10740,57426,83035,IT,CH
16052,1699471500,1699476180,4680,121337,56512,GB,GB
153579,1699323480,1699337340,13860,35118,29047,IT,IT
180598,1699341360,1699354980,13620,69681,100035,CA,US
186936,1700041380,1700072880,31500,23844,75639,TR,TR
91029,1698852060,1698865980,13920,119427,113830,US,US
29976,1699294560,1699301280,6720,59806,133211,NL,NL
33837,1700438220,1700441820,3600,95129,47892,GB,GB
137149,1700101200,1700134380,33180,85914,121859,TR,TR
9676,1699426320,1699430580,4260,148687,152492,GB,GB
41898,1699989300,1699992900,3600,167485,87783,GB,GB
127768,1700363760,1700393760,30000,112927,148291,TR,TR
22500,1698965520,1698973980,8460,98899,73027,ES,ES
155128,1700260140,1700294220,34080,40498,141705,TR,TR
80979,1699646280,1699653900,7620,74014,102771,IT,IT
2578,1698950460,1698957540,7080,9878,193190,NL,NL
43541,1699367220,1699401840,34620,26318,62011,TR,TR
90966,1699130160,1699165620,35460,172061,20783,TR,TR
131318,1699431900,1699464420,32520,166868,39634,TR,TR
19939,1699171920,1699206180,34260,25705,107584,TR,TR
16837,1700398320,1700428800,30480,93954,85192,TR,TR
161933,1699025520,1699043280,17760,34795,40284,BE,NL
111559,1700167860,1700171460,3600,62357,6139,NL,NL
174755,1698844800,1698875460,30660,20630,59220,TR,TR
155848,1700479800,1700511720,31920,62596,109505,TR,TR
161926,1699820760,1699824360,3600,93352,7244,GB,GB
78294,1699873800,1699890900,17100,101591,46996,US,US
93427,1700011800,1700015400,3600,128712,70086,GB,GB
85956,1699574400,1699583700,9300,156452,163271,IT,IT
63235,1700728560,1700748300,19740,121439,154358,FR,FR
76819,1700493840,1700508900,15060,66378,30017,FR,ES
53349,1698876540,1698893640,17100,10286,147648,FR,FR
82077,1699671060,1699700340,29280,188627,63981,TR,TR
92875,1699724940,1699728540,3600,122062,108223,GB,GB
23802,1699035960,1699070940,34980,120241,57814,TR,TR
22081,1699304640,1699317540,12900,80733,33600,US,US
153484,1698905700,1698936900,31200,69256,147099,TR,TR
41260,1700694840,1700727720,32880,104347,118654,TR,TR
39284,1700780760,1700808960,28200,123814,138313,DE,NL
108839,1699405140,1699408740,3600,88087,154310,GB,GB
67796,1700729820,1700746980,17160,93229,137389,US,US
151166,1699617660,1699621260,3600,138776,178500,GB,GB
93821,1698906780,1698940200,33420,84757,190545,TR,TR
129540,1699455360,1699466100,10740,57553,68001,HR,HR
69038,1700167740,1700172780,5040,1141,27901,NL,NL
161763,1699900620,1699931220,30600,45189,149305,TR,TR
79059,1699778700,1699812660,33960,2307,75718,TR,TR
54242,1699054260,1699072620,18360,90690,157981,FR,FR
13130,1699750380,1699766160,15780,165339,47402,FR,ES
20127,1699089540,1699118880,29340,196862,98418,TR,TR
98635,1700374380,1700408580,34200,145747,122677,TR,TR
187882,1699844820,1699848420,3600,185414,72369,GB,GB
33827,1699352820,1699370100,17280,50575,116649,SE,SE
75062,1700382540,1700412360,29820,35346,77935,TR,TR
56457,1700642220,1700657640,15420,197230,84461,US,US
55622,1699889040,1699909860,20820,189085,176748,FR,AD
96624,1699690800,1699722960,32160,172479,28100,BA,BA
65444,1699724100,1699745280,21180,128577,90706,FR,FR
121690,1700146800,1700181720,34920,73061,195490,TR,TR
97900,1698844020,1698876540,32520,66619,52946,TR,TR
59384,1700825040,1700834760,9720,132232,115511,EE,FI
124466,1699594560,1699631640,37080,58467,81508,MX,MX
157530,1699375740,1699388520,12780,92833,146966,US,US
158954,1699544340,1699577100,32760,74329,173715,TR,TR
59198,1698988620,1699018560,29940,56398,152722,TR,TR
59854,1699521000,1699553580,32580,86305,134287,TR,TR
139210,1699519680,1699551540,31860,168740,96778,TR,TR
54005,1699312800,1699344600,31800,145361,153089,TR,TR
89688,1699555260,1699568580,13320,13939,158799,PT,PT
35217,1699186440,1699201020,14580,177023,51268,US,US
27682,1700058600,1700062200,3600,67825,144600,GB,GB
199965,1699623000,1699653960,30960,47980,173511,TR,TR
72273,1699957260,1699969440,12180,140539,44241,IT,IT
42901,1699974060,1700008020,33960,88224,83305,TR,TR
151023,1699947480,1699979160,31680,130255,15406,TR,TR
136493,1699246260,1699267980,21720,50367,170390,PL,PL
71058,1699237680,1699272900,35220,150581,24741,TR,TR
37902,1698892860,1698926700,33840,68850,193945,MX,MX
106578,1699005540,1699013340,7800,176935,111100,HR,BA
148513,1699533000,1699539840,6840,156318,110492,GB,GB
155339,1700758200,1700772720,14520,125281,65895,FR,FR
177132,1700203740,1700215680,11940,155976,36147,US,US
173723,1700793720,1700824980,31260,140843,50359,BA,HR
196419,1700598240,1700608920,10680,84670,152583,PT,PT
38282,1700223900,1700236140,12240,150218,40283,PT,PT
160148,1698928440,1698940440,12000,161968,124063,AT,AT
15043,1699690440,1699714200,23760,6438,5795,DE,CZ
91269,1700255160,1700289180,34020,128354,30721,TR,TR
110822,1699962540,1699984380,21840,130446,108159,DK,DK
2296,1700470020,1700498880,28860,63875,50545,TR,TR
94487,1700141280,1700159100,17820,170355,127275,AT,AT
32492,1700828040,1700832720,4680,103926,109949,NL,NL
63730,1700635080,1700648520,13440,165791,147740,IT,IT
88010,1700144580,1700179440,34860,8200,71168,TR,TR
165136,1699551960,1699587780,35820,87563,6749,TR,TR
138560,1700847780,1700851380,3600,93346,152668,NL,NL
194654,1698964800,1698996900,32100,54912,193691,TR,TR
167500,1699943340,1699950480,7140,34619,99948,CL,CL
126316,1700671740,1700704620,32880,40263,129145,TR,TR
22348,1700042340,1700077380,35040,96604,196864,TR,TR
32297,1699196280,1699211400,15120,76938,36502,US,US
47768,1700366640,1700395500,28860,9157,70854,TR,TR
7559,1700081640,1700113020,31380,86585,131604,TR,TR
15305,1700021100,1700028480,7380,194907,36833,PT,PT
158803,1700165160,1700194500,29340,186885,27198,TR,TR
116391,1700745780,1700749380,3600,170061,148348,GB,GB
139892,1700188740,1700192340,3600,193964,92406,GB,GB
170598,1699335600,1699351380,15780,4347,9740,US,US
4723,1699502640,1699538820,36180,148026,180734,MX,MX
199093,1700351820,1700364300,12480,196220,8317,US,US
10594,1699025280,1699034100,8820,196546,172216,IT,IT
147235,1700529180,1700561940,32760,1859,92221,TR,TR
111265,1699223820,1699227420,3600,125901,188534,GB,GB
136580,1700442600,1700461740,19140,41919,95361,DK,DE
184272,1700819580,1700830800,11220,143992,44212,US,US
106043,1700848440,1700856780,8340,118768,169464,IT,IT
129057,1699001760,1699031040,29280,118128,105054,TR,TR
147507,1699652640,1699676940,24300,197431,108091,DK,DK
50908,1699833240,1699868460,35220,6673,122950,TR,TR
91887,1698820560,1698826200,5640,165315,32490,NL,NL
11408,1700334840,1700365080,30240,73958,176406,TR,TR
172103,1700796900,1700805240,8340,141674,145969,IT,IT
80330,1699255140,1699262880,7740,12830,103917,IT,IT
44867,1700813520,1700846580,33060,149037,167444,TR,TR
44571,1699629240,1699658280,29040,87326,4860,TR,TR
69595,1698880860,1698897720,16860,175122,179442,US,US
153465,1700817300,1700847000,29700,73572,32578,TR,TR
157023,1699382460,1699399980,17520,177382,83550,US,US
145001,1699316340,1699330440,14100,96449,48824,IT,IT
31831,1700758860,1700773980,15120,3166,31765,US,US
133211,1699981860,1699985460,3600,42115,162197,NL,NL
154960,1699794840,1699829400,34560,84089,19561,TR,TR
171134,1700439720,1700444220,4500,16815,57846,GB,GB
109216,1700311320,1700314920,3600,175820,130532,GB,GB
193190,1699756620,1699760220,3600,198222,70833,GB,GB
91796,1700041980,1700073600,31620,165458,111085,TR,TR
130836,1699351980,1699378560,26580,56912,92562,DE,DE
10435,1700620860,1700637060,16200,175007,12911,BE,CZ
187550,1699409400,1699421160,11760,115859,107939,IT,IT
81665,1700298720,1700305260,6540,50513,199961,NL,DE
180248,1698980640,1699010160,29520,116730,58487,TR,TR
181766,1699883520,1699894620,11100,194384,97235,RS,AT
90359,1699727160,1699730760,3600,154144,14155,GB,GB
66359,1700848740,1700902200,53460,118126,158145,BG,AT
72350,1700788320,1700805840,17520,88716,48699,US,US
106266,1699547940,1699564200,16260,110482,19116,US,US
84480,1699087080,1699104840,17760,136973,107836,US,US
167559,1700606580,1700631540,24960,87709,102527,DE,DE
108137,1699694400,1699698000,3600,9817,21881,GB,GB
91354,1699388520,1699420800,32280,153778,4030,TR,TR
56802,1700682660,1700694960,12300,47114,105505,IT,IT
73772,1700765880,1700780700,14820,66878,48835,SE,NO
154533,1700619060,1700630640,11580,7925,182691,PT,PT
188458,1700511180,1700535000,23820,111939,192960,DE,DE
105038,1699308120,1699341840,33720,11344,63516,MX,MX
138813,1700771280,1700806260,34980,59221,48627,TR,TR
179311,1699986720,1700017860,31140,78569,129039,TR,TR
181994,1699990620,1700001120,10500,56234,190003,IT,IT
88832,1699209240,1699213440,4200,159788,82536,GB,GB
132745,1700084520,1700088120,3600,119677,51381,NL,NL
12589,1700156820,1700179020,22200,3828,9870,PL,PL
14652,1698826920,1698836220,9300,153081,136653,IT,IT
14606,1699591980,1699604880,12900,199515,163587,CA,US
100972,1699909140,1699921560,12420,126278,97326,AT,AT
2715,1699269000,1699272600,3600,2703,89543,GB,GB
195833,1698816840,1698820440,3600,181032,15474,GB,GB
187570,1699007580,1699038480,30900,58242,98628,TR,TR
62396,1699696140,1699728660,32520,180090,33415,MX,MX
197881,1700780700,1700812560,31860,163755,175643,TR,TR
50456,1700409060,1700422500,13440,69531,87841,IT,IT
154298,1699337280,1699348920,11640,61935,49185,HR,HR
101968,1700120100,1700149800,29700,2543,117553,TR,TR
157045,1699345620,1699350420,4800,106919,192363,GB,GB
154608,1700794680,1700827260,32580,41073,38298,TR,TR
25776,1700052420,1700067900,15480,35131,60766,CZ,CZ
149862,1700045100,1700064240,19140,37258,48409,FR,DE
63682,1700607900,1700627940,20040,175540,7253,FR,ES
59961,1700295840,1700323620,27780,102054,141808,RO,RO
147920,1700156880,1700167740,10860,142587,113397,IT,IT
170333,1698877920,1698894000,16080,122716,10014,AT,AT
24779,1699839480,1699851660,12180,117752,176215,IT,IT
94897,1699201740,1699205340,3600,149244,108916,NL,NL
82848,1699869780,1699886700,16920,98617,114226,US,US
118705,1700353140,1700369640,16500,196956,42757,US,US
150995,1700125620,1700155860,30240,62647,183191,TR,TR
33039,1700554380,1700587620,33240,191349,79961,TR,TR
140712,1699561980,1699565580,3600,14034,193165,NL,NL
8004,1700762940,1700791320,28380,105270,26840,DE,HU
78285,1699277280,1699308780,31500,158012,16898,TR,TR
14300,1700365740,1700379360,13620,138656,61763,IT,IT
164442,1700678340,1700714280,35940,124392,98413,MX,MX
59145,1699954320,1699959600,5280,69010,178769,GB,GB
106614,1699825140,1699855320,30180,163068,44897,TR,TR
145847,1699505100,1699513200,8100,108671,53839,IT,IT
181770,1699076460,1699110360,33900,107055,189109,TR,TR
126343,1700324460,1700334960,10500,152871,13416,PT,PT
69580,1700265600,1700275560,9960,61405,72456,EE,EE
177787,1700310360,1700345940,35580,140376,131460,TR,TR
157971,1700853960,1700883960,30000,91778,190856,TR,TR
51110,1699984320,1699998540,14220,52394,17071,US,US
161378,1699036740,1699067880,31140,40998,82471,TR,TR
67024,1700394720,1700426160,31440,46378,79916,TR,TR
150741,1700021160,1700033640,12480,156801,199420,US,US
5324,1700497680,1700522460,24780,153479,45081,DE,FR
67781,1699487580,1699491180,3600,184326,136397,GB,GB
117819,1700740140,1700745360,5220,183764,3351,GB,GB
9285,1700820900,1700843220,22320,90963,82632,PL,PL
114279,1700570400,1700577480,7080,50040,195725,GB,GB
15760,1700008560,1700038320,29760,118710,175322,TR,TR
199967,1699982580,1700005020,22440,144818,84041,PL,PL
27189,1699340160,1699361100,20940,144808,163100,FR,FR
104194,1699838400,1699868280,29880,166643,30399,TR,TR
71499,1699026600,1699058220,31620,103339,113662,TR,TR
179251,1700294700,1700326980,32280,32762,13255,TR,TR
70941,1700631540,1700635140,3600,73368,100954,NL,NL
50704,1700170980,1700188380,17400,199702,16274,AT,AT
166384,1698938520,1698957360,18840,89029,12050,FR,FR
101029,1698810540,1698844380,33840,86125,96625,TR,TR
103994,1699300620,1699306440,5820,153130,36781,GB,GB
181268,1700075160,1700110560,35400,164061,115467,TR,TR
171760,1700328360,1700360760,32400,145995,73848,TR,TR
34684,1700733060,1700762100,29040,58349,190151,TR,TR
135261,1699721520,1699728780,7260,137770,74911,IT,IT
73060,1700786280,1700799060,12780,127820,71022,US,US
14635,1700855580,1700866800,11220,106943,91182,CZ,CZ
107546,1699250940,1699260240,9300,141092,151733,IT,IT
20283,1699602480,1699608240,5760,64588,71473,GB,GB
151060,1698959220,1698989220,30000,129073,140578,TR,TR
107575,1699040400,1699046280,5880,177238,127706,NL,NL
125264,1698888720,1698905640,16920,99212,28237,US,US
199885,1700254260,1700265660,11400,160658,65829,US,US
26103,1699269420,1699303980,34560,49342,52953,TR,TR
144794,1700631300,1700663880,32580,163342,192373,TR,TR
159578,1699521120,1699533120,12000,77066,142102,IT,IT
122589,1700285280,1700306760,21480,126671,197012,FR,DE
62334,1699093980,1699129440,35460,184062,37930,TR,TR
144899,1698864540,1698887640,23100,8531,152213,PL,PL
24767,1700483400,1700493000,9600,152782,185894,SK,IT
70275,1699356660,1699367640,10980,88580,26260,HR,HR
2278,1700402160,1700423040,20880,158538,23926,FR,FR
85834,1699352520,1699369680,17160,116936,155939,US,US
37707,1699147020,1699164420,17400,48285,32184,US,US
78923,1699895220,1699907520,12300,133000,83658,US,US
49500,1699702920,1699735020,32100,60097,154909,TR,TR
66548,1700617980,1700647860,29880,169344,41842,TR,TR
67751,1699159800,1699167060,7260,129211,189193,EE,FI
107247,1700441760,1700450820,9060,125288,48889,IT,IT
46567,1699105260,1699123020,17760,119480,128648,US,US
159261,1700330400,1700345100,14700,74296,101454,FR,FR
23580,1699007880,1699020600,12720,111442,15160,IT,IT
178942,1699939020,1699942620,3600,43006,103517,GB,GB
164652,1700824260,1700834340,10080,122955,26379,IT,IT
48885,1699667880,1699691460,23580,41153,107787,BR,BR
124189,1700594220,1700608500,14280,184006,77996,HR,HR
100055,1699775760,1699795200,19440,170121,126687,BE,FR
98106,1699216920,1699222320,5400,118443,74224,NL,NL
109807,1699751880,1699763580,11700,46271,40447,IT,DE
79841,1699987620,1699995360,7740,110697,126943,AD,FR
131493,1700121000,1700137380,16380,76992,5129,US,US
165997,1699448280,1699462980,14700,60638,49542,FR,AD
94187,1699865280,1699896000,30720,36571,29976,TR,TR
116122,1698952320,1698961200,8880,111567,35689,IT,IT
21680,1700207520,1700211120,3600,59556,41614,GB,GB
173642,1699033800,1699038780,4980,6492,19457,NL,NL
182326,1700466240,1700499720,33480,44492,160066,TR,TR
190595,1700015220,1700031780,16560,182072,20689,CZ,CZ
142888,1699870020,1699902420,32400,94103,166909,TR,TR
134073,1698848700,1698855840,7140,152458,21820,GB,GB
103440,1698972120,1699001040,28920,183454,118885,TR,TR
32258,1700424900,1700456640,31740,100827,70472,TR,TR
185103,1700348640,1700353920,5280,48570,176874,NL,NL
115333,1699762020,1699767480,5460,87545,294,NL,NL
18650,1699750920,1699757040,6120,183836,174862,GB,GB
199913,1700727300,1700738220,10920,83230,19176,US,US
160317,1700075580,1700108520,32940,28695,115245,TR,TR
158097,1699498380,1699515720,17340,80209,103017,FR,DE
86127,1699425900,1699433340,7440,141521,133686,IT,IT
29526,1700731740,1700742660,10920,139007,128251,US,US
37893,1700709900,1700718060,8160,21402,12836,ES,ES
44736,1699429200,1699463100,33900,189097,36692,TR,TR
165802,1699750380,1699754040,3660,130749,99352,GB,GB
133487,1699667880,1699679400,11520,130828,36161,IT,IT
63609,1699791240,1699806300,15060,89843,84730,US,US
116046,1699762740,1699793760,31020,41613,27494,TR,TR
197739,1700499780,1700513640,13860,30201,79689,US,US
151678,1700854500,1700861940,7440,93180,68046,IT,IT
87251,1700197620,1700226480,28860,9637,106306,TR,TR
80254,1699148580,1699152840,4260,8666,964,NL,NL
152737,1699872660,1699902300,29640,38612,124117,TR,TR
63916,1699053960,1699114440,60480,5766,155034,UA,DE
7472,1699004640,1699008240,3600,71921,8230,NL,PL
17063,1700781960,1700813400,31440,123732,104551,TR,TR
96058,1698950940,1698980760,29820,61736,16029,TR,TR
56665,1699590780,1699621620,30840,179871,31633,TR,TR
111115,1700493900,1700528040,34140,38374,167321,TR,TR
43154,1699908000,1699918980,10980,189252,108853,US,US
122438,1699552500,1699586400,33900,132811,184982,TR,TR
88290,1700276580,1700287680,11100,179663,49487,US,US
39424,1698968040,1698977820,9780,127758,151892,IT,IT
86693,1698869100,1698901440,32340,61512,50889,TR,TR
42428,1700614200,1700617800,3600,187465,5500,GB,GB
7033,1698910080,1698913680,3600,147572,99198,GB,GB
136995,1699459860,1699488780,28920,11660,97843,TR,TR
189948,1699669260,1699675500,6240,164774,63910,NL,NL
190276,1700148960,1700157360,8400,156358,137995,PT,PT
176278,1700358660,1700385060,26400,171531,25398,RO,RO
107576,1700264580,1700290920,26340,189370,45149,RO,ES
97364,1700770620,1700776320,5700,6769,67476,GB,GB
127695,1700858400,1700891340,32940,8748,145628,TR,TR
90981,1699085940,1699097040,11100,37234,167054,CZ,DE
177805,1700449200,1700462160,12960,33322,166763,AT,PL
68987,1700844540,1700879640,35100,107334,19479,TR,TR
123805,1699195800,1699234380,38580,90702,18712,MX,MX
18045,1699892400,1699928100,35700,159158,93424,TR,TR
193949,1700578680,1700593080,14400,50873,84654,US,US
52124,1699009620,1699019640,10020,185690,174060,IT,IT
76650,1699207200,1699212060,4860,192960,145586,NL,NL
166041,1700009880,1700026020,16140,199970,141682,US,US
5980,1699136940,1699166640,29700,107374,102270,TR,TR
14699,1699183140,1699187340,4200,30870,57591,GB,GB
12045,1700836320,1700845140,8820,24238,32195,IT,DE
99259,1700370840,1700378280,7440,5141,32967,IT,IT
145762,1699823640,1699855680,32040,139801,135121,TR,TR
66249,1700624280,1700637600,13320,116583,12253,IT,IT
71402,1698838260,1698872700,34440,167236,69962,TR,TR
107960,1700572920,1700591520,18600,164348,90259,FR,NL
49522,1700789580,1700821680,32100,127548,102773,TR,TR
141876,1699488960,1699519620,30660,184987,94801,TR,TR
56909,1700567700,1700573400,5700,145564,167283,GB,GB
51628,1699336140,1699340520,4380,171414,57113,GB,GB
164264,1699561680,1699572720,11040,7698,129079,US,US
36398,1699615800,1699626300,10500,134336,172999,SK,SK
5683,1699782120,1699790460,8340,11179,198540,IT,IT
111013,1700763300,1700776620,13320,84151,120888,US,US
115346,1699289340,1699328820,39480,156917,122892,MX,US
129231,1699491420,1699508220,16800,113049,46826,SE,SE
176496,1700683140,1700716620,33480,1585,170007,TR,TR
88633,1699695360,1699706400,11040,79066,58991,HR,HR
34779,1698977400,1698987480,10080,130287,191835,PT,PT
62122,1699485540,1699516440,30900,136008,58922,TR,TR
170608,1699785360,1699816440,31080,176565,141412,TR,TR
76110,1699110300,1699145580,35280,154111,19400,TR,TR
138707,1700681160,1700720340,39180,173518,119663,MX,MX
91095,1699831080,1699845540,14460,52012,185517,US,CA
53378,1700281020,1700300340,19320,177505,156008,BE,NL
149004,1698990420,1699008000,17580,144348,56239,US,US
95428,1698861900,1698874560,12660,145936,77593,PT,PT
127929,1699666380,1699695240,28860,121085,42563,TR,TR
9851,1699042860,1699071840,28980,161901,163529,TR,TR
102034,1699691400,1699696140,4740,18414,165588,GB,GB
52749,1700165460,1700181180,15720,49483,64070,RS,RS
38613,1700676420,1700705880,29460,97898,31288,TR,TR
177616,1699500720,1699511640,10920,121896,141621,CZ,AT
24216,1699261440,1699279680,18240,33282,178108,SE,SE
34701,1699801260,1699818660,17400,68183,127594,US,US
44000,1699332300,1699349460,17160,94052,61543,AT,AT
142326,1700505600,1700511960,6360,32328,159672,GB,GB
61415,1700499540,1700524380,24840,41581,545,RO,RO
3163,1700810280,1700845620,35340,11922,8387,TR,TR
88061,1700789880,1700802120,12240,194127,112122,US,CA
110751,1700763480,1700790960,27480,106682,58088,HU,AT
16799,1700675160,1700689140,13980,124452,8560,US,US
97071,1699992660,1700001720,9060,117523,146256,IT,IT
174471,1700030040,1700060280,30240,192002,104580,TR,TR
30391,1698998520,1699017420,18900,17094,21571,FR,FR
3377,1700618280,1700651520,33240,197962,145704,TR,TR
129279,1699749900,1699780080,30180,121760,29022,TR,TR
187285,1699305060,1699320600,15540,106065,34407,US,US
145832,1700470320,1700498820,28500,91941,186151,HU,RS
131060,1699737420,1699750200,12780,113515,118682,RS,RS
80423,1699169280,1699181040,11760,1808,197638,PT,PT
32926,1700353800,1700380860,27060,143976,89486,PL,PL
109596,1700256840,1700291700,34860,42380,51523,TR,TR
154054,1699567380,1699591920,24540,1974,172935,PL,PL
87396,1699065660,1699070160,4500,174435,192389,GB,GB
106394,1700038380,1700067480,29100,112041,123876,TR,TR
68952,1699538880,1699558440,19560,182001,6444,SI,RS
88127,1699153560,1699163100,9540,167022,27605,IT,IT
18085,1700207580,1700236140,28560,152533,133215,DE,HU
152294,1698865140,1698895020,29880,182066,155112,TR,TR
165917,1700283780,1700299620,15840,120401,176787,US,US
79668,1699661220,1699693560,32340,128433,79403,TR,TR
87973,1700710500,1700741520,31020,66354,135532,TR,TR
99456,1700562900,1700573820,10920,139698,61629,PT,PT
77162,1700318220,1700349840,31620,66414,177258,TR,TR
150629,1699438440,1699472100,33660,51045,19865,TR,TR
191823,1700081460,1700092800,11340,112361,166954,PT,PT
157040,1699572480,1699605900,33420,123031,57268,TR,TR
107446,1699909380,1699944660,35280,48088,116225,TR,TR
170754,1700164320,1700182260,17940,149983,51170,FR,NL
81653,1700530680,1700543280,12600,170659,155008,US,US
104484,1699035060,1699067760,32700,42806,37706,TR,TR
183352,1699524480,1699554720,30240,96385,50639,TR,TR
18776,1700731920,1700735520,3600,36375,151543,NL,NL
42081,1699490700,1699498320,7620,125670,44532,PT,PT
69943,1699270800,1699305180,34380,69189,148954,TR,TR
111063,1700414820,1700418420,3600,152766,178463,GB,GB
117566,1700755740,1700773560,17820,159832,44859,FR,CH
180187,1699552680,1699579380,26700,184549,51662,PL,PL
128353,1699784280,1699790940,6660,181661,88087,GB,GB
194078,1699265220,1699300320,35100,86922,85665,TR,TR
158553,1700550180,1700576520,26340,45275,176112,PL,PL
97561,1699319220,1699354500,35280,116815,158502,TR,TR
87769,1698911400,1698916860,5460,78981,197718,NL,NL
175809,1699239480,1699255320,15840,195583,128771,US,US
116943,1699956840,1699992420,35580,189037,147345,TR,TR
39888,1699267620,1699299600,31980,183137,70418,TR,TR
127367,1699580580,1699596540,15960,48506,198061,US,US
148226,1699276980,1699294200,17220,198619,121628,US,US
129983,1700281380,1700305320,23940,14710,94696,PL,HR
46523,1699346460,1699377180,30720,157642,128707,TR,TR
191066,1699328880,1699364820,35940,81767,128627,TR,TR
134120,1700410320,1700413920,3600,199446,167955,NL,NL
7596,1700614200,1700617800,3600,185203,114175,GB,GB
169958,1700729940,1700762100,32160,32042,16159,TR,TR
63203,1699716480,1699726860,10380,114208,19730,IT,IT
32920,1700005680,1700040300,34620,37945,37581,TR,TR
175116,1699445880,1699479180,33300,143359,137922,TR,TR
165293,1698954240,1698974220,19980,123275,66727,FR,ES
175754,1700249820,1700253420,3600,189933,116449,GB,GB
149782,1698814620,1698827700,13080,135234,82997,HR,HR
48834,1699920600,1699934280,13680,142516,64732,HR,HR
192401,1699166340,1699173900,7560,81273,154004,IT,IT
196960,1698920460,1698959040,38580,64744,19430,MX,MX
6344,1700588640,1700613900,25260,49412,16669,DE,DE
143218,1700640120,1700651100,10980,33094,60566,SK,AT
137026,1699490520,1699521540,31020,96103,175436,TR,TR
88748,1699598160,1699603140,4980,81369,138029,GB,GB
166420,1698859260,1698890760,31500,69543,127029,TR,TR
88760,1700535120,1700561580,26460,126243,122160,BR,BR
52000,1699212960,1699239960,27000,154610,26002,DE,DE
17144,1700693400,1700697780,4380,185248,32015,EE,EE
61184,1700307840,1700321220,13380,1981,198032,HR,BA
63396,1700140560,1700175480,34920,74911,189911,TR,TR
56832,1700603280,1700632200,28920,133635,159043,TR,TR
52898,1700254980,1700285640,30660,173523,3723,TR,TR
159692,1700273580,1700304780,31200,78644,20220,TR,TR
139643,1700005800,1700017080,11280,155768,169736,US,US
135994,1700590860,1700603160,12300,15432,160635,RS,ME
100816,1699298940,1699334760,35820,198837,82136,TR,TR
103621,1700781360,1700785260,3900,23373,14393,NL,NL
88426,1699702260,1699716840,14580,120673,110778,US,US
12766,1699147140,1699180500,33360,38659,102946,TR,TR
7931,1698966240,1698999000,32760,130593,136904,TR,TR
185664,1699587900,1699600320,12420,156032,23798,US,US
11623,1699434780,1699453680,18900,15933,191595,FR,ES
72103,1699343220,1699375200,31980,14953,163330,TR,TR
71641,1700509980,1700533560,23580,116090,168444,DE,UA
57848,1700033340,1700057220,23880,34991,16151,PL,UA
32082,1698849900,1698909000,59100,83538,60701,UA,DE
55394,1700656680,1700692200,35520,10684,144539,TR,TR
182623,1699044540,1699079820,35280,33431,41750,TR,TR
193699,1698983100,1698991440,8340,39764,160068,HR,HR
126373,1699960020,1699966260,6240,63099,171997,GB,GB
132706,1699006920,1699010820,3900,173519,30810,NL,NL
47645,1700608080,1700643480,35400,37427,137978,TR,BG
150552,1699211820,1699220460,8640,125752,130688,HR,DE
121186,1699602600,1699635780,33180,194093,139577,TR,TR
45521,1699750440,1699763760,13320,139718,21615,US,US
108656,1700172840,1700186220,13380,175669,31970,ES,FR
37011,1700818860,1700828040,9180,126484,63009,IT,IT
156689,1699599360,1699609260,9900,151966,140729,ES,ES
154088,1700286120,1700289720,3600,106930,82660,GB,GB
65123,1698939660,1698970020,30360,178912,110179,TR,TR
67655,1700654340,1700658060,3720,197802,124433,GB,GB
63866,1699509900,1699513500,3600,123748,179357,GB,GB
98257,1699777980,1699799280,21300,90067,155888,FR,FR
188116,1699563780,1699596900,33120,170875,107482,TR,TR
188156,1700808960,1700833620,24660,122824,37571,DE,HU
131183,1699311660,1699317240,5580,166506,89674,NL,BE
1681,1700600640,1700630160,29520,114512,173660,BA,RS
93489,1700403600,1700435820,32220,145543,152330,TR,TR
109486,1700268840,1700304360,35520,74022,189719,TR,TR
130344,1700670360,1700681640,11280,54043,51441,US,US
102826,1699867080,1699898520,31440,132898,27676,TR,TR
22939,1699948440,1699982460,34020,38734,121672,TR,TR
23159,1698963480,1698976140,12660,173903,155432,IT,IT
39130,1699638360,1699667280,28920,151940,98854,TR,TR
178791,1699424400,1699436880,12480,59828,65260,IT,IT
104243,1699874880,1699908780,33900,152901,188641,TR,TR
61416,1699824900,1699881540,56640,44878,14692,UA,PL
96375,1699227240,1699259520,32280,96725,83617,TR,TR
150274,1699106340,1699109940,3600,148768,119057,NL,GB
83954,1699066980,1699098540,31560,137931,5065,TR,TR
165048,1699608780,1699614960,6180,93258,191224,NL,RS
106635,1699640040,1699643640,3600,156175,52059,GB,GB
49122,1698885720,1698914700,28980,153075,129315,TR,TR
130237,1700271660,1700278320,6660,112531,198128,GB,GB
56886,1698975480,1698983880,8400,124050,143856,IT,IT
90292,1700245020,1700278860,33840,120699,6380,TR,TR
95087,1700744340,1700751960,7620,82702,137008,IT,DE
77018,1699724940,1699735020,10080,192394,85214,ES,DE
81299,1700847000,1700874780,27780,169294,85126,DE,DK
66570,1700570940,1700580900,9960,75687,171224,IT,IT
95521,1699133160,1699148340,15180,108535,193272,US,US
56288,1698918240,1698926580,8340,103698,67943,IT,FR
118321,1700216040,1700221980,5940,100056,171121,NL,NL
3725,1699507620,1699521180,13560,15414,168923,ES,ES
41972,1699151940,1699182600,30660,106251,149679,TR,TR
158340,1700636340,1700647500,11160,197473,145995,PT,PT
182200,1700129640,1700151600,21960,49618,96479,DK,DK
169208,1700684040,1700716560,32520,122066,157146,TR,TR
194074,1699240860,1699244460,3600,74926,116498,GB,GB
130180,1699819140,1699832040,12900,72454,194552,IT,IT
101734,1700241060,1700244660,3600,142452,122425,GB,GB
163248,1699339860,1699367760,27900,88249,184618,HU,IT
194892,1699047060,1699078080,31020,111380,135945,TR,TR
122154,1699237500,1699271280,33780,126216,82321,TR,TR
72646,1700711040,1700742000,30960,129783,175273,TR,TR
166497,1699268460,1699303200,34740,88812,20591,TR,TR
76769,1700453940,1700488860,34920,91081,191135,TR,TR
196348,1698892380,1698927780,35400,68027,28130,TR,TR
132245,1699992780,1700003940,11160,149381,175657,HR,HR
77589,1699400640,1699427580,26940,45475,41797,DE,DE
69156,1699618620,1699628220,9600,92881,149084,PT,PT
144712,1699193760,1699197360,3600,9633,56547,GB,GB
72931,1700129220,1700161080,31860,147358,126254,TR,TR
44982,1699046880,1699052160,5280,85780,62024,GB,GB
88945,1699229400,1699256640,27240,75031,55975,DE,CH
117485,1699281180,1699312440,31260,125794,94464,TR,TR
103868,1699172100,1699177320,5220,184270,99360,GB,GB
159934,1699295460,1699302300,6840,107271,184701,GB,GB
194113,1700614620,1700626500,11880,6886,108924,IT,IT
167818,1700393580,1700410080,16500,115243,52609,US,US
99294,1700016180,1700051100,34920,56173,180557,TR,TR
71082,1699876920,1699906380,29460,149689,36872,MK,AL
180047,1698802560,1698836160,33600,94846,167187,TR,TR
130740,1699549440,1699572900,23460,7404,155226,DE,DE
143369,1699011600,1699027800,16200,2558,39742,US,US
124061,1700638260,1700671800,33540,20084,86406,TR,TR
161782,1700530560,1700560020,29460,44325,81072,TR,TR
928,1699645980,1699678380,32400,73658,109055,TR,TR
183969,1699395900,1699399500,3600,198049,115720,GB,GB
23204,1699001820,1699005600,3780,18781,46653,NL,FR
43192,1700625000,1700660580,35580,73567,178127,TR,TR
147308,1699690500,1699694700,4200,97329,183646,NL,NL
76452,1699413900,1699446360,32460,97555,170035,TR,TR
61449,1699506720,1699515780,9060,172365,189555,IT,IT
7445,1700410200,1700424720,14520,102526,155845,US,US
52655,1700073300,1700079540,6240,11152,68167,NL,NL
98398,1699744320,1699754460,10140,35568,151338,PT,PT
116459,1699481160,1699494420,13260,166724,152108,US,US
166466,1699443360,1699478580,35220,162982,123364,TR,TR
148478,1700458620,1700487960,29340,124086,167665,TR,TR
96954,1699791240,1699821900,30660,46138,59552,TR,TR
158815,1698982920,1698988980,6060,158532,180146,GB,GB
156327,1699835280,1699865700,30420,21351,137722,TR,TR
123291,1699706640,1699723440,16800,53723,99593,US,US
140686,1699020780,1699032600,11820,188631,1695,AT,DE
52615,1698919920,1698947880,27960,194187,198814,DE,DE
15344,1700091900,1700125200,33300,146333,171913,TR,TR
96453,1700420280,1700453520,33240,155816,1412,TR,TR
170991,1698816600,1698824160,7560,84547,28903,IT,CH
40715,1700474940,1700489400,14460,190811,161402,US,US
36882,1700738160,1700744280,6120,58155,140385,GB,GB
159633,1699577700,1699581300,3600,95944,130339,GB,GB
59756,1700711580,1700715180,3600,111653,46880,NL,NL
56434,1699703160,1699706760,3600,178599,134241,GB,GB
191345,1700513040,1700541240,28200,179020,92052,BR,BR
51347,1699180740,1699196640,15900,24449,72928,US,US
57318,1700319660,1700345040,25380,145665,99269,BR,BR
98,1699227780,1699261740,33960,114284,55134,TR,TR
26143,1699512120,1699520460,8340,78285,138195,IT,IT
157481,1700185800,1700218020,32220,176838,21114,TR,TR
77915,1699399920,1699403520,3600,141650,71244,GB,GB
29488,1699356180,1699391040,34860,89367,87295,TR,TR
133162,1700688300,1700712120,23820,93333,23657,DE,HR
57620,1700611500,1700645940,34440,147224,97412,TR,TR
13959,1700024580,1700033220,8640,142183,97655,HR,HR
67072,1699034040,1699047240,13200,70828,9119,US,US
142529,1700288940,1700323740,34800,48680,148962,TR,TR
98752,1699777680,1699810260,32580,167919,143171,TR,TR
149732,1699242600,1699258560,15960,8144,92214,SE,SE
85034,1700224320,1700238600,14280,111445,82437,US,US
44384,1700675340,1700688840,13500,143,101389,AT,DE
133311,1700104620,1700134800,30180,77114,50473,TR,TR
16963,1700256960,1700272560,15600,93737,23155,US,MX
111391,1698882720,1698904680,21960,78031,175847,DE,DE
86573,1699013160,1699047840,34680,149583,191977,TR,TR
184259,1699260300,1699277340,17040,103537,88443,CZ,CZ
92906,1700812980,1700843160,30180,145430,188390,TR,TR
71387,1700237220,1700271960,34740,66793,151714,TR,TR
7190,1699590060,1699618800,28740,31459,105474,DE,IT
134946,1698973200,1698976800,3600,72939,118958,NL,NL
78713,1700245620,1700255040,9420,123621,57754,PT,PT
113706,1698825240,1698859380,34140,13402,130391,TR,TR
17566,1700237460,1700245080,7620,109562,47261,PT,PT
137569,1699448640,1699462560,13920,121798,64284,IT,IT
155748,1699412280,1699427400,15120,143190,65307,US,US
177603,1700010240,1700013840,3600,145595,66979,GB,GB
165926,1700562000,1700596380,34380,97254,154912,TR,TR
36534,1700336460,1700351820,15360,60832,91528,CZ,PL
184936,1699623240,1699628700,5460,79821,133420,GB,GB
84979,1699916700,1699951020,34320,35247,81885,TR,TR
16566,1700033040,1700063580,30540,137263,17787,TR,TR
62497,1700035800,1700064660,28860,125092,36794,TR,TR
188744,1699771620,1699779420,7800,2226,59477,IT,IT
114488,1698853260,1698888540,35280,106845,149543,TR,TR
63977,1698901380,1698906360,4980,122843,56378,GB,GB
76160,1700829960,1700863680,33720,194929,134794,TR,TR
185792,1699656300,1699671600,15300,21751,187842,US,US
46847,1700865540,1700893080,27540,92082,49235,BR,BR
49724,1700504880,1700517000,12120,89332,144526,US,US
156479,1700450940,1700474220,23280,195253,24720,DE,CZ
63940,1699208280,1699215720,7440,83205,79115,ES,ES
177455,1700149440,1700156220,6780,68043,197841,GB,GB
110642,1699573140,1699588920,15780,194368,121171,US,US
10985,1699661760,1699681260,19500,24763,102709,FR,FR
168932,1700243880,1700274540,30660,192547,7170,TR,TR
25391,1700277840,1700308980,31140,184165,64602,TR,TR
121363,1699374960,1699378560,3600,96923,122675,NL,NL
36039,1699167360,1699178520,11160,69228,196373,IT,IT
73658,1700657340,1700678760,21420,22935,64144,FR,FR
52130,1699807860,1699816860,9000,77216,6986,IT,IT
54867,1699444500,1699474020,29520,38745,67881,TR,TR
64580,1699580520,1699586340,5820,75947,195112,NL,NL
170084,1700578260,1700585040,6780,33135,130773,NL,NL
94510,1699473840,1699477440,3600,75642,147041,NL,NL
142679,1700230080,1700245500,15420,169401,9737,US,MX
162418,1699586940,1699610940,24000,124986,766,DE,DE
188124,1700127120,1700131800,4680,49534,152721,GB,GB
39431,1700844120,1700872440,28320,118619,164348,PL,PL
137493,1699854120,1699861380,7260,172570,35383,SK,SK
12228,1699660320,1699677900,17580,93835,168630,BE,FR
182117,1700409300,1700432640,23340,72087,25907,DE,DE
13428,1699434360,1699458420,24060,19730,23816,HU,AT
41765,1699931040,1699947780,16740,31328,174934,FR,FR
154871,1699468260,1699482900,14640,185891,126118,US,US
173418,1700039160,1700071440,32280,94750,119574,TR,TR
190411,1700439540,1700451540,12000,73527,20093,IT,IT
14485,1700625660,1700658600,32940,7266,166994,TR,TR
5940,1699135380,1699148340,12960,128630,191730,IT,FR
185674,1700319960,1700340180,20220,38596,197246,BE,NL
93763,1699638960,1699669500,30540,3163,164146,TR,TR
147420,1700600160,1700608740,8580,76311,173091,PT,PT
121957,1698925260,1698928860,3600,168569,118375,NL,NL
93796,1699262340,1699291320,28980,105562,89697,TR,TR
40414,1699752000,1699787040,35040,191142,25058,TR,TR
58061,1699412580,1699417800,5220,198351,140598,GB,GB
1741,1700595480,1700629140,33660,74085,134559,TR,TR
124085,1699699080,1699728780,29700,184058,789,TR,TR
27206,1699938600,1699951200,12600,95061,97283,IT,IT
171764,1700648220,1700671860,23640,72563,11024,DE,PL
5466,1699736340,1699753140,16800,15555,135854,US,US
162075,1699026540,1699053840,27300,68724,194135,BR,BR
96445,1699122840,1699126440,3600,21852,87215,GB,GB
7286,1700256000,1700286660,30660,28844,112418,TR,TR
108983,1699798140,1699810800,12660,143244,87955,HR,RS
39261,1698905520,1698937680,32160,45847,84741,TR,TR
163748,1700467680,1700480700,13020,131425,178404,SK,FR
174212,1700649840,1700682780,32940,113293,106791,MX,MX
183989,1700863800,1700889360,25560,104595,164973,PL,DE
61081,1699686360,1699694100,7740,93303,24085,PT,PT
49602,1699176660,1699210560,33900,149002,169329,TR,TR
156481,1699821240,1699857120,35880,113609,26608,TR,TR
164818,1700337420,1700366880,29460,34125,111369,TR,TR
126949,1699900920,1699912500,11580,106865,66929,US,US
122391,1699811760,1699823040,11280,181341,6621,ES,ES
180786,1699760700,1699796040,35340,193792,147962,TR,TR
13229,1700372640,1700393940,21300,100375,28948,FR,FR
137031,1700065920,1700119860,53940,78866,137955,BG,BG
115064,1699003080,1699036080,33000,33505,14331,TR,TR
102819,1699120020,1699125300,5280,160714,110439,GB,GB
183683,1699067940,1699122780,54840,190618,94965,UA,CZ
33996,1700780640,1700794020,13380,134404,195695,RS,RS
36767,1700706060,1700731800,25740,93090,153520,DE,IT
78553,1700071740,1700103600,31860,121455,58888,TR,TR
182236,1700238540,1700255580,17040,120944,192799,US,US
50131,1699705920,1699739160,33240,191284,177263,TR,TR
35191,1699638240,1699655880,17640,161014,173533,FR,IT
176615,1699528860,1699542780,13920,127552,25521,US,US
47094,1699374120,1699389000,14880,22263,132075,FR,FR
95408,1699782720,1699795020,12300,100748,90773,US,US
66066,1699573260,1699590000,16740,115199,196278,US,US
84076,1699297380,1699325040,27660,133624,110533,RO,TR
101438,1699619100,1699634580,15480,176203,120365,US,US
72117,1700481660,1700511660,30000,62542,166526,TR,TR
122350,1699294380,1699327440,33060,46939,18459,TR,TR
183087,1699310880,1699324920,14040,148875,53330,HR,HR
102969,1699843020,1699857060,14040,147046,79589,US,US
80842,1700013780,1700024160,10380,192784,52401,IT,HR
638,1699172100,1699182060,9960,13467,22141,IT,IT
120228,1700800800,1700833080,32280,188523,165866,TR,TR
33720,1699916520,1699929240,12720,863,65822,IT,IT
75028,1699467480,1699474620,7140,25288,123640,NL,NL
198311,1698910200,1698922920,12720,162340,40154,US,US
134473,1700421540,1700449200,27660,48182,64200,DE,CH
183184,1698991380,1698998400,7020,52718,48874,NL,NL
97804,1700847240,1700901540,54300,43422,20336,BG,DE
186999,1700746140,1700776260,30120,193680,96854,TR,TR
15360,1700316720,1700332140,15420,116271,126875,FR,FR
32512,1699444260,1699476240,31980,72685,17155,TR,TR
137143,1698884400,1698900960,16560,188679,173580,US,US
192784,1700752380,1700783220,30840,24016,90020,TR,TR
135319,1699582200,1699606320,24120,146614,56887,BR,BR
76138,1700061540,1700074500,12960,77007,66883,HR,HR
76654,1700779380,1700793240,13860,109132,171627,IT,IT
183109,1698910560,1698920940,10380,31061,186860,HR,HR
174721,1699785480,1699797420,11940,141612,52137,US,US
5034,1699125960,1699143660,17700,48433,26046,FR,DE
184068,1699683540,1699699320,15780,98614,74407,US,US
156453,1699796280,1699801500,5220,31385,33388,NL,NL
191851,1699205400,1699218240,12840,111573,41321,IT,IT
143120,1698911760,1698941700,29940,21865,49116,TR,TR
29543,1699521720,1699545180,23460,166992,91457,DE,DE
82949,1700226120,1700255400,29280,87001,166919,TR,TR
149694,1699470360,1699473960,3600,104171,51544,GB,GB
195000,1700631240,1700634840,3600,11824,174839,NL,NL
164640,1700771160,1700801580,30420,53195,168926,TR,TR
174902,1699812000,1699821000,9000,59208,94615,IT,IT
160450,1699242180,1699245780,3600,44154,135893,NL,NL
66984,1700350320,1700403960,53640,63168,143653,BG,DE
35637,1700337660,1700369520,31860,146678,68213,TR,TR
70255,1700083620,1700121000,37380,196188,19436,MX,US
43435,1700096340,1700129460,33120,130810,167550,TR,TR
33550,1699970700,1699992360,21660,156378,82661,DK,DK
121401,1699628460,1699650480,22020,164172,127018,RO,RO
176683,1700806380,1700809980,3600,123758,88923,NL,NL
108821,1700144760,1700157300,12540,66181,50809,US,US
57837,1699512900,1699544040,31140,23786,90278,TR,TR
174585,1700000040,1700029260,29220,5652,90616,TR,TR
9925,1700491620,1700502000,10380,85779,167588,HR,HR
58509,1698891900,1698925320,33420,128482,195264,TR,TR
87867,1699825380,1699832580,7200,143254,55881,IT,IT
13780,1699331580,1699346340,14760,45684,127776,RS,RS
14052,1700786400,1700790000,3600,20981,104721,NL,NL
102338,1700324040,1700333400,9360,49087,54085,IT,IT
7405,1699370760,1699381380,10620,142250,145318,EE,EE
48018,1699072140,1699077900,5760,178419,182651,NL,NL
16231,1698798240,1698821220,22980,113806,40914,DE,FR
178001,1699064880,1699100400,35520,92784,170316,TR,TR
89269,1700444280,1700473320,29040,144305,25787,TR,TR
133253,1700499480,1700510700,11220,40452,64410,IT,IT
112547,1700005080,1700017920,12840,105477,166464,PT,PT
181269,1699456740,1699489200,32460,122110,75905,MK,AL
118984,1699625580,1699662120,36540,169716,99351,MX,MX
128490,1700444400,1700461740,17340,39034,179470,US,US
53967,1699379340,1699390260,10920,92473,92679,CA,US
186218,1700536140,1700568120,31980,75458,197615,TR,TR
49687,1699441560,1699455180,13620,134794,174573,IT,IT
171930,1700809620,1700814060,4440,78507,179363,NL,NL
130569,1700774460,1700807700,33240,95415,16171,TR,TR
10801,1699902120,1699936800,34680,69992,157857,TR,TR
99837,1700049300,1700055000,5700,2095,187922,NL,NL
128435,1698835920,1698839520,3600,145089,191049,GB,GB
153634,1699385460,1699415640,30180,164668,33303,TR,TR
1536,1699168320,1699197420,29100,109158,79699,TR,TR
107924,1698976620,1698989580,12960,77399,145047,ES,ES
153760,1700862960,1700866560,3600,185613,35245,NL,NL
47674,1700331540,1700349420,17880,169884,31550,RS,RS
54137,1700099940,1700103540,3600,135382,164158,GB,GB
161472,1700632500,1700645940,13440,155473,135361,PT,PT
61509,1699441680,1699474620,32940,117438,75163,TR,TR
167906,1700101080,1700112660,11580,99086,125918,AT,RS
29134,1699178880,1699208880,30000,24862,75897,TR,TR
151706,1699336620,1699342740,6120,177591,129313,GB,GB
31038,1700754780,1700761140,6360,10648,72010,GB,GB
24050,1699882140,1699901940,19800,139620,121705,FR,DE
23173,1699568160,1699600080,31920,157135,144680,TR,TR
64703,1699232040,1699246800,14760,122913,50006,US,US
97276,1699897620,1699916280,18660,151386,20178,FR,CH
102195,1699272060,1699306080,34020,152657,197657,TR,TR
15671,1700463660,1700494440,30780,37673,162651,TR,TR
73030,1699410000,1699440660,30660,52074,123156,TR,TR
80486,1700353560,1700383500,29940,110664,166025,TR,TR
123711,1699356780,1699389120,32340,121453,167466,MK,CH
14203,1699726860,1699743420,16560,32150,82863,CZ,DE
49995,1700102040,1700130960,28920,164535,134992,TR,TR
140865,1699837560,1699869120,31560,19319,86709,TR,TR
26559,1700599500,1700612220,12720,130173,99882,IT,IT
18472,1700519640,1700527140,7500,167585,9746,IT,IT
36872,1700607360,1700615580,8220,130303,189082,IT,IT
28539,1699968900,1699976760,7860,60417,26250,HR,HR
71041,1699484880,1699516920,32040,108194,187324,TR,TR
4692,1700193120,1700224140,31020,150339,198866,TR,TR
113199,1699752660,1699787340,34680,144765,33666,TR,TR
2113,1699208700,1699222860,14160,125940,46002,US,US
9598,1699090560,1699122480,31920,97657,91544,TR,TR
176952,1699031040,1699043340,12300,198065,83703,IT,IT
168506,1700117580,1700152920,35340,193976,50448,TR,TR
16060,1700107320,1700119860,12540,77617,166099,IT,IT
28171,1698802380,1698814860,12480,31969,16928,IT,IT
196942,1699531260,1699549020,17760,138226,139216,US,US
164427,1700628480,1700650020,21540,41821,113003,FR,FR
196667,1700201580,1700205180,3600,62680,5256,NL,NL
43906,1699052400,1699069080,16680,179691,22674,US,US
104599,1700016960,1700020560,3600,138107,60439,GB,GB
157012,1699344240,1699349520,5280,105901,88210,NL,GB
120181,1700164500,1700198580,34080,88572,8773,TR,TR
35186,1699813980,1699817580,3600,168504,72753,NL,NL
51792,1700369580,1700404020,34440,30454,35502,TR,TR
184261,1699894080,1699928520,34440,149446,34205,TR,TR
153029,1699205100,1699218180,13080,157104,164160,IT,IT
190899,1700308980,1700338980,30000,135795,199635,TR,TR
151792,1699957980,1699991280,33300,87515,84312,TR,TR
99497,1699076100,1699082880,6780,138046,22608,GB,GB
129049,1698824820,1698829380,4560,9349,134861,NL,NL
147607,1700841480,1700852940,11460,105215,61711,SK,AT
188243,1700543880,1700556540,12660,20664,152261,AT,AT
15065,1700084100,1700102220,18120,155561,182750,FR,FR
93061,1700113260,1700145300,32040,163382,58528,TR,TR
26311,1700061000,1700089920,28920,173011,140299,TR,TR
15844,1700430240,1700433840,3600,158860,160204,GB,GB
179675,1700120580,1700142000,21420,71411,58230,FR,HU
182892,1700368260,1700401560,33300,109670,127745,TR,TR
46381,1700107020,1700112000,4980,105167,69565,GB,GB
121698,1699904520,1699940400,35880,18713,28658,TR,TR
16846,1700179620,1700214240,34620,188821,176095,TR,TR
111209,1699158180,1699193400,35220,81123,182593,TR,TR
78466,1700420460,1700429820,9360,173845,103359,IT,IT
93187,1699953180,1699968120,14940,23624,86377,US,US
194216,1699355340,1699359120,3780,31074,57717,GB,GB
97541,1699561920,1699566720,4800,146942,54810,GB,GB
68151,1699174140,1699186800,12660,105541,10202,CZ,CZ
174250,1699215540,1699250280,34740,121065,13871,TR,TR
44998,1699911480,1699926540,15060,29230,172791,US,US
199531,1700717100,1700752320,35220,37569,143862,TR,TR
32827,1700086320,1700118600,32280,88040,20062,TR,TR
149035,1699876020,1699885620,9600,144998,192483,IT,IT
153374,1698795000,1698803940,8940,17452,122431,HR,HR
62137,1699285860,1699297440,11580,176802,151061,RS,SI
134145,1700022660,1700035440,12780,51418,185939,HR,HR
116263,1699573020,1699608660,35640,34184,65494,TR,TR
88455,1700594700,1700598300,3600,195844,98945,GB,GB
138519,1700837700,1700865660,27960,99320,1881,PL,DE
118492,1700635320,1700652660,17340,57169,142997,FR,FR
52057,1698835980,1698839580,3600,164727,167179,NL,NL
178074,1699037220,1699040820,3600,157029,107904,NL,NL
179981,1699195560,1699199160,3600,53697,34600,NL,NL
173594,1699688340,1699719720,31380,38390,58526,TR,TR
14371,1699310520,1699329960,19440,152356,135869,FR,FR
155571,1700691240,1700722440,31200,79039,36708,TR,TR
38288,1699096020,1699107300,11280,137856,147731,IT,IT
195480,1700038080,1700041680,3600,92268,120098,GB,GB
13884,1699855200,1699860900,5700,150563,164901,GB,GB
26253,1699917780,1699949280,31500,126193,7356,TR,TR
142883,1698915840,1698944400,28560,148530,81032,DE,BA
40773,1699757760,1699788720,30960,88409,162214,TR,TR
64058,1699923240,1699926840,3600,107158,174893,GB,GB
62131,1699634280,1699664040,29760,35509,68696,TR,TR
131212,1699200900,1699205160,4260,11310,3263,GB,GB
157995,1698979500,1699008360,28860,2061,54647,TR,TR
184495,1698967740,1698996960,29220,36785,82679,TR,TR
137885,1700187960,1700193720,5760,101498,49961,NL,NL
189300,1699793580,1699810320,16740,71177,62077,FR,FR
23357,1698954180,1698983640,29460,71336,104237,TR,TR
179937,1700151660,1700185980,34320,91295,86302,TR,TR
9409,1700312640,1700316240,3600,191814,94743,NL,NL
45916,1699123740,1699144140,20400,185935,138334,FR,ES
142173,1700665980,1700696340,30360,1602,8508,TR,TR
54936,1699877460,1699881060,3600,24661,175310,GB,GB
128963,1699519320,1699537800,18480,141699,152257,FR,FR
78023,1700529420,1700540460,11040,91152,58955,US,US
199755,1700057700,1700086740,29040,87004,181657,TR,TR
133492,1698959520,1698963120,3600,150724,169145,NL,NL
17558,1699260600,1699266180,5580,88525,198944,GB,GB
72340,1700001720,1700024700,22980,150192,12068,DE,HU
178923,1699612620,1699625640,13020,127482,92825,US,US
26464,1700480880,1700484480,3600,137713,8952,GB,GB
2084,1700012880,1700047140,34260,119979,83412,TR,TR
2988,1700804640,1700838180,33540,192160,74087,TR,TR
80348,1699355700,1699359660,3960,139158,97165,EE,EE
176943,1700029500,1700038620,9120,16432,80775,ES,ES
13549,1700342700,1700356980,14280,114076,105256,PT,PT
150209,1699036380,1699043040,6660,82643,75828,EE,EE
55836,1698872940,1698876540,3600,199500,16870,NL,NL
92266,1699222260,1699230000,7740,136172,159461,HR,HR
101742,1699862460,1699886580,24120,10318,101188,DE,DE
101432,1700228700,1700263560,34860,105075,94225,TR,TR
176013,1700750280,1700762940,12660,17564,94658,IT,IT
46003,1699111320,1699134000,22680,133697,113675,CH,DE
64075,1699891740,1699907040,15300,197360,33621,US,US
88817,1698872580,1698901440,28860,70125,89246,TR,TR
176337,1699358100,1699370160,12060,149596,182398,US,US
57981,1700634240,1700640720,6480,107906,64799,GB,GB
56770,1699065180,1699077840,12660,67876,147772,IT,IT
64379,1698841080,1698871740,30660,124159,99131,TR,TR
12484,1700166060,1700197260,31200,132340,47932,TR,TR
56208,1699840020,1699870500,30480,149341,91084,TR,TR
104608,1699669620,1699681080,11460,82154,120546,IT,IT
98146,1699067760,1699074780,7020,71793,92215,GB,GB
111483,1700237100,1700254560,17460,177123,176488,US,US
167708,1699873320,1699909260,35940,100577,103912,TR,TR
11228,1699390980,1699420920,29940,147153,136804,TR,TR
62902,1698914460,1698945900,31440,184071,22207,TR,TR
115042,1700011380,1700043840,32460,97158,3158,TR,TR
12417,1700089020,1700102880,13860,75776,51416,US,US
59038,1699935660,1699949820,14160,80948,187633,IT,IT
97034,1700731500,1700761980,30480,133002,82959,TR,TR
176506,1699668780,1699683000,14220,113900,195169,HR,HR
70009,1698927360,1698965760,38400,160574,81924,MX,MX
103090,1700146080,1700178240,32160,185576,59180,TR,TR
82789,1700608020,1700628780,20760,13733,167923,DK,DK
118715,1700751480,1700775540,24060,144434,109499,DE,BG
132368,1699867080,1699884780,17700,91710,169306,US,US
90082,1699343340,1699354620,11280,88568,198520,US,US
112240,1699133100,1699159440,26340,96586,86715,DE,FR
56248,1699180980,1699211880,30900,102870,33033,TR,TR
49048,1700568060,1700576400,8340,127125,90720,IT,IT
27499,1700781060,1700795880,14820,95251,30198,FR,CZ
115902,1699744740,1699749900,5160,114724,137939,GB,GB
188043,1699573320,1699590540,17220,185219,36888,US,US
145678,1700636160,1700641920,5760,156134,187141,EE,EE
79041,1700379240,1700431200,51960,193533,72901,BG,BG
122215,1700460240,1700494980,34740,165276,177412,TR,TR
8030,1699453320,1699471440,18120,78059,81943,FR,ES
131724,1699592520,1699617120,24600,96871,172217,DE,DE
136006,1699874220,1699907640,33420,81180,110294,TR,TR
59027,1699272060,1699276500,4440,33464,57364,NL,NL
23881,1699668060,1699678620,10560,24797,61072,IT,IT
136406,1700674680,1700699880,25200,88535,112670,DE,DE
46548,1700499000,1700502600,3600,49786,50428,GB,GB
28939,1700519400,1700523000,3600,91573,46167,GB,GB
108443,1699371420,1699401600,30180,122322,95693,TR,TR
132034,1699979400,1699994400,15000,1914,136143,US,US
66756,1699752180,1699758180,6000,61187,139344,GB,GB
35466,1700813340,1700816940,3600,5615,175290,NL,NL
63881,1699494720,1699509240,14520,125995,69584,AT,AT
33305,1700681940,1700687460,5520,131348,182799,GB,GB
198112,1698990420,1699021140,30720,108366,115528,TR,TR
183222,1700446200,1700449800,3600,167955,45780,GB,GB
165389,1699400460,1699406340,5880,72217,141907,GB,GB
173783,1699790220,1699801320,11100,193703,41536,CZ,SK
169527,1699774500,1699786320,11820,118028,69426,US,US
46836,1699719300,1699751700,32400,189053,52703,TR,TR
19258,1700032980,1700043420,10440,62075,50298,PT,PT
53809,1700813820,1700844480,30660,76365,98492,TR,TR
53903,1700471160,1700500200,29040,93733,21192,TR,TR
54466,1698909840,1698932100,22260,45134,24490,DE,BG
69029,1700098200,1700109600,11400,141514,64976,RS,RS
37710,1699553760,1699574580,20820,46859,93543,FR,FR
74327,1699293540,1699307040,13500,173375,31656,ES,FR
49305,1699865880,1699900020,34140,45971,16587,TR,TR
15407,1700041620,1700045220,3600,62032,116801,NL,DE
89705,1700524980,1700555460,30480,53060,153053,TR,TR
60417,1699664760,1699694340,29580,3791,178638,TR,TR
144308,1700597640,1700635680,38040,116497,172594,MX,MX
71089,1698983880,1699019160,35280,181777,17682,TR,TR
196481,1699933320,1699943820,10500,84717,157244,ES,ES
1671,1700784240,1700796540,12300,1989,138475,HR,HR
63129,1698909540,1698923640,14100,153418,11858,US,US
152505,1699799940,1699828440,28500,185261,109456,BR,BR
38690,1699508880,1699514400,5520,73782,84271,AD,FR
107110,1699847640,1699856940,9300,27993,95572,IT,IT
143509,1699425660,1699429260,3600,157144,46391,GB,GB
107826,1700764620,1700773320,8700,15632,180920,HR,HR
93321,1699397820,1699430760,32940,186063,34104,TR,TR
130475,1699030500,1699066140,35640,38989,149029,TR,TR
70336,1699030560,1699060440,29880,175020,127989,TR,TR
65871,1700770320,1700803740,33420,74428,14137,TR,TR
69898,1699263960,1699269240,5280,59265,9786,GB,GB
65066,1699840620,1699844220,3600,45364,181344,NL,NL
152105,1699828740,1699832340,3600,76065,47911,GB,GB
31025,1699898940,1699912200,13260,48752,198318,IT,IT
138909,1699610160,1699627560,17400,104933,102452,RS,DE
56580,1699136820,1699141680,4860,59434,51832,GB,GB
61585,1698856440,1698891180,34740,185717,162644,TR,TR
4978,1700240460,1700252820,12360,172217,163815,US,MX
128106,1699075800,1699087140,11340,141167,79074,US,US
65643,1698952680,1698962100,9420,45341,22784,IT,IT
164119,1699473000,1699481400,8400,164923,82502,HR,IT
138021,1700476680,1700488620,11940,106211,185831,PT,PT
59742,1699199700,1699210020,10320,73480,139960,SK,SK
198831,1700257320,1700292900,35580,51546,146782,TR,TR
122213,1699333200,1699349580,16380,68520,40269,CZ,DE
95878,1700034480,1700066460,31980,70634,8837,TR,TR
77184,1699019940,1699023540,3600,111778,156877,GB,GB
194265,1699386600,1699394820,8220,56010,124275,HR,HR
58281,1700004360,1700038140,33780,176245,170194,TR,TR
129302,1698837300,1698869220,31920,155228,106211,TR,TR
49345,1699408980,1699419900,10920,5392,147525,ES,ES
196536,1698819840,1698830460,10620,113053,34667,IT,IT
184400,1699002360,1699032960,30600,67682,138013,TR,TR
175870,1700536800,1700557860,21060,117742,177436,FR,BE
164922,1699030260,1699061520,31260,26965,187564,TR,TR
126086,1699567080,1699580160,13080,96434,28682,HR,BA
58814,1699024680,1699036860,12180,37110,64958,IT,IT
174325,1700785140,1700800020,14880,125742,90219,FR,BE
185003,1699883760,1699912980,29220,165445,49188,TR,TR
45744,1699126860,1699148460,21600,179595,111970,RO,RO
6126,1699692960,1699707600,14640,14561,59987,US,US
92140,1700106600,1700120340,13740,122201,143819,HR,HR
69572,1699609140,1699641540,32400,119208,19044,TR,TR
49213,1700384640,1700401860,17220,12641,8650,US,US
73941,1700163240,1700176620,13380,104000,83451,PT,FR
14221,1699300680,1699308360,7680,119753,143227,IT,IT
184532,1700503860,1700538360,34500,196074,142954,TR,TR
114676,1699107360,1699120320,12960,6462,79712,IT,IT
63624,1699095060,1699126860,31800,167179,185266,TR,TR
1842,1700463300,1700518800,55500,139473,112713,UA,PL
119878,1699163160,1699177560,14400,52989,187539,RS,SI
166482,1700287260,1700317320,30060,10327,129554,TR,TR
153210,1700050260,1700082540,32280,165601,131759,TR,TR
1845,1699909200,1699923240,14040,12275,189838,US,US
199501,1700547900,1700563080,15180,149808,169055,AT,AT
94436,1700750400,1700786340,35940,34609,112311,TR,TR
151057,1699054680,1699075860,21180,38965,73272,FR,DE
93813,1699423500,1699435080,11580,56232,83742,US,US
29359,1699187040,1699190640,3600,111909,91807,GB,GB
197099,1700754720,1700767680,12960,3600,4481,PT,PT
187596,1700143860,1700159880,16020,1955,163626,US,US
149938,1699668060,1699701960,33900,150800,1282,MX,MX
95942,1699399740,1699411740,12000,278,179461,IT,IT
165242,1699497840,1699530180,32340,78431,90700,TR,TR
152965,1699006200,1699009800,3600,192440,170925,NL,NL
4845,1700167080,1700182140,15060,148578,108633,CZ,SK
13713,1699010400,1699024860,14460,73447,50852,US,US
125797,1700692740,1700723220,30480,31392,118479,TR,TR
113016,1699196340,1699250400,54060,46589,23242,UA,DE
136869,1700773860,1700803380,29520,73566,2585,TR,TR
41941,1700372100,1700407140,35040,79980,195581,TR,TR
108145,1699478280,1699485240,6960,97623,157070,GB,GB
141673,1700787900,1700796480,8580,124246,85495,SK,AT
43694,1700538780,1700542380,3600,191809,172984,GB,GB
40094,1699078740,1699109040,30300,198518,159666,BA,RS
109146,1700489580,1700521260,31680,195349,5360,TR,TR
13097,1699203780,1699239120,35340,131612,15737,TR,TR
62818,1699254960,1699263300,8340,60730,70217,IT,IT
60329,1700500980,1700533560,32580,80071,131638,TR,TR
24523,1699907100,1699910760,3660,5121,122353,NL,NL
62265,1700860620,1700873760,13140,98577,55829,CZ,CZ
148853,1699689900,1699700880,10980,70531,145650,US,US
79548,1699136520,1699147980,11460,148200,132628,IT,IT
141505,1700397000,1700412900,15900,8980,3387,US,US
107666,1699411680,1699440480,28800,43747,100905,TR,TR
84149,1700654700,1700658300,3600,32234,171797,GB,GB
122744,1699993680,1700005320,11640,743,190036,US,US
103859,1699635180,1699638960,3780,172010,150282,GB,GB
163103,1698924720,1698957300,32580,91079,97497,TR,TR
107462,1698816300,1698849540,33240,8532,290,TR,TR
110544,1699501380,1699512780,11400,51231,53683,US,US
20873,1700317440,1700323740,6300,179888,49888,GB,GB
112974,1699196640,1699231920,35280,47722,46382,TR,TR
72789,1699983300,1699994820,11520,135662,152311,US,US
104281,1698991320,1698994920,3600,65464,182514,NL,NL
119858,1700637120,1700650860,13740,72496,51392,US,US
135538,1698814140,1698842700,28560,194370,5315,HU,CZ
169498,1700535660,1700571900,36240,136030,35710,MX,MX
45339,1700791260,1700801760,10500,30687,47436,IT,IT
23403,1700540220,1700550720,10500,146997,185948,IT,IT
80258,1699113960,1699129620,15660,87962,103922,US,US
98549,1699706040,1699714020,7980,108496,72072,IT,IT
13464,1700217300,1700251140,33840,173196,134402,MX,MX
48209,1699617480,1699631940,14460,95182,138112,US,US
125273,1700395380,1700398980,3600,67215,167402,GB,GB
66750,1700625840,1700646840,21000,80424,49780,FR,FR
73805,1700189460,1700206620,17160,84804,174102,US,US
87968,1700225820,1700237100,11280,164985,37297,US,US
19864,1698834000,1698845460,11460,152028,28693,PT,PT
58412,1700045280,1700071140,25860,157262,186179,DE,FR
19242,1700190180,1700202180,12000,140716,175568,AT,AT
157576,1700667600,1700680680,13080,18401,16992,IT,IT
109310,1699640280,1699651500,11220,129802,100753,PT,PT
51248,1700011500,1700019960,8460,21496,70314,IT,IT
51159,1700154720,1700170200,15480,89636,92623,RS,HR
64170,1699579020,1699602120,23100,153382,67134,MD,RO
40367,1700655360,1700687880,32520,43226,160735,TR,TR
43827,1700210760,1700227860,17100,176096,150821,US,US
108314,1700469180,1700498760,29580,159966,94710,TR,TR
90354,1700631840,1700647860,16020,172599,36114,US,US
55476,1699844940,1699879800,34860,151505,161070,TR,TR
79056,1699990680,1700002680,12000,62306,27648,RS,RS
127590,1700656380,1700680560,24180,75672,133659,DE,AT
91569,1700556420,1700585580,29160,28905,60580,TR,TR
104903,1699624920,1699628520,3600,127409,80397,NL,NL
147359,1699517880,1699545000,27120,159054,41602,RO,RO
56318,1700154960,1700169300,14340,156117,116872,US,US
12550,1698924720,1698959940,35220,54422,194198,TR,TR
66511,1699947240,1699979580,32340,98513,89949,TR,TR
154093,1699569720,1699573320,3600,157040,192334,NL,BE
178803,1700831460,1700868060,36600,186150,160881,MX,MX
144674,1699449420,1699475940,26520,175011,105886,HU,HR
22724,1699901400,1699913280,11880,34959,70648,US,US
8414,1700201880,1700233200,31320,70178,104990,TR,TR
1502,1700273160,1700276760,3600,155183,194072,GB,GB
188203,1700821440,1700839260,17820,26775,30634,RS,BG
126693,1699460220,1699470540,10320,2007,134453,PT,PT
30172,1699025040,1699031340,6300,609,179411,NL,NL
87809,1698892800,1698896400,3600,5867,119481,NL,NL
142884,1699891920,1699916460,24540,17458,49093,DE,DE
92793,1700019600,1700023200,3600,75496,146844,NL,NL
133122,1700354760,1700368560,13800,38179,48745,US,US
11626,1699780920,1699787340,6420,141410,83691,GB,GB
84268,1698968520,1698972120,3600,174533,199156,GB,GB
3158,1699150320,1699181220,30900,182665,16880,BA,BA
184543,1699994700,1700028600,33900,7736,154999,TR,TR
45710,1699018440,1699031220,12780,22594,118001,AT,BG
3160,1699944360,1699952760,8400,151848,172359,IT,IT
47106,1700589540,1700598360,8820,109718,181262,IT,IT
14821,1699627140,1699634700,7560,85822,134632,HR,HR
72230,1700026800,1700030400,3600,111657,5443,GB,GB
189564,1700401680,1700435280,33600,107382,15164,TR,TR
177420,1700804040,1700839680,35640,101637,167808,TR,TR
65321,1698903480,1698907860,4380,44525,84856,GB,GB
36730,1700412780,1700423160,10380,186980,58310,IT,IT
89000,1699811700,1699842240,30540,152890,63336,TR,TR
124854,1699847640,1699853100,5460,151274,43087,GB,GB
105361,1700814360,1700825940,11580,36784,71911,IT,IT
20897,1700184720,1700218920,34200,88277,100558,TR,TR
170031,1699996680,1700006460,9780,141668,117269,IT,IT
99369,1699110720,1699140180,29460,11221,192184,TR,TR
55153,1700304360,1700337900,33540,11774,52134,MX,MX
128886,1699079520,1699114860,35340,160531,184898,TR,TR
149358,1699231020,1699245900,14880,76333,199463,RS,BA
134238,1699455000,1699486980,31980,171597,43589,TR,TR
112647,1700597040,1700600640,3600,137544,28608,GB,GB
48795,1699260900,1699275960,15060,29049,143274,FR,FR
177663,1700288160,1700317080,28920,125244,83230,BA,RS
164923,1698856740,1698879780,23040,125613,87613,PL,PL
198174,1698803880,1698815220,11340,131332,169132,ES,PT
36975,1699202040,1699235580,33540,13400,86320,TR,TR
166130,1699433820,1699442940,9120,92291,191636,IT,IT
197686,1699807020,1699813140,6120,197032,109014,NL,NL
167520,1698903600,1698911280,7680,116414,21837,PT,PT
105517,1698928500,1698940380,11880,56318,144725,PT,PT
122280,1699173240,1699191060,17820,115568,148631,AT,AT
66439,1700426880,1700456100,29220,2499,129393,TR,TR
72763,1698857640,1698870660,13020,166469,25599,US,US
144492,1699406400,1699420680,14280,3727,164048,US,US
1616,1700723100,1700734680,11580,65246,72390,IT,IT
30715,1699998180,1700031240,33060,45,106805,TR,TR
153184,1700472660,1700476380,3720,46627,169836,NL,NL
7696,1698885840,1698889440,3600,177531,145322,GB,GB
4706,1699779240,1699809180,29940,50002,24896,TR,TR
99779,1700093220,1700127180,33960,74236,180396,TR,TR
91783,1699109100,1699114800,5700,161804,136884,GB,GB
61897,1700245140,1700260920,15780,823,66373,AT,AT
165034,1700505480,1700515920,10440,156320,110278,IT,IT
55369,1698928860,1698942540,13680,15967,92386,HR,HR
69196,1700375760,1700399880,24120,4542,166841,CH,FR
130866,1699050120,1699067340,17220,111932,195727,AT,SK
42440,1699453380,1699459680,6300,32919,52099,GB,GB
172322,1699162440,1699175760,13320,91909,171703,PT,PT
194086,1699405500,1699416960,11460,23346,93478,ES,ES
2255,1699329780,1699362240,32460,187463,13731,TR,TR
158527,1700065860,1700096040,30180,43276,174807,TR,TR
58833,1700017440,1700049300,31860,78144,25333,TR,TR
37946,1700674200,1700698800,24600,44327,91132,BR,BR
5174,1698852000,1698875880,23880,151459,4610,PL,CH
16666,1700106240,1700110380,4140,98199,32569,GB,GB
173969,1699621500,1699652760,31260,12534,125418,TR,TR
106630,1700292420,1700326920,34500,78839,156848,TR,TR
137625,1700564460,1700597640,33180,95814,113995,TR,TR
171694,1699308420,1699332240,23820,52088,138785,CH,PL
152866,1699980300,1699993860,13560,96351,94058,US,US
127365,1699883520,1699906380,22860,109797,164963,NO,SE
125540,1699631760,1699666380,34620,35443,126054,TR,TR
157940,1699651800,1699655580,3780,66188,90331,GB,GB
185670,1699754280,1699762140,7860,119819,62613,IT,IT
38598,1699209060,1699212660,3600,70655,185484,NL,NL
154052,1699758900,1699771320,12420,85141,63576,US,US
190404,1700349240,1700352840,3600,14235,69561,NL,NL
88612,1698978780,1698997800,19020,157299,162782,FR,FR
69579,1700762100,1700779380,17280,110632,107560,US,US
127756,1699293840,1699314060,20220,168700,94183,FR,HR
41027,1700503620,1700521320,17700,167569,12698,US,US
131835,1700725920,1700743140,17220,25220,143861,US,US
26182,1699169700,1699203060,33360,192635,186566,TR,TR
167081,1699193100,1699225740,32640,186992,114356,TR,TR
169134,1699042500,1699055460,12960,65231,160269,ES,FR
101688,1699153020,1699180620,27600,117104,39014,DE,IT
539,1700701380,1700737080,35700,51449,162437,TR,TR
79145,1700158080,1700177820,19740,198982,104903,FR,FR
57585,1700747700,1700763840,16140,79463,163545,US,US
198726,1700074800,1700079900,5100,28196,168237,GB,GB
156755,1699494900,1699506780,11880,116542,166307,PT,PT
54659,1700599020,1700617800,18780,118367,55892,SE,SE
52238,1700610120,1700631960,21840,156672,16352,CH,IT
28990,1699393020,1699403220,10200,1083,143711,IT,IT
89539,1700251980,1700285220,33240,4599,145183,TR,TR
103355,1700491320,1700525100,33780,74262,37326,TR,TR
86795,1698937140,1698948540,11400,113342,133889,US,US
40083,1699056480,1699068720,12240,39845,171378,IT,CH
177961,1699272960,1699304160,31200,13077,59803,TR,TR
46879,1700765580,1700795220,29640,138018,151397,TR,TR
146756,1699882740,1699912800,30060,35726,182197,TR,TR
4774,1700591700,1700608380,16680,147425,150445,FR,FR
155363,1698911160,1698942180,31020,160900,53875,TR,TR
110633,1699744260,1699777500,33240,45464,166029,TR,TR
188451,1699733340,1699746120,12780,33497,110411,IT,IT
79351,1699650660,1699655760,5100,21954,103184,GB,GB
92100,1698930540,1698934380,3840,144975,101756,GB,GB
149257,1700203500,1700230500,27000,94638,4296,BR,BR
77442,1699456320,1699488180,31860,49847,21723,TR,TR
38906,1699980120,1699984920,4800,184724,115624,GB,GB
28677,1698979320,1698982920,3600,167820,74524,GB,GB
79702,1700574660,1700607420,32760,156753,84013,TR,TR
85937,1699819680,1699828860,9180,23870,97622,HR,HR
132326,1699072920,1699086720,13800,22989,183931,IT,IT
113911,1700012040,1700046240,34200,116871,58364,TR,TR
150666,1699866660,1699870260,3600,175696,98900,GB,GB
198944,1700073000,1700102100,29100,114292,99319,TR,TR
55056,1699650780,1699684740,33960,115749,19165,TR,TR
197223,1699062900,1699066500,3600,12028,37082,NL,NL
165630,1699548660,1699583580,34920,148709,13389,TR,TR
95636,1698912300,1698918360,6060,169373,130789,NL,NL
127223,1699898700,1699902300,3600,187269,30420,GB,GB
105673,1698937620,1698963060,25440,192985,128130,DE,BG
166024,1700728500,1700734500,6000,107247,43570,NL,NL
160070,1699779300,1699792920,13620,115308,161686,US,US
186095,1699886520,1699895640,9120,23756,163215,IT,IT
79035,1699061940,1699076220,14280,150824,116819,US,US
57690,1698861840,1698917940,56100,64706,74145,BG,BG
38453,1699405200,1699419900,14700,89217,192089,US,US
29903,1700370540,1700423160,52620,101457,179970,BG,AT
39009,1700780880,1700809920,29040,48749,165901,TR,TR
43722,1700665740,1700699700,33960,156078,84649,TR,TR
26337,1700782920,1700786520,3600,81794,72470,NL,NL
148648,1699814460,1699820580,6120,58279,89221,NL,NL
82181,1698815640,1698819240,3600,3000,190160,GB,GB
49145,1699949280,1699955040,5760,36917,151785,NL,DE
174350,1699905540,1699910640,5100,86511,2172,GB,GB
75135,1699128000,1699146960,18960,164761,131060,FR,FR
111693,1700275560,1700287620,12060,22656,11196,CA,CA
43064,1700746440,1700761140,14700,80292,140566,US,US
64091,1699435380,1699465260,29880,130211,151278,TR,TR
21359,1700724420,1700754660,30240,16787,79368,TR,TR
24721,1699759500,1699788600,29100,137644,176777,TR,TR
135809,1700770740,1700787120,16380,185075,16951,RS,RS
127053,1700255520,1700290800,35280,92540,57880,TR,TR
134029,1700313780,1700349720,35940,149064,24358,TR,TR
140055,1700855160,1700862300,7140,196499,162928,AD,FR
185321,1700524500,1700554140,29640,124674,153873,TR,TR
177088,1700835540,1700848920,13380,68169,76564,IT,IT
46270,1699751280,1699775940,24660,195690,64773,DE,DE
108611,1699088760,1699092720,3960,82825,6060,NL,NL
51549,1700663280,1700696100,32820,134253,13864,TR,TR
10665,1700384940,1700419380,34440,194597,118683,TR,TR
44059,1700163900,1700174040,10140,157688,147160,IT,IT
20853,1700454420,1700458020,3600,111059,124787,GB,GB
34473,1699677720,1699700820,23100,11858,144390,CH,DE
166241,1699830720,1699834620,3900,152172,157128,GB,GB
168619,1698854880,1698886560,31680,11275,138776,MK,CH
83746,1699869840,1699876140,6300,11487,158408,NL,NL
156824,1699260840,1699290600,29760,67063,180801,TR,TR
155031,1700130960,1700166000,35040,50535,106578,TR,TR
160531,1699326420,1699357740,31320,170138,99881,TR,TR
18498,1699028100,1699031700,3600,161459,147496,GB,GB
64078,1699949880,1699965720,15840,55816,84829,US,US
60985,1698928140,1698957900,29760,157136,46479,TR,TR
139664,1699215780,1699248180,32400,194443,20071,TR,TR
10727,1698892740,1698896340,3600,103672,103028,GB,GB
35552,1700380140,1700402100,21960,19685,42078,PL,DK
188233,1700469000,1700503320,34320,70522,56890,TR,TR
150701,1698942840,1698955800,12960,129222,41669,US,US
134033,1700213580,1700242500,28920,58658,117352,TR,TR
92455,1700436840,1700441460,4620,107905,94446,GB,GB
48875,1700054880,1700068500,13620,124185,29917,US,US
162179,1700834760,1700851320,16560,53500,26859,CZ,SK
85672,1699643100,1699652760,9660,149531,147783,IT,IT
11862,1700686080,1700708460,22380,124597,157996,PL,PL
196204,1699671840,1699699740,27900,169075,44154,PL,NL
148126,1700529240,1700565120,35880,59024,20621,TR,TR
39081,1699376400,1699380000,3600,101964,50621,GB,GB
36408,1699837800,1699868100,30300,76981,109087,TR,TR
99738,1698951960,1698977640,25680,60406,132380,DE,PL
13448,1700375340,1700386740,11400,131437,93689,US,US
96803,1699488240,1699518060,29820,108806,198160,TR,TR
86395,1699067700,1699082580,14880,111331,158216,BE,PL
131434,1700480100,1700510760,30660,107559,36998,TR,TR
73552,1700397600,1700425080,27480,88908,54668,DE,DE
194296,1700694240,1700728560,34320,104221,90629,TR,TR
47417,1699088940,1699122360,33420,187322,11682,TR,TR
83275,1698964500,1698971160,6660,27390,120275,GB,GB
126839,1699992960,1700023200,30240,185029,33338,TR,TR
109571,1700583420,1700619060,35640,93708,4622,TR,TR
161911,1699432920,1699455360,22440,76834,100772,DE,DE
29692,1700058180,1700066460,8280,28982,172587,PT,PT
18424,1700779560,1700793180,13620,151739,23038,RS,RS
173804,1700085360,1700109060,23700,504,91005,DE,FR
59914,1699178280,1699188540,10260,51844,115360,IT,HU
124868,1699330080,1699340280,10200,107690,27461,PT,PT
102768,1700382960,1700393880,10920,175388,85828,US,US
116304,1700861160,1700864760,3600,197525,121466,GB,GB
19764,1700153040,1700169360,16320,76417,156567,AT,AT
76275,1700669700,1700678400,8700,163293,29875,EE,FI
130221,1699391520,1699405740,14220,46896,119525,RS,RS
152160,1699688460,1699722660,34200,76388,14964,TR,TR
64343,1700801520,1700830920,29400,137819,21068,TR,TR
132233,1699160160,1699190880,30720,80714,145793,TR,TR
34679,1699731000,1699741440,10440,185954,188136,IT,IT
68171,1698859380,1698888240,28860,153317,154810,TR,TR
100623,1699861980,1699895820,33840,10862,8284,TR,TR
193897,1699694760,1699730340,35580,12308,156918,TR,TR
133806,1700705340,1700708940,3600,172722,95226,GB,GB
10960,1700823540,1700829180,5640,138497,105812,AD,FR
113542,1699488120,1699505100,16980,29451,52568,FR,IT
153604,1700246880,1700250480,3600,124904,37829,GB,GB
55126,1699814040,1699845240,31200,104020,22791,TR,TR
177269,1699431000,1699466340,35340,109045,70671,TR,TR
28192,1699142100,1699158960,16860,53731,157080,US,US
64628,1699081920,1699111260,29340,128544,143366,TR,TR
169613,1700246580,1700278260,31680,91127,75529,BA,BA
79928,1699880040,1699903260,23220,114258,60273,DE,AT
124026,1699452840,1699464000,11160,199104,38256,ES,ES
42793,1699411080,1699445700,34620,170822,94807,TR,TR
74742,1699587180,1699599180,12000,94266,57950,IT,IT
52815,1700525520,1700553180,27660,138390,155235,BR,BR
83097,1699091340,1699120500,29160,24120,89912,TR,TR
14575,1699665180,1699675080,9900,141809,6010,IT,IT
198432,1699559940,1699620540,60600,11567,46732,UA,DE
21763,1700009700,1700024100,14400,186041,21055,FR,PL
90145,1700260020,1700263620,3600,56886,127829,NL,NL
131246,1699335900,1699339680,3780,90764,133627,GB,GB
52968,1700328180,1700359980,31800,159016,12751,TR,TR
3399,1699929000,1699942380,13380,184879,21004,RS,DE
193462,1700318580,1700325960,7380,131720,131164,ES,ES
104324,1699134300,1699163580,29280,30066,111952,TR,TR
117702,1699823340,1699854360,31020,30127,149203,TR,TR
120502,1700807040,1700840880,33840,46852,51882,TR,TR
128280,1699269840,1699282260,12420,28022,83383,US,US
192711,1700493180,1700528280,35100,51575,191456,TR,TR
53930,1699076100,1699109760,33660,61286,74208,TR,TR
118696,1699132140,1699135740,3600,138547,133384,GB,GB
160624,1700110260,1700144820,34560,184445,176945,TR,TR
27546,1698844560,1698848160,3600,132411,142968,GB,GB
57306,1699670880,1699684680,13800,26373,192579,PT,PT
180708,1700074380,1700085900,11520,4066,34449,IT,IT
178170,1700781660,1700812500,30840,129183,68697,TR,TR
53430,1700192520,1700205060,12540,130870,12199,US,US
86999,1699470300,1699505160,34860,36081,138966,MX,MX
54271,1699515540,1699540740,25200,65221,4072,DE,BG
139939,1699906140,1699919220,13080,99480,177704,IT,IT
39305,1700114160,1700130120,15960,39379,185312,US,US
57953,1700476800,1700485800,9000,151404,194810,IT,IT
27782,1699356120,1699370760,14640,24758,196863,AT,AT
196500,1700293980,1700297580,3600,82633,114389,NL,NL
17082,1699986000,1699994100,8100,7892,135352,HR,HR
133796,1698811680,1698868200,56520,154383,192792,BG,AT
92685,1699448520,1699463580,15060,173604,46935,US,US
158471,1699895460,1699926840,31380,159352,168738,TR,TR
104439,1699530720,1699540440,9720,101118,17262,PT,PT
103256,1700345520,1700375820,30300,142073,197397,TR,TR
119214,1700049000,1700065680,16680,45306,182386,BE,NL
105803,1699205340,1699222620,17280,111450,16291,US,US
32433,1700083740,1700091540,7800,159835,130442,HR,HR
162775,1699415520,1699445520,30000,98776,174992,TR,TR
147657,1700549580,1700553180,3600,68309,66902,GB,GB
29104,1700496240,1700525580,29340,43620,17885,TR,TR
70473,1700185260,1700214240,28980,48436,23295,TR,TR
133665,1698867300,1698883860,16560,10244,63969,AT,AT
47396,1700482920,1700500440,17520,11609,167817,FR,IT
165531,1699799160,1699802760,3600,109050,160443,GB,GB
28605,1699508820,1699514760,5940,160729,30106,GB,GB
109705,1700464380,1700482200,17820,96776,178468,FR,DE
41008,1699845420,1699857480,12060,23319,37067,IT,IT
129780,1699050960,1699059360,8400,186005,21687,HR,BA
95591,1699075740,1699106160,30420,62240,126238,TR,TR
59910,1700092500,1700104920,12420,9332,40315,US,US
111177,1700501100,1700531580,30480,8620,51289,TR,TR
100436,1699725240,1699739160,13920,46188,144792,IT,IT
30117,1699752300,1699787760,35460,75770,82009,TR,TR
146914,1700713260,1700745420,32160,40199,156387,TR,TR
166456,1700538480,1700542080,3600,146339,20422,GB,GB
195760,1700408520,1700439240,30720,129972,34189,TR,TR
78706,1700638140,1700668380,30240,54477,23239,TR,TR
174299,1699330140,1699356780,26640,123659,44967,BR,BR
85018,1700419920,1700446800,26880,23367,13097,DE,UA
112308,1700513220,1700547780,34560,170363,56083,TR,TR
20541,1698924660,1698954180,29520,100291,197105,TR,TR
163135,1699255740,1699291440,35700,182767,27540,TR,TR
118527,1698982500,1699001160,18660,22747,162325,BE,IT
41485,1699734360,1699764540,30180,65871,169726,TR,TR
175543,1699641060,1699672440,31380,91899,143020,TR,TR
36234,1700783220,1700816040,32820,12144,196372,TR,TR
189527,1699874880,1699886340,11460,150954,60947,RS,RS
39378,1699541460,1699575120,33660,17242,96478,TR,TR
159918,1699766280,1699796100,29820,63580,115805,TR,TR
52125,1700386800,1700404620,17820,53538,81034,FR,NL
120615,1700179920,1700186160,6240,144022,69005,NL,NL
116313,1700270640,1700285280,14640,8836,20713,US,MX
173974,1700163660,1700216100,52440,30704,141040,BG,DE
18077,1700461740,1700494440,32700,198453,198145,TR,TR
14036,1699845600,1699876980,31380,193273,132747,TR,TR
125820,1700730600,1700737200,6600,6649,193513,EE,EE
15071,1699095600,1699099200,3600,176300,126245,GB,GB
13498,1699474080,1699504920,30840,151853,100897,TR,TR
128257,1700512140,1700549640,37500,126057,42433,MX,MX
149224,1700290920,1700296260,5340,165129,179388,GB,GB
42588,1700283780,1700294880,11100,25810,68325,HR,HR
26313,1700377560,1700433180,55620,41276,61907,BG,AT
25870,1700183580,1700187180,3600,15504,36875,GB,GB
84988,1699146480,1699150080,3600,188986,179306,NL,NL
14751,1699065360,1699071720,6360,154883,15274,NL,NL
20871,1700449620,1700453460,3840,42428,158362,GB,GB
142725,1699846380,1699864980,18600,95428,143152,FR,CZ
184295,1698860640,1698877920,17280,104548,69225,US,US
146432,1699473420,1699508580,35160,49839,7758,TR,TR
104359,1698996540,1699025760,29220,187837,183913,TR,TR
56439,1699434480,1699449420,14940,129944,63719,FR,CH
116236,1700847840,1700860080,12240,103687,130661,US,US
178212,1699814040,1699837680,23640,101798,161918,DE,FR
70248,1700388240,1700402400,14160,46982,171145,IT,IT
186825,1699151700,1699183320,31620,165621,130834,TR,TR
94651,1700858340,1700887740,29400,177352,109919,TR,TR
50597,1699142880,1699155960,13080,7075,48530,IT,IT
114276,1700027700,1700032800,5100,81648,10985,GB,GB
155162,1700104920,1700121840,16920,51303,3370,RS,HU
182344,1700593860,1700605680,11820,152000,61312,US,US
21390,1699092960,1699122900,29940,160366,47825,TR,TR
25044,1700611440,1700640120,28680,65460,180921,BR,BR
189029,1700718180,1700753640,35460,108473,55741,TR,TR
171008,1700248200,1700265300,17100,96465,80643,US,US
139522,1700840040,1700856960,16920,124147,60951,CA,US
167381,1700338740,1700361000,22260,148839,96176,DE,CH
71574,1700634060,1700637660,3600,115081,118418,NL,NL
121318,1699323240,1699338840,15600,108994,41900,CA,CA
171251,1700083920,1700093820,9900,24522,38271,IT,IT
57886,1699809120,1699839120,30000,47857,92147,TR,TR
123956,1700180460,1700210520,30060,70351,165799,TR,TR
121232,1699611300,1699624020,12720,4583,38088,PT,PT
42303,1699559280,1699570200,10920,67886,91972,CZ,CZ
57141,1699272600,1699305000,32400,75786,36929,TR,TR
107104,1699599780,1699632540,32760,15815,163448,TR,TR
135684,1699088400,1699092000,3600,140820,95284,GB,GB
142064,1698793800,1698805380,11580,129912,134690,US,US
53423,1698887100,1698892260,5160,156384,128356,NL,NL
65219,1699744500,1699779780,35280,103598,199505,TR,TR
63057,1700475060,1700509440,34380,125312,137948,TR,TR
35607,1700468400,1700498280,29880,187873,5618,TR,TR
115501,1700411220,1700438340,27120,59631,64432,RO,MD
18379,1699249740,1699262040,12300,182169,146791,HR,HR
19718,1700205960,1700224020,18060,92837,90927,BE,IT
89588,1699548420,1699555440,7020,73018,110404,GB,GB
185884,1700487960,1700502300,14340,96861,120234,US,US
10283,1698932700,1698965040,32340,51392,189548,TR,TR
19974,1700028060,1700063040,34980,26704,1860,TR,TR
126776,1700012880,1700038980,26100,116019,42084,BR,BR
172111,1700649420,1700681400,31980,96594,19220,TR,TR
186311,1700815260,1700827260,12000,126150,189633,US,US
79214,1700131800,1700146140,14340,125235,5768,US,US
66412,1699304460,1699309320,4860,15714,16380,NL,HR
130164,1699595880,1699626720,30840,151874,159709,TR,TR
131068,1700296800,1700328960,32160,70816,66921,TR,TR
111827,1700118780,1700151540,32760,9213,128916,TR,TR
161515,1699982040,1700011380,29340,121344,99522,TR,TR
29370,1700810040,1700820840,10800,158049,109855,IT,FR
21398,1699400340,1699427700,27360,187703,53902,BR,BR
188574,1699714320,1699720320,6000,89450,150277,GB,GB
121819,1699259340,1699265400,6060,84542,72331,GB,GB
199070,1698862560,1698875940,13380,25942,80433,IT,IT
35107,1700253300,1700286060,32760,138505,140007,TR,TR
152988,1698842280,1698845880,3600,142254,189883,GB,GB
178559,1700089800,1700093400,3600,62780,57104,NL,BE
191777,1700429400,1700461440,32040,105196,197711,TR,TR
54949,1699090260,1699102320,12060,45920,63752,US,US
7587,1698819780,1698852840,33060,96911,111396,TR,TR
141486,1700461500,1700490300,28800,167279,74920,TR,TR
48596,1699717620,1699728960,11340,40622,136873,AT,SK
66884,1700477580,1700490600,13020,22631,150161,PT,IT
6697,1699330500,1699364040,33540,76295,148075,MX,MX
138740,1700814840,1700829360,14520,115556,55481,AT,AT
6270,1698924060,1698956160,32100,123385,109678,TR,TR
132632,1700811540,1700845860,34320,21868,80818,TR,TR
127746,1700224860,1700235360,10500,26403,110003,IT,IT
106655,1700742060,1700777160,35100,131664,197771,TR,TR
173835,1699408860,1699419720,10860,58685,113267,IT,IT
42660,1700725740,1700731080,5340,165008,11207,GB,GB
49408,1698987780,1698993600,5820,4450,8363,NL,NL
29113,1699194120,1699207620,13500,2704,77756,SK,AT
153075,1699154580,1699169580,15000,173359,15559,US,US
120303,1700624280,1700638680,14400,143462,95319,US,US
100452,1699823940,1699856100,32160,199711,19942,TR,TR
132672,1698958440,1698971160,12720,131376,61650,AT,HU
196443,1700836860,1700871780,34920,108306,146632,TR,TR
30479,1698858000,1698893400,35400,35441,140057,TR,TR
36345,1699069020,1699099620,30600,77918,141386,TR,TR
83761,1699316520,1699347420,30900,79905,19253,BA,AT
160693,1700709060,1700742960,33900,9927,133857,TR,TR
198521,1698964800,1698974700,9900,22482,158255,ES,FR
101602,1700753580,1700757720,4140,167499,16671,CL,CL
41256,1699306500,1699321620,15120,110036,154888,US,US
41589,1699549800,1699582860,33060,44583,86846,TR,TR
96708,1700675700,1700679300,3600,17318,172626,NL,NL
101969,1700728260,1700758080,29820,73245,109856,TR,TR
2051,1699825920,1699855800,29880,107829,187879,TR,TR
132839,1700222880,1700230980,8100,25805,165306,HR,HR
76865,1700086980,1700108940,21960,72206,141558,RO,RO
14100,1699305180,1699317180,12000,32004,89638,CZ,CZ
105560,1699311900,1699320900,9000,137801,15077,IT,IT
70451,1698895860,1698929940,34080,22964,40748,TR,TR
90812,1699801620,1699835400,33780,28701,171572,MX,MX
148597,1700085480,1700116680,31200,135605,18618,TR,TR
120450,1698936480,1698968100,31620,118901,65936,TR,TR
84957,1699051320,1699054920,3600,144316,10478,GB,GB
67743,1699661220,1699692660,31440,171034,137812,TR,TR
141840,1699829700,1699842120,12420,102222,146849,US,US
154899,1700040540,1700067300,26760,124042,104371,PL,HU
65835,1699980000,1699988520,8520,148408,27643,EE,FI
18232,1699385940,1699394280,8340,124507,7770,PT,PT
69470,1698905460,1698936120,30660,35789,171673,TR,TR
3523,1700349240,1700380080,30840,118186,146491,TR,TR
156210,1700179800,1700192700,12900,159991,134548,SK,SK
181008,1699379400,1699383120,3720,89727,114266,GB,GB
53326,1700323800,1700337060,13260,31516,21290,RS,HU
184627,1699936080,1699959660,23580,178105,19067,HU,BG
63677,1700707080,1700718720,11640,40044,28389,US,US
103797,1698972300,1698983880,11580,197490,102975,IT,IT
49211,1700409660,1700421600,11940,193912,36050,US,US
105778,1698842880,1698848700,5820,74372,101988,NL,NL
49883,1698976020,1699006080,30060,144318,93925,TR,TR
115829,1699989840,1700020560,30720,183635,180709,TR,TR
158110,1700191560,1700210760,19200,181872,41058,FR,CZ
111332,1700769960,1700787240,17280,189155,52665,SE,SE
161145,1700142780,1700167080,24300,132531,146666,DE,BA
29060,1699881120,1699915260,34140,112026,10778,TR,TR
111953,1700339280,1700350140,10860,6920,127237,ES,ES
148256,1699464720,1699476840,12120,166730,125563,IT,IT
192702,1699661940,1699678260,16320,182766,115844,US,US
131994,1699033980,1699046520,12540,75665,74109,US,US
154285,1699636080,1699639680,3600,101171,164733,GB,GB
38039,1699215240,1699228860,13620,197640,17872,IT,IT
70350,1699308720,1699325520,16800,131237,175925,FR,FR
149454,1699813020,1699843320,30300,129377,36037,TR,TR
15244,1700113620,1700149800,36180,124356,114982,MX,MX
88343,1699751880,1699785660,33780,135351,194755,TR,TR
148968,1700218980,1700232060,13080,152744,107813,IT,IT
147273,1700278080,1700287800,9720,75135,111738,IT,IT
103724,1699862400,1699895700,33300,139796,177901,TR,TR
88418,1698990660,1699006440,15780,169570,126188,US,US
162994,1699592580,1699604700,12120,5285,19287,RS,RS
21273,1699771080,1699803360,32280,117274,144627,TR,TR
96373,1699553880,1699557660,3780,76439,171347,NL,NL
9779,1700598900,1700628060,29160,84544,150158,TR,TR
135561,1700197380,1700225520,28140,182951,148883,RO,MD
151974,1699541940,1699574520,32580,89089,181243,TR,TR
158290,1699797960,1699809240,11280,80006,65485,PT,PT
151878,1699702980,1699717680,14700,41744,133642,FR,ES
27416,1699725960,1699736760,10800,181288,199952,IT,RO
51701,1699946460,1699968480,22020,170494,171586,DE,DE
138968,1699176420,1699209120,32700,158465,84713,TR,TR
195111,1700639700,1700675340,35640,4349,1312,TR,TR
107882,1700042400,1700054160,11760,115806,61978,IT,IT
69163,1699125960,1699158060,32100,172069,594,TR,TR
189159,1700197860,1700209800,11940,19943,127931,IT,IT
473,1700687580,1700718780,31200,77537,96529,TR,TR
111519,1699571280,1699582320,11040,77661,116405,IT,IT
159525,1700107920,1700142300,34380,1161,55421,TR,TR
171667,1699826460,1699840020,13560,41388,122079,ES,ES
137903,1699391400,1699425120,33720,3826,5254,TR,TR
197592,1700720160,1700728740,8580,177604,114274,IT,IT
199313,1699864320,1699897500,33180,11314,112664,TR,TR
101467,1699583880,1699614120,30240,81333,91042,TR,TR
20448,1700083800,1700114100,30300,158412,57633,TR,TR
128339,1700756100,1700786220,30120,157768,67797,TR,TR
193165,1698830820,1698834420,3600,145279,106043,GB,GB
24709,1700059920,1700088900,28980,68150,33290,TR,TR
28936,1700445540,1700453520,7980,76584,62000,HR,HR
126135,1700338920,1700368860,29940,91251,58670,TR,TR
181677,1700633520,1700647740,14220,33418,27250,IT,IT
176771,1698821640,1698856560,34920,171164,147394,TR,TR
187528,1700682480,1700686260,3780,28160,76331,EE,FI
69416,1700585760,1700598120,12360,116032,147468,PT,PT
194423,1700564220,1700575380,11160,41296,75213,PT,PT
180285,1700009040,1700040600,31560,55090,24468,TR,TR
85043,1699447200,1699476420,29220,130479,120317,TR,TR
110988,1699260840,1699293240,32400,159541,39863,MX,MX
158262,1700546340,1700568540,22200,84297,73046,RO,RO
93133,1699578420,1699586460,8040,190099,80622,PT,PT
81303,1700230260,1700263260,33000,26714,44798,TR,TR
46280,1700043840,1700074200,30360,71412,58774,TR,TR
91837,1699322160,1699340760,18600,66334,8529,SE,SE
106756,1700216820,1700249400,32580,146328,120978,TR,TR
94531,1700155320,1700159280,3960,135940,99912,GB,GB
4214,1699591920,1699598400,6480,187913,23107,GB,GB
107034,1700059740,1700070480,10740,97486,123618,PT,PT
8498,1700307720,1700337540,29820,69921,120941,TR,TR
86009,1700637240,1700659620,22380,54301,52113,DE,DE
48390,1699892700,1699927380,34680,3878,95961,TR,TR
96581,1699335300,1699354740,19440,64855,92995,FR,BE
44956,1700734020,1700768460,34440,13652,119329,TR,TR
154191,1699563720,1699581600,17880,175321,71761,FR,CH
132710,1699408740,1699416300,7560,156124,144107,HR,DE
50904,1699111200,1699140660,29460,80222,108388,TR,TR
59411,1699744620,1699757820,13200,64030,60973,US,US
32001,1700816820,1700853300,36480,131349,52550,MX,MX
199518,1699114380,1699143420,29040,5433,54304,TR,TR
132542,1700496360,1700516640,20280,137387,115695,FR,DE
99195,1700848920,1700876940,28020,36001,143074,DE,GB
502,1700637900,1700668860,30960,53736,126250,TR,TR
39246,1699025700,1699060500,34800,168258,1887,TR,TR
77489,1698985500,1698997200,11700,183707,162835,SK,BE
57007,1700403720,1700436360,32640,187972,84690,TR,TR
120234,1698895080,1698929460,34380,185738,51187,TR,TR
75613,1700501940,1700519340,17400,154803,127090,US,US
18680,1699370340,1699373940,3600,26534,169431,GB,GB
129639,1700264640,1700280000,15360,108917,149495,US,US
72240,1699414200,1699443300,29100,99395,188451,TR,TR
134350,1698991080,1699026420,35340,47803,58546,TR,TR
15762,1699709760,1699736340,26580,31440,73428,DE,AT
104828,1699113780,1699141320,27540,177938,111839,PL,PL
116685,1698995160,1699007220,12060,151815,186663,IT,IT
191617,1699468920,1699503840,34920,13097,172995,TR,TR
181701,1699299300,1699354920,55620,63699,55246,UA,PL
4351,1699428720,1699432320,3600,73757,77741,NL,DE
79653,1699858140,1699873440,15300,172136,170058,US,US
166617,1700353980,1700384880,30900,52483,151887,TR,TR
151781,1700327400,1700361180,33780,67734,171855,TR,TR
47779,1700821020,1700843520,22500,83375,45998,BR,BR
52255,1699980660,1699984260,3600,143595,160313,GB,GB
190047,1700247180,1700268960,21780,181860,61949,DE,DE
61520,1700588100,1700602200,14100,142771,44275,CZ,BE
173150,1699264740,1699281120,16380,195409,27514,FR,FR
132571,1698966000,1698998460,32460,107715,177213,TR,TR
37611,1700257380,1700271000,13620,68630,199566,US,US
48696,1700099640,1700113020,13380,68057,198052,US,US
151861,1700837700,1700854200,16500,154362,20634,US,US
3690,1698990600,1698999660,9060,26180,80907,HR,HR
66109,1699535700,1699564080,28380,109288,117109,DE,CH
138545,1700128740,1700157780,29040,14817,26136,TR,TR
137766,1699712460,1699743000,30540,141488,38773,TR,TR
146658,1699510740,1699523160,12420,99615,102897,IT,IT
33185,1699386960,1699393080,6120,176376,43671,GB,GB
197051,1700600700,1700635440,34740,144401,59840,TR,TR
46465,1699363380,1699367100,3720,165532,19103,GB,FR
22141,1700309880,1700334240,24360,144373,37482,PL,PL
140219,1699850400,1699863180,12780,69139,44861,US,US
144658,1699578780,1699582380,3600,165873,154977,GB,GB
11746,1700496960,1700508960,12000,160099,132228,IT,IT
120,1700489160,1700511900,22740,13871,142639,BR,BR
188254,1699610160,1699625760,15600,184401,126552,AT,AT
196700,1699573260,1699585560,12300,155137,123413,IT,IT
86084,1698816720,1698829980,13260,74968,187181,RS,RS
176282,1700587260,1700598540,11280,161684,27270,US,US
55845,1699358400,1699392900,34500,75091,154305,TR,TR
190897,1699350900,1699365240,14340,192331,91743,US,US
58052,1698880380,1698915540,35160,67958,82619,MX,MX
101426,1700075700,1700102280,26580,14525,183424,DE,UA
96709,1698978540,1699012140,33600,127752,165191,TR,TR
185111,1699257480,1699287720,30240,89271,158796,TR,TR
126347,1699354440,1699380780,26340,162103,54766,PL,PL
180700,1700121120,1700150880,29760,19781,90296,TR,TR
120278,1699708140,1699719300,11160,10953,168604,IT,IT
109626,1700132040,1700145840,13800,104368,108,AT,AT
112198,1699716600,1699751340,34740,11068,95948,TR,TR
41102,1700470080,1700474940,4860,111293,100165,GB,GB
3009,1700303100,1700337840,34740,159508,6614,TR,TR
142839,1700326440,1700341080,14640,126783,166383,BE,NL
173084,1698803940,1698819900,15960,127844,51637,US,US
6066,1699897980,1699906140,8160,154848,148062,IT,IT
190009,1700099520,1700103120,3600,6537,156223,NL,NL
965,1700000460,1700011680,11220,38032,137992,US,US
197139,1700434440,1700469960,35520,61828,180326,TR,TR
190421,1700577960,1700610420,32460,57124,79041,TR,TR
17471,1699275420,1699297740,22320,113218,75695,SI,RS
69052,1700511600,1700535900,24300,22942,87691,DE,BA
109702,1700161800,1700195700,33900,197948,139291,TR,TR
46497,1699446060,1699454880,8820,158352,150111,FI,EE
133536,1700435820,1700467980,32160,187562,152807,TR,TR
9915,1699673340,1699676940,3600,143150,74339,GB,GB
81146,1700047380,1700050980,3600,72461,129702,GB,GB
100682,1699995300,1700016780,21480,26613,114532,BE,NL
92974,1699341360,1699346040,4680,60398,127656,GB,GB
116900,1699147740,1699166580,18840,197787,69630,SE,SE
56540,1699044420,1699074720,30300,38441,56784,TR,TR
26554,1699789080,1699792680,3600,155363,120396,GB,GB
147338,1699524840,1699528440,3600,103312,184921,GB,GB
132493,1698941760,1698975660,33900,123113,191697,TR,TR
171591,1699612140,1699644780,32640,14106,190362,TR,TR
121181,1698986940,1698999420,12480,142155,97891,US,US
149776,1699132380,1699147920,15540,56956,67632,US,US
105675,1700050320,1700058840,8520,161111,94968,IT,IT
2581,1700035380,1700056860,21480,129174,35963,FR,DE
50019,1700357400,1700387700,30300,196452,156088,TR,TR
59033,1700173320,1700206980,33660,70002,88469,MX,US
186700,1698874980,1698898080,23100,71454,117112,DE,BE
10337,1700636160,1700670060,33900,157490,41680,TR,TR
9922,1700660700,1700674680,13980,124413,30022,US,US
18494,1700456520,1700486520,30000,134939,58222,TR,TR
59583,1700455020,1700466540,11520,121990,97990,US,US
44063,1700381400,1700440920,59520,51607,86372,UA,PL
45556,1700526840,1700561040,34200,147003,20208,TR,TR
191321,1699024500,1699028100,3600,10886,197150,NL,NL
180474,1700700660,1700717340,16680,35929,126836,US,US
64441,1700321520,1700329440,7920,12865,16740,IT,IT
146753,1699953420,1699987920,34500,56634,15835,TR,TR
190171,1699590480,1699596300,5820,166933,110222,GB,GB
45515,1699832520,1699860000,27480,143013,46210,PL,IT
25553,1700045160,1700072640,27480,180609,177173,DE,CZ
93981,1699784460,1699797060,12600,20414,51135,HR,DE
30484,1699297860,1699308420,10560,80325,57660,ES,ES
36585,1700428680,1700444520,15840,12892,74740,US,US
74133,1700343900,1700357280,13380,56347,29567,RS,BG
47311,1700575920,1700595420,19500,101372,119192,FR,FR
125947,1700567160,1700587320,20160,176527,85134,DK,DK
108339,1700758080,1700793660,35580,146106,43890,TR,TR
114842,1700053260,1700071140,17880,88869,13514,SE,SE
18942,1699559880,1699569060,9180,113059,3917,IT,IT
90579,1699294680,1699308120,13440,92789,70729,IT,IT
23446,1700395680,1700428860,33180,140358,80563,TR,TR
161772,1699795860,1699815240,19380,15290,34782,FR,CH
192495,1699833600,1699867620,34020,124033,104412,TR,TR
145901,1700383800,1700387460,3660,7975,37214,GB,GB
19681,1699248840,1699261620,12780,172143,11438,US,US
166176,1700641200,1700644800,3600,17888,189776,NL,BE
146827,1700545800,1700555880,10080,116200,2350,IT,IT
73058,1698864180,1698873780,9600,66250,138623,IT,IT
140950,1700547720,1700581980,34260,197890,124818,TR,TR
167319,1699328340,1699331940,3600,100802,126870,GB,GB
157156,1699505940,1699537320,31380,185062,118256,TR,TR
105505,1700574240,1700590560,16320,147304,176778,US,US
94021,1699954320,1699988460,34140,91432,151514,TR,TR
121460,1699118340,1699123500,5160,11675,15796,GB,GB
69712,1698922920,1698952560,29640,133545,115671,TR,TR
161072,1699118940,1699142280,23340,29689,49606,DE,DE
196588,1700309580,1700338500,28920,2906,164330,TR,TR
66677,1700849760,1700883540,33780,108780,77557,TR,TR
41157,1698818100,1698832440,14340,32946,75114,RS,ME
85726,1698859080,1698893280,34200,20729,96053,TR,TR
53140,1699476480,1699511940,35460,8227,10001,TR,TR
175765,1699215480,1699240200,24720,143349,152406,PL,PL
105930,1700603280,1700633880,30600,46724,13752,TR,TR
56990,1699570800,1699576500,5700,90673,143738,GB,GB
149138,1699592520,1699620900,28380,20745,176104,DE,DE
50283,1699082640,1699099140,16500,72116,82241,US,US
99272,1700540940,1700572260,31320,199417,82402,TR,TR
142599,1700469480,1700477040,7560,9271,56907,AD,ES
15879,1699501860,1699532640,30780,102099,168288,TR,TR
18885,1699173900,1699205460,31560,12389,60772,TR,TR
140613,1698939480,1698949260,9780,110130,177877,IT,IT
156714,1698991140,1698998400,7260,177282,128800,IT,HR
59974,1700242740,1700256600,13860,107949,127318,HR,HR
6519,1698914760,1698947040,32280,40053,130847,TR,TR
178080,1699429800,1699434480,4680,74250,84634,GB,GB
69674,1699284960,1699293420,8460,103448,196390,IT,IT
160876,1700823660,1700828580,4920,176637,58362,GB,GB
171381,1699402320,1699406040,3720,187952,23048,NL,FR
134089,1699746600,1699776180,29580,168802,98321,TR,TR
177514,1700473980,1700480580,6600,84975,126829,NL,NL
145335,1700648700,1700654100,5400,143968,192183,GB,GB
174960,1698802440,1698828240,25800,71621,121555,DE,HU
26992,1700792580,1700821800,29220,63855,199618,TR,TR
80996,1700417640,1700433600,15960,126497,18638,FR,IT
177009,1700464800,1700482680,17880,56053,101541,FR,FR
31348,1700328120,1700339460,11340,163003,142678,IT,IT
179882,1700475840,1700509740,33900,8095,80273,TR,TR
173959,1698800940,1698840300,39360,169419,143278,MX,US
19339,1698980820,1699025700,44880,56077,151925,LU,PT
99104,1700775660,1700808540,32880,75580,138537,TR,TR
1074,1699606680,1699619580,12900,54839,172509,IT,IT
163386,1699294680,1699298280,3600,854,74495,GB,GB
124785,1698979080,1698983700,4620,128995,72452,GB,GB
78101,1699841700,1699876980,35280,184733,132274,TR,TR
97870,1699315080,1699330080,15000,116212,56034,US,US
142695,1700239860,1700250480,10620,1472,40938,IT,IT
120530,1700273460,1700279940,6480,171735,154954,GB,GB
8691,1699800780,1699819860,19080,17494,49758,BE,NL
97134,1700438520,1700442600,4080,84583,80934,NL,NL
2542,1700853300,1700869020,15720,148162,69809,US,US
168413,1699018200,1699048380,30180,117915,3412,TR,TR
176706,1699273740,1699308120,34380,45662,21530,TR,TR
133020,1699263420,1699297080,33660,749,11884,TR,TR
149078,1699734720,1699745640,10920,50336,64806,IT,IT
16553,1699560360,1699578120,17760,183526,185201,FR,FR
153242,1699039500,1699065180,25680,185035,195063,DE,HU
136397,1699325640,1699357140,31500,50170,183127,TR,TR
55913,1699428060,1699435260,7200,60572,164811,IT,IT
83877,1699569840,1699582500,12660,11980,194251,PT,PT
135741,1698981360,1699012380,31020,161653,82336,TR,TR
130484,1698807180,1698824520,17340,38379,184133,US,US
929,1699062000,1699096200,34200,55968,30954,TR,TR
121724,1700544120,1700552940,8820,69317,7277,IT,IT
196480,1700239920,1700243520,3600,48291,103327,GB,GB
6527,1700448360,1700501940,53580,62587,113874,BG,DE
118112,1699156320,1699167660,11340,92190,181051,US,MX
111237,1700785080,1700817000,31920,29911,59860,TR,TR
117855,1700770380,1700780640,10260,169511,156943,IT,IT
169540,1700171040,1700198460,27420,158706,89114,PL,PL
94604,1699657740,1699674540,16800,82639,99581,US,US
71752,1699706760,1699719120,12360,164876,78083,US,US
131707,1699519560,1699531740,12180,58488,159267,US,US
101721,1699258740,1699274160,15420,171156,179036,FR,FR
181741,1699124940,1699128540,3600,78101,77800,GB,GB
172605,1700333880,1700366460,32580,189038,122726,TR,TR
96655,1700488440,1700524320,35880,83118,22939,TR,TR
29775,1699828680,1699833420,4740,134291,56896,GB,GB
149911,1699738860,1699761120,22260,85119,143683,PL,PL
116270,1700203260,1700209740,6480,122787,170186,NL,NL
111846,1699222740,1699257840,35100,164653,139407,TR,TR
179482,1700761320,1700772300,10980,45731,96826,IT,IT
47268,1699850400,1699868820,18420,153048,153878,FR,GB
12357,1700067780,1700085060,17280,87367,2161,US,US
185269,1700711700,1700727420,15720,137040,40111,US,US
2267,1699427580,1699437780,10200,121146,177980,PT,PT
181755,1700118360,1700129820,11460,49182,49167,US,US
165449,1699228080,1699245840,17760,159182,174508,RS,SI
14677,1698830640,1698834240,3600,175241,142607,NL,BE
102142,1699654500,1699668480,13980,24123,178624,IT,IT
154187,1699741800,1699770600,28800,94996,169264,TR,TR
178977,1699430760,1699461060,30300,59291,190326,TR,TR
482,1699536900,1699566000,29100,58490,77248,TR,TR
131460,1699321560,1699329660,8100,133416,199465,PT,PT
184977,1699364040,1699377780,13740,5104,74140,US,US
69731,1700675100,1700706000,30900,134686,30553,TR,TR
126150,1699228380,1699237320,8940,21833,53304,IT,IT
93422,1699431240,1699440000,8760,156178,146477,IT,IT
10970,1700045520,1700065800,20280,11529,198956,FR,AD
113379,1699309440,1699329000,19560,53449,17565,FR,FR
155588,1700264640,1700299920,35280,153114,2701,TR,TR
10446,1699967340,1699981560,14220,56105,188760,IT,DE
104256,1699435080,1699470900,35820,93908,38421,TR,TR
171539,1700310420,1700335800,25380,136971,91881,DE,IT
171067,1700636460,1700642820,6360,53888,165481,GB,GB
72639,1698990540,1698994140,3600,169319,128487,GB,GB
167744,1699665960,1699699260,33300,33326,136309,MX,MX
29395,1698982860,1699017540,34680,2440,26063,TR,TR
47881,1699438080,1699448220,10140,61183,78564,PT,PT
53934,1700164680,1700198220,33540,68293,166428,TR,TR
62112,1699988400,1700023920,35520,83511,97794,TR,TR
26676,1698875040,1698904260,29220,1005,117932,TR,TR
118983,1699281780,1699285380,3600,8812,26196,GB,GB
117975,1700409300,1700413560,4260,107659,99311,GB,GB
126476,1700201760,1700214540,12780,32936,18205,US,US
67381,1699475520,1699484340,8820,23167,175854,PT,PT
35361,1700140140,1700153640,13500,133070,141381,PT,PT
107283,1698884640,1698888240,3600,24677,42676,NL,NL
37578,1700483520,1700512860,29340,89206,49031,TR,TR
158570,1700037120,1700070240,33120,88497,38864,TR,TR
20757,1700155320,1700167320,12000,133323,101529,SK,BE
19177,1699029120,1699052700,23580,141686,86961,PL,PL
37757,1699742100,1699771260,29160,110176,17858,TR,TR
76288,1700124600,1700158080,33480,129508,45652,TR,TR
48283,1700844240,1700857620,13380,26202,195325,IT,IT
170165,1699023240,1699026840,3600,106380,94971,GB,GB
3841,1700343540,1700370780,27240,11607,50398,DE,DE
14587,1700745540,1700778240,32700,91382,101959,TR,TR
21396,1699845060,1699852500,7440,4533,101298,IT,IT
84061,1699901760,1699934700,32940,164353,132895,TR,TR
171476,1700224260,1700231640,7380,21585,32745,IT,IT
184764,1700759160,1700794440,35280,196274,98428,TR,TR
9009,1700845620,1700875380,29760,125331,36413,TR,TR
12856,1699044840,1699073340,28500,127451,116981,DE,DE
168945,1700841060,1700868240,27180,199017,21600,CH,MK
101136,1699744260,1699751100,6840,11545,116602,GB,GB
64027,1699518000,1699523400,5400,88501,55257,GB,GB
108175,1699561080,1699594440,33360,116065,73724,MX,MX
187499,1699786800,1699801380,14580,24386,124998,RS,RS
74293,1699467960,1699488960,21000,27732,116684,FR,FR
94126,1699748340,1699751940,3600,172277,113418,GB,GB
42603,1700114820,1700130720,15900,30430,11320,US,US
88281,1699938840,1699945620,6780,107197,2065,GB,GB
194921,1700743740,1700768340,24600,180112,89520,PL,CZ
88330,1699543020,1699577280,34260,159784,91351,TR,TR
190640,1699500300,1699522920,22620,93088,30304,DE,PL
98408,1699273800,1699304100,30300,188435,92433,TR,TR
89842,1699093140,1699099860,6720,42796,6115,CL,CL
9733,1700757480,1700787000,29520,63357,10868,TR,TR
23441,1698837600,1698869280,31680,161165,183133,TR,TR
23227,1699348380,1699360620,12240,88713,71364,PT,PT
78617,1700724840,1700733780,8940,114893,64318,HR,HR
76802,1698909120,1698919440,10320,60140,166663,IT,NL
86206,1698983340,1699016220,32880,110439,600,TR,TR
112786,1700462640,1700476920,14280,144515,113088,US,US
165653,1700501700,1700516400,14700,198079,56222,US,US
188920,1700820660,1700845380,24720,192056,15989,PL,PL
14705,1699416120,1699431600,15480,90010,102513,FR,IT
22276,1699305900,1699312560,6660,32872,170567,GB,GB
174120,1700143140,1700178900,35760,8562,57673,TR,TR
107997,1700156700,1700162340,5640,118508,186980,GB,GB
10573,1699623000,1699640340,17340,76204,118696,SE,DK
133058,1700462520,1700484240,21720,35245,178822,BR,BR
106777,1699609080,1699621140,12060,79229,151735,IT,IT
115525,1698811260,1698844140,32880,138726,28950,TR,TR
146722,1699303620,1699334160,30540,159666,99373,TR,TR
34223,1699958160,1700012460,54300,87871,181158,BG,DE
124433,1700696820,1700712780,15960,43255,192603,US,US
73695,1700150280,1700153880,3600,53810,40063,GB,GB
71039,1699645260,1699648860,3600,139977,180056,GB,GB
192927,1700532600,1700537820,5220,71158,151884,NL,NL
95168,1700214600,1700224320,9720,183760,83599,IT,IT
81335,1699966080,1700004300,38220,114513,158825,MX,MX
192896,1700613360,1700619720,6360,7003,86180,GB,GB
33220,1700356800,1700388180,31380,54663,39063,TR,TR
198372,1699143000,1699156620,13620,195999,51634,RS,RS
129101,1700240640,1700244720,4080,97821,77947,GB,GB
81883,1700747100,1700780640,33540,92811,39053,TR,TR
178767,1700634360,1700664060,29700,101656,161565,BA,HR
73099,1699519680,1699550220,30540,89548,108562,TR,TR
44482,1700458620,1700513580,54960,10197,182896,BG,DE
171426,1699782300,1699803360,21060,197931,76734,BE,FR
184222,1699191660,1699195260,3600,10423,34630,NL,NL
63272,1698857580,1698874740,17160,34196,45091,US,US
129225,1699353120,1699385700,32580,156422,32392,TR,TR
54157,1700699220,1700702820,3600,79656,6181,NL,NL
96076,1699572720,1699576320,3600,147401,76721,NL,BE
118110,1699106820,1699112820,6000,184737,28805,NL,NL
65742,1700113980,1700126760,12780,24869,123736,IT,IT
148069,1699410300,1699436040,25740,174614,160420,BA,HR
143360,1699455900,1699471020,15120,8622,6585,US,US
78849,1700093340,1700101560,8220,77416,68824,IT,IT
178244,1700028360,1700061660,33300,92367,154020,MX,MX
163240,1700111640,1700115240,3600,55444,8932,GB,GB
199345,1699158840,1699176780,17940,170918,116942,US,US
92470,1698952620,1698981480,28860,182258,90141,TR,TR
41014,1699175640,1699186800,11160,38591,144018,IT,IT
102998,1700692380,1700718060,25680,64229,41002,DE,HU
15962,1699879260,1699935000,55740,108247,128668,BG,BG
105319,1698895560,1698924720,29160,141437,129681,TR,TR
186365,1699978260,1699994160,15900,113790,31341,US,US
110191,1700473140,1700505420,32280,778,171281,TR,TR
183204,1699585080,1699614960,29880,37030,158908,TR,TR
26829,1699731660,1699743420,11760,106814,88794,US,US
87760,1699411980,1699440780,28800,7364,149720,TR,TR
180353,1700397180,1700401740,4560,28443,104612,GB,GB
21898,1699135200,1699142880,7680,118772,3935,IT,IT
102701,1699611540,1699624080,12540,115577,148676,AT,PL
34383,1700716260,1700725440,9180,188711,28088,IT,IT
181130,1699261860,1699285080,23220,166125,153914,DE,CH
58343,1700244360,1700275500,31140,179814,188465,TR,TR
193606,1699417440,1699449720,32280,86458,187617,TR,TR
158337,1700759160,1700788320,29160,15388,182462,TR,TR
121718,1700002500,1700037300,34800,101029,86120,MX,MX
162032,1700724720,1700755440,30720,176043,136536,TR,TR
60042,1699185060,1699189980,4920,73777,136703,GB,GB
143678,1698936180,1698952680,16500,60639,140707,US,US
26484,1699902300,1699916520,14220,88286,92887,US,US
66596,1700327820,1700357580,29760,67562,25028,TR,TR
80647,1699437480,1699451700,14220,159014,160175,HR,RS
13253,1699407600,1699420680,13080,124225,145424,US,US
73369,1700611380,1700635020,23640,77468,43023,RO,MD
186149,1698938400,1698942000,3600,39102,97006,NL,NL
15579,1699816260,1699846500,30240,154444,176661,TR,TR
136990,1700345580,1700361420,15840,42450,81685,CZ,PL
48363,1699787820,1699822080,34260,44159,135129,TR,TR
157676,1699669380,1699703520,34140,17772,2964,TR,TR
160155,1699113180,1699148940,35760,17500,44771,TR,TR
163506,1698885300,1698918900,33600,38832,61789,MX,MX
142596,1699664700,1699694580,29880,192964,187159,TR,TR
46703,1700618760,1700625720,6960,51390,83339,NL,NL
34718,1699883520,1699905900,22380,188521,88524,PL,DE
42494,1700507640,1700537160,29520,84122,49510,TR,TR
122450,1699573320,1699584300,10980,156468,134358,US,US
172754,1698923940,1698937080,13140,69174,62610,IT,IT
110551,1700403900,1700437620,33720,94798,66037,TR,TR
172903,1700047980,1700073420,25440,28945,78459,BA,DE
61149,1699825980,1699840080,14100,23420,51400,US,US
125038,1699051620,1699060140,8520,149831,199019,IT,IT
132635,1700365800,1700398320,32520,161983,64644,TR,TR
45323,1700563200,1700575860,12660,43477,199685,IT,IT
195905,1699426260,1699429860,3600,42440,127449,GB,GB
140886,1698953820,1698989040,35220,83162,177069,TR,TR
10761,1700244480,1700278560,34080,98324,165684,MX,MX
117674,1700784960,1700800320,15360,65166,186226,US,US
120745,1700292660,1700296500,3840,55654,70343,GB,GB
107928,1700847540,1700880780,33240,170736,196087,TR,TR
60244,1699766700,1699772520,5820,149335,180260,EE,EE
153306,1698983400,1698987000,3600,96564,32666,NL,NL
128202,1700373840,1700401860,28020,77368,109252,DE,DE
56146,1700074140,1700086920,12780,110449,156277,IT,IT
130498,1700176980,1700211780,34800,60549,118921,TR,TR
112506,1700484060,1700516880,32820,5813,102561,TR,TR
60148,1700780820,1700787180,6360,101319,16623,GB,GB
49001,1699817100,1699850280,33180,100889,47794,TR,TR
121214,1699590780,1699622520,31740,63954,11513,TR,TR
3162,1698846360,1698864180,17820,53395,177911,AT,AT
92795,1700221680,1700247600,25920,141761,118988,HU,BG
76146,1699564800,1699594020,29220,145657,188831,TR,TR
141841,1700248380,1700282940,34560,144660,181436,TR,TR
96948,1700444400,1700455200,10800,103138,182176,RS,ME
61690,1699368840,1699404420,35580,193162,178213,TR,TR
5805,1699425240,1699430940,5700,191384,182830,GB,GB
26161,1699094340,1699097940,3600,47943,42161,NL,NL
150385,1700805660,1700832600,26940,100912,75540,BR,BR
190608,1699975380,1699988460,13080,37861,44224,RS,RS
80112,1700639880,1700650800,10920,133053,131428,RS,RS
161680,1700098680,1700107140,8460,175056,119224,IT,IT
39445,1699088640,1699094580,5940,396,18237,CL,CL
145719,1699764600,1699796760,32160,25469,80296,TR,TR
93795,1699412460,1699421940,9480,104381,142236,AD,ES
47186,1699930560,1699949160,18600,8972,17626,FR,AD
192591,1700810940,1700843340,32400,192934,78331,TR,TR
94529,1699067100,1699100880,33780,113897,115741,TR,TR
164561,1700379240,1700393400,14160,182702,14756,HR,HR
27129,1699349520,1699378320,28800,135515,70576,TR,TR
193933,1700377020,1700412480,35460,179503,165569,TR,TR
54500,1700596920,1700611140,14220,170223,123198,US,US
108032,1699606680,1699637520,30840,82564,93845,TR,TR
43392,1700331300,1700347740,16440,59481,173626,US,US
79590,1699426560,1699457700,31140,134503,93613,TR,TR
80560,1700288760,1700321940,33180,3679,83010,TR,TR
29868,1700712360,1700723940,11580,96517,11548,IT,IT
84730,1700840220,1700853660,13440,42756,28446,US,US
1296,1700717400,1700756940,39540,117888,74419,MX,US
33183,1700386560,1700402760,16200,10314,117350,AT,AT
186686,1699745100,1699757340,12240,127555,103998,RS,RS
52421,1700842620,1700877300,34680,83290,68649,TR,TR
41455,1699274100,1699290600,16500,149246,71769,US,US
199808,1700293320,1700328300,34980,127478,41489,TR,TR
154757,1699309380,1699319880,10500,138270,181275,IT,IT
41834,1698833400,1698837000,3600,56148,74525,NL,NL
47348,1699286160,1699289760,3600,45356,189163,GB,GB
82534,1700078040,1700084520,6480,34685,158356,NL,NL
59800,1700438040,1700448360,10320,162920,155347,IT,IT
99175,1698966660,1698980460,13800,145904,86948,CA,CA
98652,1699525440,1699559880,34440,58664,8531,TR,TR
179353,1699626060,1699642320,16260,1889,55868,US,US
99467,1700528700,1700537220,8520,100183,34513,PT,ES
183580,1700498520,1700529360,30840,141486,170975,TR,TR
84442,1700165820,1700187120,21300,82741,9235,FR,CH
10958,1699048500,1699059900,11400,146805,80457,US,US
60211,1699850220,1699867620,17400,72686,128501,AT,AT
99305,1699579920,1699611960,32040,10462,85233,TR,TR
94568,1699420440,1699424400,3960,26876,179263,GB,GB
158253,1699269660,1699303260,33600,28818,116434,TR,TR
2737,1699024620,1699034220,9600,169035,16471,IT,IT
184870,1699988820,1700022660,33840,157483,180316,TR,TR
191457,1700541060,1700556900,15840,59986,13832,US,US
40510,1700835660,1700865000,29340,111062,180885,TR,TR
196411,1698821340,1698829140,7800,114860,125862,HR,HR
160149,1699768380,1699785540,17160,157193,77473,US,US
14431,1699343520,1699369140,25620,69106,166999,DE,CZ
69136,1699923180,1699934160,10980,78224,183978,IT,IT
183924,1700504700,1700517360,12660,69334,81583,US,US
158572,1700066040,1700069640,3600,170682,194001,GB,GB
133549,1700605860,1700638560,32700,2258,9514,TR,TR
26321,1700170260,1700184420,14160,166286,199496,AT,AT
188655,1700609400,1700639580,30180,194241,8101,TR,TR
77272,1700190300,1700222340,32040,148841,39637,TR,TR
41628,1699716180,1699725540,9360,67679,33142,HR,HR
46559,1699614060,1699624920,10860,146800,130306,RS,RS
66176,1700175180,1700198580,23400,39071,127007,DE,FR
138298,1699987200,1700002080,14880,4279,124737,RS,RS
111710,1698850800,1698883860,33060,187088,97485,TR,TR
107540,1699058940,1699087920,28980,184604,99601,TR,TR
80385,1699547580,1699573260,25680,106737,111518,CH,DE
131686,1700429580,1700442660,13080,177270,107440,CZ,CZ
14822,1700291760,1700319540,27780,113314,146440,HU,PL
11213,1699643340,1699676340,33000,89871,192264,TR,TR
166083,1698973920,1698988980,15060,139693,71937,CZ,CZ
93141,1700850240,1700878500,28260,180600,24929,DE,DE
188604,1699287600,1699294080,6480,99173,6538,GB,GB
154378,1699684500,1699695900,11400,151240,46460,HR,HR
155733,1699935360,1699989660,54300,31698,149612,BG,DE
135291,1699791540,1699795740,4200,80944,4720,GB,GB
7918,1699578780,1699594560,15780,27313,72746,FR,FR
136602,1700505420,1700535660,30240,157700,153420,TR,TR
61993,1698886620,1698898320,11700,123314,152736,RS,RS
58718,1700011140,1700020380,9240,36746,145051,HR,HR
47654,1700012700,1700049540,36840,47601,65894,MX,MX
21080,1700151420,1700155020,3600,62663,150567,NL,NL
64745,1698840180,1698851460,11280,2075,86642,IT,IT
90769,1699291800,1699305360,13560,42040,175059,US,US
151322,1700432700,1700463960,31260,156719,34440,TR,TR
57519,1700119440,1700152980,33540,199890,59068,TR,TR
181275,1700483520,1700498640,15120,97322,94559,FR,RO
132130,1699033200,1699038960,5760,55320,93182,GB,GB
77809,1700071800,1700088900,17100,166406,194189,US,US
142203,1700707380,1700710980,3600,42295,125920,GB,GB
23860,1699262460,1699313820,51360,4621,110285,BG,RS
10319,1700594100,1700597700,3600,165699,79032,NL,NL
172459,1698823980,1698858900,34920,67680,95504,TR,TR
86752,1699774620,1699791900,17280,183156,141548,US,US
94804,1698948240,1698953280,5040,98006,176207,GB,GB
199514,1699755540,1699785720,30180,28646,185968,TR,TR
81139,1699366320,1699394280,27960,98144,121183,DE,DE
193279,1700260380,1700295180,34800,59288,102489,TR,TR
61735,1699791060,1699826760,35700,21888,197613,TR,TR
140387,1699266780,1699279440,12660,36005,172698,US,US
177599,1700497020,1700514660,17640,120122,157641,US,US
154744,1699172340,1699202040,29700,138811,171819,TR,TR
128761,1700660880,1700678220,17340,12645,196069,US,US
39671,1700110320,1700122380,12060,150535,2217,HR,HR
170931,1699865280,1699869180,3900,21168,149392,NL,NL
62252,1700794440,1700798040,3600,43941,80224,GB,GB
9363,1698867840,1698880380,12540,17566,125180,ES,ES
143038,1698900240,1698931980,31740,44523,43877,TR,TR
190673,1699097820,1699102440,4620,117930,85865,GB,GB
180407,1700346720,1700358720,12000,190794,46869,IT,IT
116962,1700809260,1700812860,3600,17410,38821,GB,GB
186312,1699619520,1699649280,29760,150190,156947,TR,TR
189354,1700852940,1700868840,15900,183208,156383,US,US
17374,1699592700,1699607040,14340,52387,145454,AT,AT
107474,1700510100,1700546040,35940,62840,34633,TR,TR
109490,1700027580,1700031180,3600,66521,189357,GB,GB
75417,1700028960,1700065500,36540,113115,1682,MX,MX
194704,1699341120,1699352100,10980,10701,23560,AT,AT
185544,1700166060,1700196780,30720,163294,63581,TR,TR
45166,1699125840,1699159200,33360,159894,51430,TR,TR
116468,1700069880,1700073480,3600,38899,69148,GB,GB
83374,1699471500,1699489200,17700,147775,94553,US,US
139425,1699425780,1699448700,22920,159394,77265,DE,FR
194477,1699611360,1699629240,17880,13646,11002,US,US
116259,1699230420,1699241940,11520,109046,134504,RS,RS
150668,1700603940,1700608920,4980,122936,98482,NL,NL
27860,1700519520,1700531400,11880,4569,74964,US,US
76585,1699870980,1699901940,30960,76850,116785,TR,TR
21202,1700800140,1700831280,31140,132195,7634,TR,TR
9286,1699905360,1699914000,8640,119057,87171,IT,IT
114600,1700752560,1700784000,31440,90994,103231,TR,TR
40621,1700530680,1700534520,3840,49422,160245,NL,NL
22672,1699699140,1699704060,4920,63743,126158,EE,EE
69139,1699581120,1699609020,27900,32460,16392,RO,RO
131888,1699187820,1699199760,11940,158739,23212,RS,RS
172585,1699803120,1699827840,24720,102163,61129,RO,MD
41360,1700360160,1700390280,30120,20035,15185,TR,TR
77275,1698823860,1698829560,5700,174875,55386,GB,GB
75869,1699559640,1699590420,30780,70491,48133,TR,TR
86614,1699264980,1699279200,14220,25562,161884,US,US
2847,1699359720,1699365120,5400,6880,53200,GB,GB
73578,1699754340,1699783500,29160,128807,108933,TR,TR
144510,1699998540,1700010360,11820,12888,56425,US,US
16482,1700694600,1700729280,34680,148070,198188,TR,TR
157773,1700325300,1700338500,13200,25153,168807,US,US
137706,1700176140,1700185740,9600,72864,1812,ES,FR
140888,1698853500,1698879600,26100,82753,157492,DE,HR
115160,1700249580,1700281740,32160,160120,131006,TR,TR
28756,1698986220,1698997500,11280,59028,816,IT,IT
19209,1699932960,1699946640,13680,94696,92408,US,US
41548,1699681380,1699690560,9180,82492,91154,IT,IT
7104,1700857920,1700888880,30960,107088,22938,TR,TR
199868,1699450140,1699453740,3600,164475,103973,GB,GB
161685,1699539360,1699542960,3600,73783,101145,NL,NL
180056,1699802820,1699809840,7020,74471,165457,NL,NL
45968,1699938000,1699954440,16440,172065,140139,RS,BA
8616,1699983060,1699996440,13380,197790,116288,US,US
193440,1699389120,1699398840,9720,66551,21050,HR,HR
164176,1699212900,1699229880,16980,67048,41092,US,US
32133,1699925100,1699928700,3600,48735,190941,GB,GB
108623,1699425780,1699460460,34680,180666,196557,MX,US
195439,1700118420,1700131260,12840,150924,101061,US,US
33911,1699256460,1699280940,24480,17737,32307,DE,DE
136921,1699171920,1699175520,3600,28870,150012,NL,NL
19679,1699666860,1699696080,29220,135459,33904,TR,TR
191822,1698972780,1698978000,5220,862,103980,NL,NL
16854,1700846700,1700850300,3600,103161,85913,GB,GB
23114,1699928520,1699935120,6600,72311,55886,NL,NL
169607,1699816080,1699821660,5580,45258,148852,NL,DE
6745,1698834840,1698844380,9540,188056,1848,PT,PT
152646,1700232300,1700266500,34200,29669,178591,TR,TR
154344,1698895260,1698909900,14640,173494,149793,US,US
18466,1700178480,1700189460,10980,30881,57746,ES,ES
116989,1700255340,1700278260,22920,78921,63045,PL,UA
143810,1699536840,1699542540,5700,100332,153366,GB,GB
185805,1699696080,1699701180,5100,22749,119003,GB,GB
82890,1698898500,1698930120,31620,102954,112667,TR,TR
159127,1700085240,1700113500,28260,98051,90434,PL,DE
193546,1699564380,1699568400,4020,37448,173181,GB,GB
75608,1699469880,1699499280,29400,66481,92107,TR,TR
82504,1698913980,1698944460,30480,77030,67169,TR,TR
81284,1699396320,1699407600,11280,36889,83884,US,US
118741,1700611260,1700621940,10680,31681,184519,IT,IT
106607,1700280240,1700315280,35040,191792,113406,TR,TR
15906,1699865280,1699900080,34800,26410,177685,TR,TR
143711,1700391300,1700408580,17280,56662,23633,US,US
107362,1700103720,1700133480,29760,110395,105406,TR,TR
72436,1699517760,1699537140,19380,67409,199868,SE,SE
6299,1699661280,1699678920,17640,610,157138,US,US
49451,1700627100,1700658060,30960,89212,178090,TR,TR
8373,1700739780,1700770920,31140,50103,63374,TR,TR
42809,1699948080,1699951680,3600,102152,103168,GB,GB
111574,1698916380,1698932280,15900,129855,198054,US,US
91427,1700863380,1700897340,33960,124715,17141,TR,BG
199416,1699039680,1699053900,14220,195468,117404,US,US
187433,1698949380,1698975240,25860,199318,78947,PL,DE
29667,1699438260,1699460820,22560,166124,113930,DE,BE
47966,1698930600,1698942240,11640,99097,128599,IT,IT
180176,1698897780,1698910980,13200,24625,128907,US,US
3431,1699533660,1699563660,30000,39987,17198,TR,TR
96481,1700666580,1700677380,10800,147075,61381,US,US
175803,1699871220,1699883520,12300,150590,158323,US,US
37271,1700781600,1700787300,5700,103498,174961,GB,GB
106215,1700646180,1700677020,30840,192493,169302,TR,TR
49555,1698981420,1698992640,11220,13416,146187,AT,MK
96553,1698859860,1698888120,28260,79328,136626,BA,BA
142167,1699001520,1699019040,17520,143679,183055,SE,DK
48405,1700630220,1700655600,25380,29147,60298,DE,BG
139860,1699544220,1699576140,31920,171902,62838,TR,TR
74282,1699182420,1699212720,30300,176079,30524,TR,TR
26040,1699711500,1699724220,12720,113927,65193,AT,AT
67269,1700317740,1700351160,33420,77054,199687,TR,TR
191013,1700760420,1700789280,28860,164180,85773,TR,TR
137399,1699548360,1699554960,6600,121905,128031,GB,GB
128213,1700288400,1700305860,17460,29038,16753,US,US
98100,1699297740,1699321260,23520,122993,479,DE,RO
96777,1699872840,1699878240,5400,134654,22850,NL,NL
23513,1699882680,1699888320,5640,125601,20657,GB,GB
154233,1699440900,1699465080,24180,13117,177925,HU,PL
100953,1699536420,1699549920,13500,103867,29283,US,US
52753,1700140260,1700154540,14280,187890,184844,IT,IT
141465,1699752780,1699768200,15420,88879,33283,FR,FR
197640,1700294580,1700309700,15120,199130,85619,US,US
58329,1699507860,1699511460,3600,68281,143983,GB,GB
23100,1699842240,1699877040,34800,59920,99634,TR,TR
25990,1699045920,1699075200,29280,34089,148219,TR,TR
138500,1698895140,1698925380,30240,123757,34239,TR,TR
184110,1700480880,1700511600,30720,73185,147186,TR,TR
32960,1700026200,1700042760,16560,54702,15131,AT,AT
141567,1699746420,1699776180,29760,143115,197643,TR,TR
116326,1698928680,1698940320,11640,113863,10295,PT,PT
70896,1700839320,1700850480,11160,85520,188385,US,US
77350,1698857520,1698886740,29220,2338,121741,TR,TR
127678,1699735320,1699741800,6480,113221,167230,NL,NL
56938,1698994920,1699015500,20580,30323,78454,FR,FR
55968,1699708020,1699724520,16500,189768,174593,RS,RS
196222,1699101540,1699115700,14160,178665,79616,US,US
109851,1699268460,1699302060,33600,98361,69157,TR,TR
171470,1699777440,1699793820,16380,28315,137542,CZ,CZ
172078,1700001960,1700035740,33780,86998,48529,MX,MX
84931,1699044900,1699053900,9000,21796,15500,EE,EE
108888,1700378100,1700414280,36180,77242,96368,MX,MX
29638,1700640360,1700652180,11820,86692,139169,PT,PT
71627,1699953240,1699987380,34140,82961,86978,TR,TR
154524,1700208540,1700240580,32040,79215,166591,TR,TR
165148,1699452720,1699486800,34080,166035,8162,TR,TR
14458,1699807920,1699813920,6000,90986,125600,NL,NL
92883,1700028780,1700052420,23640,100148,93229,PL,PL
25052,1699509480,1699524480,15000,59531,198112,FR,FR
198148,1699717560,1699745460,27900,184709,35645,DE,DE
193683,1699841460,1699845060,3600,119194,17757,GB,GB
154062,1700745180,1700779080,33900,71014,171564,TR,TR
148944,1700495580,1700499180,3600,162527,122613,NL,NL
197344,1698826140,1698835260,9120,167876,153920,IT,IT
147501,1699278120,1699311180,33060,96049,177674,TR,TR
138480,1699888200,1699900080,11880,113479,146670,CZ,PL
18031,1699724400,1699735860,11460,171869,9557,PT,ES
33847,1700166600,1700180820,14220,196777,164378,US,US
47565,1698839220,1698866760,27540,176264,25683,BR,BR
75032,1700746320,1700764320,18000,23929,168782,FR,FR
122979,1699309020,1699343880,34860,46331,46596,TR,TR
164999,1699566420,1699574820,8400,94233,7852,ES,ES
91134,1699484760,1699495380,10620,13395,55116,IT,IT
118902,1698814920,1698827280,12360,190068,146002,US,US
71377,1699449960,1699461360,11400,93255,58279,US,US
190444,1699175220,1699181520,6300,159041,42715,GB,GB
150938,1698990960,1699025460,34500,77334,12403,TR,TR
181635,1700745660,1700777460,31800,72132,84853,TR,TR
152905,1700219520,1700254860,35340,197329,196204,TR,TR
111671,1699039860,1699043460,3600,74645,69782,GB,GB
74502,1699174920,1699192620,17700,40402,114832,US,US
160300,1700721420,1700743920,22500,99315,39840,ME,RS
98775,1700427180,1700462400,35220,4116,129031,MX,MX
180191,1700146800,1700176020,29220,61573,93488,BA,HR
75811,1699912080,1699929720,17640,20987,182415,US,US
22854,1699936740,1699970580,33840,84687,54558,TR,TR
159224,1700593980,1700608800,14820,9982,177493,US,US
196047,1700848380,1700859360,10980,150566,174267,IT,IT
5622,1700733900,1700766060,32160,185112,62274,TR,TR
143484,1698897660,1698930120,32460,13102,116047,TR,TR
170582,1700739300,1700754540,15240,175789,118352,US,US
80953,1699513500,1699524300,10800,163105,26578,US,US
109825,1699454580,1699464720,10140,36313,184828,IT,IT
73966,1699046220,1699074840,28620,82099,138519,DE,DE
184057,1699577460,1699606260,28800,10789,73282,TR,TR
96316,1700729280,1700745660,16380,77591,146720,CZ,CZ
17641,1699011540,1699051080,39540,197410,44632,MX,MX
37601,1699858800,1699862400,3600,168832,55683,GB,GB
134383,1699530120,1699541040,10920,135168,19569,US,US
134180,1700031240,1700044320,13080,11938,167626,US,US
88483,1700579760,1700593980,14220,60401,178537,IT,IT
25443,1700223600,1700229000,5400,94610,89309,EE,EE
161000,1699677540,1699712220,34680,9280,98345,TR,TR
48997,1700406180,1700445480,39300,55413,71868,MX,MX
27387,1699030800,1699060500,29700,125510,83725,TR,TR
163402,1699519380,1699527120,7740,56324,13077,IT,IT
166597,1700602800,1700616840,14040,122518,193658,IT,IT
29695,1699313880,1699321140,7260,26001,88141,IT,FR
184061,1700066820,1700098080,31260,49562,158432,TR,TR
163098,1700511600,1700519520,7920,78085,71954,IT,IT
42762,1700271480,1700304660,33180,186751,123583,TR,TR
75871,1699431240,1699463100,31860,45190,176070,TR,TR
163142,1699561140,1699564980,3840,170021,159060,GB,GB
5141,1699958640,1699991340,32700,113151,61117,TR,TR
90983,1699308960,1699324200,15240,99387,123164,US,US
79276,1698861240,1698896520,35280,49432,105894,TR,TR
54159,1700742180,1700758020,15840,28010,33152,FR,HR
179842,1700802180,1700814660,12480,59493,159462,US,US
13182,1699531380,1699549020,17640,141541,23691,US,US
181193,1700230860,1700263500,32640,133681,64280,TR,TR
137753,1700117280,1700151420,34140,99255,140137,TR,TR
176395,1699672020,1699684500,12480,57018,173111,CZ,FR
127067,1698878520,1698914100,35580,189091,68054,TR,TR
10677,1699431240,1699444800,13560,79881,169994,AT,AT
57260,1700755500,1700759100,3600,167252,71158,GB,GB
168846,1699785600,1699792740,7140,198847,179981,NL,NL
118309,1700850120,1700863740,13620,174008,182014,IT,IT
22925,1699061040,1699078080,17040,82094,30293,US,US
47790,1700082900,1700098920,16020,91604,91946,SE,SE
187102,1700308200,1700316180,7980,72824,144435,HR,HR
111610,1699713660,1699731540,17880,50998,16180,US,US
144720,1699789800,1699819440,29640,154754,139150,TR,TR
32766,1700454060,1700467260,13200,113686,137723,IT,IT
196918,1699331880,1699365240,33360,129906,185901,TR,TR
61375,1700065080,1700075040,9960,175059,82996,ES,ES
177457,1699902000,1699912860,10860,137183,53395,US,US
53144,1699841520,1699846740,5220,84473,145839,EE,EE
15961,1700439120,1700449980,10860,167745,196860,IT,IT
125613,1699616160,1699637340,21180,166046,53358,FR,FR
142919,1699420500,1699454940,34440,124022,43629,TR,TR
114500,1699903080,1699915440,12360,8190,52586,US,US
160436,1698983160,1698990600,7440,7006,105223,HR,HR
34036,1699088280,1699091880,3600,19945,138114,NL,NL
77552,1699858260,1699893360,35100,59323,34735,TR,TR
144716,1700072640,1700087700,15060,154838,44482,US,US
192536,1699081980,1699115340,33360,16730,83847,TR,TR
194270,1700404080,1700433480,29400,61886,135950,TR,TR
109866,1699241460,1699276440,34980,121648,33102,TR,TR
151349,1700429280,1700439600,10320,59582,183510,IT,IT
163114,1699822680,1699852080,29400,25070,195255,TR,TR
28130,1700479980,1700483580,3600,104816,947,GB,GB
12804,1700385300,1700403180,17880,36069,22893,FR,FR
70799,1699000080,1699010640,10560,39446,95960,IT,IT
144507,1699719180,1699734120,14940,66128,134885,IN,IN
102283,1699485900,1699499820,13920,87183,40605,US,US
29339,1700348460,1700379960,31500,193314,7105,TR,TR
175849,1700375160,1700398860,23700,122351,100384,RO,RO
73005,1699338120,1699361340,23220,10329,124372,RO,RO
15310,1700793960,1700827320,33360,65503,27550,TR,TR
28327,1699487040,1699522740,35700,70702,50498,TR,TR
104467,1700839080,1700842680,3600,148600,116530,GB,GB
45224,1699910640,1699914240,3600,191862,196716,GB,GB
179578,1699172400,1699189080,16680,84492,199926,US,US
146926,1698856320,1698890820,34500,152025,81732,TR,TR
144036,1700228880,1700260500,31620,49558,190710,TR,TR
115265,1699910160,1699922220,12060,37011,175870,SK,AT
82319,1699497000,1699527660,30660,155339,166860,TR,TR
167606,1699852920,1699856520,3600,156824,128960,GB,GB
84311,1700212800,1700245260,32460,8137,28013,TR,TR
33149,1700366220,1700386320,20100,136876,13774,FR,FR
8909,1699221240,1699226400,5160,144132,4410,GB,GB
197607,1699573020,1699603200,30180,124584,136043,TR,TR
181494,1700096100,1700103900,7800,77992,198024,IT,IT
44766,1700327040,1700341080,14040,51955,89424,US,US
5206,1698830340,1698863040,32700,15931,83302,TR,TR
132856,1700812560,1700817540,4980,187666,66731,EE,FI
79364,1699133280,1699138320,5040,97777,129318,GB,GB
96946,1699722420,1699734780,12360,33602,48422,US,US
77981,1700308680,1700325540,16860,78965,66197,US,US
114434,1700322480,1700356560,34080,187774,113156,TR,TR
97773,1700471160,1700506200,35040,171452,63039,TR,TR
47580,1700101560,1700115840,14280,97242,84434,HR,HR
27808,1698808920,1698862740,53820,113036,173955,BG,AT
136617,1699960800,1699973460,12660,40385,92044,IT,IT
109374,1700378640,1700409120,30480,148695,160387,TR,TR
158425,1699628580,1699645740,17160,120248,58275,AT,BG
188910,1700195160,1700227740,32580,47710,160701,TR,TR
41300,1699720680,1699741020,20340,185868,162548,FR,FR
12321,1700262720,1700271360,8640,89621,18956,ES,FR
96379,1699341600,1699358400,16800,78277,41674,US,US
120346,1699124040,1699144800,20760,38528,66378,BE,NL
129597,1699708200,1699718220,10020,180398,161446,IT,IT
163742,1700640060,1700643660,3600,116573,141326,GB,GB
58771,1700554980,1700587380,32400,135337,52917,TR,TR
95180,1699634580,1699638180,3600,39397,135476,NL,NL
111200,1699331520,1699343760,12240,160326,13183,CZ,ES
42302,1698817920,1698842760,24840,65665,29675,BR,BR
34144,1699800360,1699812120,11760,76285,9486,US,US
136918,1698937800,1698962520,24720,108380,164522,DE,DE
96484,1699519080,1699554420,35340,42965,149361,MX,MX
25159,1700472660,1700476260,3600,166071,50401,GB,GB
135509,1698992940,1699010280,17340,190361,69229,US,US
146131,1698917400,1698921000,3600,87410,21973,NL,NL
109795,1700215800,1700248980,33180,82842,195153,MX,MX
78331,1699506660,1699510260,3600,188011,98611,GB,GB
63666,1699648380,1699665600,17220,16636,21829,US,US
94831,1699058100,1699072560,14460,128881,107427,US,US
131458,1699104540,1699115640,11100,173312,105582,US,US
6738,1698999900,1699009740,9840,49668,69829,PT,PT
133302,1700773560,1700785380,11820,44321,186444,CZ,CZ
123857,1698943980,1698959340,15360,184327,52458,US,US
135222,1699908360,1699911960,3600,39226,54140,GB,GB
161914,1699273800,1699279920,6120,74605,23952,AD,ES
115368,1699530240,1699540380,10140,62435,79638,SK,SK
33836,1699592940,1699614600,21660,183177,50595,DE,DE
109688,1700212140,1700225760,13620,170369,77010,US,US
171465,1700861040,1700888880,27840,168574,101073,DE,DE
5247,1699604520,1699637700,33180,176694,60535,MX,MX
103244,1699825560,1699853460,27900,124454,179124,PL,PL
141212,1699594560,1699625280,30720,187347,23497,TR,TR
91972,1699813680,1699817280,3600,199226,147026,GB,GB
13627,1700317740,1700322480,4740,61767,54641,GB,GB
195310,1698908700,1698944520,35820,110949,1748,TR,TR
74744,1700628540,1700644080,15540,10695,167539,CA,US
149216,1700427300,1700457000,29700,85927,177824,TR,TR
90365,1700354880,1700368080,13200,190731,7395,IT,IT
8642,1700417100,1700424480,7380,167915,124049,ES,ES
66504,1700859300,1700864160,4860,19590,127191,GB,GB
41509,1699368120,1699403760,35640,156288,20395,TR,TR
18618,1699093440,1699097040,3600,91489,62458,NL,NL
157572,1699076100,1699083540,7440,127423,195088,IT,IT
40674,1698892920,1698906960,14040,195978,92703,HR,HR
101680,1699564200,1699594260,30060,81554,137770,TR,TR
30874,1700516640,1700551980,35340,92708,63487,TR,TR
82548,1700095080,1700109360,14280,16533,58339,CZ,CZ
172883,1700719260,1700740260,21000,58928,76174,FR,IT
129270,1699163760,1699170420,6660,77246,52118,GB,GB
73168,1700010600,1700015040,4440,151659,11185,NL,NL
39725,1699791180,1699794780,3600,165210,21210,GB,GB
57783,1700625360,1700634780,9420,71417,8750,IT,IT
74740,1700717820,1700748780,30960,180525,176568,TR,TR
53105,1699167720,1699171560,3840,17788,189233,GB,GB
51860,1700779200,1700834100,54900,43251,60231,BG,AT
136682,1700425440,1700436960,11520,195528,165830,US,US
43080,1700234580,1700263020,28440,27928,180712,PL,AT
198475,1699454640,1699469340,14700,111058,55212,CA,CA
51219,1700414400,1700448060,33660,196565,69375,TR,TR
20841,1699270440,1699300020,29580,91678,773,TR,TR
189167,1699766280,1699797240,30960,8505,14543,TR,TR
109053,1699058340,1699076280,17940,150122,16060,FR,FR
182847,1700709120,1700736240,27120,157943,69419,BR,BR
29167,1700162400,1700177820,15420,1282,23993,CZ,CZ
53576,1699785900,1699821000,35100,21484,87651,TR,TR
155742,1699689600,1699705800,16200,92086,157046,US,CA
117368,1700589780,1700622000,32220,10001,31187,TR,TR
189619,1700448840,1700458200,9360,74814,25872,HR,HR
93571,1698825060,1698857340,32280,86334,173210,TR,TR
19012,1699193280,1699197420,4140,21517,155787,NL,NL
9206,1698802500,1698821520,19020,17407,108417,SE,NO
84907,1699380060,1699413120,33060,125078,190451,TR,TR
115999,1699935840,1699948500,12660,55194,70856,CZ,DE
8461,1700781180,1700793000,11820,43049,36318,HR,HR
72336,1699577700,1699608180,30480,143314,116569,TR,TR
28256,1699512420,1699517820,5400,183832,188368,GB,GB
150591,1700824380,1700856120,31740,60908,12315,TR,TR
79384,1700495520,1700526900,31380,64810,50050,TR,TR
84115,1698829740,1698859860,30120,175719,157897,TR,TR
180356,1700654580,1700666100,11520,187013,6797,US,US
32970,1699629000,1699632600,3600,76298,77037,GB,GB
196743,1699951200,1699954800,3600,122113,156742,GB,GB
191352,1699131600,1699137660,6060,179175,93860,NL,NL
87361,1698978480,1698993120,14640,120466,80221,US,US
26489,1700157480,1700167080,9600,35196,21286,ES,ES
149740,1700603700,1700638560,34860,186402,104079,TR,TR
149059,1700739840,1700748000,8160,148067,146238,PT,PT
62459,1699471920,1699497840,25920,155788,113275,DE,PL
99299,1700558280,1700566560,8280,139682,138280,IT,FR
179516,1700118600,1700149980,31380,89790,70882,TR,TR
291,1699441500,1699445340,3840,110782,42499,NL,NL
126874,1699239180,1699272240,33060,81924,180766,TR,TR
135422,1700262960,1700266560,3600,141203,154378,GB,GB
74296,1699702260,1699706340,4080,30581,146835,GB,GB
22846,1699634520,1699657740,23220,73501,6273,DE,DE
126648,1700055480,1700072820,17340,147814,111304,US,US
119078,1700764680,1700787000,22320,48909,121937,DE,DE
72966,1698869520,1698880620,11100,36096,156706,US,US
73503,1700374500,1700378100,3600,147593,57521,GB,GB
98524,1699248960,1699286760,37800,56290,73412,MX,MX
14169,1700295180,1700334480,39300,177099,59146,MX,MX
68140,1700529660,1700558640,28980,105264,122772,TR,TR
53571,1699887900,1699907520,19620,40680,155114,FR,FR
67004,1700034180,1700050620,16440,50053,160471,CZ,CZ
53070,1699780080,1699795860,15780,121147,52281,FR,DE
64254,1699411200,1699440900,29700,113931,73710,TR,TR
72169,1699876500,1699908540,32040,65746,128597,TR,TR
164615,1700215440,1700244420,28980,67853,64916,TR,TR
109,1699222320,1699227960,5640,175772,2871,GB,GB
118562,1700708880,1700742660,33780,64420,77709,TR,TR
92989,1699787100,1699821420,34320,137370,162826,TR,TR
92681,1700809500,1700844840,35340,25207,49119,TR,TR
176838,1700187780,1700221560,33780,110999,124262,TR,TR
150437,1698811080,1698848160,37080,25697,166357,MX,MX
48872,1700090760,1700101740,10980,5171,189969,PT,PT
43379,1699265220,1699282560,17340,11750,98887,US,US
137896,1698931920,1698964320,32400,199151,190965,TR,TR
138268,1699604040,1699611660,7620,151451,181836,IT,IT
135923,1699498560,1699528860,30300,81936,142044,TR,TR
187942,1700154300,1700158200,3900,21756,46628,NL,NL
82117,1700000640,1700029980,29340,173934,64141,TR,TR
4964,1698920640,1698924240,3600,15851,55327,GB,GB
137900,1700008200,1700064480,56280,191353,195761,UA,CZ
45330,1699367340,1699400100,32760,111448,85522,MX,US
71883,1699980960,1700014800,33840,109595,15460,TR,TR
98102,1700059260,1700091300,32040,111577,66059,TR,TR
16286,1700569800,1700585700,15900,10888,15440,RS,RS
53123,1699892880,1699908360,15480,64822,7546,CZ,PL
120367,1700170800,1700187000,16200,174034,198775,US,US
171215,1699553280,1699577160,23880,96324,134460,DE,DE
170205,1699723260,1699739820,16560,166758,71596,BE,NL
127877,1700224320,1700260800,36480,143906,150896,MX,MX
57866,1700613600,1700620620,7020,103602,178925,GB,GB
154202,1700226900,1700234760,7860,136255,179212,IT,FR
188734,1699871100,1699904160,33060,12741,89760,TR,TR
50538,1699634040,1699669440,35400,104495,90313,TR,TR
92859,1699751340,1699760220,8880,7721,73463,PT,PT
128074,1700847420,1700851020,3600,7067,53653,NL,NL
68986,1699858260,1699894080,35820,58246,63323,MX,MX
7269,1699333740,1699343700,9960,161790,187982,IT,IT
181803,1698797640,1698819900,22260,135882,143470,PL,PL
36367,1700332860,1700347080,14220,162018,180490,IT,IT
79868,1700142000,1700197620,55620,140035,75912,UA,CZ
11469,1699847100,1699859580,12480,190424,4849,IT,IT
93911,1700858340,1700873760,15420,171192,101386,SE,SE
164881,1700407980,1700432220,24240,179570,20767,PL,PL
137723,1700081580,1700094780,13200,187079,5998,US,US
23662,1699677120,1699684380,7260,64146,25817,IT,IT
103067,1700371980,1700389320,17340,150723,71315,US,US
44689,1699596480,1699601160,4680,82274,103658,GB,GB
124116,1700694300,1700705220,10920,101854,85562,US,US
12200,1698942300,1698959460,17160,27099,169227,US,US
155579,1700168520,1700198580,30060,180048,53525,TR,TR
186192,1699675920,1699686780,10860,101226,46062,PT,ES
140963,1699988160,1700015820,27660,160430,89487,DE,DE
152742,1700840880,1700855340,14460,181987,119817,FR,BE
88446,1699015860,1699050660,34800,197854,102754,TR,TR
32293,1699277640,1699309320,31680,194418,154693,TR,TR
104132,1699967760,1700001660,33900,98525,149654,TR,TR
148074,1700513700,1700544960,31260,14552,183183,TR,TR
61846,1699794300,1699807920,13620,15106,186111,IT,IT
163811,1699590360,1699617420,27060,61879,159058,DE,BE
170029,1700773380,1700780160,6780,124161,28175,GB,GB
134939,1700388480,1700419860,31380,15535,158016,TR,TR
120722,1699907820,1699940940,33120,51732,167512,TR,TR
98471,1700315940,1700323260,7320,119195,61775,ES,BE
121099,1699638480,1699647300,8820,119529,130123,HR,DE
137103,1699372140,1699380420,8280,60514,139553,ES,ES
116839,1698961320,1698966660,5340,147170,66476,GB,GB
45876,1699395000,1699428480,33480,60491,177128,MX,MX
146261,1700785860,1700802540,16680,133956,188759,US,US
21030,1700051700,1700074740,23040,70891,20292,DE,HU
66828,1700845020,1700875560,30540,191650,8347,TR,TR
56124,1698956880,1698987300,30420,15779,14257,TR,TR
133995,1700177340,1700182080,4740,63212,182187,NL,NL
123571,1700303340,1700332980,29640,79377,38918,TR,TR
171053,1699178820,1699182420,3600,99033,81825,GB,GB
162330,1700058180,1700066880,8700,174826,42783,HR,HR
120462,1699271280,1699300800,29520,82533,133681,TR,TR
70662,1699031160,1699038600,7440,156642,109302,HR,HR
46637,1699186380,1699189980,3600,48545,8767,GB,GB
21280,1699634040,1699640100,6060,69402,181940,GB,GB
123883,1700183760,1700214480,30720,98693,38387,TR,TR
67696,1699287300,1699294200,6900,93093,101409,GB,GB
128578,1699607400,1699643760,36360,127434,17957,MX,US
44987,1700213040,1700248740,35700,106961,77313,TR,TR
12919,1699485900,1699494120,8220,95404,38605,PT,PT
90269,1699232700,1699242960,10260,58348,79227,PT,PT
58152,1699498440,1699533420,34980,196988,131486,TR,TR
180391,1699337160,1699370220,33060,44240,19187,TR,TR
47282,1700457060,1700490600,33540,62849,100530,MX,MX
73193,1700132820,1700141460,8640,122443,153566,IT,IT
117548,1699681800,1699712940,31140,173144,10723,TR,TR
86606,1698836040,1698870960,34920,93224,103756,TR,TR
14379,1700538780,1700573100,34320,144950,189663,TR,TR
162529,1699217880,1699251600,33720,169460,60936,TR,TR
25308,1698862620,1698874980,12360,16706,52826,IT,IT
114603,1699311180,1699343700,32520,27859,69823,TR,TR
133935,1700736420,1700740800,4380,18655,78744,GB,GB
45912,1700843460,1700875020,31560,114542,144060,TR,TR
171726,1699168380,1699178700,10320,61451,153246,IT,SK
71177,1699216200,1699233900,17700,54129,127585,US,US
152500,1700206980,1700242860,35880,169196,173444,TR,TR
121260,1699352340,1699370160,17820,40189,192557,FR,FR
190217,1699663380,1699697940,34560,193069,13206,TR,TR
122743,1699647600,1699661460,13860,116099,164197,IT,IT
10790,1700584800,1700588820,4020,161061,23133,GB,GB
6506,1700541240,1700544840,3600,143838,93025,NL,NL
28102,1699699440,1699728540,29100,53658,53019,TR,TR
74043,1700283960,1700316420,32460,91220,130933,TR,TR
170616,1700730300,1700760720,30420,198287,86396,TR,TR
126332,1699057920,1699065720,7800,55009,120764,HR,HR
11214,1699083420,1699104540,21120,46853,120831,BE,NL
62740,1699199040,1699217400,18360,56939,51073,DK,DK
131997,1699900140,1699934100,33960,127346,2364,TR,TR
130068,1699907160,1699916040,8880,49784,16436,HR,DE
20049,1700404860,1700412420,7560,141946,122197,PT,PT
102412,1700085900,1700108700,22800,48584,156659,HU,DE
27726,1699068480,1699078620,10140,164896,114087,HR,HR
193659,1699476660,1699489800,13140,29037,137883,US,MX
102046,1699323420,1699351800,28380,189690,14485,DE,DE
469,1699640400,1699644000,3600,76525,77207,NL,DE
35244,1700731200,1700744760,13560,99080,38138,HR,HR
185839,1698917820,1698930240,12420,192269,198059,IT,IT
167396,1699372800,1699403580,30780,103725,70550,TR,TR
196947,1700745900,1700763600,17700,187275,100135,US,US
17883,1699201440,1699231200,29760,157238,38626,TR,TR
60836,1700299080,1700310060,10980,178519,75786,US,US
179188,1700328360,1700361900,33540,124343,122694,TR,TR
155386,1699000740,1699035180,34440,108993,173983,TR,TR
119602,1699783260,1699813380,30120,24478,165530,TR,TR
151916,1700758920,1700789640,30720,71762,173959,TR,TR
81562,1698963900,1698979440,15540,129950,86854,FR,FR
38356,1699214580,1699247760,33180,56881,8622,TR,TR
77992,1699476180,1699505400,29220,60928,139518,TR,TR
156582,1698931020,1698945240,14220,54530,192039,HR,HR
73174,1699466880,1699483920,17040,58282,5921,US,US
137033,1700273760,1700299500,25740,109121,116020,DE,PL
72978,1699020960,1699024560,3600,96779,47323,NL,NL
74299,1699641360,1699653720,12360,42018,142695,IT,IT
44722,1699805160,1699811580,6420,189462,123535,GB,GB
36343,1700636040,1700656020,19980,126152,146522,FR,DE
15483,1699171800,1699202100,30300,181710,14385,TR,TR
116801,1699914060,1699942920,28860,103789,4305,TR,TR
115479,1700679360,1700695920,16560,195120,47057,US,US
9116,1700001060,1700022000,20940,92303,195227,FR,FR
68958,1699318920,1699351260,32340,53926,164694,TR,TR
66154,1699960200,1699966140,5940,143344,51238,GB,GB
184220,1699501800,1699534200,32400,148956,127265,MX,MX
124511,1699509300,1699520460,11160,173366,101729,US,US
163670,1699680840,1699713180,32340,47845,169289,TR,TR
139356,1699805700,1699816560,10860,117180,51479,US,US
103867,1700064300,1700093100,28800,94508,115791,TR,TR
48814,1700263080,1700294460,31380,167741,73679,TR,TR
84252,1699750680,1699761480,10800,45333,4196,IT,FR
119265,1699225620,1699254720,29100,28845,8852,TR,TR
62849,1699342440,1699372860,30420,123526,104515,TR,TR
194290,1698942240,1698953640,11400,90129,167678,US,US
48463,1699681860,1699708320,26460,17297,148592,BR,BR
122292,1700473440,1700487300,13860,143376,180197,US,US
177726,1699409580,1699421340,11760,59711,40509,US,US
162712,1700205660,1700238240,32580,10840,79148,TR,TR
169762,1698984240,1699000560,16320,198636,44135,FR,IT
50293,1700572560,1700579040,6480,4345,21709,NL,NL
54919,1700832000,1700844360,12360,124844,190406,US,US
101645,1699755240,1699783800,28560,162529,87488,DE,DE
193254,1698994440,1699002360,7920,10823,4,IT,IT
67991,1700341800,1700354520,12720,96310,90589,IT,IT
61934,1699850340,1699884720,34380,57911,27742,TR,TR
186437,1699325100,1699340160,15060,153755,151736,CZ,CZ
166335,1700857140,1700874060,16920,187222,88050,CZ,CZ
161870,1699768800,1699798320,29520,63384,71875,TR,TR
66302,1699410060,1699426020,15960,15080,9637,AT,HU
121602,1699224660,1699228260,3600,89338,182155,GB,GB
138739,1699980540,1699992480,11940,120415,127850,HR,HR
85064,1700769300,1700773080,3780,57155,45398,NL,NL
52432,1699952640,1699958940,6300,159065,93161,GB,GB
121874,1700628120,1700663880,35760,105886,96540,TR,TR
170331,1700006760,1700038380,31620,69266,94063,TR,TR
120164,1699842840,1699876140,33300,70210,149676,TR,TR
75581,1700662920,1700689380,26460,58818,115927,PL,PL
149329,1699939920,1699967940,28020,178130,88488,BR,BR
77527,1699281420,1699295520,14100,122867,57601,AT,RS
27709,1700395800,1700407920,12120,86902,85120,US,US
63320,1699395840,1699418160,22320,72261,6974,BR,BR
154721,1699150380,1699180740,30360,90495,126581,TR,TR
60132,1699941360,1699952760,11400,31423,46840,IT,IT
29363,1700436660,1700468160,31500,63828,143287,TR,TR
111375,1698950280,1698981780,31500,142709,83616,TR,TR
135061,1699430280,1699462740,32460,4036,77912,TR,TR
133859,1698838140,1698851460,13320,171627,194535,HR,HR
75086,1699933740,1699963440,29700,172611,108123,TR,TR
155510,1699502460,1699506060,3600,176164,8307,NL,NL
6402,1699707180,1699710780,3600,12685,113244,GB,GB
20885,1699894860,1699908900,14040,19727,77360,US,US
151595,1700012880,1700045460,32580,49686,41626,TR,TR
56071,1700542440,1700576820,34380,137924,69890,TR,TR
187611,1700797500,1700812740,15240,69219,146123,US,US
139427,1699568760,1699575360,6600,756,199793,GB,GB
78970,1699426260,1699437720,11460,102789,197449,CA,US
121558,1700805240,1700810820,5580,185557,137506,GB,GB
183156,1700841240,1700876760,35520,126782,89741,TR,TR
71809,1699792800,1699804260,11460,169056,150055,IT,IT
171101,1700742480,1700778120,35640,165296,112850,TR,TR
193842,1699286820,1699318500,31680,56940,180708,TR,TR
38336,1698837660,1698841260,3600,63385,100393,NL,NL
163477,1699786860,1699821960,35100,140288,1465,TR,TR
51677,1698860160,1698894360,34200,145448,165660,TR,TR
193153,1700396880,1700428500,31620,167712,133267,TR,TR
148441,1698935520,1698967980,32460,57836,10299,TR,TR
110077,1700437920,1700450340,12420,198409,113562,IT,IT
29897,1699557840,1699587420,29580,38839,120278,TR,TR
140600,1699092120,1699122720,30600,187960,70977,TR,TR
177863,1699379520,1699383840,4320,146990,198001,GB,GB
36065,1700675520,1700710320,34800,172688,83256,TR,TR
35670,1700034720,1700069880,35160,178990,17353,TR,TR
55724,1700584920,1700616060,31140,17331,163146,TR,TR
125269,1699285860,1699310820,24960,9678,77833,RO,RO
66115,1699861920,1699896120,34200,2096,121361,TR,TR
3798,1699897800,1699932180,34380,65568,106185,TR,TR
23806,1699405440,1699438500,33060,188862,102027,TR,TR
141083,1700648760,1700671740,22980,183568,16413,DE,DE
193677,1699212420,1699222320,9900,196881,40006,IT,IT
29679,1699846260,1699851360,5100,120508,58938,GB,GB
183246,1699154520,1699188960,34440,151600,190897,TR,TR
154614,1700434980,1700438580,3600,83617,64963,GB,GB
164868,1699032480,1699052760,20280,77280,159179,FR,FR
198445,1699735560,1699759980,24420,150145,96932,PL,PL
93831,1699408440,1699435920,27480,133551,180223,RO,RO
142720,1700833680,1700863740,30060,13187,107301,TR,TR
91058,1699816260,1699819860,3600,17801,176159,NL,NL
63030,1699933500,1699944600,11100,66032,140607,PT,PT
173500,1699869540,1699874580,5040,55460,158132,GB,GB
138923,1699173660,1699187280,13620,74290,84960,CA,CA
181358,1700362680,1700395320,32640,75230,157003,TR,TR
135331,1700823780,1700829660,5880,169643,20993,GB,GB
117124,1700685060,1700688660,3600,50465,140218,GB,GB
69586,1699861680,1699876260,14580,13799,173454,CZ,CZ
146943,1699506720,1699517580,10860,3448,158054,US,US
171310,1699047000,1699060920,13920,64629,31393,PT,PT
194413,1700406600,1700438520,31920,104437,50495,TR,TR
171792,1700699280,1700731560,32280,157812,174421,TR,TR
36869,1699707120,1699717140,10020,53380,135676,SK,SK
72277,1700620260,1700635740,15480,143845,112205,FR,FR
17694,1700802420,1700818860,16440,47187,72202,FR,NL
18343,1699559220,1699578660,19440,149492,193359,FR,GB
58533,1700449200,1700457480,8280,5641,109543,ES,ES
26371,1700688600,1700692200,3600,161829,170083,GB,GB
179916,1699244040,1699254660,10620,6788,170164,ES,AD
36729,1699019040,1699035840,16800,184719,7785,FR,RO
147570,1699721520,1699725120,3600,150944,129917,GB,GB
86405,1699784100,1699794900,10800,122981,108868,AT,AT
30941,1699766820,1699790880,24060,153789,190843,DE,DE
121689,1698903600,1698907200,3600,38875,143840,GB,GB
88825,1700037960,1700071620,33660,125586,39719,TR,TR
88623,1700767080,1700789460,22380,185896,84770,DE,AT
190760,1699972860,1700001660,28800,123559,25925,TR,TR
186175,1700232780,1700241600,8820,102682,28346,PT,PT
29563,1700401800,1700435820,34020,79,12845,TR,TR
85948,1700004960,1700035920,30960,155644,168319,TR,TR
102096,1698982440,1699015800,33360,199743,170684,TR,TR
75343,1700218560,1700254380,35820,163806,71466,TR,TR
169798,1699232700,1699253700,21000,167129,139340,BE,NL
63252,1700708040,1700727360,19320,65508,128554,FR,FR
86277,1699074900,1699104660,29760,49900,73783,TR,TR
66102,1699785360,1699815780,30420,148014,108244,TR,TR
97181,1700702820,1700733660,30840,192158,56321,TR,TR
155558,1699554180,1699581420,27240,103884,54938,CH,IT
121903,1700252340,1700289900,37560,65533,83964,MX,MX
179257,1700364540,1700393640,29100,39233,160857,TR,TR
144127,1699381080,1699404840,23760,180842,123298,DK,DK
175210,1698924720,1698960660,35940,36921,76909,TR,TR
115502,1700660040,1700693280,33240,101426,178149,TR,TR
11970,1699143060,1699158480,15420,95057,178722,FR,FR
8375,1699293780,1699310100,16320,8864,190193,US,US
165837,1699212360,1699230000,17640,73547,137311,AT,AT
134717,1700502240,1700517720,15480,16818,91675,US,US
107844,1699723020,1699754940,31920,103081,195013,TR,TR
13384,1699867140,1699905960,38820,37300,160549,MX,MX
100283,1700758380,1700765760,7380,163018,89438,PT,PT
54539,1700794080,1700828160,34080,131902,183262,TR,TR
28958,1698917940,1698952740,34800,13537,84085,TR,TR
76334,1699435740,1699446840,11100,195176,23915,US,US
60524,1699350660,1699366800,16140,197814,40384,US,US
64786,1698830160,1698863280,33120,108525,45272,TR,TR
172055,1699138800,1699150440,11640,81031,193147,IT,IT
13418,1699066140,1699098900,32760,131020,144658,TR,TR
18984,1699501140,1699513080,11940,61785,29573,IT,IT
143791,1700060700,1700064300,3600,193294,168767,GB,GB
69226,1699685820,1699699020,13200,65499,71297,US,US
114248,1698828300,1698863760,35460,59872,130200,TR,TR
57347,1699104300,1699109460,5160,42549,131898,NL,NL
122011,1700209140,1700219520,10380,117231,46968,IT,FR
14469,1698844740,1698870780,26040,148374,177781,DE,PL
167857,1700495880,1700510880,15000,99941,81535,BE,FR
28424,1699975740,1699984680,8940,74413,175439,SK,SK
54084,1699608240,1699630860,22620,104594,40028,RO,IT
54370,1698912600,1698935100,22500,30573,37713,PL,PL
77177,1699716060,1699750800,34740,119570,64018,TR,TR
104047,1700161380,1700195760,34380,131127,34951,TR,TR
51444,1699942680,1699970640,27960,53623,123689,BR,BR
146205,1699126020,1699136160,10140,125796,181558,IT,IT
178223,1700711280,1700723100,11820,158128,5274,US,US
71148,1700000940,1700013780,12840,118490,43622,AT,AT
197555,1699515180,1699522200,7020,161310,159492,GB,GB
190519,1699669680,1699703820,34140,126199,76767,TR,TR
169579,1700334000,1700340120,6120,47109,171195,NL,NL
145727,1699400940,1699432500,31560,109580,11475,TR,TR
27343,1700260140,1700294340,34200,35510,44026,TR,TR
145490,1698915540,1698922500,6960,122104,36508,GB,GB
69418,1699976580,1699985940,9360,27900,64756,HR,HR
68516,1700488560,1700520000,31440,66965,119560,TR,TR
144739,1700127540,1700164860,37320,22128,62668,MX,MX
113077,1700142960,1700171880,28920,92349,103643,TR,TR
10845,1700399400,1700414640,15240,2438,79552,US,US
199554,1699472640,1699494480,21840,2545,117627,DE,PL
111835,1700677320,1700708880,31560,75314,10658,TR,TR
157066,1698832020,1698855420,23400,62044,181970,DE,DE
182968,1699519560,1699549020,29460,69988,141665,TR,TR
121871,1699603200,1699660680,57480,110776,154641,BG,DE
42869,1699256280,1699259880,3600,58654,132373,GB,GB
64500,1700818440,1700827860,9420,30257,27654,IT,IT
175442,1698930540,1698959400,28860,149337,121693,TR,TR
83191,1700641560,1700672880,31320,58331,12964,TR,TR
2181,1700303400,1700332860,29460,129189,107203,TR,TR
92051,1700575620,1700593440,17820,76127,102579,US,US
21932,1699077360,1699109040,31680,7077,148730,TR,TR
115380,1699950780,1699971540,20760,100165,63808,FR,BE
156028,1699513920,1699518780,4860,82231,2807,NL,NL
138180,1699819260,1699834140,14880,94847,88124,US,US
1553,1700724900,1700753760,28860,6156,126575,TR,TR
57488,1700361540,1700374320,12780,33185,112049,IT,IT
26232,1700710440,1700718720,8280,117897,29781,IT,IT
9568,1700415420,1700424480,9060,16468,40904,IT,IT
47785,1699002660,1699033860,31200,62732,141777,TR,TR
30241,1699155660,1699165980,10320,90549,1384,PT,PT
154370,1699673460,1699696320,22860,176217,146710,RO,RO
121632,1699593000,1699622100,29100,96600,162817,TR,TR
191604,1700511780,1700534160,22380,161252,37739,RO,RO
64007,1699120800,1699135020,14220,63885,19228,US,US
9647,1699850100,1699880460,30360,192592,185002,TR,TR
54119,1700026680,1700056740,30060,160110,112647,TR,TR
59018,1700003340,1700032980,29640,85747,72991,TR,TR
118924,1699080240,1699112460,32220,116161,48520,TR,TR
31915,1699085100,1699119900,34800,54099,167751,TR,TR
165682,1699383600,1699398060,14460,32671,139468,RS,RS
198252,1699574160,1699589460,15300,54200,96182,CZ,UA
54804,1700619420,1700655360,35940,5772,118193,MX,MX
74120,1700797320,1700830800,33480,72075,37014,TR,TR
134994,1700634900,1700650560,15660,67667,51730,US,US
89624,1700559240,1700591760,32520,144189,197042,TR,TR
161628,1698877380,1698910200,32820,188610,75805,TR,TR
190082,1699100700,1699106520,5820,90118,80519,GB,GB
151193,1699500180,1699533240,33060,176420,80236,TR,TR
59754,1700278680,1700312340,33660,139625,157740,TR,TR
65581,1699694040,1699707960,13920,161169,48899,IT,IT
39078,1700110500,1700132580,22080,19691,7116,BR,BR
36004,1700154180,1700191380,37200,4060,149946,MX,MX
109818,1699318380,1699328460,10080,107620,65253,IT,IT
129184,1700510340,1700513940,3600,93741,20798,GB,GB
64804,1699400760,1699413660,12900,189385,100189,HR,HR
198520,1698863220,1698886140,22920,99882,179592,DE,CZ
150051,1699279920,1699313940,34020,63533,145409,TR,TR
127762,1699415220,1699447740,32520,42959,43625,TR,TR
20811,1699696560,1699728960,32400,58910,177500,TR,TR
176264,1699584420,1699596600,12180,47252,120613,US,US
977,1699889280,1699920540,31260,165144,121013,TR,TR
113991,1699820760,1699826340,5580,186268,55727,GB,GB
23285,1700121420,1700133900,12480,128383,193931,PT,PT
16673,1700649720,1700657400,7680,125402,156690,IT,IT
39170,1699329480,1699365000,35520,188732,86513,TR,TR
105771,1700246820,1700276760,29940,199191,176879,TR,TR
88578,1699187460,1699198140,10680,103748,194318,IT,IT
120060,1699987920,1700022540,34620,151526,193252,MX,MX
20640,1700036160,1700043900,7740,161841,115888,PT,PT
48851,1700396760,1700428740,31980,106883,52288,TR,TR
116408,1699564080,1699595640,31560,25856,24844,TR,TR
148646,1699081440,1699117140,35700,104441,65228,TR,TR
124259,1699350480,1699383060,32580,100567,197337,TR,TR
59389,1698881700,1698898860,17160,138933,67739,US,CA
79722,1698877080,1698908700,31620,44458,27254,TR,TR
169031,1699262160,1699284840,22680,72174,56095,NO,DK
119425,1699077900,1699081500,3600,41372,117105,NL,NL
155402,1700408820,1700421300,12480,132791,142734,US,US
152234,1699481700,1699486020,4320,175425,197605,NL,NL
29704,1699735380,1699750440,15060,114837,61820,US,US
15454,1700596800,1700608920,12120,147815,142605,RS,BA
173159,1699508640,1699534800,26160,73803,176841,DE,FR
196736,1699599780,1699613220,13440,197404,109982,US,US
133735,1700179500,1700215020,35520,183263,122401,TR,TR
59889,1699349220,1699363560,14340,189254,185605,US,US
107147,1699720020,1699725240,5220,169721,125720,GB,GB
81220,1699509060,1699538640,29580,45820,171800,TR,TR
57500,1700090160,1700115120,24960,103006,102659,PL,LV
105457,1699370880,1699403820,32940,102861,104312,TR,TR
119819,1699243980,1699276980,33000,152883,167930,TR,TR
37248,1699969140,1699981020,11880,175875,185518,ES,ES
4550,1699262040,1699293120,31080,171816,15099,TR,TR
118850,1699308000,1699336980,28980,123207,190316,TR,TR
56872,1699946520,1699952700,6180,74893,22633,NL,NL
105421,1699192380,1699203720,11340,159621,115209,US,US
37430,1700488140,1700502960,14820,82501,101759,RS,HR
37330,1700189400,1700202900,13500,175355,1716,US,US
126474,1699888260,1699891860,3600,111957,7812,NL,NL
88009,1700119500,1700123100,3600,142846,93897,GB,GB
78002,1698882000,1698916140,34140,125200,178429,TR,TR
193570,1700575980,1700610840,34860,116428,120097,TR,TR
81519,1699811220,1699824420,13200,28660,64279,ES,ES
145348,1699526100,1699538580,12480,179053,70083,IT,IT
124812,1700344860,1700378460,33600,88850,163693,TR,TR
80672,1699429620,1699459680,30060,184617,49701,TR,TR
40867,1699295820,1699299900,4080,7768,124592,GB,GB
81006,1700035620,1700043480,7860,40546,24856,IT,IT
165110,1699398720,1699432380,33660,124663,159570,TR,TR
129582,1698998940,1699030860,31920,1383,49120,TR,TR
70801,1699751040,1699754640,3600,111644,96830,GB,GB
66239,1699145640,1699157460,11820,37457,66437,ES,ES
198420,1698997560,1699029900,32340,3310,19292,TR,TR
13064,1699930260,1699963860,33600,104821,138087,TR,TR
180381,1699834140,1699865880,31740,164752,129350,TR,TR
89676,1699342200,1699371720,29520,41205,8682,TR,TR
26509,1700804640,1700810640,6000,127267,140653,EE,FI
93993,1698973320,1698976920,3600,2664,95730,NL,NL
71761,1698952800,1698987000,34200,129163,132800,TR,TR
17538,1699486620,1699518240,31620,61346,124484,BA,HR
157904,1699862400,1699895280,32880,111826,133700,TR,TR
172366,1700583180,1700598240,15060,176186,143325,US,US
99809,1700404860,1700408460,3600,66963,15166,GB,GB
86979,1700097720,1700133420,35700,191016,183521,TR,TR
58180,1699041840,1699054980,13140,78150,116621,US,US
154971,1699699980,1699714800,14820,3324,179951,US,US
155268,1699468140,1699503360,35220,116838,26201,TR,TR
9914,1699845000,1699869720,24720,179235,78174,RO,RO
17203,1698963540,1698970800,7260,172504,97803,IT,IT
81052,1700835900,1700847360,11460,87402,171341,US,MX
158095,1699167780,1699202580,34800,8777,38373,TR,TR
185798,1700622840,1700640420,17580,108714,98056,FR,FR
44487,1699747980,1699773480,25500,97316,14038,HU,DE
109045,1698860880,1698894420,33540,114749,155854,TR,TR
90305,1699154340,1699166040,11700,98346,8163,AT,AT
34094,1700304600,1700320680,16080,136262,199738,AT,DE
158490,1700308440,1700321580,13140,156276,67585,AT,AT
125107,1699917120,1699945620,28500,59392,119884,PL,PL
57836,1699570620,1699587360,16740,20988,150287,US,US
194826,1698868800,1698899160,30360,118928,170257,TR,TR
33170,1699782900,1699793280,10380,96918,133466,EE,EE
76954,1699978560,1699983360,4800,79963,53893,GB,GB
124931,1700746980,1700750580,3600,72840,28787,NL,NL
147582,1699317540,1699350300,32760,111963,193443,TR,TR
2089,1699014600,1699051140,36540,17859,17743,MX,MX
93589,1699343340,1699353600,10260,153471,42244,IT,IT
9506,1700623560,1700655720,32160,124223,181851,TR,TR
102821,1700776620,1700781240,4620,137501,127868,GB,GB
190400,1700019000,1700032440,13440,185572,188642,US,US
189367,1700718600,1700753640,35040,117735,89877,TR,TR
54735,1699744980,1699775160,30180,1587,73398,TR,TR
86311,1699903020,1699915920,12900,15794,132072,AT,SK
197435,1700307840,1700330820,22980,121,55785,DE,DE
1279,1699129620,1699142340,12720,70851,143735,HR,HR
176174,1700149920,1700161920,12000,113749,195731,IT,IT
47921,1700295360,1700325000,29640,194844,104196,TR,TR
34967,1699328940,1699336080,7140,144865,183236,NL,NL
153511,1700202780,1700222520,19740,44667,192580,FR,ES
13251,1699930260,1699942800,12540,50470,152974,IT,IT
167771,1699105920,1699138200,32280,25407,35618,TR,TR
41079,1700361660,1700365260,3600,199032,66666,NL,NL
94473,1699569720,1699599180,29460,57929,189815,TR,TR
44382,1700395080,1700428680,33600,86976,14197,TR,TR
75895,1700309100,1700339460,30360,86170,182164,TR,TR
48389,1700062620,1700087820,25200,93187,198721,RO,MD
62490,1699101180,1699133820,32640,42779,111621,TR,TR
49315,1699339740,1699363800,24060,95697,7428,BR,BR
134452,1700480820,1700494500,13680,175233,163624,PT,PT
117473,1700164800,1700193600,28800,49462,133848,TR,TR
109232,1698959880,1698963480,3600,112392,7478,NL,NL
170260,1698955020,1698965160,10140,78331,184815,IT,IT
100078,1699812480,1699816080,3600,30767,102840,GB,GB
98968,1699516680,1699549440,32760,148876,133552,TR,TR
8738,1699227180,1699280400,53220,32144,150061,BG,DE
78435,1700449980,1700467620,17640,39924,49894,FR,FR
176022,1699690140,1699696200,6060,6441,40887,GB,FR
40576,1699578300,1699607400,29100,43017,107968,TR,TR
56736,1699987380,1699999020,11640,156499,118796,IT,IT
27236,1700586840,1700618220,31380,141528,57672,TR,TR
100754,1700251140,1700279040,27900,96802,31345,RO,RO
199630,1699951200,1699986600,35400,102376,41285,TR,TR
118511,1700032980,1700045700,12720,13527,29431,US,US
94426,1699925280,1699935900,10620,19824,47450,PT,PT
125632,1699852320,1699890120,37800,34309,172422,MX,MX
50020,1699858980,1699893480,34500,118877,138932,TR,TR
148086,1699734240,1699738980,4740,66817,80931,NL,NL
26216,1699693860,1699708980,15120,85769,43531,BE,FR
150841,1698899280,1698906600,7320,28047,54517,IT,IT
143225,1700375700,1700397420,21720,198673,20276,DE,DE
190083,1700816580,1700824260,7680,30991,52904,IT,IT
149330,1700533080,1700549040,15960,20360,121470,US,US
16075,1700488920,1700512080,23160,101768,22556,DE,DE
65105,1700849100,1700863920,14820,190011,141423,BE,NL
64277,1699177380,1699180980,3600,46269,44360,GB,GB
4191,1698801960,1698806940,4980,44155,179,EE,EE
51637,1699231380,1699267440,36060,124987,146953,MX,MX
97495,1699070940,1699088280,17340,6472,178581,US,US
37897,1700837820,1700867940,30120,97492,188374,TR,TR
99736,1699336500,1699369980,33480,102871,127380,TR,TR
171617,1700864400,1700880000,15600,191744,129880,US,US
85741,1699199640,1699206900,7260,189801,25807,IT,IT
48331,1699761780,1699769940,8160,51337,19689,HR,HR
134143,1700416140,1700449800,33660,76504,39724,TR,TR
160824,1700377680,1700408580,30900,104154,121838,TR,TR
96107,1700609580,1700633340,23760,185160,169437,DE,DE
96718,1699201200,1699208700,7500,82640,96196,HR,FR
16313,1700792820,1700825280,32460,102379,68086,TR,TR
154727,1699192920,1699196520,3600,163631,34432,GB,GB
380,1699898220,1699928640,30420,125910,135784,TR,TR
55335,1700136480,1700140080,3600,151100,61796,NL,NL
37809,1700068260,1700085540,17280,16104,87567,US,US
60575,1699942620,1699956300,13680,177117,21424,IT,IT
119252,1699792560,1699826160,33600,148754,44247,TR,TR
120289,1699993680,1700024520,30840,103420,109245,TR,TR
81182,1699367340,1699372920,5580,73047,85204,NL,BE
112405,1700300220,1700304780,4560,138078,79735,NL,NL
193017,1700790540,1700805900,15360,162099,29543,AT,AT
131798,1700652900,1700667960,15060,46527,7140,AT,DE
173133,1700728560,1700739780,11220,108355,28599,ES,AD
39715,1700310660,1700323200,12540,1062,133274,IT,IT
63698,1699201320,1699215660,14340,53559,180484,US,US
162676,1699644180,1699678080,33900,197888,72882,TR,TR
118376,1699860180,1699863780,3600,159580,67988,GB,GB
47670,1700570700,1700604600,33900,106993,162791,TR,TR
34002,1699536420,1699555080,18660,77237,196265,FR,FR
69080,1699009860,1699013460,3600,101718,142587,NL,NL
77262,1699792140,1699821000,28860,19018,157387,TR,TR
53412,1699734600,1699769700,35100,152227,59424,MX,MX
64596,1700739780,1700745120,5340,72933,111462,GB,GB
175756,1699906920,1699926900,19980,106847,130794,FR,CH
166919,1699306560,1699334520,27960,45760,30834,RO,MD
86807,1700501940,1700530800,28860,95479,67051,TR,TR
101173,1699313160,1699341900,28740,109958,199120,DE,FR
87483,1700631480,1700654040,22560,118888,142536,RO,RO
97507,1700296740,1700300340,3600,99877,94493,NL,NL
121002,1700469660,1700479380,9720,43737,194506,SK,SK
162764,1700733660,1700737260,3600,23792,159937,GB,GB
191087,1699559940,1699590360,30420,156812,166959,TR,TR
118969,1699101600,1699132320,30720,3083,1667,TR,TR
112329,1700587080,1700601300,14220,69804,49567,RS,RS
173002,1699869060,1699907160,38100,97318,65704,MX,MX
113525,1699610580,1699630020,19440,124425,83639,FR,CH
124063,1700583300,1700593380,10080,128667,93870,EE,EE
80296,1700395920,1700399520,3600,33967,53472,GB,GB
94781,1700804160,1700838300,34140,150786,47247,TR,TR
36813,1699966320,1700018760,52440,106698,91347,BG,AT
88463,1700702280,1700717700,15420,48979,153968,US,US
3396,1700618400,1700631660,13260,111423,62543,US,US
36115,1700671320,1700709180,37860,121321,8115,MX,MX
66683,1700424120,1700444700,20580,36296,25300,FR,ES
62906,1698991440,1699006800,15360,52885,171679,US,US
90187,1700451720,1700467620,15900,192429,53781,US,US
90241,1698852900,1698867780,14880,185116,194647,US,US
87371,1699914420,1699938420,24000,183818,169308,DE,FR
111916,1699948140,1699951740,3600,177975,187650,GB,GB
9897,1699570140,1699584600,14460,99559,26377,FR,FR
171037,1700098200,1700112660,14460,58655,198970,RS,DE
191271,1699019940,1699054500,34560,24591,154439,TR,TR
70506,1699793460,1699820220,26760,17754,84868,BR,BR
47115,1700605440,1700628780,23340,97118,4892,BR,BR
159102,1699831800,1699840260,8460,69126,92899,IT,IT
87909,1700213340,1700216940,3600,26369,198579,GB,GB
136669,1699758000,1699769640,11640,29354,101439,ES,AD
144732,1699428480,1699442160,13680,44230,68652,IT,IT
169045,1699093440,1699128720,35280,26606,173553,TR,TR
39583,1699059540,1699093080,33540,163365,53258,TR,TR
178152,1700525700,1700560680,34980,16133,27721,MK,AL
77596,1698876960,1698906480,29520,58716,11945,TR,TR
124353,1699071000,1699095480,24480,57679,42428,BR,BR
14353,1698826020,1698859980,33960,63263,108595,TR,TR
9926,1700347200,1700365800,18600,119213,179195,SI,RS
47108,1700587320,1700614740,27420,81520,91552,RO,RO
112884,1699689960,1699703040,13080,49178,90387,US,US
167550,1700759400,1700783520,24120,113032,34322,DE,FR
112273,1698817920,1698847920,30000,70822,88326,TR,BG
31988,1699642680,1699677060,34380,95700,104669,TR,TR
4060,1699279920,1699293480,13560,52474,49976,US,US
88289,1700194440,1700227020,32580,196745,134419,TR,TR
107404,1699147080,1699164180,17100,72753,128573,FR,ES
31994,1699381740,1699417620,35880,144805,148303,TR,TR
195405,1700681400,1700689560,8160,84380,60930,HR,HR
110148,1699650840,1699683180,32340,192283,181022,TR,TR
11185,1700051760,1700057880,6120,21737,52356,GB,GB
108738,1700583840,1700598300,14460,48104,184175,US,US
121751,1700176440,1700210220,33780,114952,156259,TR,TR
169005,1698876540,1698887520,10980,157021,9103,IT,IT
60098,1699326600,1699330200,3600,196066,71548,NL,DE
1637,1700597940,1700629440,31500,190756,8778,TR,TR
64815,1699038960,1699043700,4740,35362,109357,EE,FI
107783,1700692080,1700701860,9780,45406,120760,IT,IT
159610,1698859920,1698893040,33120,32038,29766,TR,TR
33036,1700341500,1700355540,14040,111519,81719,US,US
13761,1699529400,1699562460,33060,128576,178970,TR,TR
95160,1699017540,1699031820,14280,40100,39627,IT,IT
155954,1699629060,1699633740,4680,125074,16482,GB,GB
117427,1700426280,1700458860,32580,11013,5042,TR,TR
88822,1700746560,1700750160,3600,178751,158767,GB,GB
84407,1700335680,1700352840,17160,126907,162189,CZ,DE
20339,1699131480,1699168980,37500,135542,3374,MX,MX
169259,1699863960,1699872780,8820,53273,146683,IT,IT
78106,1699320840,1699328400,7560,94853,66992,PT,PT
104857,1699977840,1699991880,14040,154578,140162,IT,IT
23632,1699832280,1699865160,32880,17850,11444,TR,TR
167587,1698999720,1699014180,14460,104559,160605,US,US
107797,1700570040,1700582040,12000,125010,44069,US,US
76434,1699427940,1699461180,33240,147243,136393,TR,TR
104316,1700001960,1700034180,32220,146959,186136,TR,TR
110884,1699362540,1699391940,29400,81428,135927,TR,TR
43005,1699222140,1699239120,16980,20209,154925,US,US
50792,1699642140,1699656420,14280,103902,123693,CZ,DE
55639,1700567280,1700580600,13320,55230,11671,US,US
116894,1698831960,1698839700,7740,170215,185324,IT,IT
49405,1699316400,1699352100,35700,199242,10035,TR,TR
185355,1700653800,1700682900,29100,95096,174422,TR,TR
20973,1700339640,1700373000,33360,134085,134577,TR,TR
98247,1700444820,1700480700,35880,151803,83380,TR,TR
141790,1699236480,1699249800,13320,86811,48553,HR,HR
199180,1699992300,1699998780,6480,79225,16382,GB,GB
78251,1700683140,1700715720,32580,60269,60018,TR,TR
87367,1699805820,1699815660,9840,110114,116131,ES,FR
151897,1699209600,1699238880,29280,121339,184058,TR,TR
9687,1699209960,1699241040,31080,50262,60932,TR,TR
5053,1698907620,1698940560,32940,147533,22962,TR,TR
141224,1699509840,1699545180,35340,85671,151512,TR,TR
137366,1699423080,1699448820,25740,16826,173772,DE,ES
177810,1699045560,1699054080,8520,190849,39807,HR,HR
198517,1699539420,1699557180,17760,199501,188727,US,US
56901,1700800980,1700823060,22080,143972,85627,DE,DE
151549,1700053620,1700072400,18780,67874,165216,DK,DK
182881,1700115540,1700145000,29460,123973,107039,TR,TR
171116,1699482480,1699511340,28860,43536,47232,TR,TR
51315,1698949980,1698980220,30240,58555,76567,TR,TR
131131,1699645560,1699649700,4140,194098,47071,NL,NL
137125,1699946040,1699951860,5820,189044,32398,GB,GB
89154,1700209260,1700239320,30060,32050,106003,TR,TR
65088,1700105760,1700110080,4320,194754,199294,GB,GB
175877,1700684820,1700701560,16740,169257,60519,US,US
193379,1699900440,1699932540,32100,37530,51550,TR,TR
62862,1700482380,1700508960,26580,44010,27322,DE,DE
129811,1699857780,1699891080,33300,35088,8700,TR,TR
27890,1699017360,1699030380,13020,32654,46847,AT,AT
50061,1700402940,1700418240,15300,66788,195875,US,US
77982,1700342640,1700353620,10980,145861,178517,US,CA
77458,1699164180,1699168140,3960,148815,192841,GB,GB
100700,1698992220,1699019040,26820,151801,23066,PL,DE
26255,1699826280,1699855080,28800,68730,187435,TR,TR
27404,1700717880,1700731980,14100,92427,66651,IT,IT
106390,1699655700,1699686060,30360,22045,57835,TR,TR
117926,1700762460,1700796120,33660,169447,119964,TR,TR
182051,1698938340,1698955920,17580,47981,78796,US,US
42667,1700520180,1700571720,51540,118513,65183,BG,BG
51282,1699306020,1699336680,30660,86844,190266,TR,TR
43604,1700631060,1700634660,3600,18505,47221,NL,NL
143047,1699836180,1699865640,29460,11596,86534,TR,TR
168669,1699517460,1699534980,17520,61250,74245,US,US
16780,1699144500,1699154280,9780,162481,147395,HR,HR
149247,1700526060,1700562300,36240,58252,140183,MX,MX
161048,1700279460,1700295300,15840,82309,123748,US,US
83905,1700185560,1700197200,11640,43835,163235,PT,PT
198960,1699481880,1699494420,12540,164510,98521,US,US
23900,1699870680,1699905840,35160,40584,89763,MX,MX
10007,1699330200,1699347000,16800,177838,82326,US,US
89557,1700285520,1700316180,30660,132433,150571,TR,TR
55184,1700518320,1700553540,35220,124500,108372,TR,TR
1314,1699846500,1699879260,32760,87150,141225,TR,TR
192095,1699774200,1699777800,3600,137276,67991,NL,NL
119941,1699917480,1699950720,33240,17226,16961,TR,TR
127330,1700534100,1700537700,3600,8285,104931,NL,NL
41634,1699785600,1699789200,3600,32757,107544,GB,GB
33653,1700444940,1700469780,24840,46101,102331,PL,PL
25153,1699758960,1699792920,33960,55770,184952,TR,TR
61557,1700062800,1700068080,5280,67297,115572,GB,GB
175475,1699780740,1699788600,7860,121338,107542,IT,IT
92792,1700002200,1700035740,33540,160804,8236,TR,TR
123546,1699263240,1699293900,30660,111204,141124,TR,TR
86417,1700154420,1700169540,15120,100231,52411,AT,AT
154530,1700522160,1700525760,3600,8717,196426,GB,GB
109279,1700031660,1700040720,9060,20813,13148,IT,IT
101480,1699178160,1699189380,11220,28266,113123,PT,PT
179229,1700094060,1700119680,25620,54822,176520,BA,DE
98181,1699197720,1699233600,35880,3135,52299,TR,TR
10248,1699366320,1699401060,34740,111511,73728,TR,TR
32965,1699912560,1699947000,34440,129124,58720,TR,TR
173606,1700075820,1700099940,24120,177523,50822,DE,FR
67665,1699755120,1699790280,35160,109108,57061,TR,TR
100544,1700767500,1700801160,33660,150950,75267,TR,TR
59431,1698869220,1698899160,29940,32530,78329,TR,TR
184842,1699834920,1699848540,13620,91679,63555,IT,IT
192834,1698815880,1698830880,15000,198,17284,FR,DE
134832,1700240880,1700276820,35940,144930,187850,TR,TR
179761,1699643880,1699648020,4140,193526,67399,NL,NL
54260,1699923120,1699937340,14220,79692,93636,PT,PT
152612,1699348020,1699377120,29100,1750,127365,TR,TR
130458,1700706540,1700739060,32520,152733,122132,TR,TR
182045,1700366340,1700377380,11040,154078,136879,US,US
92888,1699015860,1699051500,35640,23904,56990,TR,TR
122764,1700464800,1700486760,21960,133883,177637,BR,BR
47976,1700822460,1700826060,3600,76020,146614,NL,NL
20610,1700700180,1700733900,33720,152658,3584,MX,US
107098,1700557800,1700563440,5640,25989,20446,NL,NL
20696,1699420620,1699433400,12780,75280,65126,US,US
117058,1699245960,1699275960,30000,95134,92537,TR,TR
115972,1700118720,1700126220,7500,39462,28757,HR,HR
113411,1699961100,1699991760,30660,698,16165,TR,TR
147193,1700603100,1700610240,7140,55775,71684,GB,GB
160261,1700440020,1700474220,34200,24528,149,TR,TR
113661,1700130900,1700161380,30480,8895,56995,TR,TR
53585,1698878160,1698901560,23400,99904,98876,DE,LT
124009,1699133340,1699144620,11280,39097,81500,US,US
12195,1700030280,1700036820,6540,26873,1854,EE,EE
5269,1700018760,1700022360,3600,24342,118507,GB,GB
15687,1699482360,1699512780,30420,121504,69182,TR,TR
135902,1699181640,1699213860,32220,25721,96372,TR,TR
98083,1700492880,1700497200,4320,16450,187034,GB,GB
184874,1698846180,1698851520,5340,109728,174187,GB,GB
8764,1699118040,1699133520,15480,43548,74606,US,US
180973,1700639940,1700675340,35400,100379,7022,TR,TR
8026,1700670840,1700690460,19620,32786,150011,FR,FR
16696,1699140060,1699151640,11580,145961,89835,US,MX
39145,1699917600,1699952460,34860,17847,32179,TR,TR
179625,1699630020,1699633620,3600,9609,176367,NL,NL
95797,1700478900,1700507820,28920,1670,126143,TR,TR
82309,1699905900,1699918560,12660,44266,8080,RS,RS
95830,1700051520,1700055120,3600,129557,95421,NL,NL
125897,1700061480,1700093040,31560,106775,174741,TR,TR
73318,1699219380,1699229880,10500,72896,34306,IT,IT
19661,1698887580,1698909300,21720,158259,41803,RO,RO
23005,1700573880,1700603160,29280,157202,35811,TR,TR
53187,1699190940,1699206780,15840,108918,2146,US,US
82286,1698963720,1698975840,12120,173582,70386,US,US
196136,1699488060,1699494840,6780,91443,115366,FI,EE
41820,1700829300,1700832900,3600,59187,37673,GB,GB
124341,1700612040,1700641440,29400,183291,90133,TR,TR
197482,1700410320,1700441400,31080,93017,47077,TR,TR
7468,1698919440,1698952740,33300,52046,147412,TR,TR
165742,1698958320,1698990540,32220,141788,82373,TR,TR
195421,1700113740,1700124780,11040,188280,53049,HR,HR
124060,1699458960,1699474020,15060,145508,154325,US,US
74531,1699549380,1699586940,37560,175577,4372,MX,MX
3114,1700673000,1700689020,16020,87855,148142,US,US
174829,1700220180,1700235240,15060,183851,161891,US,US
161923,1700411460,1700444280,32820,73356,196306,TR,TR
135754,1700425440,1700460720,35280,176726,148691,TR,TR
27844,1700429220,1700442240,13020,24411,132543,IT,IT
43083,1699837620,1699871880,34260,1079,31634,TR,TR
114227,1698855840,1698887580,31740,78458,131121,TR,TR
55235,1699637520,1699672980,35460,198534,146381,TR,TR
82522,1698852300,1698875520,23220,124776,1955,DE,DE
47367,1699025340,1699029600,4260,72590,49199,GB,GB
81832,1699146900,1699163340,16440,120135,72308,US,US
133012,1699136340,1699168080,31740,15927,137792,TR,TR
21536,1699216980,1699250760,33780,57167,56369,TR,TR
143669,1699292160,1699309500,17340,99037,16893,US,US
34962,1700556240,1700559840,3600,97439,40132,NL,NL
74284,1699186140,1699222140,36000,155715,29558,MX,MX
34693,1700801100,1700831400,30300,46960,124949,TR,TR
129477,1699509660,1699513260,3600,153069,45586,GB,NL
96455,1699261800,1699272120,10320,78451,93541,IT,IT
11657,1699578780,1699586100,7320,173984,114480,AD,ES
14512,1698918900,1698953820,34920,141785,82737,TR,TR
103703,1698929220,1698958380,29160,29764,90005,TR,TR
159734,1698906120,1698935520,29400,121463,61739,TR,TR
175780,1699118520,1699152480,33960,129632,136001,TR,TR
152078,1700782320,1700789040,6720,197393,93071,NL,NL
58008,1700502780,1700511540,8760,118970,126308,IT,IT
34914,1699014420,1699020060,5640,6910,143049,GB,GB
190316,1699435320,1699441920,6600,158713,34078,NL,NL
101427,1700390280,1700415660,25380,2212,159682,PL,CZ
12654,1699329480,1699335120,5640,93336,27600,NL,NL
160856,1699681020,1699693620,12600,106821,146901,HR,HR
154986,1700423580,1700435400,11820,49727,135087,IT,IT
182744,1700845500,1700858580,13080,6065,16209,SK,PL
131632,1700287320,1700325660,38340,108991,60423,MX,MX
197299,1699560720,1699586340,25620,180116,11943,PL,PL
61962,1700319420,1700323020,3600,51087,141940,NL,NL
71368,1699021920,1699031940,10020,175773,190302,IT,IT
85437,1699524660,1699531080,6420,106048,35161,GB,GB
23182,1698847500,1698878820,31320,110787,182543,TR,TR
155314,1700186820,1700203440,16620,56211,71849,FR,ES
147972,1699303320,1699313520,10200,120731,95042,IT,IT
120103,1699950420,1699973460,23040,110822,164695,BR,BR
147971,1699896120,1699905120,9000,183978,152291,IT,IT
144792,1699418280,1699434660,16380,53293,147131,AT,SK
1441,1698960840,1698969780,8940,122917,120636,IT,IT
121570,1698832920,1698862440,29520,40475,49805,TR,TR
131695,1700657040,1700690880,33840,183729,9317,TR,TR
73687,1700178600,1700193480,14880,29906,132565,US,MX
29322,1699039020,1699042620,3600,68095,157168,GB,GB
105809,1700680920,1700685780,4860,125136,126177,NL,DE
118077,1700505540,1700539800,34260,82247,98156,TR,TR
55812,1700277060,1700311740,34680,95337,126887,TR,TR
182538,1700813520,1700826960,13440,143592,90469,ES,ES
118546,1699539660,1699543800,4140,158354,50878,NL,NL
166297,1700485680,1700514420,28740,166495,115300,DE,DE
34409,1700497680,1700527560,29880,48678,77324,TR,TR
197698,1699636020,1699639620,3600,79095,32757,GB,GB
68839,1700530800,1700565300,34500,163305,120020,TR,TR
60796,1699211460,1699244880,33420,29898,77352,TR,TR
24814,1699847100,1699860960,13860,171774,121818,HR,HR
63457,1699143600,1699155780,12180,142638,159395,HR,HR
64217,1699436760,1699445160,8400,188665,52174,IT,IT
132988,1699204680,1699219260,14580,156274,99885,FR,FR
69494,1700638200,1700673600,35400,4491,176427,TR,TR
84447,1699384080,1699415700,31620,111104,73623,TR,TR
54578,1700338080,1700368260,30180,152519,57581,TR,TR
190235,1699247520,1699258020,10500,191692,107257,IT,IT
199186,1700081640,1700116020,34380,5162,140827,TR,TR
42359,1698978180,1698986040,7860,17370,90173,EE,EE
197570,1700719320,1700729700,10380,78837,108375,PT,PT
88598,1699035900,1699043280,7380,169521,161976,SK,SK
108282,1699371240,1699397880,26640,144093,186416,BA,RS
165772,1698915000,1698927840,12840,99674,145270,US,US
181949,1700018940,1700054280,35340,194774,92609,TR,TR
180499,1699596600,1699631400,34800,170825,107933,TR,TR
93500,1700725920,1700730420,4500,61447,68413,NL,NL
170879,1698942480,1698953520,11040,199363,162147,US,US
189792,1699316520,1699325280,8760,15001,77401,PT,PT
106104,1700014920,1700031180,16260,109002,144739,CZ,CZ
142496,1700522820,1700539800,16980,32908,149795,US,US
134315,1700544660,1700565660,21000,147225,197240,DK,DK
120013,1700737680,1700767980,30300,103025,169879,TR,TR
47184,1698871380,1698882060,10680,188403,160154,IT,IT
604,1700387040,1700401140,14100,50729,69644,IT,IT
49985,1700217540,1700246760,29220,116916,41958,TR,TR
54517,1699218720,1699241400,22680,197512,148886,BR,BR
80902,1699254060,1699265340,11280,29220,26573,SK,IT
75116,1699609620,1699622640,13020,146754,53411,US,US
86363,1699409760,1699444200,34440,187137,67703,TR,TR
114570,1700617560,1700648880,31320,18367,47924,TR,TR
185907,1699419360,1699451040,31680,168245,42124,TR,TR
29315,1700739780,1700743380,3600,58216,94276,NL,NL
197465,1700061540,1700097360,35820,196088,123426,TR,TR
6360,1698942420,1698976560,34140,193607,67078,TR,TR
199993,1699892400,1699898220,5820,73350,24142,GB,GB
90248,1700578260,1700586360,8100,155703,38,IT,IT
36725,1699242780,1699255380,12600,194537,174960,ES,ES
190734,1700763540,1700797920,34380,81525,151770,TR,TR
87945,1699585080,1699618380,33300,175996,3303,MX,MX
95253,1699333380,1699336980,3600,76024,140126,GB,GB
160513,1699382760,1699386360,3600,49237,165081,GB,GB
29452,1700557440,1700562540,5100,130471,81729,NL,NL
77167,1700246760,1700261640,14880,135401,55038,FR,IT
112832,1700863980,1700899560,35580,156578,7637,TR,TR
143888,1700094960,1700125860,30900,34687,107140,TR,TR
189458,1699379460,1699395960,16500,173112,65938,US,US
70537,1700649780,1700666880,17100,158964,29348,AT,AT
76817,1698977160,1699008240,31080,105376,132109,TR,TR
33627,1700663760,1700692740,28980,151370,16312,TR,TR
71065,1700371920,1700383680,11760,43743,58461,US,US
166121,1698887640,1698895440,7800,153386,38809,IT,IT
123885,1699656660,1699664040,7380,179791,194218,HR,HR
119568,1700598720,1700602320,3600,187469,95133,NL,NL
6722,1699519860,1699543560,23700,127150,3984,DE,BA
197358,1699857600,1699880700,23100,133476,140431,DE,IT
64451,1699105020,1699126740,21720,158531,63703,SI,PL
42835,1700629680,1700664840,35160,49917,70126,TR,TR
141594,1699375260,1699398660,23400,157669,61889,PL,RO
167300,1699492680,1699526880,34200,99681,39783,TR,TR
39040,1700793840,1700821860,28020,84466,56139,PL,UA
69316,1699600800,1699608960,8160,170112,86974,IT,IT
147472,1699677120,1699682340,5220,39252,108720,GB,GB
160916,1700240340,1700249280,8940,158280,49163,IT,IT
39218,1700489580,1700496300,6720,84643,1073,GB,GB
86730,1699966680,1699976100,9420,91961,38424,PT,PT
77793,1699687260,1699709880,22620,176411,104566,DE,AT
26483,1700022240,1700041800,19560,100975,25641,FR,IT
136442,1699709400,1699726680,17280,87507,91018,US,US
185222,1700835360,1700866620,31260,10088,133068,TR,TR
65880,1699184640,1699192920,8280,138277,28645,PT,PT
59127,1700193900,1700223120,29220,20027,31540,TR,TR
191511,1700831100,1700856240,25140,79358,179023,BR,BR
68212,1699461000,1699472400,11400,113668,13588,US,US
70006,1700403900,1700435520,31620,119268,116545,TR,TR
4712,1698981720,1699013820,32100,53345,19200,TR,TR
151443,1699402680,1699413840,11160,195760,58309,IT,IT
97821,1699643520,1699679100,35580,123241,3743,TR,TR
66231,1700069940,1700103600,33660,73024,185778,TR,TR
111370,1699606500,1699610160,3660,88196,171037,GB,GB
26507,1700190300,1700220120,29820,63657,78737,TR,TR
59918,1699556760,1699574340,17580,197141,125309,US,US
192229,1699822140,1699851900,29760,113265,80406,TR,TR
107220,1699742580,1699774920,32340,198730,13726,TR,TR
190261,1700329740,1700358960,29220,102868,29710,TR,TR
3912,1699746060,1699780920,34860,167318,47003,TR,TR
16614,1700039160,1700054820,15660,4296,65362,FR,FR
25559,1700547840,1700574240,26400,137438,59863,DE,LT
154369,1699528020,1699560480,32460,92650,52536,TR,TR
3517,1700352720,1700358060,5340,134609,95810,NL,NL
78164,1699399080,1699410720,11640,93141,152888,US,US
38535,1700568840,1700592720,23880,38364,139852,PL,PL
88252,1699389540,1699393140,3600,120645,131880,GB,GB
171430,1699936800,1699952940,16140,108801,95783,US,US
181456,1698906720,1698916320,9600,124222,182070,IT,IT
112187,1699384380,1699415400,31020,180341,18337,TR,TR
51205,1700468040,1700483340,15300,82283,43881,FR,FR
14031,1700049600,1700077920,28320,104758,11481,BA,HR
113296,1700162220,1700193600,31380,74387,84063,TR,TR
126563,1700649060,1700683200,34140,48460,84747,TR,TR
160850,1700787240,1700807640,20400,180749,103763,FR,ES
10792,1698962880,1698976560,13680,148720,155021,IT,IT
122266,1700124900,1700155260,30360,49849,39968,TR,TR
161184,1699762380,1699773720,11340,28373,157988,IT,IT
172099,1699587180,1699621080,33900,89496,160153,TR,TR
177249,1699323420,1699338060,14640,72108,173345,FR,FR
148497,1699666080,1699699800,33720,62087,19593,TR,TR
192270,1698926160,1698935700,9540,192194,176322,IT,IT
133049,1700520480,1700556000,35520,184862,38313,TR,TR
191105,1700549100,1700560020,10920,169726,72384,IT,IT
4729,1699056180,1699067460,11280,100904,71672,SK,SK
199526,1700107200,1700128860,21660,67529,17836,HU,AT
184637,1699638720,1699665480,26760,129112,143199,DE,DE
151245,1700684520,1700720280,35760,120964,171871,TR,TR
53206,1699716780,1699730820,14040,78385,98903,IT,IT
179727,1699639320,1699642920,3600,127408,186893,NL,NL
172046,1698807120,1698861600,54480,22360,191830,BG,TR
25860,1699384440,1699390140,5700,13335,105450,GB,GB
99365,1699273380,1699284360,10980,17685,80318,US,US
84731,1699284240,1699301040,16800,5114,119533,US,US
98944,1699049160,1699056120,6960,171770,40446,NL,BE
137372,1699815000,1699818600,3600,154114,54236,GB,GB
153260,1698874020,1698899040,25020,106567,178812,DE,AT
44955,1699264440,1699290060,25620,155688,174483,DE,PL
96349,1700242860,1700277780,34920,24860,100460,MX,MX
12566,1698979500,1698995040,15540,196047,72330,AT,CZ
148360,1699178160,1699211340,33180,90189,22351,TR,TR
80890,1699449180,1699463100,13920,1220,61207,US,US
60770,1699901220,1699924200,22980,108474,143137,DE,DE
44620,1699990800,1700021280,30480,17779,115009,TR,TR
62391,1700727600,1700741460,13860,175148,154258,ES,ES
69753,1700251380,1700284920,33540,80830,143326,TR,TR
142852,1699243920,1699264920,21000,38008,179478,FR,ES
24283,1700033040,1700063460,30420,511,51172,TR,TR
183245,1700398560,1700412540,13980,10292,44956,US,US
49370,1699534140,1699543680,9540,3984,14698,IT,IT
67113,1699843320,1699847640,4320,197219,11790,GB,GB
128024,1699393980,1699428660,34680,85079,107472,TR,TR
147877,1698994260,1699016460,22200,187057,139770,BR,BR
43686,1699245480,1699256280,10800,179001,198912,IT,IT
45313,1698930900,1698960600,29700,165145,159794,TR,TR
149271,1698871860,1698905340,33480,26206,26676,TR,TR
30066,1699086600,1699100340,13740,90897,99520,IT,IT
77815,1700000640,1700012400,11760,94159,106161,US,US
139606,1698913080,1698922980,9900,43988,87386,IT,HU
144339,1699831980,1699836540,4560,182572,3648,GB,GB
30347,1700154000,1700157600,3600,95011,51532,NL,NL
26320,1699767060,1699789680,22620,24134,161994,DE,RS
51523,1699093140,1699097760,4620,155751,149779,GB,GB
185926,1699028340,1699057440,29100,73194,57766,TR,TR
117004,1700719980,1700748480,28500,87607,51052,DE,CZ
67146,1699765380,1699785480,20100,4245,22742,FR,ES
99279,1700733840,1700763060,29220,8463,182456,TR,TR
172671,1700422740,1700433480,10740,78191,135367,PT,PT
175737,1699040280,1699043880,3600,98772,92853,GB,GB
105598,1700854260,1700868900,14640,2788,40383,US,US
67570,1700705820,1700726580,20760,185045,42228,FR,FR
117990,1699964160,1699998120,33960,110815,142895,TR,TR
173323,1699114200,1699148700,34500,31721,36973,TR,TR
23278,1699639560,1699655280,15720,62417,3464,FR,BE
80086,1700535840,1700568660,32820,141290,128612,MX,MX
25798,1700694780,1700730360,35580,103273,21179,TR,TR
121280,1699234620,1699261560,26940,167048,143516,DE,PL
192629,1699307580,1699336680,29100,92930,164491,TR,TR
178843,1700816280,1700827200,10920,70959,179323,IT,IT
189939,1699192620,1699208280,15660,197457,196417,FR,FR
90289,1699178040,1699192200,14160,135802,97275,RS,FR
188213,1700171160,1700179200,8040,19049,157846,PT,PT
50541,1700392440,1700415840,23400,54153,195969,PL,PL
114754,1700292900,1700324460,31560,14976,31993,TR,TR
129254,1700621220,1700654640,33420,42491,191270,TR,TR
124775,1699813080,1699848660,35580,118486,173679,TR,TR
50761,1699203480,1699220220,16740,86357,12422,US,US
72526,1700677500,1700711640,34140,93285,182577,TR,TR
4518,1700043840,1700076060,32220,150551,85648,TR,TR
17399,1699092660,1699119420,26760,110234,34758,DE,FR
130662,1698910680,1698926160,15480,22163,1842,CZ,FR
164663,1700771820,1700794620,22800,2465,91445,DE,DE
62901,1700208240,1700242860,34620,140954,84774,TR,TR
75812,1699952940,1699987200,34260,153231,88585,TR,TR
19480,1699601580,1699630560,28980,125493,106953,TR,TR
168391,1700430000,1700460120,30120,2441,124241,MK,BG
151776,1700374860,1700378460,3600,128208,122858,GB,GB
103945,1700611200,1700632980,21780,188635,50684,DE,HR
87472,1698955560,1698991320,35760,125849,182435,TR,TR
143070,1699966260,1700004060,37800,196866,17335,MX,MX
72490,1699324320,1699340640,16320,38524,156560,RS,IT
175304,1699085520,1699097040,11520,121509,195096,US,US
125217,1700161800,1700165400,3600,124850,116759,NL,NL
22033,1700466300,1700499060,32760,165890,116631,TR,TR
98704,1699584840,1699588440,3600,24273,30158,GB,GB
87438,1698904860,1698943980,39120,155577,171002,MX,MX
74278,1700074020,1700091180,17160,136684,2309,CZ,HR
102290,1699864980,1699897560,32580,29674,24575,TR,TR
6865,1700264820,1700275620,10800,25067,12153,IT,IT
1950,1700523180,1700553300,30120,45512,39000,TR,TR
197738,1700650380,1700659320,8940,96457,18137,PT,ES
67371,1699533000,1699559400,26400,41208,125078,DE,PL
71473,1700431680,1700438760,7080,35621,94487,GB,GB
1915,1700144280,1700160240,15960,163353,108467,US,US
44812,1700707860,1700740620,32760,33243,73996,TR,TR
98606,1700735760,1700746560,10800,142785,49409,IT,IT
183993,1699090800,1699099860,9060,190022,169296,IT,IT
168467,1699459080,1699463460,4380,154163,10277,NL,NL
176911,1700022420,1700031900,9480,183663,3378,PT,PT
103449,1698915000,1698918600,3600,25164,88372,GB,GB
33101,1699466940,1699475220,8280,169017,53566,ES,ES
20866,1700548140,1700564580,16440,72844,127373,AT,DE
187089,1699690080,1699722000,31920,99081,127419,TR,TR
131203,1699872360,1699879620,7260,90956,142546,IT,IT
167222,1699405140,1699418460,13320,102537,8593,US,CA
124952,1699690200,1699722420,32220,90142,173380,TR,TR
152689,1700634180,1700667960,33780,12656,53483,TR,TR
43088,1700214300,1700237280,22980,90485,29795,ME,RS
152595,1699533180,1699540620,7440,72492,108692,IT,IT
70893,1700844480,1700876460,31980,117825,80647,TR,TR
150742,1699425000,1699460700,35700,342,44131,TR,TR
196232,1699952280,1699970340,18060,16152,162401,FR,FR
50769,1699524780,1699542420,17640,84912,171362,US,US
43155,1699231260,1699243620,12360,100365,137122,PT,PT
160069,1700101800,1700110260,8460,111922,74641,IT,IT
168183,1699265580,1699272000,6420,6881,191280,NL,NL
193406,1700498340,1700506200,7860,81798,39349,PT,PT
148180,1699404780,1699435380,30600,139820,123360,TR,TR
39566,1700338320,1700346060,7740,34478,157646,IT,IT
62529,1700814120,1700845140,31020,49205,104275,TR,TR
164101,1698919080,1698932760,13680,52809,117969,CZ,CZ
100398,1699553640,1699578300,24660,108651,169485,PL,PL
38670,1700374380,1700400480,26100,198568,1291,DE,DE
150556,1700859180,1700872320,13140,188265,193146,US,US
51542,1699696800,1699730160,33360,198348,187965,MX,US
190489,1700643600,1700675760,32160,59983,70466,TR,TR
84829,1699409460,1699413060,3600,146711,79184,GB,GB
129291,1699490460,1699504800,14340,170284,24841,US,US
54083,1698905100,1698916620,11520,30300,89326,US,US
115434,1700748480,1700752080,3600,34429,72020,GB,GB
182489,1699126500,1699156920,30420,160184,83572,TR,TR
179283,1700179680,1700193360,13680,162253,44830,IT,IT
4120,1700718960,1700722860,3900,174123,44526,NL,NL
79589,1698808860,1698822240,13380,21399,68988,US,US
35142,1698914580,1698944400,29820,24407,120279,TR,TR
9093,1699425120,1699445640,20520,76876,199648,IN,IN
159958,1700526300,1700533680,7380,173536,23605,IT,IT
146494,1699360500,1699376220,15720,709,133934,CZ,CZ
109296,1700470740,1700505420,34680,186421,154762,TR,TR
141976,1698979860,1699011960,32100,2127,94179,TR,TR
193408,1700444520,1700461080,16560,92387,142017,AT,AT
199968,1698880560,1698915360,34800,63656,148836,TR,TR
17841,1700246580,1700260200,13620,51756,82571,AT,AT
43967,1699526940,1699535580,8640,165737,169841,IT,IT
140475,1699350120,1699359600,9480,50610,181659,HR,HR
93896,1700724360,1700757900,33540,158968,58094,TR,TR
126754,1699171560,1699187100,15540,192142,181773,AT,SK
174301,1699999920,1700003520,3600,94012,32494,GB,GB
52958,1700321820,1700327400,5580,198793,169700,GB,GB
22326,1700422980,1700426580,3600,48923,43586,NL,DE
167724,1698954780,1698958380,3600,93123,3570,NL,NL
103957,1699489620,1699493220,3600,179079,152479,GB,GB
26560,1699790460,1699801500,11040,191335,54509,HR,HR
48084,1699996980,1700001840,4860,55019,156716,GB,GB
150921,1700441400,1700447520,6120,40416,52335,GB,GB
25334,1699645020,1699675380,30360,40280,67000,TR,TR
90672,1699395840,1699405620,9780,159781,192472,ES,ES
176896,1700029500,1700047080,17580,115157,7971,RS,BA
9886,1700712960,1700741880,28920,199985,2641,TR,TR
87976,1700572980,1700608800,35820,77328,136980,TR,TR
54243,1700257380,1700289840,32460,130397,125532,TR,TR
187299,1700517960,1700548740,30780,9265,89901,TR,TR
34400,1699636440,1699669140,32700,124019,40400,TR,TR
93947,1699738500,1699771860,33360,144867,5075,TR,TR
139214,1699296720,1699308960,12240,183167,34253,SK,SK
92332,1699660860,1699677900,17040,60665,1188,US,US
196926,1698965340,1698994320,28980,195558,182128,TR,TR
99346,1699958340,1699992840,34500,177232,2182,TR,TR
58513,1700825940,1700833020,7080,161704,33088,EE,FI
103410,1699967100,1699975440,8340,158419,127956,IT,IT
103143,1699343640,1699376100,32460,170747,169827,TR,TR
165016,1698964500,1698993720,29220,28118,23599,TR,TR
174821,1700640600,1700657340,16740,83592,40488,US,US
194499,1698851040,1698879420,28380,158268,53353,PL,CZ
143642,1699067880,1699100220,32340,4276,180419,TR,TR
193350,1699445580,1699476360,30780,139250,119643,TR,TR
73799,1699974180,1700002320,28140,187380,188570,CH,DE
48574,1699867500,1699884360,16860,87894,181772,US,MX
96228,1699278300,1699282320,4020,117455,29061,NL,BE
103053,1700208900,1700222340,13440,152037,109805,IT,IT
42384,1700085960,1700101560,15600,128097,13691,US,US
33267,1699626420,1699638300,11880,109659,113237,IT,IT
160553,1699713240,1699744980,31740,101094,116045,TR,TR
154494,1699395480,1699401840,6360,158663,147464,GB,GB
10457,1700594520,1700601120,6600,194837,130338,NL,NL
108991,1699506180,1699525800,19620,12758,100646,IN,IN
74304,1700014980,1700045100,30120,160019,13960,TR,TR
51210,1700355000,1700384820,29820,95420,122129,TR,TR
136895,1698959760,1698967800,8040,63817,72178,IT,IT
78760,1700526960,1700558580,31620,16859,13568,TR,TR
29891,1699110420,1699122660,12240,69877,167552,US,US
11664,1699751880,1699763640,11760,166782,183182,US,US
59612,1700262360,1700270880,8520,113090,101364,HR,HR
146213,1700274180,1700307180,33000,8763,75940,TR,TR
94978,1698798060,1698827760,29700,159944,163496,TR,TR
11035,1699882920,1699918380,35460,129491,15810,MX,MX
73808,1698928500,1698959940,31440,82962,56100,TR,TR
180267,1698955260,1698990600,35340,195235,176394,TR,TR
45206,1699251540,1699255920,4380,33315,11208,NL,NL
194219,1699046160,1699058400,12240,170807,24100,IT,IT
58013,1699489980,1699501020,11040,37305,177768,IT,IT
156861,1700440020,1700473080,33060,72633,187264,TR,TR
86533,1699885260,1699894560,9300,47947,187765,IT,IT
66113,1699059060,1699064220,5160,131443,17752,GB,GB
170887,1700281080,1700314320,33240,116543,151083,TR,TR
9330,1700280480,1700313660,33180,158244,73164,TR,TR
113320,1700489400,1700508660,19260,124948,84022,FR,NL
162599,1700116440,1700130300,13860,4571,21482,SK,SK
175843,1698936480,1698969840,33360,60732,89216,TR,TR
23664,1699943160,1699974900,31740,197616,58465,TR,TR
152518,1700656980,1700662320,5340,29910,67520,GB,GB
178232,1699930440,1699963260,32820,116341,117493,TR,TR
22153,1699254600,1699268460,13860,97656,102666,AT,DE
144843,1698834900,1698863220,28320,45525,22591,DE,PL
5067,1698944580,1698976080,31500,34502,173488,TR,TR
179866,1699106100,1699132440,26340,159247,25128,PL,AT
190394,1700103840,1700135400,31560,89084,129285,TR,TR
144538,1700029800,1700042340,12540,177815,128610,US,US
174506,1700233080,1700244840,11760,190182,55596,US,US
151278,1700269260,1700289540,20280,160933,122978,FR,FR
67186,1700073000,1700105400,32400,130036,42263,TR,TR
80405,1700772840,1700790300,17460,129620,169839,US,US
6039,1698941580,1698948180,6600,104189,37206,NL,NL
50812,1699215180,1699247700,32520,91104,185143,TR,TR
25611,1699441140,1699467300,26160,11572,166738,HU,IT
97680,1699722900,1699744980,22080,50340,103065,DE,SE
102518,1700242020,1700253180,11160,155995,175395,IT,IT
73650,1699093500,1699124340,30840,86744,54414,TR,TR
114819,1699318380,1699351260,32880,137368,136891,TR,TR
57402,1699504080,1699515480,11400,103314,130386,ES,ES
107670,1699867500,1699896960,29460,199629,36128,TR,TR
27078,1699604340,1699631520,27180,163159,12942,ME,BA
135690,1699601040,1699633500,32460,145488,44765,TR,TR
171445,1700207700,1700242860,35160,132488,65715,TR,TR
63754,1699711740,1699726740,15000,64068,120403,CZ,CZ
119714,1700813280,1700825640,12360,101829,6285,IT,IT
34761,1700440260,1700477700,37440,36600,90735,MX,MX
179278,1699717500,1699722420,4920,190298,84570,GB,GB
163206,1699309860,1699340040,30180,140759,163908,TR,TR
21106,1699104960,1699140600,35640,147460,61459,TR,TR
74540,1700683440,1700718540,35100,98600,186218,TR,TR
22360,1698888240,1698895080,6840,36239,22458,GB,GB
16517,1698886200,1698912000,25800,122054,83333,DE,BG
132803,1699763940,1699768320,4380,128680,88938,GB,GB
163635,1698849780,1698880260,30480,87868,70595,TR,TR
81678,1700083440,1700106540,23100,51921,100079,RO,TR
48705,1698918960,1698953820,34860,80321,48363,TR,TR
8371,1698800280,1698803880,3600,174602,145637,NL,NL
95851,1699932000,1699943460,11460,130335,42422,US,US
12537,1698972360,1698998880,26520,81174,152085,DE,NL
187575,1698973860,1699000440,26580,27605,128965,RO,RO
62336,1699320360,1699333440,13080,90909,18952,US,US
161350,1700475000,1700485740,10740,58538,134239,IT,IT
109139,1699339440,1699347060,7620,14893,192509,ES,AD
177842,1700219520,1700250360,30840,141630,80952,TR,TR
156108,1699327080,1699334700,7620,151165,105669,IT,IT
167076,1699096800,1699130100,33300,169016,150485,TR,TR
69925,1698804120,1698810540,6420,19292,182328,NL,NL
174641,1699694160,1699726620,32460,91299,173278,TR,TR
38184,1700430960,1700464980,34020,66522,188319,TR,TR
118521,1700588220,1700601300,13080,77746,13111,IT,IT
118513,1699055280,1699067220,11940,172857,98196,IT,IT
52200,1699512360,1699545960,33600,166391,196217,TR,TR
106864,1699654620,1699685100,30480,104914,130024,BA,BA
76509,1699281600,1699311480,29880,60613,22101,TR,TR
191177,1699298820,1699315920,17100,114804,27168,US,US
5606,1700158020,1700161620,3600,180077,1768,NL,NL
59908,1699643700,1699675920,32220,63969,189410,TR,TR
173655,1700104680,1700116740,12060,66262,103173,US,US
152776,1698970380,1698989100,18720,20140,122261,LT,EE
59592,1700663700,1700692500,28800,192314,163499,TR,TR
66950,1699079760,1699089480,9720,97658,78634,IT,DE
103135,1700298300,1700310900,12600,125282,113641,IT,IT
185273,1699802640,1699826100,23460,29642,36538,RO,RO
139772,1699288140,1699322100,33960,60506,45100,TR,TR
91559,1700025600,1700059800,34200,135681,77321,TR,TR
160229,1700842020,1700877720,35700,44757,7659,TR,TR
126275,1699084320,1699115640,31320,98913,198209,TR,TR
8431,1699068360,1699100340,31980,137951,88034,TR,TR
113702,1700082900,1700114220,31320,78287,197488,TR,TR
135653,1700794080,1700824920,30840,105330,182367,TR,TR
159639,1699673160,1699707540,34380,48676,199291,TR,TR
69252,1700200860,1700204460,3600,23490,175442,NL,NL
106007,1699325160,1699360440,35280,154402,196092,TR,TR
167216,1698854100,1698866280,12180,88299,36123,US,US
186605,1699260240,1699292520,32280,176762,56900,TR,TR
193305,1699795920,1699813320,17400,184310,59856,US,US
55815,1699791120,1699794720,3600,16185,1256,GB,GB
140093,1699346880,1699358700,11820,125458,43342,IT,IT
172073,1700523960,1700539740,15780,140227,159767,US,US
141012,1700677740,1700708340,30600,115365,163416,TR,TR
63630,1700616240,1700645880,29640,130046,96500,TR,TR
10245,1699511460,1699516680,5220,157586,64687,GB,GB
18283,1699894500,1699901040,6540,52495,178680,GB,GB
175225,1699962840,1699995240,32400,105111,45192,TR,TR
43212,1698876300,1698879900,3600,47702,89194,GB,GB
34833,1700853420,1700870400,16980,956,131931,AT,AT
11412,1699726740,1699739340,12600,133187,88357,IT,IT
85645,1699583460,1699614600,31140,34624,14395,TR,TR
79147,1699328460,1699357680,29220,104781,55173,TR,TR
14220,1699509960,1699528920,18960,55801,6418,FR,NL
102923,1699218180,1699251240,33060,192401,197463,TR,TR
46403,1699419840,1699446720,26880,130391,152875,RO,ES
198283,1699124520,1699131660,7140,185645,134624,GB,GB
98966,1699523760,1699527360,3600,46207,141045,GB,GB
89121,1699680900,1699712340,31440,60052,74914,TR,TR
182400,1699043040,1699078980,35940,193520,14240,TR,TR
47949,1700552580,1700564100,11520,154891,63161,ES,ES
9111,1698819120,1698852300,33180,112897,46487,TR,TR
105822,1700434560,1700448480,13920,61155,89705,US,US
169638,1698879840,1698915360,35520,136116,43080,TR,TR
119035,1699391940,1699427280,35340,7556,133493,TR,TR
49638,1700217300,1700220900,3600,196045,95665,GB,GB
178732,1699250040,1699263060,13020,187126,77943,IT,IT
102696,1700633100,1700665200,32100,106624,189873,TR,TR
159351,1700863560,1700867160,3600,59081,20382,GB,GB
128766,1699653540,1699686780,33240,189723,171064,TR,TR
94453,1698962220,1698977100,14880,55319,49145,US,US
30336,1699778100,1699789920,11820,85714,1146,HR,HR
32404,1700438340,1700467320,28980,82747,177394,TR,TR
114181,1698849900,1698881220,31320,164924,73094,TR,TR
68291,1699635960,1699639560,3600,188212,31049,GB,GB
145823,1699785420,1699813620,28200,79918,107864,PL,PL
78119,1698821160,1698832140,10980,64355,173892,IT,IT
34332,1699467360,1699499640,32280,40311,113510,TR,TR
161644,1700366520,1700370120,3600,27102,77026,GB,GB
144781,1699788840,1699793760,4920,64541,160356,GB,GB
6023,1700063700,1700097060,33360,138953,139659,TR,TR
17355,1699618140,1699629000,10860,16218,82914,IT,IT
140217,1699843860,1699855380,11520,127416,89657,US,US
20088,1699632600,1699662120,29520,2623,91983,TR,TR
139954,1700526900,1700557320,30420,156877,184237,TR,TR
110894,1699282560,1699308120,25560,36904,173347,RO,MD
87556,1700327460,1700366460,39000,19700,79052,MX,MX
34361,1699729020,1699753440,24420,15199,105721,PL,PL
88646,1699495440,1699530120,34680,128558,180198,TR,TR
30586,1700083500,1700113320,29820,162662,89689,TR,TR
99827,1699391700,1699427520,35820,34951,118316,TR,TR
144837,1700635380,1700640840,5460,47321,126609,NL,NL
108716,1699790160,1699823760,33600,181061,80687,TR,TR
36047,1699773360,1699798380,25020,129104,68960,DE,AT
34891,1698863160,1698868200,5040,183545,13808,NL,NL
14622,1699866360,1699901460,35100,114240,35975,TR,TR
155807,1699638000,1699656060,18060,85104,83282,FR,FR
66236,1699486260,1699489860,3600,147200,128542,GB,GB
102382,1700453460,1700457060,3600,196280,12797,GB,GB
155101,1700457600,1700466900,9300,87775,99617,PT,PT
122045,1698852000,1698862980,10980,76891,75538,US,US
20441,1700824200,1700828280,4080,112078,44799,GB,GB
34030,1699073700,1699108200,34500,117595,26118,TR,TR
154819,1699165260,1699174500,9240,92456,185182,ES,ES
107418,1699626420,1699630020,3600,29261,62795,GB,GB
172988,1699757340,1699761060,3720,72807,76,GB,GB
190691,1699764180,1699794660,30480,131911,67064,TR,TR
190205,1700193420,1700229300,35880,179708,80071,TR,TR
197982,1700094660,1700100600,5940,34571,30388,GB,GB
1055,1699324320,1699329540,5220,128304,30908,GB,GB
35074,1699220340,1699248960,28620,14986,135152,BR,BR
80256,1699152720,1699185900,33180,68055,63580,TR,TR
31516,1699585320,1699602420,17100,190634,181379,US,US
156901,1698865680,1698899460,33780,56471,126090,MX,MX
34269,1699473420,1699488120,14700,127307,99366,US,US
57496,1700360280,1700393700,33420,94535,152267,TR,TR
22941,1699765500,1699781880,16380,117399,75528,RS,IT
104459,1699728780,1699737900,9120,160331,176505,IT,IT
199857,1699532040,1699548900,16860,68466,64769,US,US
129149,1699130640,1699134660,4020,169864,131364,GB,GB
183775,1700104440,1700117340,12900,8683,69172,PT,PT
129646,1698841500,1698853440,11940,62812,108860,US,US
133149,1698890160,1698922380,32220,87832,114749,TR,TR
110690,1699038960,1699046280,7320,100355,94659,IT,IT
64542,1699436340,1699442160,5820,134380,159637,NL,NL
14307,1699892100,1699895700,3600,46975,64617,GB,GB
132971,1699292940,1699315320,22380,66663,111266,BR,BR
196745,1700429220,1700441940,12720,114725,139574,US,US
159978,1699429980,1699434060,4080,134804,195179,NL,NL
167511,1699216740,1699223700,6960,113955,7278,GB,GB
15478,1700852700,1700857740,5040,92141,198306,GB,FR
44846,1699519860,1699538220,18360,124467,120986,FR,FR
138230,1700109000,1700121840,12840,149196,83045,ES,ES
12189,1700481900,1700495940,14040,24199,158819,RS,MK
196224,1699167600,1699197360,29760,27965,111507,TR,TR
43907,1699991760,1700018220,26460,102340,198205,PL,DE
1808,1699645800,1699657740,11940,61548,60066,US,MX
102003,1700649000,1700661060,12060,87714,148391,US,US
76204,1699502700,1699534560,31860,67880,120561,TR,TR
65268,1700430240,1700446140,15900,139140,36623,SE,NO
37861,1699721700,1699735920,14220,148094,164132,IT,IT
5836,1699638960,1699642560,3600,45181,29813,NL,NL
149676,1699490160,1699494900,4740,131572,140406,NL,NL
165921,1699075500,1699099740,24240,180799,71703,ME,BA
102988,1700237400,1700265540,28140,176359,47670,DE,HU
40737,1700581380,1700610720,29340,46262,117632,TR,TR
78991,1700121360,1700143800,22440,197600,24030,BR,BR
126729,1699657020,1699667880,10860,104207,63747,US,US
43007,1699630920,1699662300,31380,84864,153704,TR,TR
8419,1699777980,1699781580,3600,180209,24862,GB,GB
26931,1699551540,1699584960,33420,185020,110913,TR,TR
24777,1699253940,1699281240,27300,75667,35467,PL,CZ
40459,1699107660,1699113660,6000,96486,187788,GB,GB
31,1700129280,1700137200,7920,72099,49978,IT,IT
43926,1699930440,1699938000,7560,101897,111558,IT,IT
64257,1700750940,1700769060,18120,185063,9636,SE,DE
16446,1698832740,1698838980,6240,106069,182683,GB,GB
137112,1700807160,1700820180,13020,175468,162802,IT,IT
103619,1700728680,1700750760,22080,37601,1638,DE,DE
51488,1699411740,1699444800,33060,70150,107943,TR,TR
122082,1699194120,1699204260,10140,108082,101814,HR,HR
78577,1699874820,1699891440,16620,60465,82270,US,US
33045,1700379720,1700396280,16560,127742,120586,CZ,SK
22383,1698963420,1699019760,56340,38530,95920,BG,AT
62986,1699998180,1700023980,25800,158810,11992,BR,BR
101580,1699604820,1699631760,26940,81240,147183,DE,NL
134147,1698807660,1698811560,3900,107888,158189,NL,NL
179504,1699382340,1699411200,28860,2780,117282,TR,TR
102615,1700609820,1700625660,15840,197619,33454,RS,RS
117502,1699956000,1699963560,7560,173055,191401,IT,IT
171433,1698929520,1698960180,30660,30818,175222,TR,TR
41692,1699579560,1699585200,5640,38482,54982,NL,NL
11379,1700257980,1700287320,29340,175354,181538,TR,TR
81586,1700017500,1700049120,31620,127387,135405,TR,TR
96940,1700762400,1700789820,27420,165804,158748,DE,DE
17700,1698827160,1698858780,31620,175951,149683,TR,TR
178535,1699252740,1699268280,15540,25959,47149,CZ,CZ
114206,1699791480,1699807980,16500,27374,2556,US,US
86503,1699577340,1699606680,29340,199159,17499,TR,TR
140094,1699587300,1699590900,3600,176496,145678,GB,GB
830,1699085280,1699114140,28860,88355,122289,TR,TR
71538,1700272260,1700283240,10980,153460,51907,US,US
23413,1700169120,1700173620,4500,55100,12466,NL,NL
48019,1699211760,1699218120,6360,2566,51666,GB,GB
44565,1698856140,1698867480,11340,199752,134821,US,US
38487,1700045040,1700051760,6720,18979,174030,GB,GB
174632,1700113200,1700147400,34200,149739,64899,TR,TR
99949,1699446600,1699475820,29220,70214,175742,TR,TR
183918,1699699560,1699723440,23880,113047,39945,PL,PL
190004,1700715660,1700720580,4920,75920,165248,NL,FR
29734,1699196280,1699231560,35280,64766,53646,TR,TR
161362,1699995720,1700024580,28860,126355,161857,TR,TR
30542,1700001720,1700012460,10740,46561,168850,IT,FR
189698,1699249020,1699266420,17400,77306,133152,US,US
76332,1700430240,1700464740,34500,198251,182970,MX,MX
144166,1700060100,1700089200,29100,119091,100269,TR,TR
103958,1700012520,1700016120,3600,102041,104483,NL,NL
110370,1699621020,1699650720,29700,161862,113292,TR,TR
173108,1699286280,1699299420,13140,16272,64058,US,US
137147,1699771800,1699785660,13860,56452,57423,AT,DE
20220,1698884040,1698887640,3600,154495,106660,NL,FR
144407,1699761900,1699765620,3720,197999,146244,NL,NL
190709,1700661180,1700689500,28320,28999,148841,BA,DE
147086,1699404780,1699408440,3660,97024,38080,NL,BE
133833,1699920000,1699936860,16860,189594,180362,US,US
169741,1699206660,1699236960,30300,121032,101419,TR,TR
29589,1700308620,1700312220,3600,163290,10803,GB,GB
131500,1700209920,1700239620,29700,49415,119941,TR,TR
181704,1699024920,1699042860,17940,66540,89265,SE,SE
95898,1700100240,1700133480,33240,56154,83808,TR,TR
167143,1700290980,1700296800,5820,56898,61344,NL,NL
191308,1699063200,1699066800,3600,25378,128726,NL,NL
187947,1700679660,1700690820,11160,74169,72229,IT,IT
137923,1698883200,1698913500,30300,1067,125225,TR,TR
16147,1700107440,1700123160,15720,145985,44701,CZ,CZ
194021,1700150880,1700154480,3600,74721,92997,GB,GB
2566,1700572740,1700576340,3600,56024,66366,GB,GB
91650,1698991020,1699004880,13860,186536,128113,HR,HR
42956,1700623380,1700626980,3600,130121,155576,NL,FR
20576,1699871220,1699884000,12780,900,182244,IT,IT
194171,1700638380,1700649000,10620,33980,157429,IT,IT
188758,1700814300,1700826600,12300,61934,31814,SK,SK
145409,1699573140,1699607460,34320,77941,163526,TR,TR
84926,1700051520,1700061960,10440,160328,133025,PT,PT
49573,1699645260,1699676100,30840,195879,151552,TR,TR
86190,1699659600,1699683000,23400,161857,2454,DE,AT
82516,1699522320,1699551660,29340,85925,1433,TR,TR
19392,1700493600,1700525160,31560,165553,138907,TR,TR
63945,1699231020,1699246200,15180,23482,133744,US,US
166367,1700586840,1700620140,33300,125182,39927,TR,TR
64707,1698886620,1698910320,23700,35361,91375,DE,DE
50006,1700362140,1700392620,30480,76526,18301,TR,TR
108354,1699470480,1699501500,31020,170177,134478,TR,TR
27895,1700068800,1700072400,3600,141131,32712,GB,GB
177188,1699898520,1699911840,13320,4301,190363,US,US
11772,1700079000,1700091540,12540,144540,2515,IT,IT
53821,1699532820,1699540800,7980,30049,42388,HR,HR
79489,1700018940,1700031720,12780,190321,193827,SK,AT
194520,1698862440,1698877560,15120,207,165845,US,US
106068,1699107540,1699143240,35700,164017,107421,TR,TR
149019,1700049180,1700059800,10620,35913,164508,CL,CL
184045,1700629800,1700661480,31680,58938,89177,TR,TR
143887,1698960420,1698974640,14220,164712,21728,US,US
108887,1700113560,1700145960,32400,13155,77414,TR,TR
108216,1700289780,1700294640,4860,187250,157509,GB,GB
102549,1699032060,1699067160,35100,189967,14480,MX,MX
124476,1699063080,1699070340,7260,156223,148610,ES,FR
54525,1698988200,1698995880,7680,144242,2612,IT,IT
196855,1699672560,1699676400,3840,16098,136852,GB,GB
101697,1699368780,1699400640,31860,124491,72870,TR,TR
57647,1700116500,1700128260,11760,54937,101282,SK,SK
178233,1700448900,1700464800,15900,187959,76961,US,US
72665,1699375200,1699382280,7080,197568,52788,NL,NL
134101,1699399860,1699435080,35220,184533,56842,TR,TR
92121,1700155320,1700166300,10980,108751,140966,US,US
74541,1700451480,1700456880,5400,143639,30271,NL,NL
123894,1699702080,1699707300,5220,164505,171248,NL,NL
166046,1699929960,1699942320,12360,42341,124977,IT,IT
117235,1700838300,1700850660,12360,6273,50752,US,US
196400,1699650060,1699673760,23700,21078,38514,DE,RS
139134,1700753820,1700788620,34800,142362,54250,TR,TR
171997,1699242600,1699246980,4380,19663,174186,GB,GB
130888,1700304600,1700316660,12060,25396,114211,US,US
155806,1698897780,1698930120,32340,107572,3878,TR,TR
33330,1699110600,1699115400,4800,81904,104676,NL,NL
183199,1700032860,1700036460,3600,89261,63627,NL,NL
189797,1698819780,1698851340,31560,35864,63795,TR,TR
139083,1700259000,1700289600,30600,44658,193754,TR,TR
17731,1699844640,1699856160,11520,87093,50434,IT,IT
25369,1699487280,1699502340,15060,199350,41473,US,US
21436,1699440540,1699473240,32700,192397,161214,TR,TR
132432,1699680420,1699710240,29820,181732,28387,TR,TR
74635,1699809840,1699821840,12000,36430,86935,US,US
8014,1700636880,1700650380,13500,43618,35926,US,US
40992,1699915920,1699950900,34980,3367,189035,TR,TR
199206,1699645620,1699649400,3780,172447,42497,NL,NL
50615,1699477080,1699506120,29040,28744,85193,TR,TR
103169,1700786820,1700799840,13020,70937,161042,US,US
54694,1699539180,1699553280,14100,65552,169619,US,US
156030,1699300920,1699304520,3600,107538,199306,GB,GB
61470,1699357320,1699360980,3660,41094,80197,GB,GB
19683,1698886020,1698920100,34080,146396,2034,TR,TR
161779,1700540280,1700555220,14940,122864,20264,US,US
149267,1700141280,1700155440,14160,100958,105750,CZ,PL
130293,1700389560,1700395920,6360,152263,89211,GB,GB
106071,1698849000,1698864840,15840,146118,175133,FR,FR
172739,1699050540,1699062420,11880,144010,126745,US,US
161711,1699633800,1699641720,7920,65440,177166,HR,HR
42949,1699785480,1699796760,11280,146691,194158,CZ,CH
116804,1700057880,1700093340,35460,182369,102984,TR,TR
87139,1699362120,1699373280,11160,60529,172832,HR,HR
51565,1698897420,1698926760,29340,122301,119002,TR,TR
185970,1700637720,1700671740,34020,101850,19387,TR,TR
89311,1699521900,1699557540,35640,132885,164607,TR,TR
181894,1700200260,1700208120,7860,98749,30822,IT,IT
111007,1699698660,1699731060,32400,198959,126358,TR,TR
114287,1699226220,1699257480,31260,72110,197034,TR,TR
125432,1699843320,1699857660,14340,89168,92183,IT,IT
160694,1700472480,1700476080,3600,66278,181698,NL,NL
114955,1700393280,1700425920,32640,90583,60272,TR,TR
17685,1699621440,1699637820,16380,168957,34914,US,US
10657,1699751100,1699767300,16200,13050,97896,BE,NL
168688,1699346400,1699377540,31140,107210,111312,TR,TR
190802,1700630700,1700635140,4440,148808,175666,GB,GB
19917,1700600220,1700614980,14760,4822,118412,FR,ES
115112,1700454660,1700484840,30180,29514,184201,TR,TR
82555,1700765340,1700799900,34560,70939,193843,MX,MX
126003,1699256520,1699286220,29700,165813,36360,TR,TR
28457,1699085340,1699124040,38700,130182,97639,MX,MX
132995,1700681400,1700716380,34980,11498,183286,MX,MX
22039,1699657380,1699662900,5520,136815,179833,NL,NL
44192,1700715240,1700722020,6780,6436,35008,GB,GB
5460,1700017620,1700026860,9240,36379,36675,IT,IT
38896,1698931920,1698957360,25440,48083,8310,BA,RS
3222,1699025280,1699032060,6780,24511,192696,NL,NL
97956,1700084640,1700120400,35760,4321,109106,TR,TR
106814,1699984560,1700002440,17880,172687,103217,BE,NL
26153,1700646360,1700654580,8220,64611,47633,IT,IT
135468,1699813020,1699829340,16320,164441,163511,US,US
175411,1698968100,1698971700,3600,38471,167658,GB,GB
185603,1700062440,1700066400,3960,99734,184943,GB,GB
13040,1699826880,1699835880,9000,95369,18391,HR,HR
137872,1698961380,1698997200,35820,33855,13095,TR,TR
50592,1699590360,1699596360,6000,58990,55985,NL,NL
198446,1700148780,1700154360,5580,26242,61781,GB,GB
187139,1699981620,1699997160,15540,181412,191026,RS,RS
78400,1699487160,1699499580,12420,150389,174230,HR,HR
159630,1699900740,1699933560,32820,10288,22515,TR,TR
147119,1699816380,1699839060,22680,84632,137529,DE,DE
192492,1700228580,1700243100,14520,111007,190220,CZ,CZ
178840,1700611200,1700636940,25740,156907,36568,BR,BR
194375,1698863160,1698893040,29880,27025,1268,TR,TR
165253,1700189340,1700194140,4800,147738,13833,GB,GB
71013,1700304120,1700316660,12540,15447,165417,US,US
193892,1699010580,1699046220,35640,71855,174521,TR,TR
7311,1698901260,1698933540,32280,164856,72549,TR,TR
12461,1699085400,1699100760,15360,36451,71411,US,US
173746,1699317060,1699322460,5400,146083,46122,NL,NL
12198,1699715400,1699746840,31440,184483,187514,TR,TR
114398,1699981980,1699992060,10080,46811,3581,PT,PT
21727,1699425540,1699441680,16140,93242,173069,RS,RS
2332,1699408860,1699421940,13080,45769,122312,US,US
179557,1700055720,1700062500,6780,154306,131150,GB,GB
140335,1699917360,1699946760,29400,191399,11005,TR,TR
162233,1699556100,1699588800,32700,118127,99701,TR,TR
109808,1699621440,1699636260,14820,105460,45873,RS,RS
176099,1699521180,1699554420,33240,185064,189512,TR,TR
169407,1700337480,1700372580,35100,60552,129404,TR,TR
437,1700447640,1700479200,31560,67437,182264,TR,TR
181633,1699672320,1699689780,17460,165342,181823,FR,FR
9267,1699163520,1699173240,9720,127357,80346,IT,IT
49114,1699427340,1699438980,11640,120174,160803,US,US
167121,1699146360,1699158840,12480,30932,159122,US,US
190365,1700073660,1700084340,10680,44856,109955,PT,PT
44856,1699734480,1699761360,26880,89514,4735,HU,FR
111854,1698905460,1698909060,3600,64772,13627,GB,GB
155775,1699931160,1699965540,34380,91287,36085,TR,TR
122559,1700503140,1700514480,11340,136020,86354,PT,PT
107284,1699606920,1699624080,17160,146252,104243,AT,AT
19267,1700564640,1700574300,9660,169059,75161,IT,IT
58091,1699985340,1700021220,35880,123267,150767,TR,TR
15521,1698938100,1698948960,10860,10569,97839,AT,AT
25640,1699943340,1699954440,11100,30548,24538,HR,HR
56043,1700137800,1700162100,24300,57845,14335,RO,RO
136395,1699634760,1699646400,11640,70596,110944,US,US
142048,1699779900,1699783500,3600,120440,53495,NL,NL
50414,1699542420,1699577580,35160,61473,1135,TR,TR
52093,1699950180,1699977540,27360,152437,32730,PL,BE
164991,1699583580,1699597380,13800,55287,81303,US,US
153183,1700162100,1700179620,17520,49388,21427,CZ,CZ
186245,1699756980,1699778760,21780,42672,20835,MD,UA
98717,1699215660,1699244940,29280,56923,184928,TR,TR
190582,1699710960,1699722660,11700,173009,89330,US,US
69704,1699808640,1699815060,6420,5850,85423,NL,NL
162521,1700331240,1700360940,29700,33652,96003,TR,TR
111328,1699602840,1699635900,33060,49523,56956,TR,TR
84732,1699881120,1699895520,14400,83597,114418,FR,FR
198254,1699334820,1699354740,19920,199553,112862,SI,RS
72840,1699200300,1699211340,11040,85587,32618,US,US
34813,1699611480,1699646160,34680,88595,154538,TR,TR
56734,1700119320,1700174700,55380,17293,43866,BG,TR
51026,1700302380,1700315340,12960,37429,178675,IT,IT
98486,1699083900,1699091160,7260,85505,23086,PT,PT
149919,1699382640,1699399500,16860,52267,33845,US,US
96231,1700819280,1700835660,16380,198915,184501,US,US
46649,1699222680,1699233660,10980,136325,32850,IT,IT
46285,1700273040,1700288400,15360,52585,25579,RS,BA
71257,1698931860,1698960420,28560,161529,149066,RO,RO
17013,1699990260,1700023920,33660,142769,26154,MX,MX
180735,1699091460,1699097160,5700,184083,163354,NL,NL
162656,1699064520,1699073520,9000,67715,13109,HR,HR
95871,1700147340,1700176500,29160,54121,142063,TR,TR
97647,1700005920,1700017440,11520,156012,159935,US,US
170080,1700201340,1700230920,29580,109685,115387,TR,TR
199649,1700840940,1700870640,29700,38066,188092,TR,TR
132072,1699415520,1699447860,32340,9660,167649,TR,TR
45411,1700311380,1700345040,33660,78697,93149,TR,TR
178497,1698936540,1698940140,3600,101394,48000,GB,GB
184420,1700656680,1700691000,34320,60865,101653,TR,TR
121543,1699371840,1699398540,26700,51038,124074,DE,DE
22310,1699715760,1699719360,3600,155520,143122,GB,GB
23526,1700509680,1700538540,28860,96714,104690,TR,TR
49229,1699405740,1699421160,15420,190239,163810,US,US
19590,1699163880,1699186680,22800,102110,134723,CH,DE
157391,1699608840,1699620480,11640,145027,25789,US,US
130012,1700023440,1700039580,16140,18327,18968,CZ,FR
101244,1700064360,1700078220,13860,51553,10978,US,US
49297,1699702020,1699707840,5820,33737,177298,NL,NL
57173,1699584900,1699596240,11340,24464,81240,RS,RS
35980,1699064280,1699088100,23820,51374,165850,BR,BR
91300,1699104840,1699118220,13380,37525,116544,CZ,DE
134192,1700498580,1700534460,35880,155518,136736,TR,TR
28298,1700118960,1700143380,24420,34908,81667,RO,RO
42157,1699134420,1699148100,13680,66930,147262,IT,IT
112481,1699606680,1699634400,27720,142948,76587,RO,RO
31219,1699784280,1699798320,14040,21768,170647,US,US
55723,1699705380,1699722180,16800,14967,46866,US,US
161178,1699491540,1699525080,33540,169180,79212,TR,TR
118399,1700265600,1700294580,28980,131701,120233,TR,TR
80356,1698977880,1699010580,32700,58511,55231,MX,MX
137537,1699046400,1699081380,34980,49658,157253,TR,TR
5671,1700675520,1700706660,31140,156104,19752,TR,TR
85071,1699924380,1699936680,12300,35272,45114,US,US
85591,1699969140,1700004300,35160,98655,96983,TR,TR
48158,1698816000,1698825840,9840,169237,3778,PT,PT
150371,1700501640,1700534340,32700,188958,47876,TR,TR
103516,1699690860,1699694700,3840,174148,113042,GB,GB
155852,1700351880,1700361300,9420,68142,192630,PT,PT
161137,1699882440,1699909560,27120,106055,44866,BA,HR
29622,1699721220,1699755240,34020,14231,158158,TR,TR
14123,1700362080,1700375880,13800,199962,111023,US,US
108250,1700757060,1700761620,4560,192828,115574,GB,GB
100300,1700295420,1700317440,22020,43671,172616,PL,PL
12734,1699611720,1699617180,5460,180403,127826,GB,GB
20476,1698842700,1698872340,29640,75558,174315,TR,TR
6247,1700122080,1700129160,7080,75148,21041,GB,GB
49810,1700471160,1700506080,34920,194023,188104,TR,TR
82720,1699136580,1699147620,11040,164692,162552,IT,IT
177604,1699637280,1699664160,26880,12299,7564,PL,AT
126029,1699267860,1699302720,34860,102912,117931,TR,TR
124997,1700854800,1700858400,3600,129237,114597,GB,GB
35722,1699543260,1699551300,8040,118613,154224,IT,IT
76345,1699078440,1699110300,31860,1916,46783,TR,TR
97343,1700227080,1700236560,9480,191124,27214,HR,BA
81397,1699743960,1699747560,3600,127372,21511,NL,BE
155899,1700724480,1700760060,35580,90959,121914,TR,TR
196954,1699357020,1699386960,29940,92478,47998,TR,TR
52990,1699114320,1699124340,10020,167644,124850,ES,ES
166351,1700457900,1700492520,34620,76681,126282,MX,MX
32862,1699604340,1699608060,3720,134381,150119,NL,NL
100299,1699560780,1699592220,31440,86648,79708,TR,TR
99269,1699137300,1699150260,12960,159331,148269,IT,IT
189763,1698864180,1698875280,11100,22863,189245,ES,PT
53625,1699556700,1699574400,17700,180084,35414,CA,US
13488,1699726440,1699730040,3600,125832,107092,NL,NL
112474,1699397760,1699455420,57660,62127,180745,UA,PL
148779,1700429220,1700442000,12780,150780,114133,IT,IT
97390,1699465620,1699469220,3600,129865,59676,NL,NL
98594,1699543260,1699578060,34800,4295,70384,TR,TR
106406,1699299540,1699313400,13860,2520,84194,IT,IT
155714,1699346580,1699368480,21900,89373,98899,DE,BA
133138,1700744580,1700755740,11160,17535,97691,US,US
99598,1699114260,1699120260,6000,50309,178237,NL,NL
160586,1699869360,1699900380,31020,190163,194461,TR,TR
74508,1699328160,1699339740,11580,122979,109086,PT,PT
141775,1699432440,1699463760,31320,9304,85025,TR,TR
34819,1699459980,1699470120,10140,152888,45279,HR,HR
66592,1699703220,1699709340,6120,190999,45961,GB,GB
47298,1699371480,1699406100,34620,129810,156302,TR,TR
191046,1699835700,1699870380,34680,126460,29463,MX,MX
3473,1699197180,1699206900,9720,9497,92061,IT,IT
175321,1699498740,1699503060,4320,192727,187140,GB,GB
195787,1700369220,1700400840,31620,93412,155555,TR,TR
63170,1700267940,1700300040,32100,26161,69212,TR,TR
85220,1699945680,1699977420,31740,17674,37545,TR,TR
127949,1700313600,1700317200,3600,101828,151471,NL,NL
85668,1699399980,1699407780,7800,152547,188276,PT,PT
49983,1699397160,1699413840,16680,192623,69917,FR,FR
126964,1699399200,1699430340,31140,168673,156850,TR,TR
91924,1699206840,1699214280,7440,47586,71030,IT,IT
193568,1699136940,1699167060,30120,7146,29374,TR,TR
181446,1700462520,1700484900,22380,148984,156131,BR,BR
58051,1698801840,1698819000,17160,29272,97380,US,US
185264,1700742240,1700767440,25200,102434,187547,BR,BR
186348,1700394660,1700419680,25020,191136,106517,CH,DE
51611,1699010280,1699036320,26040,21864,16702,BR,BR
3003,1699566420,1699572540,6120,73015,19720,GB,GB
111935,1699831980,1699841400,9420,36883,186849,IT,IT
63172,1699852320,1699864500,12180,139931,77430,PT,PT
140665,1699999140,1700034120,34980,38531,55078,TR,TR
73243,1700480220,1700516820,36600,45452,127769,MX,MX
14061,1700418600,1700442180,23580,121604,103579,CH,FR
145289,1699157940,1699189200,31260,55615,180359,TR,TR
93035,1699365660,1699370580,4920,197402,104904,GB,GB
109156,1700608620,1700640180,31560,58969,17685,TR,TR
166594,1700327040,1700342460,15420,70054,156248,RS,AT
154030,1699202340,1699212180,9840,135418,176721,ES,ES
100663,1698810480,1698843420,32940,26696,104442,TR,TR
154448,1699228740,1699232700,3960,71059,120306,GB,GB
39178,1700660880,1700668020,7140,63842,2304,CL,CL
183308,1700562000,1700571960,9960,107509,69381,HR,DE
112720,1700452740,1700469660,16920,182621,24053,US,US
68063,1699967760,1699998180,30420,163354,60717,TR,TR
166347,1699539540,1699570560,31020,19281,57718,TR,TR
60612,1700010600,1700017620,7020,143515,33518,GB,GB
28513,1700463600,1700491500,27900,90957,141887,BR,BR
126782,1700005980,1700036100,30120,1511,16260,TR,TR
846,1700174820,1700178420,3600,20302,176724,NL,NL
195403,1699421580,1699436580,15000,106,144148,FR,FR
84487,1699711860,1699715460,3600,67209,49339,NL,NL
148321,1700070300,1700086860,16560,33068,21411,US,US
106964,1699553340,1699562220,8880,174517,32881,IT,IT
159626,1700763060,1700802120,39060,12095,173541,MX,MX
197308,1699436040,1699467060,31020,125587,17856,TR,TR
95555,1700829480,1700841420,11940,108212,81213,HR,HR
48428,1699646040,1699652280,6240,75518,137178,GB,GB
41330,1700841300,1700864640,23340,157442,160751,DK,SE
43401,1699321320,1699335840,14520,121160,12818,US,US
20350,1700079540,1700113380,33840,191565,27142,TR,TR
66520,1699628880,1699658520,29640,29644,14529,TR,TR
30924,1698970800,1698975900,5100,68852,162384,NL,NL
119237,1699063440,1699094700,31260,179617,91562,TR,TR
11282,1699890780,1699911060,20280,37971,29526,FR,FR
15273,1700170440,1700185920,15480,102253,185253,US,MX
155065,1699700400,1699727160,26760,58961,193610,DE,DE
76403,1700680440,1700712720,32280,109651,40540,TR,TR
195035,1700607600,1700633760,26160,70469,5,DE,PL
7277,1700718000,1700740200,22200,39726,79165,DE,DE
65336,1699401420,1699454640,53220,157699,165570,BG,DE
168840,1700503260,1700539980,36720,128589,154390,MX,MX
42423,1699641600,1699651800,10200,134992,20181,PT,PT
22499,1700629920,1700658960,29040,173060,106277,TR,TR
28912,1700404680,1700430960,26280,34832,175624,DE,DE
110999,1699617540,1699632120,14580,33489,198598,US,US
13091,1699115940,1699143540,27600,88804,44494,BR,BR
114036,1700165520,1700169480,3960,186378,21242,NL,NL
155494,1700017320,1700045520,28200,44445,116492,DE,NL
197310,1699356900,1699373940,17040,38944,133535,CZ,AT
1180,1699940100,1699971480,31380,150152,128533,TR,TR
128393,1699919880,1699929540,9660,46487,181151,SK,IT
172031,1699959900,1699984980,25080,46785,56612,CH,DE
145920,1700363340,1700377620,14280,105019,157633,AT,AT
175455,1700509740,1700526120,16380,92988,199978,US,US
187689,1699017180,1699041120,23940,42772,192576,MD,RO
164428,1699381440,1699411320,29880,20936,192805,TR,TR
117262,1700132040,1700157720,25680,11906,39502,CH,IT
83187,1700664900,1700674740,9840,19702,123610,IT,IT
9902,1700836920,1700840520,3600,14923,173357,NL,NL
81985,1699436580,1699467120,30540,92715,133395,TR,TR
157569,1699524360,1699560180,35820,191160,148742,TR,TR
125758,1700768460,1700772060,3600,141841,80003,GB,GB
123884,1700351400,1700357220,5820,194741,108429,GB,GB
180745,1699032960,1699054920,21960,166088,175656,PL,DE
183895,1700352540,1700365140,12600,41071,162402,US,US
99250,1698808620,1698838440,29820,19907,69425,TR,TR
95734,1700864460,1700881920,17460,173155,124240,US,US
81829,1699734600,1699768140,33540,35563,91108,TR,TR
166430,1698833220,1698868800,35580,111915,67152,TR,TR
170557,1699934940,1699946160,11220,195453,36064,US,US
187888,1699591140,1699601640,10500,120575,98601,ES,ES
42165,1700413380,1700442960,29580,33533,52894,TR,TR
142144,1699495560,1699507020,11460,96595,49393,HR,DE
67120,1699042080,1699077300,35220,174971,86020,TR,TR
100880,1699318620,1699333140,14520,61481,105024,US,US
175864,1700520660,1700536740,16080,34368,108383,US,US
42531,1698951120,1698984360,33240,29599,26102,TR,TR
131111,1699138140,1699153140,15000,40322,121432,US,US
6043,1699379580,1699384560,4980,43753,94856,GB,GB
156905,1700511060,1700521680,10620,46525,176439,IT,IT
146344,1699587000,1699609020,22020,35520,54286,DE,CZ
33873,1700727900,1700737620,9720,51819,164705,IT,IT
104936,1698796080,1698827280,31200,45391,179799,TR,TR
85760,1699168440,1699174440,6000,132708,130725,AD,ES
75940,1700583180,1700608740,25560,43120,140984,RO,RO
168791,1700818320,1700844900,26580,42504,69848,DE,DE
16752,1699025040,1699032360,7320,99409,83525,IT,IT
196149,1699036020,1699047360,11340,115277,114683,US,US
39987,1699993020,1699998420,5400,99051,174299,NL,NL
10661,1700230560,1700234160,3600,23784,194963,GB,GB
175360,1700290560,1700304780,14220,37379,72837,IT,IT
44719,1700034660,1700068500,33840,67841,145269,TR,TR
35953,1700656020,1700692560,36540,50590,182417,MX,US
176586,1699426920,1699456860,29940,7017,187061,MK,RS
59271,1699452360,1699465920,13560,137081,61903,IT,IT
124973,1699506960,1699511760,4800,111937,42206,NL,NL
47971,1700081940,1700113020,31080,122116,63536,TR,TR
127668,1700841000,1700851200,10200,36803,54605,IT,PT
173913,1699404000,1699413300,9300,45437,1960,ES,ES
147600,1700709060,1700740980,31920,30171,108975,TR,TR
48662,1699794300,1699807140,12840,108744,189395,HR,HR
171306,1700782800,1700815500,32700,127573,61251,TR,TR
159527,1699804740,1699818480,13740,101055,102085,RS,RS
131681,1699789920,1699794180,4260,87844,118591,NL,NL
104575,1699089840,1699121700,31860,87534,120517,TR,TR
193515,1699487580,1699517520,29940,69719,76363,TR,TR
122943,1699556160,1699567380,11220,45113,60088,PT,PT
49528,1699709880,1699719480,9600,115275,4216,IT,IT
74707,1699955580,1699981560,25980,153970,31690,RO,RO
138964,1699521840,1699525440,3600,197879,97118,GB,GB
48644,1699989780,1700021040,31260,172121,98190,TR,TR
87535,1699969620,1700003400,33780,191952,192884,TR,TR
46360,1699018560,1699022160,3600,133170,76352,NL,NL
194405,1698854400,1698888840,34440,151416,64298,TR,TR
155945,1699751100,1699759080,7980,44734,60397,IT,IT
16414,1699610640,1699646580,35940,72901,193035,TR,TR
182321,1700204340,1700224380,20040,184590,61189,SE,SE
20165,1699294980,1699311240,16260,114161,53239,US,US
145969,1698861120,1698877080,15960,137946,58185,US,US
83616,1700073900,1700078100,4200,56080,42148,NL,NL
47627,1700710080,1700721480,11400,49096,567,IT,IT
100674,1700116140,1700144460,28320,135675,108835,DE,DE
39580,1700794320,1700824440,30120,165742,106689,TR,TR
87064,1699148700,1699177980,29280,60127,191184,TR,TR
117591,1700851140,1700886000,34860,10549,94001,TR,TR
170401,1700805840,1700820960,15120,113285,142118,US,US
64950,1700717400,1700728080,10680,26310,133476,ES,ES
149656,1699328220,1699344120,15900,65461,157872,RS,RS
102200,1700715600,1700745360,29760,199103,68080,TR,TR
153093,1699855560,1699859160,3600,121347,174166,GB,GB
122335,1700127060,1700160600,33540,94726,144436,TR,TR
112693,1700092560,1700097360,4800,27581,89904,GB,GB
75092,1698975600,1699006680,31080,131728,23211,TR,TR
115745,1698978660,1699009260,30600,70713,105008,TR,TR
88572,1700104020,1700120100,16080,184631,122945,US,US
107482,1699036740,1699070580,33840,118764,109493,TR,TR
11551,1699787100,1699800240,13140,79969,16844,US,US
21617,1699272420,1699302000,29580,184564,1654,TR,TR
170663,1700225100,1700254980,29880,188840,165699,TR,TR
157589,1700337720,1700365980,28260,85935,28884,DE,BG
66739,1698884700,1698917520,32820,69443,52722,TR,TR
124406,1700451900,1700466720,14820,49703,39715,US,US
123945,1700116080,1700129760,13680,84335,96095,US,US
86215,1700345820,1700361960,16140,122367,170179,US,US
96671,1699875840,1699888200,12360,113716,63253,PT,PT
21805,1699832100,1699858860,26760,40610,166215,DE,IT
84240,1700526720,1700560440,33720,195771,194088,TR,TR
179052,1700612100,1700629140,17040,44838,20790,US,US
162554,1700671440,1700683680,12240,36223,81688,AT,AT
170240,1700541840,1700545440,3600,85486,35514,NL,NL
176251,1699291920,1699303680,11760,118658,154497,IT,IT
198421,1699377000,1699384380,7380,168366,47279,IT,HU
35623,1699815000,1699828020,13020,37380,178392,IT,IT
83280,1699423980,1699436160,12180,35604,149822,PT,PT
48149,1698979980,1698985380,5400,111513,158775,NL,NL
143950,1700808900,1700812500,3600,32030,115669,GB,GB
160108,1700450940,1700458920,7980,173444,100220,PT,PT
121931,1699221360,1699228740,7380,20984,147269,IT,IT
96641,1699422060,1699439640,17580,181271,78136,FR,FR
177994,1698882900,1698911880,28980,98759,28176,TR,TR
99737,1699353600,1699379760,26160,23909,74555,BR,BR
178922,1699256940,1699266000,9060,59569,196159,ES,ES
195442,1699513080,1699524360,11280,48096,14676,US,US
29280,1700854440,1700904900,50460,94216,162880,BG,DE
190714,1699530240,1699555380,25140,80418,136442,BR,BR
51020,1699532940,1699544700,11760,31139,69940,RS,RS
180992,1700126940,1700160660,33720,80468,19515,TR,TR
69179,1699887120,1699913220,26100,88055,2541,DE,CZ
192469,1699866120,1699898280,32160,190861,110551,TR,TR
109563,1699510440,1699520640,10200,152401,57677,SK,AT
198563,1699621800,1699635480,13680,161481,79310,PT,PT
19714,1700631240,1700661300,30060,149920,28209,TR,TR
23051,1699471020,1699483140,12120,22442,112197,IT,IT
100376,1699288500,1699318440,29940,63915,5369,TR,TR
138236,1699774860,1699804500,29640,29748,9237,TR,TR
154436,1700065380,1700102700,37320,125930,171931,MX,MX
74796,1699815900,1699850580,34680,59696,121574,TR,TR
28708,1700082720,1700100420,17700,157322,185209,US,US
25189,1700495820,1700502840,7020,103162,3016,GB,GB
132687,1699109040,1699122420,13380,58211,124607,IT,IT
53336,1700011620,1700021100,9480,41605,43223,PT,PT
167341,1700227020,1700261460,34440,151612,43481,TR,TR
114886,1699515420,1699525320,9900,2234,30802,HR,HR
12333,1699354920,1699377000,22080,87153,105916,DE,CZ
123854,1699299360,1699335240,35880,82832,66070,TR,TR
5012,1700161260,1700170800,9540,162069,34134,IT,IT
179344,1698860280,1698895980,35700,25767,121792,TR,TR
134949,1699644420,1699678200,33780,142020,80065,TR,TR
84140,1699201500,1699236420,34920,30094,51726,TR,TR
173563,1699937040,1699966140,29100,141178,89567,TR,TR
29345,1700201040,1700206140,5100,76425,44159,GB,GB
93267,1699480740,1699495800,15060,111285,93573,FR,BE
138671,1698997080,1699011060,13980,66211,81312,IT,IT
117306,1700148720,1700159700,10980,48138,154435,US,US
62357,1700024940,1700035980,11040,141609,5232,HR,PL
105000,1700423460,1700457480,34020,189635,13626,TR,TR
100435,1700617440,1700631960,14520,153019,186181,AT,BG
184483,1700343300,1700352120,8820,157482,10398,PT,ES
127372,1699548300,1699551900,3600,121600,189921,NL,NL
12351,1699049280,1699078800,29520,110301,56736,TR,TR
139019,1699432680,1699444320,11640,94623,125373,HR,HR
81528,1700659920,1700683440,23520,105163,105339,RO,RO
133633,1699152120,1699181040,28920,2448,55483,TR,TR
143064,1698994860,1699024980,30120,160232,125965,TR,TR
138770,1699850940,1699884780,33840,28428,192938,TR,TR
91405,1698871380,1698874980,3600,62422,3433,GB,GB
15028,1698895200,1698898800,3600,59083,186601,NL,NL
27608,1699013100,1699044780,31680,44009,39487,TR,TR
44590,1700568600,1700599140,30540,104876,51011,TR,TR
40255,1699924380,1699927980,3600,98790,51396,GB,GB
97525,1700447760,1700451360,3600,72889,113933,GB,GB
8926,1699065000,1699099920,34920,34300,21116,TR,TR
186402,1699570560,1699584240,13680,88680,142174,SK,CZ
138583,1698892440,1698924060,31620,155184,185141,TR,TR
51585,1699714020,1699717620,3600,110263,143281,GB,GB
160341,1699807440,1699837920,30480,169617,191320,TR,TR
40154,1700197320,1700231940,34620,42397,167963,TR,TR
18767,1700672940,1700684040,11100,129452,164720,HR,HR
122655,1699287960,1699321620,33660,172556,51767,TR,TR
86890,1699004400,1699019400,15000,183718,103491,AT,CZ
50265,1700694720,1700707500,12780,192617,111021,IT,IT
193613,1699848900,1699884240,35340,35597,12739,TR,TR
199224,1700131560,1700144100,12540,170466,131093,US,US
194170,1699284240,1699297320,13080,42335,129923,CZ,HU
38608,1699087980,1699117320,29340,11778,180936,TR,TR
48304,1700021220,1700039160,17940,82849,13976,US,US
97077,1699412820,1699448580,35760,56791,1574,TR,TR
20436,1699078980,1699110960,31980,113846,103293,TR,TR
21034,1699245780,1699264800,19020,47732,102990,FR,FR
55306,1700734320,1700739780,5460,37316,132792,NL,NL
64578,1700143680,1700157780,14100,170621,104207,IT,IT
22996,1700277540,1700312280,34740,43043,4775,TR,TR
84476,1699090500,1699105560,15060,66746,113973,US,US
171441,1699618080,1699641600,23520,41561,139358,HU,DE
104971,1700204040,1700212680,8640,162208,88641,ES,FR
56666,1700491920,1700507700,15780,58492,184733,US,US
171791,1699181280,1699192260,10980,41639,11595,SK,SK
72936,1698815340,1698847320,31980,109873,756,TR,TR
127531,1700716320,1700719920,3600,50797,7551,NL,NL
188751,1699730220,1699787460,57240,69759,46618,BG,DE
176844,1700603400,1700634000,30600,105688,63748,TR,TR
176430,1699075140,1699079820,4680,15595,5498,NL,NL
24268,1700045760,1700076720,30960,8039,146231,TR,TR
137017,1700140320,1700158140,17820,134202,46456,US,US
12816,1700456940,1700496420,39480,124964,11541,MX,US
137899,1698863100,1698871980,8880,159006,105601,IT,IT
128493,1699550760,1699584600,33840,101380,121429,TR,TR
56521,1699586160,1699589760,3600,124077,172444,GB,GB
152629,1699087140,1699090740,3600,63921,199095,NL,NL
136380,1700580900,1700587440,6540,11061,75355,GB,GB
198256,1700457780,1700487600,29820,120915,85011,TR,TR
37288,1700419680,1700430720,11040,193240,6988,IT,IT
182979,1699179900,1699212300,32400,158610,108468,TR,TR
139753,1699235580,1699267980,32400,64953,9963,MX,MX
104180,1699591560,1699625940,34380,71061,119418,TR,TR
7023,1699399440,1699404660,5220,56602,136558,GB,GB
33609,1698920580,1698953040,32460,89582,166653,TR,TR
174032,1699845960,1699867200,21240,80134,191006,FR,FR
195598,1699337040,1699356360,19320,109553,169930,FR,ES
181036,1700658000,1700668860,10860,97799,115537,PT,PT
103662,1700432640,1700440140,7500,118777,94472,PT,PT
71583,1699548300,1699560300,12000,103594,194444,AT,BG
105033,1700851500,1700868000,16500,146945,137074,FR,FR
35295,1700631660,1700655960,24300,85995,60960,DE,DK
118783,1699944660,1699948260,3600,40504,142495,GB,GB
66640,1700619300,1700626980,7680,152577,193111,HR,DE
81860,1700134080,1700159640,25560,98793,111758,DE,BG
91240,1700119800,1700123400,3600,24349,149236,NL,NL
130096,1699648560,1699681500,32940,70240,2764,TR,TR
86697,1700047380,1700079900,32520,124627,179356,TR,TR
103483,1700848620,1700854500,5880,110075,144049,NL,NL
22071,1699182240,1699218060,35820,162156,69507,TR,TR
196772,1699903080,1699937460,34380,106397,108725,TR,TR
152385,1699433580,1699468680,35100,87959,143136,TR,TR
84807,1699779660,1699793580,13920,58795,178397,PT,PT
196184,1699798560,1699811460,12900,79612,87665,IT,IT
168243,1700155680,1700188200,32520,96369,106107,TR,TR
195039,1700313000,1700364360,51360,186311,180748,BG,DE
107087,1700672280,1700684400,12120,129608,11827,IT,IT
182741,1700113560,1700130600,17040,57960,197527,FR,DE
139137,1699069260,1699072860,3600,32850,24936,NL,CZ
92659,1700416560,1700422740,6180,6194,261,NL,NL
42069,1699392540,1699396140,3600,59908,52708,GB,GB
72584,1700582880,1700592540,9660,27373,185892,IT,IT
26596,1700339640,1700360520,20880,165528,181065,FR,FR
14290,1700036040,1700055360,19320,3077,78685,BE,SK
59784,1699816620,1699821780,5160,174595,119534,GB,GB
46910,1700324220,1700356860,32640,21292,193975,TR,TR
191902,1700062500,1700075520,13020,68017,193143,RS,RS
22885,1700463300,1700476860,13560,174137,56967,US,US
30081,1699627680,1699661820,34140,31529,82070,TR,TR
86132,1700257260,1700264340,7080,191805,183687,NL,NL
49642,1699396980,1699429020,32040,78238,112054,TR,TR
79074,1699394460,1699402680,8220,80512,186465,IT,IT
15739,1700199900,1700231880,31980,195128,26147,TR,TR
136145,1700203680,1700230080,26400,115704,98303,DE,DE
108924,1699838160,1699873620,35460,65606,166561,TR,TR
35089,1699209060,1699220400,11340,197461,141593,PT,PT
51602,1698984540,1699019520,34980,170586,170027,TR,TR
16145,1700820420,1700849400,28980,151574,192379,MK,RS
104594,1700793480,1700805900,12420,163650,163476,US,US
189210,1699991520,1699995120,3600,26117,122137,GB,GB
184369,1700071980,1700096880,24900,194586,139753,DE,IT
71203,1699450500,1699484760,34260,12587,80557,TR,TR
167851,1700515200,1700528340,13140,41033,153929,HR,HR
11321,1699108140,1699139760,31620,139437,16672,TR,TR
76359,1700400600,1700418420,17820,23168,183730,US,US
149438,1700778480,1700812800,34320,177885,176524,TR,TR
22306,1699674780,1699706280,31500,113759,75438,TR,TR
708,1700776500,1700799600,23100,120335,31273,DE,DE
39146,1699455360,1699471740,16380,164472,123271,FR,FR
20821,1700003040,1700014620,11580,74982,94238,ES,ES
146235,1698829740,1698843720,13980,56666,49087,IT,IT
89284,1699927500,1699938480,10980,192090,138096,IT,IT
78008,1698805440,1698811500,6060,83741,108968,NL,NL
173842,1700379600,1700409540,29940,17626,76336,TR,TR
50255,1700158860,1700174340,15480,118803,141147,RS,RS
100103,1700290320,1700323680,33360,148216,129931,TR,TR
145602,1700663160,1700698020,34860,176586,108170,TR,TR
126126,1700028840,1700041140,12300,195887,14333,ES,FR
66278,1700157360,1700192880,35520,130322,9276,TR,TR
100656,1700627880,1700636580,8700,192178,124069,GR,MK
185404,1699564620,1699599900,35280,24735,52761,TR,TR
140272,1699176600,1699192080,15480,24385,73521,US,US
23629,1699940280,1699975860,35580,12886,114890,TR,TR
62197,1700348040,1700381160,33120,194913,194565,TR,TR
31454,1700057940,1700085360,27420,3298,149311,CH,BE
161733,1698916500,1698932820,16320,94896,109549,US,US
108841,1700211180,1700242920,31740,27316,102140,TR,TR
37873,1699302240,1699319640,17400,12471,115782,US,US
90172,1699811880,1699823640,11760,98619,13202,US,US
31401,1699724460,1699738020,13560,18788,69479,IT,IT
36551,1699359480,1699363080,3600,13678,89855,NL,NL
116414,1700038080,1700058060,19980,112275,64252,FR,FR
16014,1699609740,1699645260,35520,182709,170431,TR,TR
26159,1699715460,1699719060,3600,59006,43314,GB,GB
108378,1700628300,1700660880,32580,46337,63528,TR,TR
141581,1698891660,1698913620,21960,180684,121225,RO,RO
167888,1699428240,1699442100,13860,23799,28417,CA,US
90050,1698905280,1698909480,4200,160465,88706,GB,GB
141241,1700818080,1700852460,34380,36618,51432,MX,MX
115015,1700202360,1700215680,13320,195894,20534,US,US
48680,1699143900,1699152540,8640,192626,87749,PT,ES
115245,1699849380,1699863720,14340,160498,65592,US,US
174648,1700231340,1700250960,19620,23516,147221,FR,AD
23245,1698986220,1699016820,30600,3479,21699,TR,TR
152995,1699404000,1699437240,33240,84834,17834,TR,TR
196235,1700701860,1700734620,32760,148972,61171,TR,TR
32864,1699293420,1699310040,16620,95867,62674,US,US
75539,1699079400,1699112160,32760,110619,57670,TR,TR
146012,1699456920,1699473900,16980,104205,22470,US,US
178281,1699409400,1699442820,33420,196227,84333,TR,TR
22682,1700467500,1700498160,30660,14539,91269,TR,TR
57279,1700339160,1700373240,34080,73622,9904,TR,TR
98779,1699711140,1699740780,29640,162297,47897,TR,TR
151770,1699569480,1699574280,4800,142712,195756,GB,GB
132212,1700556420,1700569860,13440,34280,149130,US,US
14172,1698858720,1698873840,15120,40937,175739,FR,DE
102772,1699326120,1699335540,9420,178544,132426,IT,IT
36409,1699614180,1699630680,16500,166130,33664,US,US
123334,1699559280,1699589040,29760,61240,18065,TR,TR
32689,1700204160,1700210580,6420,67636,181035,NL,NL
94998,1700243280,1700259300,16020,84570,104362,US,US
104346,1699108680,1699114620,5940,152023,12888,GB,GB
68573,1698934860,1698965280,30420,165157,73328,TR,TR
8690,1699287840,1699315020,27180,182336,186044,PL,DK
150654,1699492560,1699522020,29460,143253,149995,TR,TR
81541,1699678560,1699694760,16200,158286,20620,US,US
78692,1700255280,1700267520,12240,164518,107648,CZ,CZ
58311,1700524620,1700541180,16560,10764,64987,BE,FR
54293,1699400340,1699432980,32640,163304,199292,TR,TR
59479,1699584660,1699592460,7800,52904,119019,IT,IT
81080,1699371360,1699401180,29820,155544,82462,TR,TR
159178,1700194740,1700200980,6240,159102,50782,NL,NL
60913,1700330160,1700358660,28500,105741,64512,DE,RS
168528,1700640420,1700673960,33540,185474,64305,TR,TR
21886,1699657320,1699692720,35400,110282,191472,TR,TR
86711,1700086200,1700101500,15300,14864,173062,FR,DE
84263,1699313280,1699329780,16500,141918,149062,US,US
94843,1700257680,1700292360,34680,74516,172482,TR,TR
173009,1699616520,1699648020,31500,181156,118308,TR,TR
134658,1699868160,1699902960,34800,51557,56837,MX,MX
60120,1698875520,1698886500,10980,142653,115731,US,US
145609,1699468260,1699471860,3600,97080,125701,NL,NL
18426,1699827000,1699837860,10860,57267,41456,RS,ME
129060,1700352960,1700365020,12060,150010,123595,US,US
53983,1699605660,1699630680,25020,147287,159445,RO,RO
21743,1699388460,1699418760,30300,74473,91640,TR,TR
33323,1699125960,1699138500,12540,59619,33852,US,US
198767,1700696640,1700714220,17580,57058,118954,FR,BE
63622,1700244840,1700276340,31500,89019,5151,TR,TR
157074,1699045920,1699055760,9840,73996,76752,HR,IT
184331,1699836480,1699870560,34080,8172,76463,TR,TR
57991,1699293720,1699297320,3600,47533,78877,GB,GB
43932,1699815060,1699842060,27000,155226,96090,DE,DE
38867,1699587660,1699593360,5700,139248,189698,NL,NL
13158,1699817400,1699822440,5040,159563,111901,GB,GB
190101,1700518800,1700535360,16560,179884,147971,US,US
190579,1699391460,1699395300,3840,1923,174218,EE,EE
130403,1699192500,1699229460,36960,89815,392,MX,MX
102791,1700438160,1700442960,4800,137529,113871,GB,GB
36167,1700772900,1700782740,9840,27534,82414,IT,IT
43606,1699784580,1699840320,55740,25338,111045,BG,BG
26680,1699145520,1699158780,13260,174159,41661,US,US
73639,1700668260,1700695140,26880,10167,75043,PL,DK
107230,1699316580,1699349160,32580,63347,176006,TR,TR
71224,1699076520,1699105500,28980,157223,54022,TR,TR
7053,1699252800,1699259880,7080,24107,157496,GB,GB
107021,1699361160,1699384080,22920,98903,145552,PL,PL
169608,1700270460,1700283960,13500,118935,11027,US,US
131373,1700277000,1700311020,34020,178677,60991,TR,TR
142951,1700678280,1700709060,30780,127176,123933,TR,TR
86534,1699251480,1699269780,18300,143207,2645,FR,FR
38898,1698948480,1698983100,34620,20673,182446,TR,TR
29892,1699958220,1699967160,8940,157165,183344,SK,SK
143305,1700560140,1700596080,35940,84796,7745,TR,TR
156462,1699506360,1699525680,19320,83782,137405,FR,FR
1855,1699048560,1699084440,35880,788,143072,TR,TR
13298,1699230000,1699244040,14040,15039,194589,US,US
71755,1699914720,1699950480,35760,140256,190090,TR,TR
67786,1699783740,1699799760,16020,159463,68713,BE,FR
29484,1700326020,1700357220,31200,109777,10225,TR,TR
127335,1700608680,1700617860,9180,66528,135106,IT,IT
38736,1699630740,1699635420,4680,195323,27025,GB,NL
48608,1699768020,1699800180,32160,186175,68514,TR,TR
186065,1700755440,1700765040,9600,9018,9217,IT,IT
111778,1700022300,1700025900,3600,160077,190085,NL,NL
154895,1699951020,1699965480,14460,147570,77096,FR,FR
54340,1698973020,1699003860,30840,7316,103379,TR,TR
78337,1698964920,1698973440,8520,24504,197446,IT,IT
30563,1700586600,1700622000,35400,80218,101422,TR,TR
144041,1699174740,1699191060,16320,150019,86717,US,US
139682,1699867620,1699878900,11280,22521,166533,HR,HR
125634,1699369800,1699382100,12300,145269,21889,IT,IT
89223,1699818120,1699853460,35340,153364,156013,TR,TR
177886,1699779840,1699793040,13200,113747,177847,US,US
115017,1699366320,1699393560,27240,61388,162039,DE,AT
119863,1699846680,1699879680,33000,61060,80297,TR,TR
138727,1699262460,1699274760,12300,175371,18409,RS,SI
76011,1700280420,1700293920,13500,69086,36299,IT,IT
93868,1700039220,1700055120,15900,51857,125494,US,US
156283,1700117100,1700144040,26940,577,113314,PL,PL
193991,1699046400,1699077060,30660,164469,39152,TR,TR
85602,1700716020,1700738580,22560,47082,32996,PL,DE
163293,1700551440,1700567160,15720,6843,101510,US,US
141342,1699777440,1699791120,13680,2118,73403,US,US
46052,1700749500,1700760120,10620,163880,111812,IT,IT
108564,1699170360,1699201560,31200,169888,33491,TR,TR
84614,1699414260,1699421880,7620,35074,150677,PT,PT
103881,1698935580,1698946380,10800,162740,80124,ES,ES
21513,1700659860,1700675220,15360,89059,142718,US,US
157113,1700723700,1700733240,9540,84359,72419,PT,PT
46433,1699887780,1699902420,14640,165481,129636,US,US
34596,1699910280,1699920780,10500,181784,94386,IT,IT
128057,1699837740,1699841340,3600,2951,13660,GB,GB
68527,1698851520,1698874500,22980,122954,96004,DK,CZ
21447,1699076580,1699112700,36120,70114,183592,MX,MX
32885,1699898340,1699911900,13560,69822,178197,RS,RS
106147,1699176420,1699193280,16860,32447,125622,US,US
126786,1699241220,1699257960,16740,162330,80661,CA,US
26312,1699060380,1699114440,54060,83489,124037,UA,PL
87888,1699469220,1699497420,28200,78360,100512,CH,IT
11690,1700596080,1700599680,3600,101058,60649,GB,GB
136300,1699143420,1699176300,32880,158949,85333,TR,TR
59325,1700439840,1700466000,26160,123097,68056,BR,BR
150292,1698911820,1698924360,12540,182505,135056,US,US
88599,1699186980,1699190580,3600,150655,146081,NL,NL
62449,1700107320,1700136060,28740,72453,153532,DE,DE
113387,1698931920,1698960180,28260,82008,67856,PL,PL
366,1699808760,1699836960,28200,188727,55633,PL,FI
134555,1700830260,1700833860,3600,184002,139674,NL,HR
16692,1699946940,1699964340,17400,127757,190243,US,US
165297,1699648260,1699663260,15000,182641,154087,US,US
153975,1700047680,1700059500,11820,191470,77202,IT,NL
27201,1699627860,1699640820,12960,156584,54209,IT,IT
85373,1700273340,1700287440,14100,39926,74594,US,US
126325,1699461420,1699468980,7560,22575,115547,HR,HR
42250,1699794420,1699799040,4620,106784,46737,NL,NL
42545,1699064340,1699076160,11820,79360,47347,AT,CZ
156589,1699739100,1699768500,29400,156952,98333,TR,TR
33280,1699460160,1699463760,3600,166897,42017,GB,GB
138901,1699329840,1699361640,31800,137488,184091,TR,TR
31779,1699535220,1699549740,14520,132768,69812,AT,AT
98891,1700510220,1700534820,24600,50455,65956,DE,FR
176115,1700003220,1700006820,3600,43485,109354,NL,NL
174979,1699868400,1699901820,33420,164437,80949,TR,TR
190658,1700477040,1700493420,16380,60221,60011,US,US
19870,1698876900,1698908400,31500,117356,100698,TR,TR
57147,1700160600,1700166060,5460,82471,119872,NL,NL
151033,1700461860,1700474940,13080,134814,38732,CZ,CZ
127842,1700815260,1700847480,32220,38058,193859,TR,TR
39698,1700712960,1700743620,30660,31252,195552,TR,TR
69111,1699240380,1699246860,6480,77721,25800,GB,GB
92180,1699022220,1699055940,33720,122238,89790,TR,TR
96393,1700034240,1700067600,33360,110062,165085,TR,TR
49567,1699970520,1699981620,11100,155059,96914,US,US
6692,1700859660,1700898780,39120,188235,153189,MX,US
92425,1698902220,1698905820,3600,85049,188051,GB,GB
143595,1699936380,1699970820,34440,33887,117320,TR,TR
55008,1698811320,1698824220,12900,102829,195083,IT,IT
29949,1700133660,1700163000,29340,191402,199096,TR,TR
193517,1700122020,1700130480,8460,92455,166440,IT,IT
31203,1699801620,1699805220,3600,27990,163353,GB,GB
178399,1700147040,1700161380,14340,1866,113009,CZ,CZ
97031,1699758420,1699814100,55680,127411,39573,BG,DE
14227,1700640360,1700647140,6780,61459,170945,NL,NL
53978,1699655880,1699662180,6300,40993,91219,GB,GB
98418,1698995220,1699011600,16380,5764,167006,US,US
139922,1700615520,1700650560,35040,55580,161875,TR,TR
122364,1699223400,1699232400,9000,103321,2469,IT,IT
193497,1699607400,1699642380,34980,4409,82491,TR,TR
70227,1700479080,1700482680,3600,48133,12809,GB,GB
88756,1698882000,1698886140,4140,199546,13079,NL,NL
53736,1700158740,1700163540,4800,25975,74172,GB,GB
60431,1699667700,1699701120,33420,28493,168417,TR,TR
5841,1700569800,1700603460,33660,69561,146292,TR,TR
179909,1700274480,1700310060,35580,87525,180418,TR,TR
81788,1700545380,1700565300,19920,100135,30321,DK,SE
127233,1700188620,1700207640,19020,152343,120739,FR,FR
80676,1700664840,1700680860,16020,106113,29123,CZ,DE
144958,1699085160,1699100160,15000,2090,34652,AT,AT
24328,1700284200,1700290500,6300,183244,39347,FI,EE
166003,1699185300,1699216380,31080,171008,39459,TR,TR
14374,1698818220,1698834900,16680,199528,4021,US,US
169954,1699535400,1699564260,28860,28864,78052,TR,TR
149597,1700289180,1700320620,31440,712,3706,TR,TR
105988,1700483340,1700496420,13080,142869,4290,SK,SK
2292,1699922340,1699933620,11280,52625,187101,IT,IT
18238,1699404000,1699416300,12300,40849,65360,IT,IT
60728,1700041920,1700057220,15300,120236,148052,FR,FR
80030,1698885000,1698902160,17160,22246,195798,US,US
68152,1699597200,1699602240,5040,26199,172813,GB,GB
185860,1699073460,1699105200,31740,108604,67074,TR,TR
91177,1699730160,1699736340,6180,121826,166401,GB,GB
163468,1699725360,1699750860,25500,102978,40440,PL,PL
185475,1700850660,1700879940,29280,31395,42785,TR,TR
8358,1699127940,1699145160,17220,71236,77363,US,US
2368,1700729820,1700738640,8820,5028,150547,HR,HR
53059,1700408160,1700442480,34320,66344,20733,TR,TR
71529,1699332360,1699363500,31140,12776,186065,TR,TR
2281,1699276740,1699310880,34140,73416,106431,MX,MX
175511,1700126520,1700157960,31440,156348,90766,TR,TR
110941,1699172940,1699203120,30180,51104,6648,TR,TR
17430,1699080960,1699141500,60540,151146,74243,UA,DE
19131,1699825620,1699848180,22560,66662,138267,PL,UA
98872,1700152740,1700167260,14520,39497,83351,US,US
19112,1700700960,1700714160,13200,46622,98396,US,US
128471,1699758300,1699790580,32280,24953,6022,TR,TR
111424,1699037100,1699052400,15300,67298,8279,US,US
112749,1700367360,1700383440,16080,144581,72787,US,US
43875,1699938360,1699960080,21720,126035,60139,DE,DE
101393,1699320960,1699331160,10200,180363,44513,IT,IT
62224,1698834240,1698850320,16080,62258,36997,AT,HU
194508,1700295420,1700325180,29760,47767,74918,TR,TR
131781,1698999660,1699004340,4680,71048,182857,NL,DE
45089,1699662420,1699673340,10920,136536,26615,AT,AT
173146,1700084400,1700100360,15960,115501,76374,US,US
47316,1700172060,1700175660,3600,98155,115526,GB,GB
60670,1699312680,1699321200,8520,136822,146418,ES,BE
100439,1699157160,1699191360,34200,173614,152745,TR,TR
7257,1699442160,1699471800,29640,52163,117805,TR,TR
42319,1699265340,1699297680,32340,26941,93600,TR,TR
176347,1699595280,1699619820,24540,31856,135297,HU,CZ
50858,1699551600,1699557720,6120,165173,76194,NL,NL
59390,1698886440,1698914700,28260,46802,32426,RO,RO
15417,1700521740,1700538780,17040,147517,118497,SE,SE
9852,1699650780,1699663440,12660,94386,59114,AT,AT
168408,1700579880,1700602380,22500,185862,147666,DE,IT
23026,1700813340,1700830920,17580,130586,199895,FR,CH
65648,1698798660,1698806580,7920,107101,1081,AD,ES
45923,1699508760,1699542180,33420,90945,72986,TR,TR
48269,1699558140,1699591260,33120,61546,101976,TR,TR
53896,1699683480,1699700640,17160,86944,68520,RS,RS
65405,1700839560,1700843160,3600,30377,90831,NL,BE
58872,1700121360,1700157240,35880,166562,48140,TR,TR
120754,1699747260,1699778640,31380,114782,107430,TR,TR
137556,1699893120,1699896720,3600,153867,157084,GB,GB
146661,1700233800,1700249100,15300,40843,189979,CA,CA
8739,1700753880,1700757480,3600,180637,104670,GB,GB
77712,1700154660,1700190120,35460,179429,142529,TR,TR
102867,1698816480,1698847860,31380,80987,73523,TR,TR
155546,1699857720,1699880400,22680,170106,25757,BR,BR
170956,1699192500,1699217940,25440,146206,128131,BR,BR
53718,1699182540,1699214760,32220,94875,144877,TR,TR
194292,1699109640,1699125660,16020,146946,69443,US,US
144378,1700193720,1700244960,51240,71611,63343,BG,DE
3757,1700058600,1700073060,14460,84522,38303,US,US
90483,1700247300,1700278680,31380,164455,13544,TR,TR
98921,1700404560,1700435160,30600,93828,150007,BA,HR
161740,1700524260,1700529780,5520,111279,26984,NL,BE
16380,1700584740,1700607180,22440,21908,108378,BR,BR
173924,1700559060,1700593020,33960,136189,17178,TR,TR
20784,1700846640,1700850240,3600,120839,191092,NL,NL
38265,1700272200,1700287560,15360,143027,124954,US,US
11333,1700266440,1700280120,13680,70894,90233,US,US
83426,1698805200,1698821460,16260,75380,73020,FR,RS
37233,1700700540,1700712600,12060,44892,194174,US,US
78625,1699444920,1699448520,3600,155678,147336,GB,NL
31966,1699839240,1699852020,12780,129353,167687,CZ,CZ
132093,1700705820,1700712060,6240,12203,132987,NL,NL
17019,1700726400,1700742300,15900,100754,83239,US,US
141909,1699865460,1699869060,3600,193002,88697,GB,GB
167974,1699898580,1699931160,32580,86175,132658,MX,MX
10410,1700866680,1700877300,10620,62365,45016,IT,IT
34717,1699565100,1699594560,29460,73729,8340,TR,TR
49685,1700688000,1700726220,38220,14142,166010,MX,MX
32699,1700723580,1700742900,19320,90660,63415,FR,PL
169576,1699714740,1699730400,15660,13523,33469,CZ,UA
169462,1700109900,1700118900,9000,79681,194306,ES,ES
62570,1699231920,1699264740,32820,41982,156573,TR,TR
49402,1700354520,1700364960,10440,170339,125574,IT,IT
89745,1698921240,1698934800,13560,93906,161659,US,US
21014,1699153680,1699178700,25020,88207,196570,DE,DE
161325,1700785500,1700803260,17760,100494,98804,US,US
19643,1699457040,1699466640,9600,189270,21706,PT,PT
130432,1700549640,1700581740,32100,170748,93400,TR,TR
9027,1700468940,1700479620,10680,133055,56216,IT,IT
76899,1700132100,1700144460,12360,140198,184266,US,US
150707,1698956520,1698963540,7020,84874,3055,GB,GB
48,1700525940,1700529540,3600,34126,188864,GB,GB
85616,1700136000,1700148900,12900,76809,190732,IT,IT
41958,1700568540,1700598780,30240,178549,103595,TR,TR
115531,1700317560,1700346720,29160,52426,56497,TR,TR
74756,1699314840,1699330800,15960,79464,57830,FR,FR
57086,1700363700,1700371800,8100,166845,88808,EE,EE
166118,1700598840,1700629560,30720,15365,27389,TR,TR
180659,1700762820,1700786160,23340,138204,128919,RO,RO
194071,1700192640,1700226900,34260,129980,199892,MX,MX
152681,1699891380,1699925520,34140,17135,24302,TR,TR
100255,1700006520,1700016000,9480,1727,168367,IT,IT
124096,1699829940,1699858740,28800,100331,178354,TR,TR
113873,1698941460,1698948720,7260,94661,20137,IT,IT
82561,1699747380,1699758840,11460,179460,71352,IT,IT
2169,1699823220,1699833780,10560,140603,67595,IT,IT
135696,1699643580,1699647180,3600,117640,136130,NL,BE
85893,1700338560,1700371740,33180,46036,6731,TR,TR
120939,1700405340,1700438100,32760,118247,76674,TR,TR
118200,1700837040,1700869440,32400,68998,69601,TR,TR
85105,1700092560,1700104800,12240,187065,35664,US,US
55484,1700692920,1700706540,13620,170143,50275,SK,CZ
45210,1699193700,1699210740,17040,36194,39490,FR,FR
26490,1699244940,1699248540,3600,47355,44036,GB,GB
143987,1699001460,1699017300,15840,182497,10991,FR,FR
191603,1700457300,1700473740,16440,180593,17339,CZ,PL
71536,1698885240,1698891660,6420,75694,47434,GB,GB
39785,1699038660,1699044300,5640,122287,19520,GB,GB
72801,1700296440,1700312400,15960,833,189383,US,US
23199,1699052280,1699067700,15420,73041,191281,US,US
180819,1699247700,1699264500,16800,73983,186493,US,US
11794,1700203260,1700218740,15480,101072,403,US,US
51278,1700725560,1700740980,15420,75077,11895,US,US
155064,1699982280,1700012400,30120,176692,123886,TR,TR
157104,1699796580,1699810260,13680,93391,36195,IT,IT
134875,1700227200,1700236620,9420,124762,6981,HR,HR
96023,1700186940,1700217780,30840,117497,190783,TR,TR
24937,1700819940,1700823540,3600,108896,96018,GB,GB
58531,1700770560,1700799480,28920,145820,174129,TR,TR
125012,1699101420,1699130220,28800,81078,133021,TR,TR
183766,1700585580,1700618520,32940,31473,151985,TR,TR
13268,1699967700,1699992960,25260,147383,195146,PL,DE
169726,1699478520,1699490460,11940,1990,193524,IT,IT
26140,1700703540,1700739000,35460,35300,189973,TR,TR
54358,1700270160,1700275980,5820,186469,151699,NL,NL
13301,1699103340,1699116660,13320,91523,33851,IT,IT
119113,1700823060,1700855700,32640,166899,4059,TR,TR
120372,1699444800,1699471680,26880,196035,115665,RO,RO
16971,1699893600,1699897200,3600,9488,125389,NL,NL
130889,1699978380,1699993920,15540,154975,95628,AT,AT
81464,1699392720,1699427940,35220,53759,118956,TR,TR
58021,1699336260,1699353360,17100,88412,196527,CZ,CZ
154353,1699186200,1699189800,3600,133726,136577,GB,GB
192107,1700035020,1700068920,33900,186270,199325,TR,TR
100933,1699002960,1699006740,3780,60631,153547,FI,EE
85408,1700414760,1700418360,3600,23543,104245,GB,GB
190129,1700713860,1700737560,23700,119393,90921,PL,PL
162789,1699395960,1699404960,9000,17038,35311,PT,PT
173850,1699743780,1699759680,15900,19470,24286,CZ,DE
80165,1699430280,1699466220,35940,90816,124480,TR,TR
16009,1700802480,1700813100,10620,56926,136684,PT,PT
24952,1699648500,1699654380,5880,116760,100164,GB,GB
129805,1699151040,1699183440,32400,83920,46626,MX,MX
166786,1700423760,1700453580,29820,126958,87980,TR,TR
197727,1699349100,1699384080,34980,63700,196548,TR,TR
167424,1699921260,1699951560,30300,86994,84801,TR,TR
51518,1699522860,1699560780,37920,144436,84753,MX,MX
30696,1699972740,1699985520,12780,57255,108950,ES,ES
85109,1699354440,1699358040,3600,26358,69669,GB,GB
188719,1699243920,1699254300,10380,30431,65764,IT,IT
174996,1698924360,1698958260,33900,12455,171929,TR,TR
12146,1700599800,1700611200,11400,181296,108509,HR,ME
109877,1698827640,1698860220,32580,149770,148098,MX,MX
152075,1700259720,1700268060,8340,6077,147587,SK,AT
120455,1698929820,1698933420,3600,178749,144112,GB,GB
169610,1699427580,1699433640,6060,58512,156464,GB,GB
95020,1698987000,1699004580,17580,7121,124295,US,US
86637,1699437720,1699470960,33240,13921,137222,TR,TR
42982,1700749860,1700781900,32040,185776,161044,TR,TR
183686,1700523960,1700527560,3600,131414,127624,GB,GB
84714,1699950720,1699954800,4080,188756,162150,NL,NL
30615,1700233800,1700265240,31440,22625,66635,TR,TR
122,1699036380,1699070040,33660,108127,194103,TR,TR
147277,1699430100,1699465920,35820,121852,125249,TR,TR
65740,1699794720,1699826280,31560,18192,71878,TR,TR
121987,1700536320,1700552880,16560,94664,8079,US,US
76497,1699561560,1699595820,34260,184484,67597,TR,TR
106891,1699492380,1699505460,13080,112988,10616,IT,IT
197675,1700340660,1700375040,34380,81788,191915,TR,TR
15950,1698869280,1698904560,35280,144839,34064,TR,TR
49329,1700649600,1700685420,35820,67927,117180,TR,TR
106313,1699290000,1699321680,31680,171072,28084,TR,TR
54454,1699245120,1699249800,4680,168952,70313,GB,GB
61094,1699865460,1699876920,11460,113351,139544,AT,BG
164152,1698818760,1698828120,9360,52338,143125,IT,IT
32379,1699954320,1699957920,3600,152217,94723,NL,DE
146557,1699055580,1699073340,17760,110134,190848,US,US
166082,1698942540,1698965640,23100,108767,4405,PL,CZ
135965,1699938360,1699947420,9060,59140,179328,IT,IT
93480,1699201320,1699208160,6840,138681,24831,GB,GB
180498,1700039640,1700057100,17460,100415,151327,CZ,CZ
26919,1700642220,1700647980,5760,138534,59529,GB,GB
129090,1698919260,1698928800,9540,154594,169493,IT,IT
20710,1699510380,1699539660,29280,35876,9968,TR,TR
71746,1699885260,1699916280,31020,130012,39433,TR,TR
176613,1700718480,1700750400,31920,45300,64867,TR,TR
165524,1698961260,1698973800,12540,19656,84460,CA,US
173403,1699654080,1699683660,29580,19205,105338,TR,TR
189060,1699502100,1699505700,3600,198572,185796,NL,NL
163241,1700480040,1700484180,4140,23817,112700,GB,GB
152037,1700361840,1700367720,5880,144275,151573,AD,ES
125042,1699817880,1699853700,35820,98204,60432,TR,TR
120756,1700274120,1700277720,3600,138383,86655,GB,GB
124037,1699896420,1699913040,16620,9997,105968,US,US
90618,1698948600,1698980040,31440,164482,193338,TR,TR
82605,1699476000,1699480260,4260,74495,151331,GB,GB
128836,1699032300,1699067280,34980,124717,56096,TR,TR
24688,1700546640,1700566140,19500,38037,28275,BE,NL
162301,1700439540,1700457120,17580,128926,164371,FR,FR
65980,1700534100,1700546700,12600,32843,153514,US,US
128888,1698924000,1698958860,34860,126285,166156,TR,TR
193457,1700028600,1700035680,7080,97447,63905,GB,GB
139979,1699950300,1699985280,34980,136219,169822,TR,TR
93002,1699975740,1699979700,3960,75961,69460,GB,GB
92000,1698847320,1698878400,31080,180334,134828,TR,TR
5750,1700277780,1700281380,3600,2070,161845,GB,GB
173868,1699791540,1699797900,6360,23114,35153,NL,NL
57444,1700636160,1700648340,12180,129420,72897,ES,ES
151456,1699593720,1699603020,9300,182396,126141,HR,HR
191946,1700805300,1700837640,32340,13169,20860,TR,TR
168445,1700753460,1700771100,17640,50139,46441,RS,RS
152013,1700431740,1700463600,31860,60598,152390,TR,TR
114423,1700234640,1700243460,8820,154012,194662,IT,IT
116856,1700791260,1700802060,10800,164814,118860,IT,IT
21045,1699154100,1699158600,4500,90966,53553,GB,GB
21121,1700469120,1700504340,35220,51353,181943,TR,TR
186868,1699151340,1699184040,32700,64023,171186,TR,TR
84798,1698885780,1698936360,50580,146300,88083,BG,HU
64365,1699820940,1699829640,8700,151003,24994,IT,IT
164024,1698986100,1699020780,34680,62225,192957,TR,TR
109341,1698853080,1698877800,24720,53378,183842,DE,DE
112757,1699782900,1699793220,10320,1667,7260,IT,IT
143104,1699091400,1699120620,29220,5143,125417,TR,TR
15100,1699661940,1699693560,31620,121557,95629,TR,TR
16402,1699241460,1699274280,32820,59435,87128,TR,TR
96318,1698838020,1698861540,23520,155844,40020,PL,DE
1222,1700111940,1700144580,32640,14672,67730,TR,TR
193020,1700411520,1700424180,12660,47958,176666,HR,BA
7391,1699602240,1699616880,14640,173086,49326,BE,DE
7712,1700668920,1700701500,32580,194039,118060,MX,MX
69912,1700214180,1700227080,12900,108236,19526,US,US
108310,1700107560,1700114340,6780,160507,115778,GB,GB
99125,1700781300,1700813520,32220,78850,77437,TR,TR
59130,1700299380,1700331060,31680,47884,91559,TR,TR
65284,1700296140,1700300820,4680,182713,38141,NL,NL
136113,1700787600,1700811660,24060,139058,66432,MD,RO
167303,1700380080,1700383680,3600,99844,89699,NL,NL
84046,1700487180,1700509440,22260,105999,96319,BR,BR
98467,1700705220,1700718480,13260,17680,69300,IT,IT
157547,1700622600,1700626200,3600,16660,90983,GB,GB
170117,1700123340,1700131020,7680,149624,159413,PT,PT
132948,1700857080,1700892000,34920,156065,56365,TR,TR
150541,1700377560,1700410800,33240,182755,193816,TR,TR
11736,1699269840,1699273440,3600,33878,170793,NL,NL
3075,1700047500,1700074320,26820,158664,107288,PL,BE
35923,1699450260,1699469940,19680,83603,133339,FR,FR
28674,1699257660,1699288860,31200,28714,120847,TR,TR
19052,1699693020,1699703460,10440,27885,185501,IT,IT
40383,1699364400,1699380600,16200,64021,155464,AT,CZ
62174,1699935000,1699950960,15960,187397,90412,CZ,CZ
62412,1699336500,1699342740,6240,122179,36540,NL,NL
136823,1700541960,1700553420,11460,22090,58481,AT,AT
57408,1699882740,1699887900,5160,12890,61481,NL,NL
131675,1700242080,1700259420,17340,137632,20484,FR,FR
94149,1700705100,1700732040,26940,121259,161466,RO,ES
33607,1698983820,1699007700,23880,108737,10679,BR,BR
60996,1700124540,1700156580,32040,34249,13877,TR,TR
109057,1698885480,1698917160,31680,189164,108184,TR,TR
174826,1699669680,1699683360,13680,56186,87084,IT,IT
15933,1699744860,1699748460,3600,55807,87561,GB,GB
180352,1699438620,1699451340,12720,183296,95267,US,US
121584,1700735460,1700751240,15780,48492,51880,FR,FR
104858,1698857400,1698892860,35460,24382,166917,MX,MX
189244,1700681460,1700717760,36300,117176,43672,MX,US
79488,1699633380,1699642800,9420,184111,44091,IT,IT
84310,1699021620,1699027740,6120,96850,117547,GB,GB
123202,1699020780,1699046940,26160,194002,93610,DE,RS
182947,1700646000,1700677860,31860,95878,96973,TR,TR
8643,1699904160,1699915080,10920,144630,2449,HR,HR
42916,1698989160,1699023480,34320,70009,194106,TR,TR
60094,1699912500,1699930320,17820,142027,131120,US,US
117277,1700036820,1700063640,26820,83019,181709,DE,HU
179023,1700087100,1700099040,11940,75462,32222,AT,AT
147353,1700220780,1700256180,35400,15727,125763,TR,TR
5695,1699151280,1699156740,5460,113030,167986,GB,GB
130045,1700321700,1700355600,33900,163850,115410,TR,TR
135387,1699213200,1699249800,36600,46320,93763,MX,MX
157767,1699072680,1699105260,32580,162392,142891,MX,US
99487,1699659600,1699663200,3600,137404,188540,GB,GB
196631,1698971760,1698976620,4860,106461,167828,NL,NL
64602,1700842620,1700860380,17760,58988,165826,US,US
84667,1700055720,1700068320,12600,172072,186792,IT,IT
53257,1700070600,1700099940,29340,140734,99965,TR,TR
160523,1699980180,1699996800,16620,199268,36358,FR,FR
110550,1700567940,1700573400,5460,106963,99073,NL,NL
125084,1699030020,1699038480,8460,163213,118427,HR,HR
129789,1698827220,1698844380,17160,96524,17132,US,US
170242,1699440240,1699456500,16260,17163,115727,CZ,UA
137290,1700191680,1700207340,15660,148295,53661,FR,CZ
108089,1699835760,1699847280,11520,172075,108645,US,US
745,1700658720,1700688300,29580,6204,29882,TR,TR
101405,1699443600,1699460460,16860,90422,33167,FR,FR
115538,1699152960,1699191540,38580,165993,140916,MX,MX
30661,1699881300,1699916280,34980,153716,115489,TR,TR
113392,1699170240,1699186500,16260,157052,182063,US,US
35428,1700073720,1700108880,35160,102913,88807,TR,TR
192390,1700492400,1700506500,14100,186253,182015,CZ,CZ
16102,1699891320,1699896540,5220,73134,112482,GB,GB
58487,1699234440,1699238040,3600,144089,197087,NL,NL
155824,1700335140,1700352300,17160,176525,191080,US,US
192751,1700208540,1700241240,32700,84877,29615,TR,TR
135605,1700640540,1700647860,7320,161335,157639,ES,ES
197008,1700114400,1700135880,21480,15461,134464,FR,BE
83458,1698940200,1698946740,6540,18173,55109,EE,LT
79614,1700523240,1700556900,33660,117444,174427,TR,TR
48703,1700697780,1700714400,16620,79146,193390,US,US
119277,1700333340,1700349840,16500,26229,72783,US,US
132037,1700166780,1700175720,8940,113156,106470,HR,BA
175692,1699496940,1699503840,6900,24297,91332,GB,GB
134924,1700004540,1700034600,30060,184051,182408,TR,TR
169992,1700392080,1700410020,17940,103148,46200,US,US
119076,1700446080,1700478600,32520,72059,10487,TR,TR
22259,1699509000,1699512600,3600,94867,138324,NL,NL
163321,1700142840,1700171880,29040,31704,19874,TR,TR
72738,1699296600,1699326960,30360,164005,102795,TR,TR
73278,1700864460,1700877900,13440,38510,178296,RS,RS
156669,1698876720,1698908520,31800,13985,156197,TR,TR
6845,1700749860,1700761800,11940,47135,48593,CA,US
127548,1699720080,1699751100,31020,199510,192440,TR,TR
131381,1700540220,1700569380,29160,65244,15139,TR,TR
69577,1700187000,1700204100,17100,118642,147028,US,US
89684,1699624260,1699633320,9060,23945,187389,PT,PT
111025,1699347900,1699362780,14880,2193,89443,US,US
7187,1698980100,1698994020,13920,76168,125858,CZ,FR
32090,1699441800,1699445400,3600,23924,99385,GB,GB
126452,1698825000,1698859620,34620,158440,191908,TR,TR
141075,1699450620,1699485240,34620,101582,176765,TR,TR
167739,1700016480,1700036580,20100,187051,148641,FR,BE
51946,1700627160,1700642460,15300,159268,17076,US,US
79401,1700481240,1700513700,32460,145571,4763,TR,TR
75520,1700685960,1700702520,16560,20125,42493,CZ,CZ
81394,1700865240,1700897400,32160,190917,83342,TR,TR
121792,1699828020,1699839960,11940,32779,25729,IT,IT
127209,1699431480,1699462320,30840,34040,98781,TR,TR
115190,1699418160,1699430580,12420,158644,151339,US,US
171909,1699676880,1699684680,7800,169958,39268,IT,IT
168977,1700637180,1700640780,3600,1004,99130,GB,GB
106955,1699254060,1699269960,15900,59885,161795,FR,FR
19159,1700456940,1700492040,35100,129682,124479,TR,TR
34249,1700676600,1700706660,30060,21469,136474,TR,TR
24301,1700754300,1700762940,8640,82528,186680,ES,ES
153445,1700394780,1700398380,3600,61720,147737,NL,NL
128431,1700563740,1700579940,16200,189808,156062,US,US
63486,1700007540,1700063280,55740,94648,85689,BG,AT
6007,1699344900,1699349820,4920,61319,125148,GB,GB
157470,1698907980,1698912120,4140,153835,135365,NL,NL
35790,1700661420,1700695440,34020,196720,145006,MX,MX
158567,1700611680,1700623020,11340,191412,37790,US,US
44023,1700475660,1700481780,6120,65882,97995,GB,GB
54662,1700731020,1700745420,14400,54665,9082,US,US
148133,1699266540,1699278600,12060,30268,81823,IT,IT
119726,1699897140,1699908840,11700,10756,116165,US,US
28375,1700749860,1700764920,15060,51593,101193,US,CA
131367,1700176440,1700181780,5340,129977,153606,NL,NL
49336,1700224140,1700255400,31260,145282,164921,TR,TR
153376,1700678520,1700691300,12780,68815,27019,US,US
6879,1700113860,1700130060,16200,154338,172944,US,US
126639,1699255620,1699273440,17820,123229,53408,FR,FR
4789,1699374180,1699396560,22380,8417,98688,DE,CZ
77674,1699692540,1699696140,3600,50794,85959,NL,NL
74111,1700441940,1700445540,3600,4613,76186,GB,GB
164934,1699597800,1699633140,35340,37268,24809,TR,TR
114840,1699870320,1699900800,30480,55181,137819,TR,TR
90519,1699256460,1699267260,10800,57690,148706,US,US
78529,1700405880,1700441700,35820,128116,171240,MK,RS
465,1700371080,1700401980,30900,177181,127355,TR,TR
2681,1700562420,1700575260,12840,156179,157286,HR,HR
56057,1700425800,1700458380,32580,99141,112582,MX,MX
73500,1699846140,1699861080,14940,197027,27273,BE,FR
28403,1699274580,1699309380,34800,34498,66298,TR,TR
161548,1700687460,1700719260,31800,87711,21176,TR,TR
183800,1699157400,1699163940,6540,183672,9965,NL,NL
6771,1700224740,1700240100,15360,87440,164098,US,US
174331,1699605720,1699637400,31680,13918,2809,TR,TR
49585,1699880040,1699912440,32400,140880,97061,TR,TR
159737,1699690800,1699722720,31920,58860,87366,TR,TR
153327,1700812680,1700818260,5580,131217,174626,NL,NL
168626,1700371620,1700385600,13980,87049,182836,US,US
77193,1699079400,1699083600,4200,38788,159808,GB,GB
137020,1700292000,1700325900,33900,91078,38642,TR,TR
46211,1700856540,1700875140,18600,171154,52970,SE,SE
77505,1700141760,1700155860,14100,46067,113324,IT,IT
185781,1698927060,1698962700,35640,199833,20302,TR,TR
76019,1700047260,1700055720,8460,55618,112332,SK,SK
128657,1700565420,1700586240,20820,135562,39275,FR,FR
186272,1700288880,1700292480,3600,114028,24676,NL,NL
191856,1699728900,1699757520,28620,24200,32140,DE,DK
45421,1700708880,1700725380,16500,102850,28456,AT,AT
167454,1699444860,1699457040,12180,80798,12768,HR,HR
126302,1699756260,1699781700,25440,178868,173227,DE,BE
69592,1699226880,1699238520,11640,76926,190189,IT,IT
37545,1699012800,1699048620,35820,24956,84185,TR,TR
98091,1699099140,1699104360,5220,31058,1811,GB,GB
57029,1699009920,1699044840,34920,18387,185744,TR,TR
184522,1698914520,1698937200,22680,57012,42909,DK,DK
45402,1698988860,1699020660,31800,152843,77034,TR,TR
159963,1700148420,1700184180,35760,110116,59117,TR,TR
147664,1700670600,1700703060,32460,172967,181677,TR,TR
185679,1700678400,1700709060,30660,51500,54018,TR,TR
122264,1699377480,1699411080,33600,179827,107198,TR,TR
123861,1700082900,1700118660,35760,96641,197145,TR,TR
1122,1699203240,1699238460,35220,190934,140839,TR,TR
68758,1700729100,1700741160,12060,195940,123289,US,US
79358,1699752420,1699786560,34140,79541,133051,TR,TR
122927,1700468580,1700480520,11940,140943,177215,AT,DE
92218,1700031480,1700043240,11760,108042,132754,US,CA
154579,1700078700,1700090700,12000,168449,166013,AT,AT
33274,1699004700,1699016280,11580,96206,68193,US,US
83611,1699768140,1699771740,3600,21343,22869,GB,GB
164196,1700860860,1700873880,13020,69901,180341,AT,SK
107028,1700135400,1700170800,35400,54664,49858,TR,TR
93509,1699304700,1699334280,29580,181499,2069,TR,TR
138658,1698909900,1698946200,36300,1272,18920,MX,MX
196473,1700192280,1700201580,9300,142054,34087,HR,HR
30781,1699283280,1699286880,3600,96218,59982,GB,GB
30394,1699857180,1699891740,34560,72424,64106,TR,TR
143009,1699414380,1699445280,30900,64992,2638,BA,DE
174529,1700842500,1700858760,16260,36865,21783,FR,FR
124290,1700127540,1700157960,30420,95468,127383,TR,TR
61372,1700386140,1700389740,3600,136077,105296,NL,NL
67770,1699032780,1699044120,11340,161187,126810,AT,RO
2431,1699567500,1699571100,3600,110109,169906,GB,GB
160930,1699972080,1699988340,16260,95475,57664,US,US
20721,1699988640,1700006340,17700,199457,91341,US,US
154877,1699058700,1699090500,31800,177672,22076,TR,TR
122632,1700750640,1700784240,33600,158087,55720,TR,TR
178709,1699358580,1699371240,12660,61413,175921,US,US
72057,1698883560,1698901680,18120,71534,161501,FR,DE
92962,1699271220,1699285080,13860,53484,70329,IT,IT
181364,1698887280,1698905100,17820,11905,198609,FR,ES
76649,1700267160,1700284200,17040,135998,45570,RS,RS
186142,1700659260,1700675520,16260,164385,118960,RS,DE
99119,1700376240,1700409900,33660,10882,155558,TR,TR
69393,1700724120,1700756520,32400,5545,192082,TR,TR
23421,1699306080,1699310640,4560,74500,113152,GB,GB
48953,1700337060,1700368620,31560,70654,59361,TR,TR
86367,1700274060,1700286360,12300,75849,44586,HR,HR
175605,1700783040,1700813580,30540,30551,87675,TR,TR
14051,1699059120,1699065960,6840,76764,1777,EE,EE
50686,1699680960,1699691100,10140,17586,176886,CL,CL
162445,1700655660,1700686860,31200,88489,67405,TR,TR
34422,1700563620,1700597880,34260,95012,135095,TR,TR
67636,1700318580,1700342700,24120,73999,41724,SI,BA
173589,1699783920,1699801500,17580,53876,85036,AT,AT
34777,1699123980,1699127580,3600,139929,173512,GB,GB
196812,1700070240,1700073840,3600,144457,69552,GB,GB
177163,1699116240,1699138020,21780,163651,142432,DE,BG
149387,1699636500,1699645320,8820,109715,73462,IT,IT
1619,1699862640,1699897320,34680,198087,103921,TR,TR
90298,1700097360,1700109420,12060,170193,138812,ES,ES
89400,1700649480,1700660640,11160,135786,198155,US,US
20315,1700790660,1700806980,16320,94187,127411,CZ,PL
134512,1700096100,1700128800,32700,122565,146920,TR,TR
94521,1700637120,1700640720,3600,148903,37212,NL,NL
79404,1699394700,1699398300,3600,23327,50231,NL,NL
2951,1699617300,1699628400,11100,159171,24969,PT,PT
35524,1700246340,1700262000,15660,40636,39982,FR,FR
62734,1700039520,1700045460,5940,72342,41024,GB,GB
108251,1699035360,1699065720,30360,19282,132896,TR,TR
111630,1700676000,1700680680,4680,98890,136761,GB,GB
4105,1700321400,1700356620,35220,22840,3897,TR,TR
1580,1699150080,1699185240,35160,20743,20779,TR,TR
8959,1698849600,1698863400,13800,133213,10498,US,US
51163,1700319600,1700337180,17580,128598,31757,CZ,CZ
85448,1699875600,1699884360,8760,193546,40176,IT,IT
134521,1699599240,1699630260,31020,33977,14451,TR,TR
637,1700666760,1700671020,4260,75099,44753,GB,GB
12015,1699033920,1699065900,31980,142507,63653,TR,TR
167156,1698901440,1698931320,29880,178046,121156,TR,TR
49298,1699344120,1699377240,33120,4121,8876,TR,TR
67528,1700777220,1700789880,12660,149953,160274,US,US
104025,1700365860,1700378280,12420,60358,131131,US,US
50454,1700050980,1700080920,29940,143656,136321,TR,TR
11118,1700573160,1700609340,36180,107238,194602,MX,MX
54058,1698925500,1698929220,3720,40211,194077,NL,NL
166227,1698855360,1698858960,3600,106723,117342,GB,GB
88947,1700521320,1700554800,33480,153550,164074,TR,TR
171021,1699855260,1699875360,20100,162810,155119,FR,FR
3808,1700434680,1700448540,13860,178315,181081,US,US
15235,1700368920,1700381820,12900,19551,187448,IT,IT
89960,1698887880,1698914640,26760,192288,104546,BR,BR
150178,1699126920,1699141560,14640,139402,12297,AT,SK
21715,1699213980,1699220460,6480,50834,70657,NL,NL
104012,1699605480,1699633140,27660,106752,31344,RO,RO
194115,1699451460,1699485300,33840,153542,103506,TR,TR
84815,1699422840,1699458000,35160,134722,56617,TR,TR
9660,1700316900,1700355900,39000,66507,176065,MX,MX
137661,1699963860,1699975260,11400,38266,46647,IT,IT
108441,1699164900,1699194840,29940,15559,47921,TR,TR
196971,1699125660,1699148760,23100,144699,124393,DE,BG
98057,1698814860,1698851100,36240,16742,73260,MX,MX
1400,1700158440,1700191020,32580,13100,19478,TR,TR
7321,1699904220,1699932900,28680,105218,44317,DE,RS
167382,1698890460,1698900180,9720,15298,86443,IT,IT
106124,1699682940,1699699440,16500,160816,170261,US,US
151082,1699261800,1699275780,13980,165168,16652,US,US
23656,1700595720,1700630760,35040,191233,9829,TR,TR
118368,1700260020,1700293380,33360,52685,42795,TR,TR
156320,1699291980,1699307880,15900,162380,20126,US,US
6447,1700153880,1700184720,30840,106094,12506,TR,TR
116124,1698935820,1698971460,35640,130266,19803,TR,TR
145708,1700619720,1700623320,3600,93971,117022,NL,NL
28074,1698860160,1698883560,23400,56243,30212,HU,RS
42180,1699287000,1699290600,3600,86558,79469,NL,NL
173927,1699217700,1699231980,14280,194162,137489,HR,HR
164250,1699880760,1699893600,12840,20838,173431,IT,IT
81222,1699832700,1699867860,35160,196650,4045,TR,TR
57422,1700266680,1700283660,16980,91031,119165,US,US
30845,1700299080,1700305800,6720,196089,148322,NL,NL
73871,1699234200,1699240080,5880,199070,130453,NL,NL
51882,1700815320,1700844120,28800,153765,461,TR,TR
168401,1699138800,1699156200,17400,163644,134221,US,US
36622,1698918360,1698929280,10920,127392,127353,US,US
191386,1699501260,1699536240,34980,132600,105272,TR,TR
196597,1699120200,1699131000,10800,174852,186513,IT,IT
195622,1700480820,1700515080,34260,87626,47738,TR,TR
11249,1700725680,1700748960,23280,19178,118872,PL,DE
142468,1699786260,1699820580,34320,95560,84951,TR,TR
179920,1699519080,1699542780,23700,43656,24351,DE,CH
66672,1698851700,1698886560,34860,143493,4803,TR,TR
178634,1700621400,1700625000,3600,125969,102814,NL,NL
66962,1699820460,1699826940,6480,170559,71828,GB,GB
93201,1699754880,1699787880,33000,170080,7716,TR,TR
100172,1699872600,1699887360,14760,164869,66354,BE,NL
152679,1700259060,1700291520,32460,98076,177836,MX,US
2798,1699976040,1699991940,15900,171943,176434,US,US
63047,1699077120,1699111680,34560,159249,107946,TR,TR
163041,1699433700,1699460940,27240,184047,43722,DE,DE
104145,1700206080,1700218080,12000,110599,73762,IT,IT
60953,1700539380,1700569980,30600,43306,23606,TR,TR
54737,1700334000,1700359800,25800,103027,37513,PL,HU
109272,1700247420,1700281800,34380,30461,65200,TR,TR
135887,1699765500,1699782240,16740,90325,107700,FR,FR
124910,1699958640,1699972560,13920,175302,178040,IT,IT
22078,1700025000,1700035260,10260,185581,30526,IT,IT
104162,1699246320,1699255920,9600,32417,6248,IT,IT
129375,1700131320,1700170260,38940,191908,177523,MX,MX
176033,1700400420,1700434380,33960,72069,114068,TR,TR
135273,1699316100,1699353360,37260,132248,172404,MX,MX
48508,1699922880,1699957020,34140,158055,37289,TR,TR
54446,1700491620,1700503080,11460,108339,70548,IT,IT
8825,1699853400,1699857000,3600,182241,82858,GB,GB
176117,1700697720,1700701320,3600,58169,16574,GB,GB
100476,1699851600,1699862460,10860,46727,80381,IT,IT
112345,1699928220,1699962180,33960,158185,73156,TR,TR
131640,1700566140,1700597460,31320,179905,6514,TR,TR
31267,1699510500,1699542540,32040,116324,140818,TR,TR
182298,1699021320,1699026540,5220,179457,956,GB,GB
42300,1700171700,1700202240,30540,69737,170920,TR,TR
103532,1699884480,1699900380,15900,71107,42747,FR,DE
113252,1699469640,1699483320,13680,86700,111640,IT,IT
104797,1699480020,1699512900,32880,82517,86922,TR,TR
29599,1698856920,1698860520,3600,127370,152457,GB,GB
47616,1700162640,1700193480,30840,90569,41181,TR,TR
78261,1699703040,1699712580,9540,180628,4042,IT,IT
22953,1700693940,1700702820,8880,135757,178676,PT,PT
48368,1700029020,1700034960,5940,199680,31468,GB,GB
175949,1699197480,1699201080,3600,132263,71982,NL,NL
36035,1700711100,1700729460,18360,73059,147148,FR,FR
62284,1698835800,1698850200,14400,76185,156554,FR,FR
31879,1700081940,1700085540,3600,42877,43512,GB,GB
97223,1699406640,1699440840,34200,95430,9610,TR,TR
135938,1700742480,1700753040,10560,167011,85645,IT,IT
191716,1698905880,1698926220,20340,34860,53310,MD,RO
86383,1698896160,1698909420,13260,118648,34928,PT,PT
174234,1699338180,1699369560,31380,138180,82715,TR,TR
163341,1700100420,1700135880,35460,192145,14342,TR,TR
58017,1699702800,1699738680,35880,194974,54121,TR,TR
132751,1698896820,1698919140,22320,146483,182743,PL,PL
170584,1699868580,1699899900,31320,77251,163993,TR,TR
71062,1700115360,1700131380,16020,34935,38597,US,US
91203,1699961580,1699973280,11700,2867,537,PT,PT
159136,1700432940,1700443980,11040,116896,187230,US,US
180989,1699646160,1699667100,20940,661,194426,DK,RO
158983,1700026140,1700029740,3600,80570,146282,NL,NL
49460,1699452480,1699488360,35880,105726,143332,TR,TR
154864,1699209660,1699242720,33060,153414,86526,TR,TR
195373,1700813880,1700825640,11760,40236,124455,US,US
167555,1699223760,1699258440,34680,166201,65332,TR,TR
545,1699099500,1699103100,3600,6279,181553,NL,NL
11086,1699652340,1699687320,34980,105224,138061,TR,TR
37438,1699243980,1699267380,23400,91072,194297,BR,BR
52040,1700840580,1700895240,54660,177259,188139,BG,DE
75030,1700822940,1700851740,28800,35384,133701,TR,TR
84473,1699413840,1699424640,10800,51838,8875,IT,IT
171628,1699645740,1699656720,10980,33846,146797,PT,ES
137226,1699807080,1699858440,51360,2945,91738,BG,DE
7950,1699207740,1699239540,31800,1654,79419,TR,TR
114263,1700752140,1700786340,34200,14554,83447,TR,TR
23316,1699068540,1699095420,26880,125024,113359,DE,CZ
119386,1699306020,1699311420,5400,175153,165367,NL,NL
1090,1699369560,1699383480,13920,151170,84268,HR,HR
109752,1700806380,1700828460,22080,174965,28670,DE,FR
72637,1699190040,1699193640,3600,56524,107393,NL,NL
36342,1700049540,1700062740,13200,45968,106167,PT,PT
142982,1699290840,1699303680,12840,156407,36058,US,US
108122,1699566360,1699575840,9480,198867,136452,PT,PT
186313,1699808940,1699820100,11160,98845,36337,SK,SK
171418,1699176600,1699188300,11700,120886,190582,US,US
159308,1700315880,1700348220,32340,26405,14151,TR,TR
16669,1699939620,1699974720,35100,166188,61300,TR,TR
183049,1699163940,1699195500,31560,930,184132,TR,TR
54627,1700319780,1700355660,35880,34255,182237,TR,TR
140437,1699652220,1699674960,22740,42165,188932,PL,PL
51421,1700448900,1700454480,5580,12499,22523,EE,FI
80700,1699572180,1699578900,6720,184377,55939,EE,FI
139375,1699231860,1699266300,34440,149501,60697,TR,TR
21854,1699463220,1699517940,54720,140320,71633,BG,BG
130652,1699642680,1699657860,15180,165351,157873,RS,DE
24786,1700652180,1700668740,16560,88133,129293,SE,NO
123518,1699920720,1699925760,5040,125172,110629,GB,GB
193843,1700612940,1700619780,6840,159078,156574,NL,NL
58731,1700005440,1700019840,14400,151061,73228,RS,RS
147073,1700307720,1700311500,3780,47443,152594,GB,GB
71360,1698913800,1698924660,10860,171147,128828,IT,IT
12969,1699216860,1699226520,9660,189496,116143,IT,MK
39282,1699757520,1699793340,35820,48306,144856,TR,TR
169011,1699789320,1699801020,11700,161830,155930,US,US
169037,1699487340,1699515840,28500,20629,35511,BA,RS
4644,1699178220,1699191240,13020,131774,80621,US,US
98044,1699717500,1699728720,11220,131752,98290,IT,IT
55962,1700082060,1700114400,32340,41597,122419,TR,TR
75339,1699298340,1699318080,19740,124772,193735,FR,FR
182924,1700131980,1700163660,31680,76705,74805,TR,TR
149273,1699103760,1699117200,13440,193098,126364,US,US
88552,1699985340,1700018700,33360,43661,178700,TR,TR
165661,1700801340,1700808600,7260,29448,191129,IT,CH
34817,1698889980,1698922980,33000,137491,25434,TR,TR
161532,1700057820,1700091420,33600,103834,142297,TR,TR
124339,1699547280,1699572600,25320,107761,58639,PL,SK
158686,1699520220,1699531620,11400,62609,31962,HR,HR
84500,1700599740,1700633580,33840,182471,91504,TR,TR
53933,1700241840,1700251620,9780,33436,56928,HR,HR
105792,1699628760,1699633560,4800,7646,6916,GB,GB
184502,1698994980,1699007400,12420,184472,198847,US,US
173356,1699547940,1699551540,3600,45474,44232,GB,GB
11528,1700308860,1700315280,6420,51662,165213,GB,GB
169774,1699642860,1699646460,3600,75536,19966,GB,GB
105845,1700422260,1700473380,51120,62666,2199,BG,BG
150421,1700520480,1700528880,8400,33972,162534,IT,IT
40983,1700375040,1700404620,29580,47882,65528,TR,TR
133230,1700481420,1700504700,23280,64537,51033,PL,PL
81471,1700413920,1700448900,34980,143997,226,TR,TR
7021,1699507380,1699525800,18420,51790,199310,BE,NL
93139,1700363160,1700396820,33660,153449,187613,TR,TR
47848,1700242500,1700254080,11580,117208,114917,AT,DE
128905,1700245380,1700277060,31680,140867,10405,TR,TR
21726,1700206680,1700237400,30720,74186,142928,TR,TR
140714,1699689180,1699710300,21120,101148,118383,BE,NL
19011,1700572920,1700602680,29760,110954,117783,TR,TR
125857,1698997740,1699022700,24960,122536,112593,DE,RS
56545,1700054580,1700066220,11640,98823,192362,IT,IT
149685,1700190360,1700207820,17460,65580,176954,CZ,HU
157253,1699093440,1699102800,9360,192320,147650,EE,EE
14016,1699010160,1699042380,32220,76246,67401,TR,TR
40246,1700657700,1700673060,15360,51530,199025,SE,SE
197676,1700007360,1700030100,22740,11851,174726,BR,BR
148331,1699917840,1699922760,4920,87074,12848,GB,GB
100329,1699010280,1699045980,35700,109476,18903,TR,TR
94388,1699077600,1699089300,11700,185901,176799,US,US
131734,1698929700,1698945360,15660,184935,82815,CZ,CZ
90106,1698832980,1698837840,4860,14650,948,GB,GB
116837,1699702440,1699731360,28920,195070,182584,TR,TR
145599,1700323440,1700348820,25380,189396,180059,DE,UA
51272,1699270800,1699303860,33060,22886,161458,TR,TR
189165,1699874880,1699905360,30480,181716,165545,TR,TR
180669,1699209060,1699238220,29160,92710,163153,TR,TR
61748,1699929720,1699942800,13080,28041,84407,US,US
190617,1699505040,1699561080,56040,112964,147463,BG,DE
160437,1699696620,1699704360,7740,1614,193741,IT,FR
95061,1700326320,1700361720,35400,90414,92010,TR,TR
136100,1700554800,1700577720,22920,43142,147668,DK,DK
80343,1700332620,1700336220,3600,1880,17126,NL,NL
4755,1700790300,1700826480,36180,30441,51004,MX,MX
21671,1699266420,1699274280,7860,67598,197302,ES,BE
101409,1699638300,1699650180,11880,192502,150353,RS,MK
199277,1700473920,1700479020,5100,198349,171599,GB,GB
74864,1698830880,1698865500,34620,38549,155380,TR,TR
62691,1700766180,1700780880,14700,166002,153675,RS,RS
16921,1700717640,1700728080,10440,61192,151820,IT,IT
23394,1700230320,1700246400,16080,193672,67047,US,US
198712,1699632060,1699636560,4500,153339,178858,EE,LT
27022,1699445700,1699461480,15780,150068,132260,FR,FR
40485,1699655760,1699685820,30060,45919,131009,TR,TR
182180,1699104720,1699135080,30360,50822,120072,TR,TR
30532,1698882420,1698893340,10920,113410,122683,US,US
81736,1698943020,1698974880,31860,48435,154455,TR,TR
178383,1699167120,1699179840,12720,78646,144052,US,US
39737,1700004900,1700039400,34500,199296,60641,TR,TR
110748,1700685000,1700696340,11340,127259,143191,CZ,CZ
76638,1699558380,1699593240,34860,172672,117469,MX,MX
135221,1700692140,1700695740,3600,187044,75931,GB,GB
172534,1699477920,1699496100,18180,181550,154231,FR,ES
174999,1700109780,1700134500,24720,43315,172951,DE,AT
24289,1699049520,1699057680,8160,100020,29962,IT,IT
23090,1699700520,1699704120,3600,130039,130759,GB,GB
74298,1700834700,1700872380,37680,148035,43952,MX,MX
77837,1700266440,1700284860,18420,81132,36571,FR,DE
21403,1700224020,1700237040,13020,106767,112980,HR,HR
113020,1699599120,1699603140,4020,123557,198863,NL,NL
55725,1700435040,1700468880,33840,32066,98127,TR,TR
169830,1700396220,1700399820,3600,77509,191142,GB,GB
95566,1700201520,1700230980,29460,13498,135873,TR,TR
66648,1700496780,1700509560,12780,82924,129657,HR,HR
48930,1699726740,1699756980,30240,46624,123730,TR,TR
42227,1699906500,1699920720,14220,176287,192550,IT,IT
158534,1700059560,1700063340,3780,166028,25631,NL,NL
174418,1700767500,1700803440,35940,122966,37236,TR,TR
102646,1699555980,1699591440,35460,33866,68350,TR,TR
14252,1699729800,1699743420,13620,20862,185149,US,US
107291,1699887900,1699896300,8400,159336,91927,IT,IT
176894,1700142840,1700178720,35880,125466,70860,TR,TR
176739,1698930120,1698960900,30780,130358,154597,TR,TR
187184,1699337460,1699341060,3600,98129,106246,NL,NL
129112,1699520940,1699553100,32160,111852,90861,TR,TR
142225,1700054100,1700068980,14880,77964,152538,AT,LV
12103,1700821800,1700825400,3600,119085,118946,NL,NL
159538,1699830240,1699859580,29340,104098,192774,TR,TR
34031,1698903540,1698915360,11820,124890,41823,US,US
186981,1700777280,1700808180,30900,181587,57742,TR,TR
99268,1700033700,1700037300,3600,152837,122948,GB,GB
171754,1700251140,1700263800,12660,121237,155524,US,US
134598,1700181180,1700214180,33000,123053,168322,TR,TR
126519,1700649660,1700682240,32580,115059,91211,TR,TR
137486,1699884000,1699891260,7260,61941,158863,HR,HR
19223,1700151420,1700156580,5160,45041,107380,NL,NL
116731,1700430360,1700463900,33540,59071,156348,TR,TR
148051,1699866720,1699895880,29160,126411,111765,TR,TR
190618,1699502160,1699506300,4140,172914,63535,AD,FR
120012,1700436480,1700469360,32880,182778,51412,TR,TR
37714,1699142940,1699177740,34800,188685,22321,TR,TR
54703,1700289060,1700306820,17760,194186,195167,US,US
93148,1698878700,1698891720,13020,123159,103367,US,US
183208,1700709420,1700737800,28380,144250,160354,RO,RO
128463,1700840520,1700846700,6180,190071,70698,GB,GB
197394,1700550660,1700565900,15240,53521,59986,AT,AT
165151,1700412300,1700446320,34020,96624,141771,TR,TR
80870,1699562220,1699597440,35220,130949,69956,TR,TR
167595,1700311800,1700319060,7260,111693,92462,HR,HR
87904,1699111680,1699123380,11700,87807,187192,PT,PT
28491,1699476480,1699490340,13860,92883,141376,IT,IT
89130,1699426320,1699429920,3600,74927,86465,NL,NL
140124,1700782980,1700796720,13740,190302,31551,IT,CH
97212,1700115360,1700118960,3600,179994,195681,NL,NL
192507,1698812340,1698836040,23700,101505,160720,RO,RO
149857,1700019600,1700046660,27060,185148,92662,PL,PL
147171,1698871140,1698906420,35280,68866,131570,TR,TR
131912,1699642320,1699677540,35220,130867,41435,TR,TR
144675,1700562420,1700566020,3600,174411,81738,NL,NL
124502,1700823180,1700854740,31560,130902,27308,TR,TR
49786,1699903140,1699933200,30060,29016,86000,TR,TR
59669,1699015560,1699049580,34020,5857,37413,TR,TR
122157,1699507680,1699543500,35820,116718,185690,TR,TR
2470,1700468760,1700484300,15540,60307,109790,FR,FR
93446,1699788000,1699822980,34980,194776,35910,TR,TR
67304,1700043060,1700046780,3720,25255,47275,GB,GB
185105,1699634160,1699647540,13380,85805,155842,RS,RS
88684,1699184280,1699198080,13800,130612,48134,US,US
143173,1699098300,1699119600,21300,140911,160855,AL,BA
187008,1699777800,1699808640,30840,45488,20463,TR,TR
71108,1699332480,1699350360,17880,140649,92986,BE,NL
15937,1700195760,1700210460,14700,43321,35946,US,US
94208,1700718300,1700754060,35760,116708,151033,TR,TR
134271,1699219740,1699249680,29940,178253,134710,TR,TR
55883,1699533120,1699537920,4800,90260,126530,NL,NL
3673,1699720320,1699744320,24000,33461,149354,RO,RO
61583,1698884820,1698890400,5580,99533,114499,NL,NL
112188,1700032500,1700060280,27780,119497,196515,DE,DE
119196,1699713120,1699726320,13200,46014,75065,PT,PT
56032,1699479060,1699488480,9420,187377,186244,IT,IT
167607,1699480500,1699495320,14820,150966,25095,US,US
147778,1700774940,1700785020,10080,81722,162277,IT,IT
87532,1698911700,1698922680,10980,187844,143930,IT,IT
161622,1700466840,1700471160,4320,10181,186269,NL,NL
103158,1700091840,1700124720,32880,144227,69602,TR,TR
28138,1699148040,1699151640,3600,125422,84939,GB,GB
128567,1700496120,1700501160,5040,120656,91177,NL,FR
173714,1700112720,1700116320,3600,175429,26216,GB,GB
196626,1700372700,1700390160,17460,36238,3075,US,US
83391,1699356720,1699368540,11820,10855,189591,US,US
84048,1698911880,1698928080,16200,158714,31485,CZ,CZ
41155,1699848060,1699871100,23040,62731,139918,DE,AT
116243,1699424340,1699455720,31380,105567,128991,TR,TR
162631,1699538580,1699545960,7380,125497,130745,IT,IT
161085,1699690380,1699724460,34080,90233,45300,TR,TR
146520,1700846040,1700849640,3600,131124,102119,GB,GB
165981,1699983600,1700018760,35160,43323,71826,MX,MX
49130,1699077420,1699099680,22260,145527,164791,PL,NL
161848,1699293900,1699305540,11640,41310,88543,IT,IT
127489,1700034540,1700050320,15780,134781,192276,AT,SK
14342,1698871200,1698902940,31740,90303,133541,TR,TR
48376,1699794180,1699797780,3600,133179,98721,NL,NL
4734,1699991580,1699996920,5340,28327,71056,GB,GB
49948,1699425780,1699455960,30180,88689,103124,TR,TR
58843,1700689080,1700701140,12060,85044,57530,US,US
31563,1700690640,1700725500,34860,53509,177547,TR,TR
144004,1700063220,1700071020,7800,104452,197803,ES,ES
122751,1700193540,1700205600,12060,20127,134627,CZ,CZ
43633,1699804920,1699820340,15420,42565,161096,RS,RS
27057,1698829920,1698833520,3600,167211,58295,GB,GB
70016,1699528620,1699562760,34140,28365,60877,TR,TR
107330,1700575440,1700589960,14520,162962,60990,US,US
64355,1698809760,1698838320,28560,6368,18450,DE,IT
180616,1700242140,1700247720,5580,172810,177338,GB,GB
25582,1699622340,1699637220,14880,5052,15292,US,US
157231,1700547000,1700579040,32040,116077,106982,TR,TR
189274,1698852660,1698885180,32520,53615,145005,TR,TR
110595,1699160460,1699195320,34860,129958,108246,TR,TR
16907,1699413660,1699419240,5580,179025,94148,NL,NL
67555,1700538780,1700549100,10320,61614,194730,IT,IT
178648,1700464740,1700496780,32040,48119,22301,TR,TR
157664,1699060500,1699076280,15780,181620,61226,FR,FR
102111,1700335080,1700367780,32700,82638,31717,TR,TR
133321,1700599080,1700602680,3600,169130,4365,GB,GB
118664,1699420200,1699450440,30240,115006,181364,TR,TR
195430,1699488840,1699492440,3600,186528,199200,EE,EE
54982,1700813820,1700847840,34020,69140,190022,TR,TR
44161,1700064000,1700093400,29400,79070,89180,TR,TR
70699,1699418160,1699448700,30540,85316,167141,TR,TR
57339,1699158600,1699173840,15240,44564,38726,US,US
38973,1699509960,1699540680,30720,91923,36737,TR,TR
139082,1700091720,1700124780,33060,90027,136418,TR,TR
115073,1700668200,1700703480,35280,82443,168097,TR,TR
55789,1700744340,1700774040,29700,133855,82202,TR,TR
165798,1698871500,1698876840,5340,123262,162942,GB,GB
81072,1698893340,1698908520,15180,94563,198973,US,US
72121,1699316220,1699348680,32460,124742,192057,MX,MX
129284,1700716860,1700731140,14280,149106,157735,US,US
68944,1699665900,1699672500,6600,91622,23283,GB,GB
58813,1700621880,1700637360,15480,87416,185913,US,US
33386,1699527300,1699535760,8460,80721,26240,EE,EE
140905,1700195280,1700218140,22860,58700,185079,DE,PL
159046,1699521420,1699552620,31200,188972,130792,TR,TR
60517,1699587840,1699606980,19140,94585,148894,FR,PT
32590,1700243100,1700273160,30060,183434,141790,TR,TR
73101,1700795340,1700812740,17400,23859,79628,US,US
102474,1700308440,1700329440,21000,9200,7424,FR,BE
152773,1699305180,1699317060,11880,102446,182171,US,US
39382,1698821940,1698851940,30000,27940,132715,TR,TR
137170,1699348920,1699380000,31080,45836,25103,TR,TR
127686,1700380380,1700398200,17820,99854,11323,CZ,SK
272,1699078080,1699091100,13020,131018,15442,HR,HR
7791,1699761000,1699794000,33000,44895,58876,TR,TR
62359,1699909920,1699945080,35160,64872,168976,TR,TR
2941,1698831120,1698834720,3600,78663,81995,GB,GB
22899,1698927540,1698931140,3600,75422,146903,GB,GB
67589,1700139120,1700151720,12600,145988,7225,US,US
4316,1699312860,1699326720,13860,148974,119985,IT,IT
119943,1699648380,1699655400,7020,167678,141284,NL,NL
148129,1700806560,1700838900,32340,59526,122894,TR,TR
120752,1699773720,1699807920,34200,39119,185561,TR,TR
146138,1699845120,1699857900,12780,135190,2593,IT,IT
117611,1698883620,1698922380,38760,151,189887,MX,MX
142070,1699329240,1699342560,13320,165207,58647,US,US
160006,1699249440,1699259160,9720,120073,17523,PT,PT
148681,1698919500,1698932760,13260,26821,189036,PT,PT
171248,1700665980,1700669580,3600,185205,104300,NL,NL
189327,1699280520,1699312560,32040,13963,60295,TR,TR
179436,1699867320,1699901820,34500,174462,181044,TR,TR
147147,1699074540,1699109040,34500,92424,153217,TR,TR
20548,1698912840,1698925500,12660,164097,12307,PT,PT
109999,1698922920,1698935040,12120,147099,112396,US,US
101416,1699387080,1699402440,15360,70019,37751,US,US
169258,1700685360,1700698560,13200,44769,44980,RS,RS
52955,1700345700,1700375460,29760,173678,83830,TR,TR
79769,1699456980,1699470180,13200,107904,198957,RS,RS
87776,1700197320,1700209500,12180,152247,130416,IT,IT
73587,1700321820,1700352180,30360,173397,7655,TR,TR
73829,1700533080,1700546640,13560,184991,128961,AT,AT
169360,1699144440,1699198740,54300,52867,34681,UA,CZ
150308,1700449620,1700466840,17220,183940,38751,US,US
31925,1700865900,1700876940,11040,3906,129894,US,US
146274,1699462560,1699493400,30840,44058,65050,TR,TR
32134,1700580960,1700584560,3600,167120,25522,GB,GB
20078,1699356240,1699383600,27360,104030,36332,DE,DE
177648,1699014300,1699021080,6780,189681,159439,GB,GB
193678,1699699620,1699709040,9420,194056,28318,HR,BA
138541,1700599260,1700611320,12060,190046,167142,IT,IT
7306,1699896780,1699910520,13740,28464,161478,US,US
35765,1700451600,1700465160,13560,133740,173618,IT,IT
124184,1700614980,1700645280,30300,184559,54576,TR,TR
22903,1700155200,1700193000,37800,43437,127117,MX,MX
60949,1699906740,1699919820,13080,97580,157337,IT,IT
109270,1700575200,1700580960,5760,190937,174493,GB,GB
86909,1700633760,1700639400,5640,93212,93216,GB,GB
113218,1699318620,1699325760,7140,50960,105264,GB,GB
5873,1700396040,1700410740,14700,187011,123537,US,US
114313,1700758020,1700788380,30360,79052,146307,TR,TR
46175,1700603700,1700620380,16680,118405,37606,US,US
182851,1699088580,1699110780,22200,140380,104109,BR,BR
30028,1699313220,1699327020,13800,38246,173447,HR,HR
81889,1699121340,1699131060,9720,66400,102287,IT,IT
12125,1700254440,1700265540,11100,28329,117306,IT,IT
59923,1698798360,1698814500,16140,177386,174193,US,US
164746,1699427220,1699458060,30840,40033,190764,TR,TR
166228,1699058640,1699072740,14100,189372,906,US,US
162255,1699563480,1699592160,28680,156580,175179,PL,PL
31947,1700279460,1700289900,10440,29262,49846,IT,IT
113286,1700313000,1700327520,14520,148916,163299,US,US
78069,1699266960,1699288380,21420,55329,31536,SE,SE
171567,1700445120,1700461860,16740,152454,78285,US,US
14240,1700786220,1700821800,35580,35003,188930,TR,TR
75025,1699027680,1699059420,31740,47010,13666,TR,TR
27850,1698893580,1698928860,35280,25284,24462,TR,TR
110632,1700009820,1700021760,11940,98939,2496,US,US
154265,1699696680,1699706280,9600,130728,85429,IT,IT
37569,1699212840,1699242060,29220,29403,22487,TR,TR
159804,1698963960,1698980940,16980,119602,116753,US,US
2287,1700184720,1700214240,29520,20741,111719,TR,TR
134902,1699495500,1699504440,8940,114951,22483,IT,IT
46685,1699513140,1699526160,13020,74984,11318,RS,RS
135341,1699621680,1699653540,31860,114591,149507,BA,HR
180335,1699611000,1699640400,29400,63771,124860,TR,TR
104685,1700093220,1700123340,30120,133890,69102,TR,TR
59830,1699477140,1699512960,35820,182625,14421,TR,TR
131020,1699752060,1699756200,4140,145190,38457,NL,NL
142736,1700801880,1700820360,18480,122380,54485,FR,GB
83320,1699369980,1699386720,16740,111447,117518,US,US
149959,1699679160,1699695660,16500,101555,71405,FR,CH
157454,1699908900,1699939920,31020,108283,176111,TR,TR
36753,1700303400,1700313780,10380,181306,197192,IT,IT
81563,1698888900,1698893880,4980,195268,91141,NL,NL
136114,1698911280,1698943080,31800,69655,155671,TR,TR
79157,1700755020,1700783580,28560,123182,178966,DE,UA
11205,1698826980,1698861600,34620,135646,33815,MX,MX
52982,1700200020,1700203620,3600,123316,119089,NL,NL
95976,1699537140,1699550220,13080,82338,185372,PT,PT
47299,1700494140,1700525460,31320,89667,178252,TR,TR
143890,1699274400,1699279560,5160,4968,34009,GB,GB
108497,1699895640,1699929000,33360,155832,106259,TR,TR
48386,1699899840,1699929900,30060,21337,879,TR,TR
134489,1699424340,1699427940,3600,146594,163226,GB,GB
137905,1699747200,1699781700,34500,4586,26897,TR,TR
31395,1698829920,1698860520,30600,35481,114686,TR,TR
93215,1699051980,1699063320,11340,40039,85837,IT,IT
121498,1700701980,1700728860,26880,26588,22720,BR,BR
168312,1699404840,1699409280,4440,152429,175884,GB,GB
39313,1700612220,1700620800,8580,112406,162965,ES,AD
155420,1698865080,1698897180,32100,146625,92407,TR,TR
150649,1699256460,1699291320,34860,127779,138939,TR,TR
10867,1699792680,1699824480,31800,199631,79103,TR,TR
113068,1699182240,1699193760,11520,191504,34476,IT,FR
186928,1700273640,1700281140,7500,36876,24795,IT,IT
132906,1700660640,1700696160,35520,112895,107197,TR,TR
149718,1698877320,1698884640,7320,186859,63151,IT,IT
13733,1700229600,1700264400,34800,179312,52580,TR,TR
150793,1700555520,1700559420,3900,25330,123966,GB,GB
109556,1700209200,1700244300,35100,56828,123202,TR,TR
4207,1700798820,1700827560,28740,125059,40173,DE,HR
128672,1698866220,1698871200,4980,83023,121266,AD,FR
35413,1699970040,1699979460,9420,139300,187476,ES,RO
15029,1700015040,1700022120,7080,110422,121548,NL,DE
62542,1700383380,1700407740,24360,79491,83745,RO,DK
104237,1700749380,1700768640,19260,80505,33660,FR,BE
3174,1700819220,1700829060,9840,84346,11504,IT,IT
98305,1700599860,1700603460,3600,60040,84161,GB,GB
69657,1700753700,1700776800,23100,100941,150191,PL,PL
74195,1699098960,1699111980,13020,2231,86810,AT,DE
194441,1699724340,1699738980,14640,74460,5770,US,US
134634,1699028820,1699040640,11820,49110,74807,US,US
174006,1699265880,1699276500,10620,71581,159349,EE,FI
127689,1699585020,1699593300,8280,107616,153557,HR,HR
77889,1699625100,1699660560,35460,137345,50148,TR,TR
125766,1699979220,1699982820,3600,75586,183489,NL,DE
138935,1700628420,1700658540,30120,98030,48074,TR,TR
43561,1699632360,1699646460,14100,152301,176844,US,US
164417,1699064220,1699084260,20040,85801,146852,DK,DK
195445,1700230740,1700261220,30480,12620,2640,TR,TR
174516,1698919020,1698954420,35400,96630,104796,TR,TR
74772,1699995840,1700006700,10860,106691,141774,CZ,CZ
66559,1700600820,1700604420,3600,94324,127109,GB,GB
192931,1698898860,1698907380,8520,32713,179262,ES,ES
50107,1700205120,1700211480,6360,29457,4597,EE,EE
156250,1700389980,1700395500,5520,71935,8789,GB,GB
142860,1700519040,1700536380,17340,109541,157314,AT,BG
169765,1698857280,1698868560,11280,127170,164312,HR,HR
52857,1700183280,1700212440,29160,4673,24709,TR,TR
122606,1700802120,1700815980,13860,130210,23585,HR,HR
179970,1699398000,1699411860,13860,114742,147403,IT,DE
76228,1699023660,1699036560,12900,169325,123682,AT,SK
66320,1700814960,1700827980,13020,116698,109713,PT,PT
186360,1699157880,1699193700,35820,6222,127969,TR,TR
57416,1700507940,1700521500,13560,95454,19810,CA,CA
55876,1700483160,1700544120,60960,74198,144850,UA,PL
6114,1698965760,1698969480,3720,157957,96264,GB,GB
44480,1700459400,1700490360,30960,101362,194648,TR,TR
41126,1699424580,1699441740,17160,190622,11670,CA,CA
164764,1700813220,1700848800,35580,177710,172908,TR,TR
109489,1699470000,1699498320,28320,190403,128162,BA,HR
46005,1699544640,1699548240,3600,12938,150068,GB,GB
18576,1700776920,1700791260,14340,83339,119448,AT,HU
177991,1699995360,1700029080,33720,105614,126768,TR,TR
140327,1700361360,1700376720,15360,192680,85450,AT,AT
80691,1699003020,1699013040,10020,20778,139393,PT,PT
117755,1699200900,1699214040,13140,146100,48652,IT,FR
191369,1699559820,1699599060,39240,174272,63848,MX,MX
153303,1700686860,1700701800,14940,51311,82063,CA,CA
65975,1699121280,1699130160,8880,179049,127215,IT,IT
70781,1700439420,1700470920,31500,149641,185478,TR,TR
12615,1700302800,1700312820,10020,1359,176609,IT,IT
124923,1699534800,1699552260,17460,14929,122305,US,US
98064,1699058820,1699064100,5280,118651,157120,GB,GB
193137,1699195320,1699226580,31260,131896,73561,TR,TR
174106,1699466520,1699489560,23040,123767,18864,BR,BR
76436,1700708760,1700719980,11220,34799,111577,ES,AD
163,1699284900,1699293540,8640,122892,59279,ES,ES
89697,1698883560,1698913500,29940,47570,192414,TR,TR
169634,1699812960,1699837320,24360,101002,4236,DE,DE
152513,1699850580,1699867380,16800,199574,118929,US,US
37165,1699883280,1699912320,29040,192666,91858,TR,TR
50733,1699910160,1699943400,33240,124150,16978,TR,TR
109373,1700740200,1700763360,23160,3762,164557,DE,HR
125430,1700441880,1700458920,17040,72472,38102,FR,AD
57749,1700750280,1700782260,31980,124639,166781,TR,TR
196696,1699177860,1699207740,29880,181354,108538,TR,TR
165271,1699836840,1699869720,32880,94431,43872,TR,TR
131617,1699173360,1699181640,8280,86890,56524,IT,IT
2142,1700163420,1700167020,3600,4682,165146,GB,GB
193559,1699167120,1699177980,10860,65869,41920,IT,IT
163829,1700525340,1700533620,8280,155707,166361,PT,PT
152954,1700339160,1700344500,5340,160129,64088,GB,GB
126152,1699769760,1699773360,3600,90289,74336,GB,GB
36025,1700120580,1700146740,26160,119118,167901,DE,NL
198511,1699363740,1699391220,27480,136195,199222,DE,BA
92972,1700286960,1700314800,27840,197885,56247,DE,DE
70641,1699872780,1699885020,12240,111786,182980,PT,PT
130840,1700510760,1700524680,13920,18585,9807,CZ,CZ
142398,1698962100,1698976140,14040,111175,119502,US,US
129158,1700674800,1700680740,5940,7898,104974,GB,GB
126025,1700184180,1700192880,8700,47574,150619,IT,IT
156737,1699033020,1699036620,3600,165612,117294,GB,GB
51839,1699201380,1699211220,9840,8010,46419,IT,IT
80069,1699018440,1699049100,30660,199010,116788,TR,TR
154060,1700041020,1700065740,24720,109412,52060,DE,DE
157276,1699953660,1699986900,33240,14141,78768,TR,TR
131643,1700140020,1700174940,34920,143912,127540,TR,TR
49358,1700438940,1700442540,3600,70663,176888,GB,GB
147028,1700288640,1700292240,3600,164538,15087,GB,GB
142907,1699225260,1699258980,33720,175243,43279,TR,TR
2701,1700802720,1700838360,35640,178134,76064,MX,US
52444,1699821420,1699842840,21420,100634,63600,DK,DK
24929,1700764500,1700797380,32880,109924,23799,TR,TR
18747,1699307280,1699317420,10140,92528,99101,EE,EE
70320,1700733660,1700749260,15600,172586,150416,AT,DE
19563,1698928680,1698946260,17580,8496,9455,BE,FR
81746,1699949460,1699966740,17280,117138,28219,FR,FR
140631,1700149680,1700160840,11160,170243,132718,IT,IT
154216,1699601280,1699632360,31080,3181,162015,TR,TR
104778,1699958880,1699981320,22440,51336,86232,HU,BG
108396,1699739880,1699773060,33180,105467,57979,MX,MX
141638,1699947240,1699980420,33180,154689,119896,TR,TR
144751,1700311980,1700320200,8220,50084,104496,IT,IT
184921,1699583760,1699607700,23940,95215,162391,AL,BA
165781,1700058840,1700093400,34560,82589,61587,TR,TR
48531,1699471740,1699502280,30540,126282,190130,TR,TR
56681,1700782620,1700788020,5400,159306,38099,GB,GB
161987,1699365300,1699372680,7380,101024,164863,HR,HR
54303,1700111940,1700124660,12720,148742,7315,IT,IT
77920,1700536560,1700559240,22680,506,104590,PL,PL
148522,1700377620,1700382120,4500,192920,173087,NL,NL
30027,1699355640,1699359240,3600,65894,126189,GB,GB
149531,1699973820,1700009700,35880,101157,8283,TR,TR
167116,1699383180,1699387080,3900,115544,76952,GB,GB
82250,1700123760,1700128080,4320,142219,60880,GB,GB
120616,1699609080,1699622760,13680,18460,196462,IT,IT
120780,1699044180,1699059180,15000,11007,190762,US,US
165042,1698930720,1698942420,11700,15837,53316,US,US
148929,1699899720,1699903320,3600,30539,79926,GB,GB
23425,1700082900,1700092260,9360,179143,40379,HR,BA
74464,1699624680,1699628280,3600,60037,82631,NL,NL
194668,1699330620,1699343760,13140,123615,36444,HR,BA
87841,1699731900,1699760700,28800,18150,90806,TR,TR
81410,1699003680,1699007280,3600,57574,855,GB,GB
31726,1699890360,1699893960,3600,172638,163853,GB,GB
144260,1700472540,1700506620,34080,127735,184963,TR,TR
47382,1698980220,1699014480,34260,105960,79782,TR,TR
141288,1699716900,1699741620,24720,17437,69232,PL,HR
195147,1699576440,1699587240,10800,3402,161236,US,US
195270,1700635080,1700665260,30180,88852,74763,TR,TR
79972,1699407420,1699424880,17460,142714,50989,US,US
33536,1699348680,1699361400,12720,140047,135584,US,US
103752,1698901980,1698915720,13740,96377,58238,RS,RS
7344,1700112900,1700127240,14340,79675,141987,IT,IT
2819,1700079420,1700104260,24840,84904,39905,DE,AT
44869,1700325360,1700352060,26700,115820,5265,BA,BA
85218,1700372940,1700408280,35340,75879,55540,TR,TR
182920,1699055640,1699066740,11100,75892,90184,IT,IT
46472,1699491360,1699508220,16860,25359,65955,AT,AT
187968,1699813980,1699817580,3600,69492,10459,GB,GB
132829,1698799920,1698806580,6660,45396,167895,GB,GB
1067,1700183280,1700196000,12720,165684,20697,US,US
199553,1699941600,1699976040,34440,22884,67125,TR,TR
22407,1700857860,1700871900,14040,169534,180617,IT,IT
153966,1698905580,1698931320,25740,75277,41354,BR,BR
65440,1698963960,1698993000,29040,174158,111807,TR,TR
92650,1699632660,1699636260,3600,101062,132246,NL,NL
71973,1700732520,1700736600,4080,77179,62518,NL,NL
30344,1700077920,1700113680,35760,188158,59464,TR,TR
2854,1699066620,1699104900,38280,142216,165471,MX,US
6969,1699651740,1699682520,30780,176765,98826,TR,TR
16634,1699559340,1699569480,10140,109410,117486,IT,IT
13263,1700753520,1700769960,16440,12547,187016,US,US
164247,1700231400,1700248740,17340,197909,123099,US,US
61114,1700736240,1700750280,14040,39028,107952,US,US
170809,1699513920,1699548240,34320,49482,111053,TR,TR
29547,1700408580,1700412180,3600,177577,123026,NL,NL
61402,1699827420,1699838760,11340,137095,39941,ES,CZ
196880,1700298060,1700326860,28800,56323,194202,TR,TR
48913,1699328700,1699353840,25140,112324,60353,DE,DK
171946,1699459560,1699494360,34800,143201,57555,TR,TR
169876,1700605560,1700618940,13380,93576,37002,AT,AT
38195,1700444280,1700452680,8400,85772,9767,IT,IT
188756,1699326960,1699334820,7860,65689,84327,IT,IT
143202,1699175100,1699207800,32700,177424,26799,TR,TR
111184,1700560020,1700590800,30780,40634,18251,TR,TR
126484,1700378460,1700402400,23940,56832,185076,DE,BA
61407,1699170540,1699187760,17220,119530,69850,US,CA
2462,1700335200,1700364720,29520,550,174076,TR,TR
29470,1699377660,1699402740,25080,179891,110006,PL,HU
148906,1700039820,1700053740,13920,55874,61033,US,US
196698,1699574160,1699606200,32040,87349,113549,TR,TR
4942,1699310760,1699336200,25440,55103,65747,BR,BR
115494,1698982080,1698993900,11820,185481,138298,US,US
750,1699025460,1699032600,7140,90193,44329,GB,GB
122709,1699198200,1699228080,29880,125371,132651,TR,TR
10928,1699997640,1700008680,11040,159099,185688,US,US
190346,1700061060,1700073060,12000,120530,9852,PT,PT
36220,1699798560,1699802160,3600,150186,25938,NL,NL
132965,1699268160,1699273860,5700,20966,75949,NL,NL
92589,1698876780,1698880380,3600,90104,109494,NL,NL
139929,1699108800,1699121160,12360,131997,148526,IT,IT
148500,1700084100,1700091660,7560,60273,82868,SK,SK
87094,1700292960,1700299800,6840,169378,67635,NL,NL
160045,1699467480,1699496760,29280,50329,29366,TR,TR
62149,1700658780,1700679120,20340,41203,13980,FR,IT
76528,1699626360,1699632240,5880,184643,143542,NL,NL
32160,1699363560,1699392900,29340,18256,124294,TR,TR
147402,1699545120,1699557840,12720,39494,145035,US,US
78910,1698909060,1698942780,33720,6389,166360,TR,TR
78297,1698818760,1698853740,34980,144424,150283,TR,TR
158712,1699625280,1699636620,11340,82495,112834,CZ,CZ
13149,1700647260,1700658960,11700,124966,20804,IT,IT
141857,1700539020,1700572560,33540,50284,1410,TR,TR
51576,1698824220,1698839340,15120,184828,86736,US,US
89071,1699940820,1699945740,4920,42832,60512,GB,GB
3186,1699499760,1699535340,35580,7744,110479,TR,TR
28288,1699463400,1699490880,27480,135635,90156,DE,FR
131416,1700468220,1700474340,6120,160487,56123,GB,GB
141814,1699263300,1699300260,36960,93635,27312,MX,US
36650,1700299020,1700316120,17100,79079,6386,FR,FR
126109,1699292880,1699323960,31080,1196,150394,TR,TR
26496,1699645560,1699649760,4200,104906,5933,NL,NL
5892,1699752720,1699788060,35340,35806,16303,TR,TR
89605,1699124340,1699147980,23640,101751,89972,RO,RO
136282,1700501640,1700526900,25260,8504,138241,PL,PL
4366,1700679120,1700685540,6420,141166,60687,NL,NL
31231,1700836140,1700865480,29340,56365,119225,TR,TR
11142,1700766240,1700797500,31260,194246,88748,TR,TR
24136,1700382660,1700395200,12540,109985,199640,RS,RS
157501,1700157120,1700190480,33360,191193,172479,TR,TR
184743,1700713920,1700721300,7380,18080,152422,IT,IT
172620,1700008320,1700011920,3600,60963,131775,GB,GB
161210,1699164960,1699195800,30840,49291,80281,TR,TR
82711,1700506680,1700541120,34440,27749,73127,MX,MX
45722,1700347500,1700377860,30360,195391,18189,TR,TR
93566,1699571820,1699577880,6060,67690,98171,NL,RS
136586,1699463340,1699491540,28200,61025,40867,DE,DE
32778,1699244640,1699258680,14040,151724,180194,IT,IT
42626,1699266060,1699283580,17520,188423,89564,US,US
6661,1699126620,1699161000,34380,18099,21792,TR,TR
89955,1700041800,1700071620,29820,54849,150091,TR,TR
169932,1700619600,1700648640,29040,96835,159845,TR,TR
9362,1700490480,1700520300,29820,167066,70337,TR,TR
98991,1699408020,1699411620,3600,179920,46652,GB,GB
156466,1700084640,1700114460,29820,191860,90036,TR,TR
105448,1700850960,1700854560,3600,78309,74318,GB,GB
175660,1699738080,1699749480,11400,80164,176083,IT,IT
156587,1699890600,1699901940,11340,111566,68881,US,US
12401,1700358300,1700370360,12060,67524,198697,IT,IT
174685,1699499220,1699502820,3600,157675,44997,NL,NL
141269,1699392420,1699426680,34260,38670,39998,MX,MX
52310,1699232040,1699259640,27600,66561,97424,CH,FR
45776,1700121600,1700152920,31320,86418,196985,TR,TR
141171,1699068480,1699101900,33420,13848,92606,TR,TR
132621,1700192640,1700221440,28800,3070,147362,TR,TR
142713,1700084100,1700097120,13020,25259,96578,AT,AT
48791,1699945560,1699951440,5880,149561,103308,NL,NL
56809,1700105160,1700139960,34800,189390,65426,TR,TR
127487,1700277540,1700311740,34200,174488,66081,TR,TR
24420,1699079760,1699092420,12660,195708,162143,PT,PT
167016,1700017800,1700043600,25800,123927,142186,DE,CH
56433,1699691100,1699694880,3780,161044,188439,GB,GB
81670,1698907140,1698931080,23940,122890,7483,CH,BA
2210,1700008200,1700030040,21840,177070,28806,DE,DE
69419,1700594640,1700610120,15480,135224,180673,US,US
131504,1700468100,1700494440,26340,6974,4554,PL,PL
172991,1699038360,1699068420,30060,145040,180350,TR,TR
194664,1699152360,1699188960,36600,130307,66628,MX,MX
172520,1699591500,1699623540,32040,73516,144587,TR,TR
115105,1700633340,1700646000,12660,27413,197168,AT,SK
151441,1698861720,1698872640,10920,40395,41707,US,US
85813,1699799280,1699830300,31020,38550,69762,TR,TR
139703,1700752440,1700765100,12660,48577,121414,US,US
66413,1700157420,1700193000,35580,912,141135,TR,TR
28519,1699649100,1699682100,33000,56361,39342,TR,TR
103500,1699736580,1699750080,13500,165105,8619,US,US
168371,1699315560,1699349760,34200,177976,199900,TR,TR
77095,1700333100,1700340960,7860,80859,188259,IT,IT
76224,1699840320,1699843920,3600,42012,179963,GB,GB
19984,1698945240,1698971220,25980,90195,44291,DE,DE
38567,1699877040,1699889880,12840,118782,18075,HR,BA
169714,1699292640,1699302360,9720,77558,145911,ES,ES
122541,1699511520,1699518780,7260,99499,77357,IT,IT
45563,1699334280,1699350840,16560,75931,57011,US,US
171297,1700323740,1700332800,9060,150578,169658,IT,IT
48091,1699495680,1699509420,13740,155441,25264,US,US
106657,1699148700,1699152960,4260,106233,133484,NL,NL
140802,1700396580,1700403180,6600,40308,120977,GB,GB
99514,1700738340,1700773980,35640,88621,117810,TR,TR
85769,1700623080,1700638800,15720,161591,83315,BE,FR
45268,1699674720,1699685640,10920,54870,18923,RS,SI
180325,1699956120,1699959720,3600,156511,108181,GB,GB
132835,1699363320,1699416600,53280,153351,92674,BG,HU
1814,1699008480,1699028280,19800,199974,67203,FR,IT
131939,1700174280,1700185140,10860,154940,172918,ES,PT
56912,1700798880,1700809920,11040,75352,124831,RS,RS
93950,1700019900,1700028300,8400,159892,140438,IT,IT
23915,1699258620,1699271880,13260,64512,64490,IT,IT
9644,1699442400,1699467420,25020,120780,12383,BR,BR
59641,1700820000,1700854680,34680,191319,55601,TR,TR
84129,1700764320,1700795100,30780,197586,192775,TR,TR
22658,1699633800,1699647960,14160,174182,121992,HR,HR
173823,1699049100,1699053780,4680,98550,144995,GB,GB
189140,1699177140,1699187820,10680,199643,64989,IT,IT
101387,1698803700,1698818100,14400,69308,187678,US,US
196294,1700509740,1700522520,12780,133633,145044,US,US
142735,1699575840,1699605960,30120,46267,2920,TR,TR
110685,1699420380,1699423980,3600,4391,177869,GB,GB
96062,1700079960,1700111340,31380,192805,41898,TR,TR
57040,1700346180,1700381880,35700,4370,104700,TR,TR
174683,1700747280,1700781360,34080,71294,164039,TR,TR
117283,1699436640,1699448040,11400,130948,157963,US,US
145232,1700249880,1700283840,33960,194507,98606,TR,TR
22690,1699847400,1699879500,32100,67647,127877,TR,TR
133476,1699956240,1699972800,16560,178502,76371,US,US
22108,1699014540,1699025820,11280,9235,29254,PT,PT
73539,1699659300,1699670940,11640,161460,77372,AT,AT
109348,1700019840,1700049540,29700,66610,22154,TR,TR
31288,1699274340,1699301100,26760,104291,194434,DE,DE
107081,1699729680,1699734360,4680,172862,167425,NL,NL
73103,1699876980,1699911360,34380,167469,91565,MX,MX
188475,1700407740,1700437140,29400,147439,81593,TR,TR
135991,1698809760,1698822660,12900,35495,83957,US,US
102514,1699633200,1699691700,58500,198827,14720,UA,DE
28263,1699173960,1699190460,16500,35890,178398,US,US
55901,1699634640,1699640220,5580,139272,89005,GB,GB
125985,1698989400,1698993000,3600,53805,54528,GB,GB
16585,1699095240,1699126560,31320,149592,118245,BA,AT
20017,1700527440,1700552520,25080,105266,11727,DE,DE
149851,1699313520,1699328220,14700,36949,65133,FR,BE
46742,1700543820,1700560800,16980,135212,101524,US,US
197271,1699185060,1699201320,16260,185562,44694,US,US
184281,1699999800,1700005500,5700,122806,146969,NL,NL
123396,1700498160,1700529480,31320,155959,60440,TR,TR
159518,1699282140,1699290540,8400,31901,16610,IT,IT
171963,1698987720,1699020720,33000,38949,119676,MX,MX
73751,1700450460,1700479860,29400,158759,69245,TR,TR
165368,1700226780,1700243400,16620,168658,45719,US,US
51366,1699351680,1699363560,11880,3657,166120,RS,RS
32851,1700671140,1700700660,29520,136874,150375,TR,TR
84612,1700551080,1700585760,34680,106427,168772,TR,TR
150972,1699499880,1699530720,30840,60498,37090,TR,TR
82621,1699377360,1699406520,29160,147802,79674,TR,TR
138773,1699478400,1699510020,31620,175393,85615,TR,TR
96320,1700207880,1700239800,31920,3305,54452,TR,TR
71734,1699077480,1699109220,31740,57774,92446,TR,TR
47141,1699813740,1699871100,57360,56917,153279,BG,TR
99938,1699193040,1699228560,35520,108942,199210,TR,TR
65954,1700812680,1700836980,24300,165112,112455,DE,BG
81323,1699620960,1699655400,34440,39038,189876,TR,TR
194187,1700238240,1700244660,6420,18383,170689,EE,EE
185460,1700463000,1700476320,13320,86069,96774,IT,IT
27327,1699421760,1699434120,12360,51582,93764,IT,IT
142634,1700048160,1700079960,31800,7258,179341,TR,TR
53783,1700530140,1700554560,24420,179904,108508,DE,HR
7827,1700349480,1700381100,31620,108721,123259,TR,TR
135791,1699236780,1699270200,33420,106941,125932,TR,TR
38638,1700175480,1700189820,14340,105121,104871,US,US
93548,1699791360,1699819860,28500,28089,127857,PL,PL
175303,1699961640,1699996860,35220,19124,15587,TR,TR
101951,1699612860,1699616460,3600,144913,126324,GB,GB
191926,1700473560,1700503500,29940,23162,165757,TR,TR
124975,1700063580,1700074920,11340,93571,165739,US,US
76785,1700247300,1700285940,38640,92178,35172,MX,US
189000,1700782020,1700817480,35460,199547,182007,TR,TR
178809,1700829420,1700833980,4560,56084,194840,NL,NL
187400,1698925080,1698959100,34020,134392,163195,TR,TR
155304,1699943220,1699971000,27780,94575,41259,BR,BR
153372,1698957000,1698974580,17580,168774,71898,US,US
29966,1700164320,1700191800,27480,119095,99508,PL,AT
189685,1700295300,1700298900,3600,55606,112517,GB,GB
8758,1699471440,1699482480,11040,174985,101049,ES,AD
199813,1700472480,1700529120,56640,162115,198754,BG,AT
167783,1699619760,1699641600,21840,134997,184423,DE,DE
137592,1699430520,1699453380,22860,70317,185251,DE,NL
69356,1699216560,1699250880,34320,99357,124785,TR,TR
36656,1700595840,1700622420,26580,62328,49790,PL,PL
43779,1699575720,1699610220,34500,94761,107223,TR,TR
141277,1699026360,1699052760,26400,64921,134849,RO,ES
21659,1700075700,1700079300,3600,5130,49301,NL,NL
20643,1700241240,1700254320,13080,154818,135594,AT,AT
174070,1699907820,1699919520,11700,188341,104356,PT,PT
33632,1699601040,1699622460,21420,113962,101583,FR,BE
114020,1699618260,1699627500,9240,73353,140521,IT,IT
52407,1698883920,1698895440,11520,192892,85416,US,US
103038,1700156640,1700187840,31200,173030,11667,TR,TR
54551,1700220000,1700226480,6480,112237,31736,NL,NL
61867,1699121340,1699133940,12600,106948,77681,IT,FR
35826,1700402040,1700413920,11880,105026,5796,US,US
80302,1700571840,1700605320,33480,71285,99627,TR,TR
64443,1700066580,1700080440,13860,112168,7705,HR,HR
124327,1698894540,1698900960,6420,753,48191,NL,NL
166387,1698890340,1698893940,3600,49981,167790,GB,GB
499,1700786700,1700790300,3600,88929,149159,GB,GB
132136,1698909840,1698931620,21780,117015,190676,DE,DE
33501,1699509720,1699542120,32400,136567,162948,TR,TR
38814,1700755920,1700759520,3600,805,98768,NL,NL
10675,1698906120,1698922380,16260,184022,67523,RS,HR
114855,1699626780,1699644240,17460,143361,170677,CZ,PL
160853,1699199460,1699211100,11640,11040,76164,IT,IT
34666,1700726400,1700737200,10800,28728,9949,CZ,FR
197777,1699830900,1699837140,6240,84280,127243,GB,GB
49934,1700731380,1700764500,33120,128929,166900,TR,TR
160103,1700006640,1700021340,14700,177368,5701,US,US
163783,1699636920,1699666080,29160,193716,24632,TR,TR
170437,1699439220,1699466760,27540,101126,88196,DE,DE
139154,1700325060,1700350920,25860,981,90739,RO,RO
161792,1700705400,1700737500,32100,39696,85594,TR,TR
180327,1700772180,1700778360,6180,159965,153135,NL,NL
197574,1699337160,1699371360,34200,58327,19096,TR,TR
36857,1699945920,1699950540,4620,54911,186370,GB,GB
24530,1699094880,1699105560,10680,55452,175495,IT,IT
89845,1700637300,1700662800,25500,171338,92141,DE,DE
95359,1700733480,1700762700,29220,111750,148870,TR,TR
176486,1698857220,1698887580,30360,64764,156911,TR,TR
126992,1700093640,1700097960,4320,36168,45613,GB,GB
175014,1699161780,1699170180,8400,134608,70676,PT,PT
37858,1699638300,1699651020,12720,72861,23811,IT,IT
165527,1699172400,1699202520,30120,40916,153348,TR,TR
46631,1699420380,1699438200,17820,77638,88199,US,US
11445,1700066580,1700085840,19260,106998,9277,FR,NL
62417,1700708280,1700738040,29760,79610,142555,TR,TR
192140,1699753200,1699772640,19440,59062,91439,FR,AD
30808,1700157420,1700190600,33180,31383,102378,TR,TR
124024,1699348200,1699365900,17700,94813,95127,AT,SK
67051,1699288020,1699317840,29820,54689,101380,TR,TR
22888,1699289400,1699315440,26040,94778,156147,PL,PL
16072,1700652960,1700670720,17760,102623,133893,US,US
117373,1699702860,1699732380,29520,83875,186917,TR,TR
26541,1700778240,1700786340,8100,79228,100226,IT,FR
110014,1700264220,1700276460,12240,86916,37093,US,US
60528,1699260660,1699296300,35640,9009,97579,TR,TR
47395,1700511180,1700548740,37560,3604,123940,MX,MX
176760,1699150380,1699170660,20280,69418,190876,BE,NL
89300,1698999600,1699004040,4440,99962,127516,GB,GB
73960,1700429640,1700433660,4020,127656,1675,GB,GB
13175,1699358700,1699369560,10860,174084,97328,CZ,CZ
170152,1700536080,1700590080,54000,105136,185099,BG,DE
31714,1699333680,1699357860,24180,137579,42164,PL,PL
182386,1700666760,1700683500,16740,103556,159718,US,US
22371,1700081040,1700110140,29100,114070,9864,TR,TR
144424,1698898860,1698912000,13140,187979,74123,IT,IT
131410,1699633500,1699666380,32880,146740,58464,TR,TR
175351,1700660160,1700694240,34080,194180,188511,TR,TR
103465,1700361480,1700397000,35520,123149,92093,TR,TR
175772,1700252400,1700284140,31740,143296,4725,TR,TR
4301,1700720220,1700737260,17040,64775,100964,US,US
95225,1699324500,1699336500,12000,60923,1772,US,US
90205,1700826660,1700861820,35160,159117,74408,TR,TR
20392,1699532100,1699567140,35040,121986,135745,TR,TR
20664,1700191140,1700224200,33060,168052,112024,MX,MX
20077,1700042040,1700046240,4200,125039,185197,GB,GB
3941,1700624340,1700637720,13380,45911,24691,US,US
8830,1699440480,1699475340,34860,128918,54135,TR,TR
110746,1699651260,1699686900,35640,139120,72688,TR,TR
84359,1700520840,1700554260,33420,150220,158021,TR,TR
165915,1700494140,1700504580,10440,152862,95815,EE,EE
19138,1699594080,1699617180,23100,94533,118098,DE,DE
89727,1699412160,1699441680,29520,94425,29162,TR,TR
46551,1699527960,1699542120,14160,169651,134592,RS,RS
64643,1699412640,1699419900,7260,161233,16185,HR,HR
78494,1699582920,1699603860,20940,31559,189594,BE,DE
52020,1699272900,1699302000,29100,78584,96530,TR,TR
71343,1700063940,1700073300,9360,141677,114393,HR,HR
156650,1699081380,1699111680,30300,136168,177776,TR,TR
148128,1699625340,1699656600,31260,78811,165076,TR,TR
183761,1699101780,1699130760,28980,130395,73939,TR,TR
46335,1699131600,1699164540,32940,191273,22941,TR,TR
150940,1699489020,1699522320,33300,9643,73144,TR,TR
19585,1699505880,1699539960,34080,180576,147164,TR,TR
175453,1700127480,1700138640,11160,78032,195347,US,US
9709,1699178580,1699194180,15600,192913,150889,FR,CZ
86382,1699609320,1699622520,13200,138159,108500,PT,PT
21731,1699644000,1699647600,3600,191208,24577,GB,GB
180371,1700793480,1700824200,30720,116732,58568,TR,TR
48305,1699587840,1699600320,12480,26804,124834,HR,HR
158131,1699741560,1699774920,33360,142601,22736,TR,TR
129313,1699664880,1699675680,10800,54288,150337,CA,US
181086,1699851420,1699873440,22020,92953,138454,PL,DE
48433,1699173060,1699201080,28020,2411,155562,BR,BR
167,1699965720,1699996920,31200,144896,72852,TR,TR
63875,1700204160,1700207760,3600,125926,182716,GB,GB
118427,1699013580,1699017180,3600,55779,194167,GB,GB
15602,1700654820,1700709420,54600,171109,199044,BG,DE
29350,1699763400,1699777560,14160,95554,182352,US,US
71186,1698939540,1698943140,3600,37034,95168,NL,NL
85851,1698989100,1699017960,28860,124287,114985,TR,TR
146387,1700690340,1700695020,4680,96256,82102,GB,GB
76835,1698805200,1698819300,14100,63156,37708,IT,IT
14967,1700151540,1700162220,10680,151761,186191,HR,HR
90982,1699930440,1699958040,27600,21604,177441,HU,UA
184935,1700740380,1700750760,10380,173143,180425,IT,DE
71648,1700351040,1700367720,16680,126137,183976,US,US
127182,1699333380,1699365420,32040,80188,190643,TR,TR
125200,1700632440,1700666940,34500,55892,116840,TR,TR
56226,1699213500,1699243320,29820,21909,158560,TR,TR
121803,1698979860,1699009560,29700,72697,194022,TR,TR
192585,1700625840,1700629440,3600,110854,96596,NL,NL
48195,1699725120,1699754220,29100,41155,182065,TR,TR
75987,1699700280,1699729560,29280,83487,110565,TR,TR
125050,1700269260,1700299860,30600,48112,191559,TR,TR
18722,1700474820,1700488800,13980,51113,80615,US,US
171682,1700651160,1700654820,3660,159624,166579,NL,NL
19765,1699536960,1699540560,3600,172821,127843,NL,NL
195548,1699339140,1699342980,3840,157932,143845,GB,GB
140013,1700799960,1700811960,12000,173268,34832,ES,ES
136786,1700469060,1700493420,24360,49420,158803,PL,PL
144627,1700629320,1700661840,32520,95989,146323,TR,TR
63904,1700330940,1700343000,12060,7334,190863,AT,SK
143615,1700574480,1700606520,32040,123632,15423,TR,TR
66279,1698946680,1698963660,16980,101684,154264,CA,US
14789,1699564080,1699574940,10860,199341,125567,HR,HR
153179,1699428540,1699432140,3600,166116,83813,GB,GB
147914,1699881660,1699899180,17520,56789,64302,US,US
161568,1700344740,1700348340,3600,47521,8889,GB,GB
67541,1700392200,1700402460,10260,100687,130077,ES,ES
105436,1699904520,1699922160,17640,84399,101023,US,US
179320,1700401740,1700413440,11700,192395,160887,HR,HR
198998,1699628880,1699636980,8100,192290,57681,AD,ES
118903,1699943040,1699953360,10320,176012,108802,IT,IT
160244,1699970640,1700000340,29700,88799,49654,TR,TR
103553,1699450980,1699462260,11280,188664,25204,US,US
151398,1698855840,1698871380,15540,119937,61372,US,US
65895,1699719300,1699748820,29520,35015,87242,TR,TR
139551,1699889100,1699896780,7680,131607,179780,EE,EE
59295,1699303080,1699306680,3600,28450,144973,GB,GB
156544,1699972200,1700002440,30240,137697,93266,TR,TR
164312,1699962840,1699992900,30060,51089,11233,TR,TR
192482,1699054980,1699086000,31020,41228,56856,TR,TR
171734,1699990860,1699999500,8640,137091,106630,IT,IT
137433,1699256100,1699261320,5220,181265,107003,GB,GB
135810,1700366640,1700396940,30300,138924,192699,TR,TR
149237,1700070240,1700091540,21300,187817,121313,FR,FR
194555,1700613840,1700626920,13080,20667,160093,IT,IT
15170,1700351400,1700385060,33660,136892,10460,TR,TR
140819,1700730720,1700762160,31440,70557,198440,TR,TR
122640,1699764900,1699790040,25140,94903,101698,CH,DE
46428,1700248800,1700283840,35040,66401,78861,TR,TR
145707,1700518920,1700534400,15480,199828,124002,US,US
31539,1699230120,1699254360,24240,78836,56704,ME,RS
3684,1699762620,1699776300,13680,109024,149420,RS,RS
93856,1699963740,1699975920,12180,108509,115715,SK,SK
113460,1699282860,1699300260,17400,70458,95966,CA,CA
11920,1700405640,1700412360,6720,108633,27335,GB,GB
194686,1700279700,1700312340,32640,8230,134466,TR,TR
118266,1698905640,1698919560,13920,133507,78069,CZ,CZ
111380,1700625060,1700633280,8220,41127,133007,PT,PT
32182,1700071440,1700106480,35040,167391,70813,TR,TR
47080,1700404500,1700438280,33780,155928,76856,TR,TR
129904,1699777320,1699790880,13560,179875,138465,RS,FR
23000,1700236320,1700270100,33780,103299,51630,TR,TR
127167,1698984720,1699019040,34320,93994,99063,TR,TR
49734,1699945140,1699949580,4440,183805,88076,NL,NL
32381,1700393220,1700415360,22140,97135,104197,DE,UA
8510,1699536240,1699566000,29760,172668,17582,TR,TR
182738,1700494620,1700525520,30900,94345,115465,TR,TR
196848,1700795880,1700830080,34200,52388,192199,TR,TR
59351,1700448540,1700456820,8280,7060,70177,IT,IT
174230,1699528260,1699558980,30720,25081,26163,TR,TR
118305,1699507440,1699525380,17940,94820,34463,US,US
52643,1699235100,1699241280,6180,101782,135404,NL,NL
1053,1698867600,1698891000,23400,183319,79346,DE,IT
2656,1700735580,1700746980,11400,57756,41076,ES,ES
161815,1700386860,1700394120,7260,1458,2717,HR,HR
127859,1699362120,1699368780,6660,119477,128106,NL,NL
98194,1699225680,1699242360,16680,149302,101547,US,US
181591,1700167800,1700196660,28860,172741,11574,BA,BA
123721,1698800880,1698814980,14100,195881,62523,RS,HR
53364,1699191120,1699225680,34560,172006,98549,TR,TR
135801,1699331520,1699364340,32820,79058,135393,TR,TR
86050,1699882140,1699906080,23940,182834,193612,DE,NL
117588,1700723940,1700727540,3600,31409,111155,NL,NL
73752,1699564440,1699592700,28260,140197,197577,DE,CZ
152850,1698835740,1698844680,8940,46873,14227,IT,IT
162314,1699445640,1699456920,11280,122803,114367,SK,SK
60245,1699271700,1699300920,29220,51854,66620,TR,TR
34874,1699549860,1699553460,3600,154688,18971,GB,GB
28945,1699912860,1699932180,19320,7386,116706,SE,SE
139030,1699591080,1699603080,12000,149019,140445,CZ,SK
131620,1699583220,1699612680,29460,125286,44471,TR,TR
46681,1698837180,1698865140,27960,92956,9045,DE,DE
93612,1699551120,1699554720,3600,39615,50964,GB,GB
118686,1699195620,1699218840,23220,62955,116237,PL,PL
89701,1700512020,1700547360,35340,180140,89404,TR,TR
192989,1699986120,1700002320,16200,189846,48164,FR,FR
83132,1698847020,1698850620,3600,191609,70006,GB,GB
69089,1700175540,1700197920,22380,119721,154911,DE,UA
54873,1699906560,1699935360,28800,40442,67309,TR,TR
514,1699035360,1699070580,35220,152970,119565,TR,TR
182435,1698865500,1698882840,17340,51897,165732,US,US
124181,1699314540,1699331160,16620,98168,49850,US,US
177240,1699515780,1699520460,4680,117879,163456,FI,EE
74978,1700445600,1700481180,35580,191442,71492,TR,TR
137958,1699177140,1699188240,11100,69516,78536,IT,IT
170315,1699541460,1699563480,22020,73556,49208,BR,BR
51384,1699811160,1699827120,15960,130325,156896,US,US
140232,1700039640,1700046000,6360,146638,100769,NL,NL
109932,1700461680,1700473620,11940,196848,129545,US,US
131451,1700136780,1700168340,31560,84740,193053,TR,BG
15040,1699568760,1699577460,8700,107198,153830,IT,IT
134927,1700467080,1700470680,3600,46241,170823,GB,GB
40685,1698806640,1698838320,31680,150983,180342,TR,TR
76162,1699635180,1699669800,34620,141615,96355,TR,TR
149687,1700376960,1700399340,22380,165965,95514,DE,PL
176131,1700319240,1700335260,16020,195732,80914,US,US
154693,1699001340,1699034820,33480,170287,134020,TR,TR
3783,1699576860,1699605900,29040,8325,177515,TR,TR
132531,1699327500,1699354800,27300,94704,115804,PL,PL
23796,1699122540,1699154100,31560,188604,168446,TR,TR
98876,1699090320,1699101540,11220,64623,145971,PT,PT
1088,1700117040,1700150400,33360,181171,9971,TR,TR
163457,1699774200,1699777800,3600,39729,96630,GB,GB
31979,1699332840,1699341360,8520,139407,26633,IT,IT
64143,1699319280,1699352460,33180,35494,192346,TR,TR
131783,1699698000,1699733700,35700,131088,192942,TR,TR
168887,1700486880,1700521920,35040,122616,25197,TR,TR
109725,1699007880,1699011480,3600,66598,165944,NL,BE
172656,1699350780,1699380600,29820,60692,125935,TR,TR
132792,1700786040,1700791260,5220,58916,45926,NL,NL
73758,1698795540,1698811140,15600,20956,184633,FR,ES
75136,1699574040,1699603620,29580,141542,73221,TR,TR
117656,1699472100,1699501260,29160,50622,102712,TR,TR
138930,1699795620,1699827540,31920,197044,167576,TR,TR
108909,1700636820,1700644200,7380,150641,26870,ES,ES
51010,1698868260,1698883140,14880,177776,139120,US,US
178146,1699140360,1699172460,32100,155625,22269,TR,TR
132543,1699408260,1699412280,4020,185084,65103,NL,NL
104953,1700350140,1700373480,23340,85062,108271,DE,SK
40664,1699686900,1699690500,3600,199355,189583,NL,NL
197699,1700516520,1700522940,6420,164745,131919,GB,GB
136352,1700383500,1700398920,15420,57025,131469,AT,AT
7410,1699114380,1699126800,12420,89620,25212,HR,HR
19846,1699435980,1699475460,39480,82764,192254,MX,MX
159391,1699895880,1699929420,33540,7807,19140,TR,TR
69395,1700387160,1700399040,11880,156088,114929,HR,HR
86365,1700264880,1700270700,5820,57650,133793,GB,GB
69721,1698846120,1698880020,33900,111360,52827,TR,TR
80193,1700571780,1700601540,29760,196889,119907,TR,TR
67062,1699066800,1699080660,13860,86518,169494,US,US
9938,1699338660,1699342260,3600,193493,86004,GB,GB
47333,1699209780,1699213920,4140,91696,69764,NL,NL
34490,1699217340,1699242240,24900,102372,122976,DE,DE
46299,1700409360,1700438220,28860,14494,121315,TR,TR
39416,1699970520,1700005140,34620,167319,29903,TR,TR
43069,1700860800,1700873640,12840,139369,66876,IT,IT
148040,1699518840,1699543080,24240,103726,85965,AL,MK
32833,1698908460,1698945360,36900,128142,79751,MX,MX
13008,1699091460,1699145940,54480,123285,199139,BG,DE
48593,1700799060,1700810400,11340,101655,163941,US,US
4502,1700223000,1700238420,15420,94039,171549,FR,FR
60618,1699646100,1699656540,10440,136749,167315,IT,IT
172326,1700842740,1700875260,32520,185369,100032,TR,TR
162468,1700143320,1700149920,6600,190116,18985,GB,GB
29912,1699528560,1699559640,31080,23550,97210,TR,TR
85628,1699184220,1699213320,29100,38816,33817,TR,TR
127154,1699735680,1699739280,3600,99099,112378,GB,GB
58220,1699906560,1699922340,15780,76643,66221,US,US
68386,1699887660,1699891620,3960,43509,65768,GB,GB
48307,1699597260,1699612560,15300,61088,186645,RS,ME
37914,1700534040,1700567100,33060,22774,90606,TR,TR
185793,1700538180,1700553300,15120,51542,184708,FR,FR
87901,1700033880,1700037480,3600,49652,126728,GB,GB
29163,1700218140,1700228400,10260,103362,125095,IT,IT
35831,1700113680,1700151840,38160,58034,37492,MX,US
84325,1700031300,1700043300,12000,162563,85679,US,US
196491,1700375040,1700392800,17760,84695,74586,US,US
174877,1698989820,1698999900,10080,36413,19021,IT,IT
46738,1699645740,1699677000,31260,39662,77382,TR,TR
7649,1700450340,1700453940,3600,35444,177900,GB,GB
91399,1700507700,1700542080,34380,104785,31433,TR,TR
96000,1700096160,1700100540,4380,167708,135992,GB,GB
16167,1700534580,1700538180,3600,62888,56469,NL,NL
130440,1700546760,1700571300,24540,76419,27921,DE,BE
154983,1700736600,1700740200,3600,116926,115567,GB,GB
71843,1698843540,1698850680,7140,90357,121436,NL,NL
116265,1699421280,1699434360,13080,123068,159592,US,US
190997,1700347680,1700363880,16200,19834,154927,US,US
143235,1698821400,1698855720,34320,193237,158465,TR,TR
102685,1699642920,1699673640,30720,100181,45324,TR,TR
187439,1699000680,1699057920,57240,77226,7550,UA,PL
193540,1700537760,1700577060,39300,39291,42040,MX,MX
55063,1700162940,1700171880,8940,65602,9240,IT,IT
158510,1699531140,1699558020,26880,151606,198443,BR,BR
92756,1700000760,1700029800,29040,135670,133962,TR,TR
114087,1700750940,1700781000,30060,106550,145114,TR,TR
160218,1699431960,1699442100,10140,76717,107843,PT,PT
38177,1699964160,1699980720,16560,75483,158310,US,US
27163,1699409700,1699437720,28020,35581,175853,DE,DE
111009,1700418120,1700441520,23400,120066,134684,PL,LT
83495,1699373340,1699429440,56100,13956,130390,BG,AT
44823,1699041060,1699057080,16020,166684,101955,FR,IT
167231,1699133880,1699150140,16260,23866,172957,FR,FR
86972,1700525760,1700558460,32700,37510,71214,TR,TR
80185,1700633340,1700663160,29820,7611,178039,TR,TR
95822,1700425380,1700432160,6780,24083,145847,NL,NL
47411,1699797240,1699831020,33780,161825,104822,TR,TR
12223,1699129380,1699132980,3600,138961,171395,NL,NL
123068,1699516020,1699537620,21600,114008,196825,DE,DE
34077,1699575900,1699607460,31560,167359,57140,TR,TR
151835,1700788620,1700823720,35100,112105,107683,TR,TR
192493,1698982620,1698995040,12420,194085,120333,IT,IT
197929,1699037580,1699041180,3600,89964,84507,NL,FR
94265,1700450820,1700463900,13080,180148,54036,IT,IT
12855,1700605680,1700661600,55920,119781,181086,BG,BG
158602,1699115040,1699128900,13860,74394,23873,HR,HR
38916,1699115700,1699119300,3600,145170,176813,GB,GB
32881,1700338320,1700353260,14940,42528,174550,FR,FR
154706,1699151100,1699182000,30900,104107,52264,TR,TR
96249,1699484400,1699489680,5280,3162,114793,EE,EE
134261,1700182920,1700190660,7740,199949,28194,SK,SK
76119,1699736040,1699751160,15120,143402,96342,CA,US
115736,1700115420,1700146860,31440,191310,185673,TR,TR
147572,1699914960,1699920660,5700,116043,94930,CL,CL
135669,1699201200,1699232280,31080,151738,144452,TR,TR
69117,1698975600,1699008840,33240,61420,20952,TR,TR
24917,1699219980,1699229580,9600,118406,13840,HR,HR
186488,1699187520,1699241700,54180,43133,14303,BG,BG
78212,1700317200,1700320800,3600,19822,136533,GB,GB
137213,1700037060,1700048160,11100,19668,17761,CZ,CZ
1372,1700290620,1700297400,6780,23590,67480,GB,GB
111727,1700572980,1700581140,8160,110707,11334,IT,IT
158615,1700163960,1700170140,6180,125368,172800,NL,NL
111948,1698949980,1698955560,5580,169390,136880,GB,GB
179579,1699255500,1699288500,33000,71631,86204,TR,TR
37120,1699716060,1699725300,9240,189859,170744,AD,FR
100058,1700497200,1700531700,34500,170435,152841,TR,TR
31100,1699116780,1699149720,32940,94649,158478,TR,TR
159556,1699387020,1699421280,34260,4422,43149,TR,TR
80500,1699214760,1699220820,6060,75151,144144,GB,GB
15446,1699325280,1699355460,30180,133113,14394,TR,TR
142087,1699021020,1699055280,34260,56122,88998,TR,TR
127249,1699789260,1699800300,11040,173166,94245,ES,AD
190531,1698894120,1698902700,8580,92399,82366,PT,PT
41876,1700510400,1700539740,29340,137275,196474,TR,TR
177195,1699688580,1699701300,12720,25940,170906,US,US
130560,1700224260,1700243160,18900,1022,75399,FR,IT
5133,1700739060,1700768520,29460,37744,130226,TR,TR
167171,1700004480,1700021700,17220,76729,143150,US,US
26473,1699862040,1699894620,32580,27508,154433,TR,TR
103648,1700369340,1700375400,6060,102964,162740,GB,GB
194083,1699563900,1699572180,8280,130452,171982,ES,ES
24083,1699256160,1699260240,4080,89544,141042,NL,NL
146940,1700624220,1700639460,15240,135443,179472,US,US
191332,1699062120,1699096080,33960,64505,157460,TR,TR
148938,1700480820,1700484600,3780,157761,180780,CL,CL
144710,1699722900,1699735620,12720,37592,9858,US,US
22139,1700498820,1700535420,36600,14549,56989,MX,US
57301,1699288680,1699293900,5220,173778,169773,EE,EE
12039,1699811820,1699849980,38160,21638,26459,MX,MX
138732,1699633500,1699641360,7860,58556,191305,IT,IT
108008,1700786700,1700795040,8340,196713,146968,IT,IT
50277,1700260020,1700292180,32160,92360,89171,TR,TR
69966,1699328220,1699357020,28800,107439,163855,TR,TR
41812,1699799700,1699811340,11640,98228,21567,US,US
133698,1700804280,1700827620,23340,42909,63470,HU,PL
168250,1699779660,1699808160,28500,44106,11340,BA,HR
39368,1700701500,1700705940,4440,28711,135075,GB,GB
140483,1700612100,1700623740,11640,177344,5233,US,US
190396,1700615100,1700645400,30300,105612,137296,TR,TR
181359,1699146660,1699150260,3600,78634,188382,GB,GB
23586,1700842980,1700870160,27180,88942,113387,RO,RO
97479,1700071740,1700087580,15840,165083,43997,US,US
79849,1699401060,1699423740,22680,104442,109346,DE,DE
112299,1700115660,1700126880,11220,3946,82567,RS,RS
90256,1699987500,1700005380,17880,33910,93949,RS,DE
58874,1700389500,1700403060,13560,109283,88048,US,US
82860,1700289480,1700297100,7620,40822,123614,IT,IT
158595,1699802100,1699822800,20700,125659,90465,FR,AD
92096,1698995220,1699002780,7560,52321,168969,PT,PT
37243,1700850000,1700860560,10560,2746,105654,IT,IT
1012,1699897080,1699928160,31080,90417,196783,TR,TR
186862,1700287920,1700298300,10380,131669,31297,IT,IT
167672,1700324040,1700335500,11460,190508,103900,CZ,AT
195099,1700262660,1700293860,31200,149828,170860,TR,TR
33041,1699175940,1699214760,38820,118007,29933,MX,MX
131946,1700511300,1700528760,17460,198433,99046,AT,HR
166171,1699151820,1699183560,31740,130073,44050,TR,TR
68910,1700192520,1700208840,16320,30833,45363,US,US
96010,1699021800,1699032660,10860,188634,62108,SK,AT
182391,1698985140,1698992760,7620,65410,109633,ES,PT
104942,1699203300,1699232580,29280,32279,87984,TR,TR
48436,1699540920,1699554900,13980,175962,5324,US,US
77004,1698868080,1698871680,3600,142906,86868,NL,NL
175433,1699437120,1699446600,9480,54716,175620,IT,IT
43525,1700180940,1700210760,29820,143232,131157,TR,TR
1255,1699707780,1699743060,35280,27349,178033,TR,TR
10254,1699906020,1699941240,35220,55186,166304,TR,TR
130755,1700270160,1700288340,18180,121517,169617,FR,FR
31614,1699134060,1699149720,15660,90182,119528,US,US
18939,1700201700,1700233860,32160,136629,116168,BA,HR
17042,1700422380,1700429220,6840,29751,154007,NL,NL
71005,1699074240,1699077840,3600,114450,31289,NL,NL
129800,1699539480,1699556820,17340,161812,182348,AT,AT
194501,1700264100,1700316780,52680,59698,32187,BG,DE
177821,1698873660,1698909240,35580,169945,195774,TR,TR
149131,1700502960,1700506560,3600,126788,98496,NL,NL
29562,1698895860,1698899460,3600,52945,148339,NL,NL
197140,1700368920,1700376180,7260,173895,87087,CL,CL
143850,1699906440,1699935660,29220,108741,164245,TR,TR
194626,1699135620,1699141620,6000,82759,93217,NL,NL
1101,1700740380,1700754420,14040,75023,65710,US,US
144592,1699225320,1699254120,28800,21649,119120,TR,TR
82266,1700814480,1700818440,3960,183833,33584,NL,NL
160320,1699992000,1700026260,34260,130512,2016,TR,TR
9682,1700562720,1700592840,30120,128780,46234,TR,TR
54734,1699551600,1699560780,9180,195749,159328,IT,IT
121548,1699985280,1700019960,34680,135661,125917,TR,TR
77817,1700584200,1700619420,35220,119861,13522,TR,TR
9476,1700275500,1700279100,3600,105958,151393,NL,NL
152458,1699709640,1699726320,16680,3226,132756,RS,RS
67785,1700264100,1700293440,29340,161327,158847,TR,TR
25793,1700088420,1700144700,56280,147391,99915,BG,BG
50140,1699544160,1699578600,34440,190671,180027,TR,TR
116913,1700616060,1700643780,27720,57773,74801,DE,DE
130723,1700449860,1700460420,10560,188765,197475,EE,EE
75038,1699982340,1699985940,3600,159776,77471,GB,GB
153972,1700366820,1700401560,34740,48975,179039,TR,TR
147383,1700680680,1700689740,9060,199404,193621,IT,IT
36609,1700666400,1700691000,24600,190587,88354,DE,DE
111668,1700275020,1700309340,34320,84204,177153,TR,TR
80420,1699640940,1699655100,14160,44725,170574,US,US
120761,1699855320,1699914900,59580,83613,168788,UA,CZ
99707,1699786740,1699799520,12780,74763,28484,AT,AT
22101,1699402320,1699433460,31140,121121,86442,TR,TR
22105,1700094540,1700129760,35220,106344,93225,TR,TR
18364,1698945660,1698981000,35340,123327,126429,TR,TR
58020,1698913620,1698947760,34140,74996,11394,TR,TR
69453,1700103360,1700132640,29280,67141,45525,TR,TR
176545,1700552100,1700561640,9540,80933,177036,PT,PT
51808,1700185320,1700208060,22740,6912,189666,BR,BR
190780,1698804780,1698827400,22620,96189,165163,RO,RO
55556,1699537860,1699555140,17280,135,131439,US,US
158768,1699000380,1699014120,13740,38704,21363,AT,AT
110625,1700332380,1700349060,16680,110046,169435,CZ,MD
89661,1700355180,1700366940,11760,112824,59288,US,US
16152,1699929420,1699943280,13860,189755,40851,US,US
45558,1699781160,1699792320,11160,25274,122233,IT,IT
10691,1700278320,1700298300,19980,179986,160449,FR,FR
25734,1699807860,1699839240,31380,61925,20342,TR,TR
18548,1699621260,1699672440,51180,54652,22544,BG,DE
33679,1700056980,1700091780,34800,33514,69281,TR,TR
123285,1700010540,1700032620,22080,99223,81876,NO,SE
23732,1699502520,1699521000,18480,57341,35350,FR,FR
52084,1699983120,1699999080,15960,35047,94361,RS,RS
93887,1700646240,1700660640,14400,146261,104439,SE,SE
84879,1699582500,1699617960,35460,140919,78996,TR,TR
160087,1699121100,1699150020,28920,106242,104994,TR,TR
33554,1700199840,1700214060,14220,129666,33308,ES,ES
70398,1699167000,1699178220,11220,58062,61316,US,US
76451,1700517600,1700550600,33000,50011,79293,TR,TR
115301,1700413740,1700440260,26520,18290,197977,DE,DE
191779,1699087560,1699091160,3600,18455,161131,GB,GB
58501,1700707020,1700740260,33240,775,17360,TR,TR
21479,1700472180,1700475780,3600,142302,54210,GB,GB
114773,1699193580,1699210140,16560,23780,88318,US,US
146991,1699837320,1699849920,12600,108433,164642,IT,IT
98230,1698900360,1698923040,22680,159480,190605,DE,FR
178666,1700086740,1700092020,5280,194989,196909,GB,GB
110044,1699754880,1699758540,3660,154551,161596,NL,FR
166999,1699184220,1699220340,36120,177001,166041,MX,MX
50184,1700538960,1700577060,38100,156576,138918,MX,MX
194152,1700457180,1700460780,3600,157786,5881,GB,GB
157312,1700236860,1700250180,13320,15265,7305,US,US
71978,1700727660,1700778060,50400,105066,157302,BG,AT
37164,1698961140,1698994440,33300,144712,174027,TR,TR
55802,1700553660,1700577240,23580,53393,48022,HU,PL
23556,1700497500,1700511840,14340,196011,26730,ES,ES
92112,1699988580,1699996560,7980,175100,160993,IT,IT
30455,1699430220,1699466040,35820,41628,93861,TR,TR
81767,1699864740,1699872000,7260,52747,179066,PT,PT
163675,1699425240,1699443240,18000,6991,162738,FR,IT
105619,1700651520,1700679840,28320,44302,14534,PL,PL
76524,1700790840,1700802000,11160,9661,29082,US,US
165095,1699861860,1699873680,11820,60148,185145,US,US
178503,1700396880,1700401860,4980,30064,56783,NL,NL
17096,1699520220,1699536060,15840,107797,34626,CA,US
180128,1700705520,1700715420,9900,189586,147376,IT,IT
145808,1698915300,1698920460,5160,20792,133712,NL,NL
183528,1700107200,1700139480,32280,127086,132803,TR,TR
54206,1700704800,1700733540,28740,99658,145482,DE,DE
81608,1699855380,1699863900,8520,48247,43794,ES,PT
99877,1700783580,1700787180,3600,43859,141351,NL,NL
97536,1698911160,1698921840,10680,67601,30496,HR,HR
37209,1699520760,1699555680,34920,190603,66504,TR,TR
86378,1699602300,1699618860,16560,52932,184940,FR,FR
182333,1699460100,1699493940,33840,97754,181717,TR,TR
6756,1700019780,1700029380,9600,7752,171850,IT,IT
117899,1700360460,1700395740,35280,139711,82288,TR,TR
46142,1699632180,1699666440,34260,119694,76757,TR,TR
196682,1698838560,1698850860,12300,120256,130017,IT,IT
129575,1699580880,1699592460,11580,57412,138540,US,US
13120,1700216100,1700250360,34260,128716,15356,TR,TR
75964,1700197140,1700212080,14940,166903,123563,FR,FR
176829,1700331780,1700365140,33360,119191,119749,TR,TR
66806,1700664840,1700700720,35880,178434,184022,TR,TR
114086,1699747080,1699757640,10560,128442,10040,PT,PT
148346,1699858440,1699862040,3600,15346,11210,GB,GB
125061,1699151040,1699169040,18000,139948,106297,FR,ES
49350,1700496660,1700530140,33480,24008,88558,TR,BG
173888,1700311860,1700336520,24660,12739,71526,CH,FR
186742,1699207980,1699211580,3600,61733,23658,NL,NL
49737,1699788660,1699801680,13020,170695,67486,US,US
36164,1700662500,1700676180,13680,2655,166328,IT,IT
29890,1699094460,1699106100,11640,22254,33218,IT,IT
87116,1700383620,1700395380,11760,122485,60517,IT,IT
67493,1699361400,1699391460,30060,185316,69911,TR,TR
175087,1699863360,1699879740,16380,32195,78771,AT,AT
105435,1700656680,1700660280,3600,120330,167022,NL,NL
116,1699384200,1699399860,15660,3648,1280,FR,FR
199205,1700349900,1700381940,32040,179132,66785,TR,TR
675,1700105580,1700120700,15120,45266,189391,US,US
12748,1700712060,1700720160,8100,75659,17697,ES,ES
169263,1699433580,1699438380,4800,138508,106254,GB,GB
197091,1700467260,1700501220,33960,89672,26806,TR,TR
184615,1699941420,1699962420,21000,114975,151889,AL,DE
126073,1699272780,1699283160,10380,103446,5000,ES,ES
76546,1699465380,1699477560,12180,191231,15314,IT,IT
14320,1700321880,1700333340,11460,20449,153875,US,US
16448,1698960600,1698969000,8400,146340,177636,IT,IT
133318,1699512900,1699542840,29940,83115,177775,BA,BA
57467,1700244720,1700275140,30420,196245,83286,TR,TR
129008,1699319400,1699330320,10920,15835,123286,US,US
73333,1700584920,1700590440,5520,144793,125135,GB,GB
190804,1700468100,1700494440,26340,65459,40201,PL,HR
93956,1699993920,1699997520,3600,197384,89279,NL,NL
198691,1700309640,1700322180,12540,119630,24258,US,US
106598,1700719560,1700732940,13380,100642,151697,HR,HR
83031,1700318040,1700331900,13860,93530,55942,IT,IT
28639,1699568760,1699597740,28980,156781,128343,TR,TR
117579,1699477440,1699509360,31920,61777,193364,TR,TR
95423,1700542920,1700570700,27780,159681,94701,DE,DE
187348,1700508900,1700524140,15240,111560,186279,FR,PL
8727,1700541780,1700570580,28800,194518,150344,TR,TR
163872,1699079100,1699108140,29040,35076,139834,TR,TR
189182,1700826780,1700856120,29340,144075,142717,TR,TR
65747,1699118280,1699146060,27780,85045,124068,DE,DE
83832,1699695180,1699723320,28140,14622,5094,BR,BR
54192,1699389840,1699395600,5760,180292,93249,NL,NL
163415,1700075280,1700096280,21000,190227,42928,FR,FR
169680,1700020500,1700073360,52860,92806,37845,BG,MK
112463,1700437200,1700445360,8160,16433,120682,IT,CH
55351,1700811180,1700823300,12120,125884,67772,IT,IT
26275,1698941580,1698977040,35460,143221,105381,TR,TR
160777,1699883460,1699895520,12060,110668,3851,PT,CH
63668,1699821540,1699833900,12360,184480,192211,US,US
114210,1699389780,1699414620,24840,89129,169587,DK,DK
29741,1700562600,1700576820,14220,196403,93517,US,US
107881,1700644680,1700648280,3600,198914,106991,GB,GB
114066,1699169100,1699200900,31800,98059,109464,TR,TR
120719,1699725360,1699738080,12720,88298,76905,ES,ES
98673,1699898580,1699908120,9540,104823,129859,ES,RO
59237,1699014120,1699031160,17040,132513,35683,FR,FR
168602,1700370600,1700382060,11460,18259,35436,IT,IT
66438,1699969620,1699982940,13320,174730,74205,US,US
82408,1700205240,1700236800,31560,140835,14474,TR,TR
3799,1699597800,1699605540,7740,194192,81800,IT,IT
177338,1700640120,1700675400,35280,150825,58726,TR,TR
161757,1699024980,1699057260,32280,46312,43285,TR,TR
53857,1698827340,1698845940,18600,105720,44618,FR,FR
141951,1699174980,1699206780,31800,58594,144950,TR,TR
162321,1700837280,1700850600,13320,9919,125205,IT,IT
92860,1699143840,1699171980,28140,81976,22365,CH,FR
177714,1700259180,1700267880,8700,118296,142729,IT,IT
129520,1699667880,1699674720,6840,20390,63320,AD,ES
107078,1699402440,1699418640,16200,65535,78895,US,US
15240,1700860320,1700869560,9240,29528,123017,IT,IT
85512,1698936480,1698958080,21600,79982,72509,HU,PL
102949,1699878360,1699900980,22620,37578,100803,PL,NL
16281,1700232900,1700258940,26040,146256,143716,PL,PL
139302,1698908640,1698942480,33840,74229,32125,TR,TR
99911,1699653660,1699684440,30780,31086,79358,TR,TR
134791,1700651040,1700669820,18780,150357,146096,FR,HU
76664,1699547940,1699553460,5520,158700,22099,NL,NL
75482,1700031540,1700036280,4740,62487,20772,NL,NL
98835,1700280840,1700292480,11640,70196,138485,RS,RS
1007,1700178120,1700208120,30000,100501,153275,TR,TR
118544,1700514000,1700517600,3600,26825,97037,NL,NL
5170,1699237440,1699273380,35940,106809,173528,TR,TR
55637,1700741100,1700760000,18900,125549,96747,FR,BE
79237,1699382820,1699398240,15420,28368,57348,RS,RS
113660,1700300940,1700330940,30000,92661,38219,TR,TR
14202,1700564160,1700575740,11580,62327,170279,US,US
172003,1699274100,1699279440,5340,1148,199219,NL,NL
173461,1700281800,1700293080,11280,191926,196178,US,US
49186,1700785920,1700799480,13560,10721,58591,CA,CA
112099,1700263320,1700277300,13980,100919,67252,IT,IT
148738,1699032060,1699038780,6720,74090,63196,NL,NL
177500,1699893960,1699924380,30420,106856,164912,TR,TR
26070,1699216140,1699240860,24720,134414,122330,DE,MK
53148,1699834920,1699864020,29100,64197,108759,TR,TR
66318,1699535040,1699570020,34980,195450,64553,TR,TR
73499,1700339580,1700374080,34500,128014,121522,TR,TR
172954,1700711400,1700715000,3600,7713,7366,GB,GB
52269,1700742480,1700746260,3780,84512,114340,AD,ES
102402,1699452300,1699476540,24240,155592,126941,NO,SE
194429,1699820100,1699852500,32400,189596,107119,TR,TR
61834,1700419380,1700422980,3600,116111,174020,GB,GB
172156,1700595900,1700630820,34920,70366,126451,TR,TR
108976,1699620000,1699623600,3600,181197,173602,NL,NL
122410,1699168020,1699174620,6600,156849,41806,NL,NL
181717,1699036560,1699052520,15960,76944,10617,US,US
114749,1700785800,1700814120,28320,87519,73957,BR,BR
1856,1700479980,1700512020,32040,93427,23344,TR,TR
190848,1699921920,1699939800,17880,52859,154069,US,US
79180,1700203740,1700229900,26160,143332,120964,HU,FR
151854,1700109600,1700142540,32940,19570,38902,TR,TR
182260,1700720280,1700723880,3600,22504,155785,NL,NL
24439,1700829000,1700846940,17940,58798,139457,US,US
131859,1700417760,1700424540,6780,164824,162170,GB,GB
151313,1699608540,1699624380,15840,22338,148001,FR,FR
164869,1699725780,1699738320,12540,118785,90505,ES,PT
166592,1700152020,1700178120,26100,119466,159690,PL,DE
191398,1699426500,1699446120,19620,9689,16529,FR,FR
73988,1700229480,1700259060,29580,133805,164782,TR,TR
121697,1699367400,1699381680,14280,24418,120226,RS,RS
106637,1699346940,1699379160,32220,108302,195422,TR,TR
118401,1700196060,1700209980,13920,195956,109293,IT,IT
126718,1698855840,1698861240,5400,183782,147802,GB,GB
111807,1699401660,1699409400,7740,41676,52874,CL,CL
94055,1700527740,1700562240,34500,52761,24405,TR,TR
137129,1699380900,1699406160,25260,114839,155509,BA,DE
2551,1699247820,1699253460,5640,67608,86345,NL,NL
106467,1700542800,1700572260,29460,97402,5047,TR,TR
188027,1698854040,1698886680,32640,36632,143704,TR,TR
127386,1700584440,1700616000,31560,89772,15610,TR,TR
27116,1699506360,1699562100,55740,71483,185789,BG,AT
180905,1699010520,1699023720,13200,54175,168181,HR,HR
147560,1700169360,1700173560,4200,102157,77689,NL,NL
155873,1699011540,1699043040,31500,170019,6834,TR,TR
185152,1700735220,1700738820,3600,22229,42144,GB,GB
122779,1699401600,1699405200,3600,19589,194215,GB,GB
150576,1700624220,1700658480,34260,54585,15825,TR,TR
66134,1699620540,1699647060,26520,118376,22866,RO,RO
30504,1700346600,1700381100,34500,115337,37472,TR,TR
154459,1700057940,1700083680,25740,15598,68449,DE,DE
171941,1700362860,1700394180,31320,65327,119478,TR,TR
143376,1700080800,1700109840,29040,12104,157164,TR,TR
183861,1699490940,1699517400,26460,132033,144707,PL,PL
149964,1699501200,1699507680,6480,21313,41185,GB,GB
13026,1700674140,1700682300,8160,165398,80871,IT,IT
124584,1700588460,1700606280,17820,166799,48973,FR,FR
105297,1700812980,1700816580,3600,27329,171964,NL,NL
43121,1700099460,1700103060,3600,56406,108161,GB,GB
22603,1700300880,1700311140,10260,161517,84559,IT,IT
186241,1700434860,1700439720,4860,115672,40747,GB,GB
42833,1699820400,1699824480,4080,175810,167464,GB,GB
100888,1699791780,1699826220,34440,189536,82973,TR,TR
156739,1700131800,1700140140,8340,100792,92323,FI,EE
58584,1700860020,1700883060,23040,10420,133242,DE,CH
108151,1699021500,1699056480,34980,184953,166313,TR,TR
175596,1699036980,1699072080,35100,136588,55417,TR,TR
172323,1700812680,1700842020,29340,145794,173183,TR,TR
127941,1699891260,1699924680,33420,183295,141943,TR,TR
3618,1699205280,1699212300,7020,190785,181240,NL,NL
171281,1700590080,1700602560,12480,120740,11801,US,US
124675,1700425200,1700437680,12480,33449,20605,US,MX
43489,1699937400,1699973280,35880,164355,156046,TR,TR
168939,1700176980,1700182260,5280,78803,196385,NL,NL
85977,1699868520,1699900620,32100,78687,16317,TR,TR
18178,1700600280,1700631960,31680,16475,11471,TR,TR
36680,1700690460,1700694900,4440,64625,31409,GB,GB
60878,1700858700,1700890680,31980,85100,85230,TR,TR
164660,1700213160,1700248260,35100,99665,140570,TR,TR
114298,1700624760,1700632140,7380,173159,155092,EE,EE
138633,1699156440,1699186680,30240,193687,83562,TR,TR
138555,1700528280,1700539080,10800,127007,72450,US,US
60171,1700472300,1700483520,11220,183574,146176,HR,HR
143984,1699366020,1699390140,24120,97339,71755,DE,DE
40119,1699831800,1699862520,30720,174422,20504,TR,TR
189989,1700364300,1700390400,26100,105636,101713,DE,SK
79073,1700398920,1700425140,26220,165020,41050,DE,ES
58653,1699949460,1699960260,10800,47034,21976,US,US
27075,1700366340,1700382480,16140,94124,173815,US,US
183162,1700335560,1700387340,51780,42072,121237,BG,DE
2107,1699807440,1699813320,5880,31547,175586,NL,NL
153681,1699112700,1699116300,3600,25807,142778,GB,GB
162487,1700489400,1700498220,8820,120671,102286,IT,IT
77570,1700372880,1700381220,8340,179654,132530,IT,IT
124270,1700739480,1700743260,3780,195974,49653,NL,NL
34940,1700046060,1700049660,3600,27252,182694,NL,NL
83084,1700805180,1700819040,13860,122502,138506,US,US
87778,1699311960,1699346280,34320,51735,143480,TR,TR
86824,1699865280,1699875660,10380,134274,11954,IT,IT
8366,1699521180,1699555380,34200,102389,32277,TR,TR
41741,1699971600,1699979940,8340,91583,72665,IT,IT
97803,1698974100,1699006800,32700,14567,196884,TR,TR
10152,1698976980,1699007820,30840,67380,45242,TR,TR
97918,1699349700,1699385580,35880,92031,115826,TR,TR
113726,1699182480,1699206900,24420,134168,95328,DE,BG
122499,1700789940,1700821200,31260,123771,48087,TR,TR
191613,1700495760,1700528460,32700,194758,166071,TR,TR
43400,1699459260,1699466640,7380,106476,38936,IT,IT
119897,1700174160,1700183100,8940,37684,55767,HR,HR
29229,1699603500,1699639260,35760,82245,189706,TR,TR
34134,1699223040,1699257960,34920,114858,125733,TR,TR
161331,1699271100,1699300920,29820,36060,16602,TR,TR
185947,1699192980,1699214820,21840,67113,81880,DE,IT
191168,1700339640,1700345400,5760,12716,15861,GB,GB
132107,1699744200,1699779180,34980,35090,195502,TR,TR
44731,1698818760,1698845100,26340,152955,137618,RO,RO
122180,1700707560,1700740680,33120,154280,5936,TR,TR
141524,1700588100,1700595060,6960,57146,193216,NL,NL
8484,1699871340,1699894380,23040,92413,99842,PL,PL
155074,1699021800,1699056300,34500,159434,197158,TR,TR
27563,1699788600,1699804320,15720,47618,173376,FR,FR
62501,1700313180,1700336100,22920,13958,103462,DE,DE
75714,1699978680,1700010960,32280,127110,122391,TR,TR
169930,1699372920,1699407180,34260,115404,136288,TR,TR
134761,1700313120,1700333460,20340,152470,102076,FR,FR
57530,1699964400,1699969200,4800,107473,143139,GB,GB
155049,1699577460,1699599960,22500,104903,152305,DE,DE
122922,1699823160,1699858980,35820,28068,134929,TR,TR
112077,1700607000,1700640660,33660,65957,2092,TR,TR
73939,1699064280,1699075680,11400,155689,159494,ES,ES
107738,1700104560,1700139960,35400,76538,121926,TR,TR
56548,1699475220,1699478820,3600,178166,195337,GB,GB
17696,1699141860,1699174620,32760,133806,119429,TR,TR
130079,1700140800,1700148300,7500,119779,146821,IT,IT
197947,1700784300,1700801940,17640,150244,56753,CZ,DE
154633,1699179780,1699210080,30300,41572,2794,TR,TR
22094,1700313780,1700327220,13440,129579,151766,CZ,CZ
20346,1700102940,1700120220,17280,126261,117792,BE,FR
131307,1699852980,1699876140,23160,8789,10481,RO,RO
173881,1700676060,1700690100,14040,170546,71958,SK,SK
5485,1699150920,1699158480,7560,124580,126597,IT,IT
59823,1699186860,1699190460,3600,124074,88730,NL,NL
84109,1700009460,1700026860,17400,49058,166329,US,US
193286,1698824880,1698830280,5400,121755,79962,GB,GB
156082,1700686080,1700709780,23700,125703,27347,SI,BA
46977,1700770860,1700799840,28980,142190,70030,TR,TR
127818,1699974300,1700003220,28920,149296,79,TR,TR
22025,1699139280,1699197240,57960,54078,114112,UA,DE
36181,1698941280,1698954540,13260,47178,67578,PT,PT
35773,1700278440,1700290140,11700,144353,21043,RS,SI
11236,1700716500,1700747760,31260,80185,68359,TR,TR
108590,1699294740,1699303740,9000,118255,101578,IT,IT
175112,1699209240,1699212840,3600,60728,144035,NL,NL
29783,1699131300,1699162680,31380,97031,177012,TR,TR
176916,1699574280,1699590360,16080,48615,108708,CZ,CZ
121807,1699072860,1699102860,30000,99155,109588,TR,TR
38302,1699922940,1699935960,13020,120918,125046,US,US
107766,1699666020,1699683000,16980,153829,94497,US,US
167144,1700365800,1700373360,7560,194367,30929,IT,IT
176045,1700852160,1700907900,55740,90098,97270,BG,DE
181908,1700777760,1700791620,13860,199747,195059,PT,PT
86085,1700080680,1700084280,3600,72891,141420,NL,NL
147176,1699530720,1699565220,34500,50909,1013,TR,TR
92624,1699945560,1699956660,11100,86610,184973,US,CA
21416,1699984620,1700007000,22380,105216,112295,PL,PL
86033,1698922620,1698935700,13080,82591,2401,US,US
3118,1700606400,1700617440,11040,199716,14605,CZ,CZ
130669,1698857040,1698869220,12180,143613,94939,US,US
105354,1700296020,1700309760,13740,146026,168137,US,US
34328,1698803340,1698806940,3600,135140,145179,GB,GB
31998,1699973760,1699989240,15480,172769,70334,US,US
52589,1700791860,1700795460,3600,50641,40049,NL,NL
128985,1699238040,1699251060,13020,35944,99405,US,US
186331,1700584140,1700595120,10980,80895,6201,US,US
98964,1699634280,1699670220,35940,38583,51243,TR,TR
105371,1699499760,1699503360,3600,38697,170207,GB,GB
143569,1700795280,1700829360,34080,131252,101553,TR,TR
150368,1699262940,1699276080,13140,42743,27268,US,US
25698,1700526360,1700529960,3600,14857,129906,GB,GB
174098,1699121160,1699152720,31560,35007,8641,TR,TR
69211,1700306940,1700310540,3600,41029,36403,GB,GB
187817,1699704240,1699719960,15720,118818,183558,US,US
14,1699364340,1699393440,29100,158979,87730,TR,TR
150133,1699196280,1699221000,24720,97908,139119,DE,DE
182120,1699485660,1699513140,27480,99310,10995,DE,IT
45687,1700849280,1700863380,14100,186894,29500,IT,IT
189852,1700640900,1700649420,8520,151268,125357,HR,FR
69001,1699425420,1699459800,34380,70678,155323,TR,TR
147002,1700308320,1700325060,16740,178839,6874,US,US
193716,1700158680,1700175180,16500,50621,141722,AT,BG
77084,1698899100,1698906000,6900,169851,149565,GB,GB
117321,1700415480,1700419080,3600,197317,190982,GB,GB
141385,1699441860,1699462680,20820,116737,175458,SE,SE
36148,1699193880,1699227120,33240,92317,129300,TR,TR
149045,1699720140,1699732740,12600,52178,52860,US,US
192505,1700801040,1700804640,3600,65171,100741,GB,GB
83976,1698843180,1698878160,34980,122696,157167,TR,TR
97196,1699196760,1699212900,16140,166789,193484,US,US
58685,1698970260,1698997440,27180,110464,146031,BR,BR
5555,1700698020,1700732700,34680,169464,52072,TR,TR
175086,1699574220,1699578480,4260,1957,106058,NL,NL
4318,1699907820,1699918320,10500,23674,128753,IT,IT
65077,1699635000,1699643100,8100,112329,154698,IT,IT
105514,1699438200,1699450740,12540,194673,105355,RS,RS
55920,1699846620,1699869960,23340,122151,14511,DE,DE
176252,1700442720,1700474340,31620,17350,186627,TR,TR
155811,1699319940,1699344360,24420,24172,118058,DE,HR
173700,1699104240,1699111920,7680,157750,157407,HR,CZ
70299,1699762080,1699765680,3600,129925,27756,GB,GB
26209,1698842880,1698877500,34620,96391,68997,TR,TR
67389,1700725860,1700737620,11760,134899,19036,CZ,CZ
197793,1700291340,1700312940,21600,195199,62325,PL,PL
169703,1700517420,1700548320,30900,3729,99284,TR,TR
73158,1700205420,1700211840,6420,72414,14235,AD,ES
170300,1699725780,1699756560,30780,106585,54481,TR,TR
32186,1699992960,1700004300,11340,190027,170161,US,US
123277,1700369400,1700402040,32640,58094,101861,TR,TR
143476,1699916700,1699941000,24300,54859,4994,PL,FR
113905,1700854080,1700887920,33840,63618,4703,TR,TR
83051,1700186580,1700190180,3600,185642,63135,NL,NL
96064,1699469340,1699500300,30960,93592,129715,TR,TR
197980,1699168380,1699203060,34680,80588,157096,TR,TR
80455,1700557320,1700570820,13500,81541,121561,PT,PT
165508,1700222640,1700256960,34320,113780,35403,TR,TR
101663,1699743420,1699747020,3600,72336,29946,NL,NL
168964,1700098380,1700110020,11640,138793,36699,IT,IT
57801,1700375880,1700382420,6540,17220,129790,GB,GB
97658,1700440620,1700470620,30000,103228,47254,TR,TR
79015,1700744220,1700775300,31080,51860,117341,TR,TR
76298,1699116060,1699119660,3600,51499,137452,GB,GB
14659,1700356380,1700370120,13740,28595,82189,US,US
148492,1699700880,1699705860,4980,47564,164219,GB,GB
98950,1700110080,1700113860,3780,147535,146227,GB,GB
138988,1699945200,1699948800,3600,129722,191874,GB,GB
93642,1700719500,1700753940,34440,20736,163294,TR,TR
174773,1699514820,1699520100,5280,173299,151886,NL,FR
123022,1700117880,1700128980,11100,1704,139028,AT,BA
179616,1698923520,1698929220,5700,83178,103207,GB,GB
145071,1700375520,1700381940,6420,67909,84502,GB,GB
63291,1700785800,1700794380,8580,115999,117551,PT,PT
177204,1700784120,1700787720,3600,112117,140558,NL,NL
99210,1699650720,1699654320,3600,156974,84930,GB,GB
94099,1698921840,1698931440,9600,99716,47711,HR,RS
24605,1700249580,1700253180,3600,113225,121570,GB,GB
118824,1699926420,1699958460,32040,192037,167967,TR,TR
116737,1698821640,1698842700,21060,178942,129471,FR,ES
87219,1699134000,1699157880,23880,68320,439,BR,BR
52586,1698849660,1698853380,3720,97198,53598,NL,NL
36402,1700575740,1700607900,32160,58670,171427,TR,TR
7066,1699344300,1699353120,8820,179774,171571,IT,IT
116797,1700800260,1700806680,6420,101025,11195,NL,NL
60210,1699814640,1699829340,14700,27052,112006,US,US
1669,1699212960,1699247520,34560,99666,177820,TR,TR
115629,1700829480,1700837100,7620,186586,53736,IT,IT
57733,1700384880,1700402400,17520,135959,190726,SE,SE
4134,1699975500,1699991640,16140,169904,24646,FR,FR
187863,1699458240,1699464600,6360,78767,181526,GB,GB
50849,1700611020,1700627100,16080,27851,52225,US,US
72650,1700024580,1700036520,11940,125147,68390,US,US
77969,1699692720,1699726500,33780,54786,170226,TR,TR
154130,1698982860,1699007520,24660,44695,119967,DE,DK
34074,1700186940,1700190540,3600,13055,147333,NL,NL
17626,1700692440,1700696040,3600,130106,48521,NL,NL
19369,1699828500,1699856580,28080,47356,44604,PL,PL
123691,1700058660,1700091060,32400,87386,43694,TR,TR
52566,1699123560,1699135980,12420,49377,2708,IT,IT
117096,1700234940,1700265060,30120,40296,163194,TR,TR
158350,1700016360,1700031120,14760,7292,26038,US,US
134903,1699805340,1699837560,32220,81337,144970,TR,TR
124200,1699501260,1699504980,3720,195822,17811,NL,NL
140010,1700327940,1700334120,6180,175003,151704,NL,NL
33975,1700774760,1700780640,5880,7893,2649,GB,GB
166824,1700122740,1700139780,17040,63972,96035,US,US
175883,1699427580,1699466460,38880,141009,105236,LV,PL
71615,1699351500,1699368540,17040,172070,89906,US,US
140694,1699145700,1699170480,24780,9740,144698,DE,BE
93515,1699519560,1699544400,24840,95735,129806,DE,DE
28374,1698842040,1698876600,34560,190272,122994,TR,TR
197966,1698881700,1698889020,7320,19964,169870,IT,IT
163116,1699613340,1699619280,5940,136010,32886,NL,NL
174459,1700064540,1700086860,22320,43982,179701,PL,PL
84053,1699861680,1699897020,35340,98409,198599,TR,TR
142293,1700345280,1700361540,16260,77873,963,FR,ES
89075,1700239620,1700269080,29460,45954,131502,TR,TR
10553,1700481120,1700505900,24780,157912,57250,HU,FR
67382,1700270280,1700286660,16380,6167,166838,US,US
9271,1700757540,1700784060,26520,46304,1376,HU,UA
186085,1700548380,1700568780,20400,149166,62817,FR,IT
177315,1698869700,1698881400,11700,31056,75962,HR,HR
31428,1699739460,1699774800,35340,22995,167114,TR,TR
65849,1700522340,1700552880,30540,100638,109395,TR,TR
49034,1698958860,1698994620,35760,146214,94582,MX,MX
177792,1700341620,1700376180,34560,52756,47085,TR,TR
64977,1699250160,1699260600,10440,45085,86010,IT,IT
145482,1700767920,1700799900,31980,193730,129685,TR,TR
121859,1700301660,1700340000,38340,10077,21374,MX,MX
165098,1699368600,1699401660,33060,20605,98216,TR,TR
188102,1700521680,1700525280,3600,56815,81114,GB,GB
149752,1699186020,1699219080,33060,136409,9814,TR,TR
124822,1700378220,1700404320,26100,198937,175947,DE,DE
84040,1699617720,1699643280,25560,159101,126589,PL,PL
89554,1700796660,1700825460,28800,118815,132601,TR,TR
160771,1699544040,1699550400,6360,110166,27904,NL,NL
29994,1700640480,1700645640,5160,54506,24373,NL,NL
10984,1700567220,1700602680,35460,133842,130732,TR,TR
76694,1700169600,1700180640,11040,165620,173453,HR,HR
27239,1699417080,1699429800,12720,199395,80153,US,US
33876,1699242780,1699270860,28080,125455,33588,BR,BR
193478,1699533360,1699547220,13860,57157,62133,AT,BG
163637,1699629600,1699660500,30900,109292,190966,TR,TR
50492,1698968100,1698985500,17400,98529,4915,US,US
23687,1698825900,1698839400,13500,68653,2198,US,US
60368,1700094960,1700098560,3600,80083,59072,NL,NL
53892,1699550760,1699580340,29580,143449,194262,TR,TR
76715,1700185320,1700188920,3600,144085,16016,GB,GB
33785,1700060460,1700070180,9720,191209,120246,HR,HR
71331,1700358840,1700373060,14220,39401,156793,SK,AT
180725,1700121180,1700143980,22800,1871,172747,AL,MK
41158,1699650000,1699665360,15360,164084,128518,US,US
99987,1700703120,1700714220,11100,173218,6979,RS,ME
176135,1700360820,1700364420,3600,167980,49663,NL,NL
115041,1700058660,1700069520,10860,125088,65642,US,US
136880,1700807580,1700864520,56940,100651,174944,BG,BG
87868,1700095440,1700114580,19140,42275,99332,FR,DE
135350,1700028000,1700061540,33540,169929,156120,TR,TR
114194,1699108140,1699118760,10620,134657,81445,EE,FI
101386,1699528740,1699561980,33240,30138,65383,TR,TR
174232,1699485300,1699489140,3840,78616,48071,GB,GB
74593,1699422240,1699432200,9960,165767,131861,AD,ES
198160,1699390200,1699393800,3600,41408,159945,NL,NL
78860,1699635600,1699666260,30660,52181,8039,TR,TR
176974,1699745460,1699759920,14460,121603,56964,US,US
6085,1699356780,1699360380,3600,39220,4900,GB,FR
15547,1699045260,1699051260,6000,96567,192842,NL,NL
161554,1699544940,1699562160,17220,107984,166492,AT,SK
120336,1699219320,1699230960,11640,174078,84319,US,US
95367,1699806720,1699812660,5940,50534,128603,GB,GB
41496,1699349460,1699384860,35400,176474,51781,TR,TR
9408,1698980100,1698999060,18960,165415,142577,MD,RO
39547,1700133060,1700145540,12480,138113,165851,HR,HR
105977,1700177100,1700193960,16860,11618,61598,US,US
28928,1700827080,1700861700,34620,24126,7793,TR,TR
8556,1700735760,1700746680,10920,82343,155474,IT,IT
1344,1700234280,1700240940,6660,53006,138249,GB,GB
58549,1699321980,1699337820,15840,171016,198116,US,US
60048,1699502220,1699523700,21480,22483,114911,FR,FR
96149,1699889100,1699903980,14880,110005,148510,AT,AT
77683,1700284680,1700296320,11640,181365,107523,US,US
55715,1699571460,1699575060,3600,122411,27427,GB,GB
83443,1700686620,1700700360,13740,93524,197375,US,US
78630,1699908480,1699939740,31260,135744,180221,TR,TR
34483,1700658000,1700662320,4320,166246,15501,NL,NL
187633,1699164000,1699199580,35580,178267,147672,TR,TR
174806,1700825880,1700853720,27840,139160,193666,HU,AT
183953,1700609400,1700641560,32160,139755,167960,TR,TR
178968,1700842800,1700846400,3600,87101,99105,GB,GB
67135,1699599060,1699629600,30540,199290,77134,TR,TR
62228,1699498620,1699529640,31020,7185,12266,TR,TR
119547,1700505060,1700539860,34800,19749,62255,TR,TR
135205,1699433760,1699469520,35760,162302,68157,TR,TR
94706,1700629260,1700660040,30780,184535,112791,TR,TR
149742,1700407800,1700461020,53220,130671,135022,BG,DE
25506,1699453560,1699468140,14580,78116,60023,US,US
68963,1699561080,1699564680,3600,145051,104028,NL,NL
167693,1699460820,1699496460,35640,63189,118393,TR,TR
94769,1698999660,1699031400,31740,77962,196944,TR,TR
14978,1698913860,1698921060,7200,27912,5777,IT,IT
115899,1700281200,1700297580,16380,1336,184191,AT,SK
62401,1699769040,1699781700,12660,28537,9568,SK,AT
1614,1700215320,1700249580,34260,144706,181133,TR,TR
126404,1699539900,1699554300,14400,47126,20303,US,US
58418,1700445360,1700462820,17460,131579,193556,US,US
88000,1699333680,1699364640,30960,72168,55788,TR,TR
185757,1699424640,1699455840,31200,154430,163238,TR,TR
139407,1699409340,1699418400,9060,58833,48004,EE,EE
177605,1699014480,1699044840,30360,77930,170285,TR,TR
93410,1700798880,1700814900,16020,16885,77273,US,US
170552,1699251060,1699260900,9840,87459,68277,IT,BE
147233,1700193180,1700199360,6180,51049,170017,GB,GB
194651,1699390800,1699420920,30120,78460,38549,TR,TR
43954,1699351620,1699365060,13440,50445,23815,US,US
114642,1700605080,1700622300,17220,18646,158389,US,US
18249,1698884340,1698887940,3600,153392,64784,NL,NL
119631,1700692200,1700709540,17340,162425,137089,US,US
127957,1699265940,1699294920,28980,41956,15045,TR,TR
26940,1699022820,1699056600,33780,36140,160532,TR,TR
21376,1700217120,1700225520,8400,56966,21830,IT,IT
165408,1699556280,1699590000,33720,86548,1306,TR,TR
179679,1700144280,1700154600,10320,118241,43421,ES,FR
19837,1698795300,1698811080,15780,192955,30267,US,US
839,1699311480,1699346520,35040,189320,128402,TR,TR
128455,1698983820,1699013880,30060,90573,110266,TR,TR
63976,1699572660,1699580160,7500,157839,106797,SK,SK
155805,1700741520,1700748840,7320,38533,73248,HR,DE
17588,1699372980,1699405920,32940,173334,22428,TR,TR
57381,1700854560,1700858160,3600,144244,166102,NL,NL
40452,1700043420,1700074080,30660,99309,168016,TR,TR
70692,1698941940,1698945540,3600,39629,17372,NL,NL
76979,1700561880,1700593800,31920,23057,5222,TR,TR
137660,1700740380,1700750400,10020,132970,146574,IT,IT
117832,1700462220,1700474400,12180,197492,94558,US,US
26548,1699036860,1699070220,33360,39878,11747,TR,TR
37915,1699232760,1699247880,15120,85974,153994,US,US
73761,1698953700,1698967680,13980,109345,29942,PT,PT
166413,1699425240,1699438740,13500,176098,194392,US,US
40908,1700331540,1700353080,21540,13307,92885,FR,FR
133711,1700590500,1700614920,24420,14481,78192,BR,BR
85262,1700194200,1700205420,11220,90742,149780,US,US
92663,1699369560,1699399440,29880,192544,48157,TR,TR
164061,1700578380,1700635320,56940,143442,161600,UA,PL
157432,1699216380,1699234500,18120,163208,71960,FR,FR
176021,1699212240,1699215840,3600,179082,42811,GB,GB
180818,1700484240,1700491620,7380,37095,22414,IT,IT
52356,1699796700,1699807980,11280,32652,175842,IT,IT
92001,1699817280,1699826760,9480,195649,140613,IT,IT
126253,1700080200,1700092260,12060,150501,75280,IT,IT
109350,1699471920,1699505100,33180,11578,177507,MX,MX
3488,1700307840,1700340540,32700,148914,162509,TR,TR
46162,1699479000,1699513500,34500,100087,160421,TR,TR
134784,1700788860,1700801760,12900,2530,87411,HR,HR
109108,1700211720,1700243340,31620,187988,52236,TR,TR
28573,1699037280,1699052700,15420,127165,83873,US,US
13335,1700647620,1700670420,22800,191982,120099,DE,IT
86782,1699863540,1699871040,7500,121508,121638,HR,HR
143243,1700647020,1700655840,8820,14154,64658,HR,BA
147419,1700357940,1700374020,16080,57285,51359,US,US
97794,1699302900,1699306500,3600,118567,90117,GB,GB
59076,1699542780,1699572120,29340,5248,154540,TR,TR
94573,1700522400,1700553240,30840,85625,117672,TR,TR
94764,1700002740,1700032020,29280,118164,30603,TR,TR
38308,1700118420,1700153880,35460,53362,37285,TR,TR
18775,1700495880,1700527680,31800,190475,49748,TR,TR
160568,1700746800,1700764560,17760,194440,127581,FR,FR
37949,1700849400,1700880300,30900,102598,44504,TR,TR
4530,1700250600,1700281140,30540,155083,135200,TR,TR
153799,1700083380,1700090400,7020,174780,158939,NL,NL
62945,1700205540,1700216880,11340,183641,17484,SK,SK
104011,1699684380,1699701840,17460,123422,184039,US,US
134557,1700778900,1700802480,23580,133533,2723,RO,RO
87680,1699856220,1699879200,22980,139410,53915,PL,BE
68673,1700656920,1700661720,4800,105128,121697,GB,GB
184561,1700626440,1700632800,6360,186211,41923,NL,NL
3762,1699438320,1699452180,13860,199934,124994,ES,FR
195333,1699454100,1699467900,13800,98957,28492,PT,PT
134000,1699469400,1699484340,14940,184217,167144,US,US
122363,1700673060,1700686800,13740,39442,123261,PT,PT
96326,1699801980,1699832340,30360,128582,55814,TR,TR
82654,1699182900,1699216080,33180,125021,36979,TR,TR
2843,1700327280,1700362740,35460,66628,162927,TR,TR
19227,1699155840,1699167600,11760,160583,138685,US,US
1900,1699527480,1699531560,4080,136693,104696,NL,NL
146496,1698800520,1698829980,29460,117211,95321,TR,TR
137707,1700640960,1700654580,13620,82122,26418,US,US
174945,1699156080,1699185540,29460,155617,183548,TR,TR
89329,1700365740,1700394060,28320,76276,132642,PL,PL
111560,1699815180,1699848360,33180,168403,173531,TR,TR
116547,1698862680,1698889680,27000,31583,165475,DE,DE
68206,1699299300,1699328580,29280,118014,171845,TR,TR
174002,1699885800,1699898160,12360,86841,43572,PT,PT
53522,1699392840,1699404420,11580,48946,189938,CA,CA
158772,1699552380,1699588200,35820,155306,47595,TR,TR
137328,1700193900,1700218440,24540,115796,9134,DE,FR
95995,1700529060,1700534040,4980,161063,169348,GB,GB
170939,1698893160,1698906060,12900,21645,10262,US,US
67835,1699940520,1699946280,5760,192601,45043,GB,GB
71231,1699488960,1699516800,27840,28777,23137,DE,DE
45731,1699549200,1699575720,26520,16842,482,PL,PL
162238,1699052280,1699084080,31800,99054,123169,TR,TR
20666,1698831540,1698849180,17640,176010,135710,US,US
26259,1700585940,1700610300,24360,11063,102758,DE,HU
139257,1699889460,1699900980,11520,95003,95044,US,US
15539,1700511780,1700515620,3840,59572,115337,GB,GB
65272,1700785140,1700798100,12960,67829,160070,IT,IT
189348,1699155420,1699169880,14460,45597,89558,RS,ME
183998,1699976280,1700009880,33600,178255,104291,TR,TR
94199,1700538240,1700558880,20640,32040,49165,BE,NL
34206,1700084520,1700137260,52740,162255,153445,BG,AT
57561,1700379420,1700383020,3600,158770,168213,GB,GB
82427,1700416560,1700449500,32940,36995,126556,TR,TR
84485,1699917720,1699949460,31740,194750,86783,TR,TR
21782,1700574300,1700603640,29340,55040,136990,TR,TR
65707,1700232000,1700268120,36120,15485,177708,MX,MX
102731,1700081700,1700091480,9780,152493,25921,IT,IT
149409,1700766540,1700780340,13800,119989,111433,SK,SK
39343,1699963320,1699990620,27300,55327,164920,BR,BR
198405,1698926580,1698957480,30900,172385,4200,TR,TR
61067,1699148220,1699183140,34920,40342,169036,TR,TR
185210,1700608320,1700633580,25260,37140,46337,DE,HU
131692,1700073420,1700102280,28860,29175,58850,TR,TR
161662,1699321500,1699355820,34320,169767,10736,MK,RS
164313,1698885000,1698900300,15300,18265,186806,AT,AT
130960,1700386860,1700417820,30960,173714,188782,TR,TR
87243,1699662000,1699672320,10320,155772,109269,IT,IT
18718,1700183160,1700200200,17040,27854,196357,RS,HR
39893,1699936800,1699949820,13020,94442,150179,US,US
93822,1700237460,1700269200,31740,182525,96832,BA,BA
67915,1700289120,1700299440,10320,175846,160550,HR,HR
86681,1700400660,1700415420,14760,177993,68015,AT,AT
29619,1700477040,1700506020,28980,178379,5053,TR,TR
52972,1698857400,1698890340,32940,74773,122566,TR,TR
172225,1700653200,1700665440,12240,54791,61139,HR,IT
58377,1699751460,1699785360,33900,135774,41387,TR,TR
191453,1699532700,1699546140,13440,56424,61979,HR,HR
37316,1699186740,1699200480,13740,12806,186290,US,US
39844,1700506920,1700528700,21780,138451,186611,DE,BG
157921,1699688580,1699723860,35280,61174,135143,TR,TR
130948,1700249280,1700284380,35100,66961,99540,MK,AL
163431,1699764540,1699797300,32760,23712,100866,TR,TR
84518,1699997340,1700018400,21060,180141,187727,BE,NL
159382,1699458180,1699471080,12900,96938,53184,IT,IT
24129,1699573560,1699608300,34740,105605,174518,TR,TR
131673,1699205700,1699209300,3600,1105,21642,NL,NL
163297,1698890100,1698896340,6240,192588,48032,NL,NL
6773,1700303880,1700338920,35040,23105,16088,TR,TR
31172,1698920100,1698931440,11340,192107,148816,US,US
102663,1699126080,1699161540,35460,153176,151602,TR,TR
4671,1699174140,1699203960,29820,92273,7103,TR,TR
193961,1700523960,1700534040,10080,89880,34255,PT,PT
163347,1700334960,1700347680,12720,96673,175440,US,US
66128,1698852420,1698857100,4680,81385,18876,NL,NL
30230,1700314860,1700373840,58980,126382,70311,UA,PL
164530,1700093580,1700105640,12060,104088,115119,IT,IT
16040,1699668840,1699682100,13260,29357,127515,IT,IT
39396,1699205700,1699237080,31380,93934,115568,TR,TR
153841,1699673460,1699686360,12900,121980,87782,IT,IT
60448,1700652540,1700684460,31920,108805,28381,TR,TR
78336,1699422300,1699434240,11940,122148,167737,US,US
163833,1699402200,1699416600,14400,47169,197843,FR,CZ
53043,1700095680,1700128920,33240,5409,7748,MX,MX
99363,1700717100,1700748120,31020,134382,25391,TR,TR
29111,1699686120,1699715160,29040,165188,158717,TR,TR
174671,1699840680,1699852740,12060,14773,173961,CA,US
172587,1699245960,1699250940,4980,142599,35999,NL,NL
80948,1699673040,1699676700,3660,99866,105843,NL,NL
128831,1700365440,1700398860,33420,171212,43814,TR,TR
57190,1699468980,1699493580,24600,82921,162730,RO,RO
85072,1699052580,1699080600,28020,110013,160423,DE,BA
58914,1699335900,1699343160,7260,52352,112964,PT,PT
51846,1700836380,1700866080,29700,103996,16592,TR,TR
93792,1699003440,1699016640,13200,75116,55941,US,US
45094,1699879200,1699886280,7080,126568,23119,NL,GB
198647,1699741260,1699774440,33180,36911,33993,TR,TR
70011,1700279340,1700293860,14520,155144,177617,US,US
122605,1699702500,1699715580,13080,183669,27080,IT,CH
9909,1699375320,1699406400,31080,51653,189734,TR,TR
16700,1700027940,1700061480,33540,116987,10879,TR,TR
62438,1699442040,1699447740,5700,67802,102232,NL,NL
86611,1700525220,1700539440,14220,179656,19203,US,US
71014,1700559840,1700590200,30360,27213,8579,TR,TR
78411,1699923120,1699930980,7860,174877,111150,HR,RS
67924,1699074600,1699103400,28800,171273,135630,TR,TR
150330,1699628760,1699632780,4020,1611,80714,GB,GB
94381,1700033100,1700043840,10740,187176,161887,HR,HR
84495,1699970940,1699974540,3600,94620,117207,NL,NL
13803,1699523640,1699558140,34500,69281,22204,TR,TR
123198,1700854500,1700858100,3600,106346,26149,GB,GB
197046,1700471880,1700503440,31560,19904,158083,TR,TR
27233,1699851000,1699865160,14160,147049,181447,US,US
191702,1700563860,1700597940,34080,58960,1576,TR,TR
87895,1699447320,1699456800,9480,44402,188663,IT,IT
141386,1699246980,1699255740,8760,125927,26682,PT,PT
112002,1699953840,1699982640,28800,124466,47480,TR,TR
30800,1700792160,1700810880,18720,127818,144473,FR,FR
111197,1699739700,1699775040,35340,100352,189644,TR,TR
151506,1700105400,1700116980,11580,31046,94592,US,US
83237,1700529300,1700544600,15300,1296,119371,FR,HR
3565,1699346280,1699385220,38940,189579,17052,MX,US
141210,1700517780,1700555520,37740,98758,168840,MX,MX
164713,1699005180,1699035540,30360,159793,154054,TR,TR
49922,1699352580,1699386480,33900,156148,195867,TR,TR
123738,1700829360,1700846820,17460,169420,95870,US,US
92981,1699316340,1699352160,35820,121019,83948,MX,MX
102135,1699005000,1699008600,3600,142421,129881,GB,GB
60866,1698955800,1698970920,15120,12664,97729,BE,SK
119487,1700149860,1700172240,22380,84956,99398,PL,PL
65158,1700397480,1700433060,35580,2501,173569,MX,US
160328,1699019400,1699031220,11820,39740,151923,IT,IT
34963,1699934640,1699950960,16320,66165,59273,US,US
65279,1699216860,1699250940,34080,40492,133527,TR,TR
111214,1700582220,1700585820,3600,162335,180681,GB,GB
117772,1700532060,1700535660,3600,107592,148398,GB,GB
30773,1699070040,1699076580,6540,137546,58929,GB,GB
12945,1698974160,1698982620,8460,43222,22907,IT,IT
100635,1698953160,1698981180,28020,198874,89781,DE,HR
97636,1699982160,1700017500,35340,182571,178936,TR,TR
56849,1700206260,1700236620,30360,107775,184350,TR,TR
113182,1700624340,1700638020,13680,130775,49059,IT,IT
177927,1700389320,1700408880,19560,49419,57444,FR,FR
109220,1700551020,1700584260,33240,5519,23179,MX,MX
84457,1699962600,1699976580,13980,71840,64900,US,US
115488,1699548000,1699561440,13440,156169,184849,PT,PT
180077,1700591460,1700600220,8760,104003,5576,IT,IT
23359,1699903860,1699920360,16500,96036,181302,US,US
144578,1699159920,1699193700,33780,77052,3842,TR,TR
101558,1699096200,1699125300,29100,83584,147144,TR,TR
183954,1699419720,1699442640,22920,175065,63350,PL,DE
74498,1699823340,1699859100,35760,92990,148647,TR,TR
88428,1699514820,1699525800,10980,65549,62598,US,US
165117,1699133760,1699137360,3600,149261,197662,GB,GB
34774,1699971360,1699978860,7500,66952,25146,IT,IT
165155,1699904280,1699921920,17640,19911,59147,FR,FR
91013,1700036280,1700050980,14700,158623,118161,US,US
166912,1699077540,1699081140,3600,112892,126256,GB,GB
161489,1700383920,1700399700,15780,56510,1837,RS,RS
165913,1699557060,1699573320,16260,131545,49238,US,US
77347,1699290000,1699293600,3600,193239,66155,NL,NL
177729,1699689000,1699719660,30660,109006,156777,TR,TR
152416,1700810760,1700814360,3600,52149,156068,GB,GB
56258,1699477380,1699513140,35760,72809,3094,TR,TR
35733,1698820080,1698850800,30720,15614,159793,TR,TR
141089,1699513020,1699525020,12000,21641,103394,ES,ES
115361,1699885020,1699903080,18060,3945,193875,BE,DE
153392,1700621880,1700629080,7200,999,125766,SK,BE
172551,1699730160,1699765140,34980,145879,197965,TR,TR
196359,1700553420,1700580840,27420,76673,73035,PL,PL
168599,1699413360,1699451280,37920,144807,40520,MX,US
69452,1699757040,1699791840,34800,73479,43925,TR,TR
194997,1699352520,1699376280,23760,130551,191937,PL,PL
181948,1699084020,1699117860,33840,50473,157662,TR,TR
184488,1698962880,1698970740,7860,171131,149755,IT,IT
154732,1700217480,1700253960,36480,28062,93412,MX,MX
42400,1698823020,1698857580,34560,66542,10353,MX,MX
128858,1698976680,1699010280,33600,170053,180995,TR,TR
38602,1700772540,1700801820,29280,40711,49293,TR,TR
98730,1699534200,1699551120,16920,136207,190470,CZ,CZ
179797,1700300220,1700305980,5760,87463,130487,NL,NL
92473,1699925460,1699936740,11280,190472,182919,US,US
20233,1699812120,1699839780,27660,19323,80122,PL,CZ
147756,1699750500,1699782720,32220,34806,108754,TR,TR
4976,1700443860,1700481300,37440,63856,156196,MX,MX
9406,1699244700,1699281960,37260,36357,55016,MX,MX
181244,1700140020,1700173980,33960,47622,102613,TR,TR
53324,1699083000,1699116300,33300,79454,178973,MX,MX
135014,1699589760,1699601520,11760,32875,37826,US,US
125349,1700014440,1700018040,3600,141614,46841,GB,GB
133531,1699803360,1699811340,7980,41846,134059,IT,IT
175477,1699195020,1699198620,3600,65135,45023,NL,NL
55156,1700855040,1700864100,9060,145937,52878,HR,HR
173577,1699387920,1699396140,8220,29961,135269,ES,ES
2539,1700661120,1700669460,8340,135204,51010,IT,IT
162678,1698913020,1698935820,22800,81383,104023,PL,UA
59628,1700475000,1700512080,37080,151138,45112,MX,MX
91752,1698836340,1698855180,18840,47203,119015,BE,FR
52025,1699642800,1699669740,26940,199383,11690,PL,UA
144325,1700453580,1700478720,25140,114013,115847,PL,PL
28421,1699311660,1699318080,6420,110904,46423,GB,GB
170371,1700102040,1700114940,12900,13272,65995,US,US
71328,1700773680,1700797200,23520,68220,113367,PL,PL
56573,1700507160,1700528880,21720,113587,170642,DE,DE
142604,1700031000,1700061120,30120,141398,37167,TR,TR
135051,1699583400,1699587000,3600,176179,80588,NL,NL
179500,1699505760,1699516080,10320,47258,175182,IT,IT
9533,1700224740,1700254200,29460,143862,134954,TR,TR
160790,1700604960,1700613720,8760,22474,174011,IT,IT
105686,1699706880,1699745460,38580,117135,74910,MX,US
66875,1700385600,1700417700,32100,87609,33572,TR,TR
182032,1700488860,1700519820,30960,10294,45879,TR,TR
184287,1700840160,1700845440,5280,154089,20630,NL,NL
64122,1700656560,1700660460,3900,163539,184284,GB,GB
68995,1700230020,1700246820,16800,154980,142783,BE,FR
40450,1699766880,1699800300,33420,135124,93770,TR,TR
68731,1699141380,1699146720,5340,158844,164956,NL,NL
1098,1700854380,1700883720,29340,143986,101719,TR,TR
57241,1700375100,1700410920,35820,14212,105009,TR,TR
70803,1699566180,1699575720,9540,134444,47996,HR,BA
142047,1699330860,1699345080,14220,148194,121433,IT,IT
152666,1699677600,1699708680,31080,157235,127219,TR,TR
181674,1699494060,1699530000,35940,62300,171456,TR,TR
1191,1698977400,1699011360,33960,113535,82170,MX,MX
189975,1699223220,1699245120,21900,162881,7570,DE,BG
90150,1700397960,1700424180,26220,102977,146371,CH,DE
36240,1699754340,1699760460,6120,144845,89825,GB,GB
42497,1699500720,1699511940,11220,191326,161095,US,US
6319,1700006820,1700017740,10920,10187,78388,HR,HR
176922,1700327880,1700345460,17580,157680,51300,US,US
8412,1699667520,1699700760,33240,52589,251,TR,TR
131868,1699274760,1699306860,32100,71044,1711,TR,TR
133316,1699429440,1699441800,12360,7392,78868,RS,RS
85763,1700050200,1700064060,13860,96664,113608,US,MX
87681,1699483020,1699492800,9780,118468,20307,PT,PT
155602,1699967400,1699993800,26400,165954,108674,HU,IT
188301,1699811940,1699826040,14100,196262,150913,US,US
43866,1700583600,1700614200,30600,84167,32756,TR,TR
31007,1699061460,1699080060,18600,142925,95914,FR,ES
64896,1699920420,1699928340,7920,194383,50213,IT,IT
175162,1700419860,1700437560,17700,140260,88864,US,US
168718,1700439720,1700443320,3600,178475,165243,GB,GB
15878,1699828080,1699862760,34680,182388,9947,TR,TR
133094,1699053960,1699060740,6780,54914,140535,GB,GB
63156,1699770240,1699789980,19740,99768,94625,FR,IT
22001,1700108700,1700139180,30480,153532,110063,TR,TR
66049,1699702260,1699724940,22680,89087,8305,PL,PL
133184,1700738700,1700746860,8160,131595,183066,SK,SK
184814,1700854920,1700886300,31380,123946,152658,TR,TR
70279,1699167600,1699184640,17040,187190,92080,FR,FR
136693,1698950100,1698965760,15660,2185,468,US,US
168575,1699073580,1699101240,27660,194795,129120,DE,DE
153673,1700851740,1700855340,3600,167156,179065,GB,GB
48735,1700341620,1700360100,18480,10084,151488,BE,DK
88728,1699463220,1699497600,34380,159319,170094,TR,TR
60676,1699432680,1699449180,16500,115110,11487,AT,AT
146281,1698842040,1698866520,24480,124254,10969,BR,BR
37319,1700362020,1700393280,31260,38962,132332,TR,TR
56870,1699081500,1699100400,18900,92617,143575,FR,BE
95043,1699152240,1699175520,23280,185638,114421,DE,BG
69202,1699117080,1699150740,33660,116964,186325,TR,TR
121921,1700155320,1700173500,18180,100091,5050,FR,ES
5131,1700067180,1700081400,14220,53382,55543,IT,IT
33449,1700491080,1700494800,3720,147316,51324,NL,NL
118234,1700165340,1700201220,35880,13925,95560,TR,TR
69736,1699686300,1699689900,3600,9766,49705,NL,NL
193133,1700825400,1700863620,38220,67983,55920,MX,MX
187723,1700016180,1700027160,10980,66638,22779,US,US
194769,1700391960,1700426040,34080,7261,135455,TR,TR
116626,1699506840,1699536540,29700,146693,60387,TR,TR
127224,1700806860,1700822700,15840,21982,69246,US,US
31162,1699107360,1699118700,11340,112668,105282,IT,IT
11569,1700614320,1700618700,4380,182950,72211,GB,GB
139274,1700538000,1700569800,31800,10198,55041,TR,TR
71554,1699381920,1699408800,26880,147321,55904,CH,DE
157850,1700366460,1700398920,32460,6314,110239,MX,US
77887,1700606220,1700618640,12420,101974,73032,IT,IT
29456,1700127300,1700158920,31620,158914,191544,TR,TR
74112,1700115060,1700150400,35340,53725,75086,TR,TR
8765,1700290800,1700294400,3600,182302,48096,GB,GB
120960,1700338320,1700349840,11520,61312,168587,IT,IT
89611,1700100960,1700133000,32040,125615,148712,TR,TR
157696,1699150140,1699182300,32160,181493,68182,TR,TR
46457,1698796620,1698832200,35580,182144,126005,TR,TR
174967,1699616580,1699627560,10980,6406,71396,ES,AD
86411,1699215060,1699254060,39000,100242,172393,MX,MX
2334,1700515440,1700547120,31680,77141,149136,TR,TR
85114,1700039160,1700055840,16680,44196,24803,US,US
56783,1700657040,1700677380,20340,116845,73501,BE,NL
359,1699075260,1699107960,32700,174815,67603,TR,TR
145995,1700187240,1700211180,23940,3236,142867,DE,RS
157952,1699545300,1699576980,31680,40397,140365,TR,TR
98165,1699999440,1700003040,3600,53683,65785,GB,GB
65260,1700228760,1700258340,29580,110622,84642,TR,TR
163369,1699249800,1699255860,6060,182391,140752,GB,GB
173411,1699279920,1699283940,4020,195368,184453,GB,GB
14991,1699324080,1699328940,4860,195455,10411,GB,GB
154754,1700088840,1700112900,24060,90170,70365,CH,DE
42271,1699906860,1699959960,53100,157280,54957,BG,AT
72455,1699411560,1699427100,15540,181850,143606,CZ,CZ
147502,1699150560,1699185300,34740,168083,12110,TR,TR
21086,1700266020,1700278740,12720,155227,192270,US,US
20726,1699988040,1700000340,12300,14740,116487,US,US
94747,1700422440,1700426040,3600,61670,87015,GB,GB
71925,1700821260,1700855460,34200,118046,177485,TR,TR
171148,1700312760,1700346060,33300,101913,34963,MX,MX
157086,1698832380,1698862920,30540,163801,1956,TR,TR
198334,1700720940,1700737740,16800,91424,103488,US,US
79833,1700564820,1700597700,32880,86778,108414,TR,TR
85077,1699978140,1699987320,9180,110115,199146,ES,ES
31182,1700701860,1700714520,12660,17404,140677,US,US
116186,1699994280,1700005380,11100,187335,46678,ES,AD
42390,1699639800,1699646460,6660,83770,110614,GB,GB
87640,1699339980,1699351740,11760,43088,68591,US,US
85422,1698855060,1698862200,7140,65099,88064,GB,GB
7056,1700583600,1700621340,37740,133585,124883,MX,MX
160004,1699711680,1699740840,29160,32973,192655,TR,TR
132492,1699981320,1700011920,30600,94934,38195,TR,TR
80481,1699521900,1699553640,31740,23783,63866,TR,TR
101939,1698964380,1698992100,27720,43168,139788,PL,PL
162141,1700687400,1700718900,31500,82457,55387,TR,TR
115956,1700320500,1700353260,32760,76621,193370,TR,TR
50883,1700091000,1700097480,6480,89907,65674,NL,NL
42426,1699106700,1699119120,12420,183218,95385,US,US
195994,1699856820,1699872240,15420,44714,141292,FR,BE
104378,1699353360,1699363080,9720,17282,16323,PT,PT
20082,1699811160,1699831860,20700,155578,83544,FR,FR
89733,1698797700,1698815400,17700,74964,5666,US,US
136864,1700260380,1700271600,11220,91740,36580,US,US
195646,1699577520,1699607640,30120,190942,98891,TR,TR
154628,1699896360,1699901100,4740,143283,79468,GB,GB
76531,1700313360,1700328180,14820,18639,113122,US,US
33306,1699583640,1699590240,6600,85936,47403,NL,NL
151444,1698945480,1698978900,33420,121728,161049,TR,TR
110765,1700458740,1700492040,33300,22741,195593,TR,TR
20745,1699486020,1699510320,24300,81994,34348,PL,PL
134083,1699129380,1699158840,29460,109197,120216,TR,TR
43996,1699492440,1699527720,35280,106116,193472,TR,TR
76804,1699855800,1699859400,3600,1038,70659,GB,GB
2990,1700023560,1700035800,12240,154140,112263,SK,SK
110146,1700341080,1700344680,3600,10673,3841,GB,GB
129853,1698886200,1698920760,34560,159106,179585,TR,TR
116458,1700441580,1700456700,15120,105245,27402,US,US
107777,1699066920,1699072140,5220,171608,37457,GB,GB
55214,1699601100,1699609620,8520,1685,180308,HR,HR
39846,1700198880,1700215740,16860,42955,35714,US,US
135889,1699907100,1699916160,9060,79622,192479,HR,HR
35684,1698889500,1698919620,30120,48868,10699,TR,TR
16249,1699925940,1699947480,21540,97465,153982,FR,AD
51879,1700340780,1700370720,29940,131485,141568,TR,TR
98821,1699186620,1699204740,18120,31542,104064,SE,SE
30226,1700174220,1700190060,15840,60916,74943,FR,FR
98383,1698868500,1698881820,13320,183944,78865,IT,IT
115945,1699532460,1699585920,53460,3290,83151,BG,DE
25392,1700596680,1700631240,34560,148230,101940,TR,TR
100408,1699216920,1699233180,16260,66646,162163,US,US
162677,1700825760,1700829360,3600,182731,3513,NL,NL
53267,1700647200,1700664420,17220,176457,99947,US,US
89089,1699691160,1699720020,28860,158251,137890,TR,TR
68833,1699208040,1699230780,22740,34647,44796,DE,CZ
164121,1700410200,1700444040,33840,31853,164558,TR,TR
184528,1699072800,1699077660,4860,188198,186809,NL,NL
86994,1698855600,1698859200,3600,95361,173736,NL,BE
20632,1699873740,1699907520,33780,197136,48348,TR,TR
117460,1698940200,1698963480,23280,103056,7912,PL,PL
55921,1700592360,1700627100,34740,122292,190791,TR,TR
144665,1700728740,1700743020,14280,8604,188479,US,US
58222,1700424900,1700460240,35340,176345,76941,TR,TR
195947,1699501680,1699509540,7860,79850,81363,IT,IT
174558,1700529060,1700563920,34860,33587,106761,TR,TR
109709,1699279440,1699315140,35700,92756,134783,TR,TR
194356,1699354380,1699387860,33480,17259,173773,TR,TR
189341,1699659120,1699673520,14400,122364,16788,US,US
99421,1700704440,1700738100,33660,35086,131216,TR,TR
183863,1699041240,1699075380,34140,172609,117379,TR,TR
69632,1700251620,1700266860,15240,51624,102560,FR,ES
26364,1700532600,1700550660,18060,178252,164918,LT,PL
122712,1700161980,1700169180,7200,79406,108371,HR,HR
67081,1700661960,1700678400,16440,196795,7657,US,US
9738,1700009580,1700021700,12120,187270,63964,US,US
122030,1699160100,1699182420,22320,178158,127459,CH,IT
39394,1699950720,1699959600,8880,75146,43192,AD,FR
124272,1699551060,1699585260,34200,71968,174725,TR,TR
47642,1700222100,1700246280,24180,69121,153359,DK,CZ
46066,1699494180,1699499820,5640,11943,30029,NL,NL
94614,1699987260,1699999080,11820,158169,63266,CZ,DE
135025,1699450740,1699484400,33660,161309,140030,TR,TR
113396,1699966080,1699982760,16680,166362,52929,AT,CZ
167435,1700614320,1700646480,32160,75715,58161,TR,TR
120437,1700014800,1700038920,24120,88270,15997,RO,RO
101495,1700761380,1700797260,35880,89445,152972,TR,TR
129324,1699680480,1699694340,13860,78357,145575,US,US
26307,1699663800,1699696380,32580,72362,83573,TR,TR
166521,1700191140,1700203020,11880,95638,38828,HR,HR
107483,1700489940,1700527260,37320,192568,84472,MX,MX
35671,1699382040,1699415040,33000,7815,92436,TR,TR
111474,1699937640,1699947720,10080,184845,81867,IT,IT
57558,1699217220,1699226160,8940,195697,189131,ES,ES
33518,1699673460,1699677060,3600,5551,11947,NL,NL
44233,1699137120,1699154280,17160,159554,170364,US,US
54079,1700502420,1700532660,30240,104366,123601,TR,TR
162814,1699565400,1699570920,5520,70773,67110,NL,NL
159812,1700572380,1700605020,32640,116680,75999,TR,TR
95746,1700064480,1700068080,3600,193420,18037,GB,GB
618,1699021320,1699054680,33360,71700,185504,TR,TR
109886,1699412460,1699429500,17040,62903,30903,CZ,CZ
194162,1700255220,1700268900,13680,69524,186170,US,US
123229,1699141440,1699165320,23880,133182,142259,PL,PL
117034,1700807160,1700841000,33840,70914,155850,TR,TR
13122,1700093220,1700122920,29700,177565,155718,TR,TR
156013,1699503600,1699521420,17820,117644,167119,US,US
262,1699840200,1699864740,24540,118568,56148,CH,IT
176107,1700731320,1700762760,31440,33600,50881,TR,TR
137341,1698986460,1699017900,31440,44710,5901,TR,TR
57014,1700206800,1700239080,32280,15345,53567,TR,TR
95934,1698869520,1698903360,33840,4281,5048,TR,TR
62226,1700292480,1700306580,14100,171498,3079,US,US
79974,1699512840,1699527660,14820,105308,63422,US,US
192100,1699555380,1699563540,8160,146899,173852,HR,HR
24482,1700562540,1700585580,23040,164542,87742,DK,DK
147865,1698861240,1698876240,15000,44448,164861,CZ,PL
4721,1700662500,1700697420,34920,154346,28123,TR,TR
118736,1699815540,1699844460,28920,99211,165983,TR,TR
32446,1699599240,1699634940,35700,123370,82940,TR,TR
176852,1700103900,1700107500,3600,180324,87622,NL,NL
130605,1700864400,1700900220,35820,35673,63272,TR,TR
74695,1698902280,1698914940,12660,75562,53068,IT,IT
157364,1699010880,1699043640,32760,110659,106918,TR,TR
142949,1700538180,1700546820,8640,80104,162896,SK,AT
5600,1700792580,1700827500,34920,66374,155403,TR,TR
182517,1698929760,1698942300,12540,192155,42753,IT,IT
185272,1700158260,1700185380,27120,28770,119719,RO,RO
37445,1699369620,1699376100,6480,30087,179475,GB,GB
91662,1698921600,1698934500,12900,9036,184087,US,CA
129523,1698805260,1698836880,31620,58686,83433,TR,TR
818,1699951020,1699957200,6180,42372,54127,GB,GB
195477,1700049720,1700078880,29160,30866,89966,TR,TR
133814,1700073900,1700095140,21240,47561,148779,FR,FR
198930,1700154720,1700186640,31920,153729,104434,TR,TR
170013,1700495160,1700529900,34740,73617,133882,TR,TR
138538,1699486920,1699515960,29040,33700,63947,TR,TR
113845,1698996060,1699011660,15600,163126,128838,US,US
166992,1700815080,1700850900,35820,98437,139380,MX,MX
158453,1700292000,1700302980,10980,99059,171941,IT,IT
43152,1699605720,1699640100,34380,88424,105597,TR,TR
24534,1700196000,1700212200,16200,73878,176616,FR,FR
93361,1699740180,1699743780,3600,188515,107639,NL,NL
122094,1699174080,1699204140,30060,30768,194746,TR,TR
37911,1700155800,1700193480,37680,157560,146801,MX,MX
83257,1700799000,1700804040,5040,85467,192494,GB,GB
68561,1700078220,1700095140,16920,23775,35079,US,US
2409,1698937440,1698971100,33660,156241,191927,TR,TR
13756,1700341560,1700347020,5460,48290,18194,NL,NL
165085,1700475240,1700492520,17280,176643,126065,US,US
157893,1699697280,1699706160,8880,88038,189929,IT,IT
14494,1700136660,1700147640,10980,197977,126237,RS,ME
98651,1700786220,1700816340,30120,80155,154403,TR,TR
53196,1700596080,1700627640,31560,147379,194321,TR,TR
76260,1700236560,1700266440,29880,118783,47288,TR,TR
195954,1699989600,1700020140,30540,166339,148329,TR,TR
44305,1698818880,1698830340,11460,25593,125953,IT,IT
172717,1698937320,1698944040,6720,171074,30841,GB,GB
12676,1699656900,1699660500,3600,126203,135134,NL,NL
73087,1699178340,1699210200,31860,86694,39820,TR,TR
161642,1699361820,1699378140,16320,52369,95734,US,US
91499,1699072980,1699104900,31920,64579,126877,TR,TR
102222,1699008180,1699019280,11100,39344,60329,US,CA
24883,1699880100,1699909980,29880,160644,129889,TR,TR
104103,1699454700,1699466280,11580,146012,157194,RS,RS
177518,1699688040,1699693020,4980,47381,67283,GB,FR
122234,1698926400,1698954840,28440,54155,189834,PL,FR
17226,1699843800,1699847400,3600,98768,7484,GB,GB
46859,1700317560,1700344860,27300,90105,43004,PL,SK
159861,1700121360,1700124960,3600,146074,54656,GB,GB
78355,1699182300,1699213980,31680,99267,121988,TR,TR
77110,1700170500,1700176260,5760,136367,162805,NL,NL
159833,1699180680,1699213620,32940,196882,133010,TR,TR
16555,1700524080,1700554440,30360,90541,68170,TR,TR
125128,1700451780,1700475600,23820,149574,162591,DE,PL
196921,1699130280,1699143540,13260,185065,193760,US,US
48419,1700570280,1700592300,22020,134385,35317,BR,BR
177699,1699954560,1699987740,33180,168183,65022,TR,TR
51201,1699105380,1699140840,35460,114105,163174,TR,TR
119145,1699498080,1699532940,34860,72821,56848,TR,TR
27438,1699964760,1699968360,3600,136793,144026,GB,GB
153427,1699050420,1699072560,22140,162580,186361,DE,FR
140098,1699329960,1699360980,31020,170832,63556,TR,TR
37262,1700395560,1700426160,30600,145401,58829,TR,TR
57508,1700483700,1700505780,22080,10801,40959,BR,BR
5923,1699009260,1699014480,5220,100766,58520,GB,GB
167085,1699957740,1699986660,28920,140211,43726,TR,TR
17670,1700806560,1700810160,3600,16258,119516,GB,GB
45295,1699029300,1699034520,5220,114802,158879,GB,GB
80756,1700707560,1700737620,30060,72609,68117,TR,TR
84254,1699585080,1699620960,35880,145868,85389,TR,TR
38901,1700367840,1700394480,26640,180247,64587,BA,HR
79843,1699238160,1699267440,29280,149568,95051,TR,TR
180317,1700829240,1700859900,30660,100,70901,TR,TR
140243,1699933500,1699947060,13560,44422,111629,US,US
190775,1699899000,1699911360,12360,125419,167754,IT,IT
151132,1698932520,1698961440,28920,140743,138774,TR,TR
153101,1700129640,1700141400,11760,106507,98534,US,US
181925,1700310180,1700315700,5520,75293,5962,GB,FR
51246,1700055180,1700064780,9600,42666,162045,IT,IT
60079,1699628820,1699662540,33720,30882,164837,MX,US
15306,1699553520,1699559340,5820,56263,188605,NL,NL
55154,1700343180,1700350380,7200,48418,77230,HR,HR
92158,1700808480,1700828520,20040,129520,113575,DK,DK
190218,1699812180,1699848540,36360,104951,149000,MX,MX
3938,1700308560,1700339640,31080,163776,190739,TR,TR
164864,1699817880,1699835100,17220,183656,192493,BE,NL
149396,1700661780,1700695200,33420,54556,156340,TR,TR
135127,1700428800,1700460840,32040,53593,21183,TR,TR
127807,1699018620,1699037280,18660,69603,132141,FR,FR
171091,1700471280,1700474880,3600,121989,15014,GB,GB
27244,1700224980,1700254860,29880,48663,157623,TR,TR
162243,1700558940,1700573700,14760,150634,135754,US,US
112368,1699252680,1699279920,27240,100700,169010,CH,IT
109382,1700352420,1700363040,10620,71111,183928,IT,IT
59007,1700741580,1700758980,17400,107052,152254,SE,SE
166222,1699585500,1699589640,4140,94247,21815,GB,GB
175995,1700131080,1700139840,8760,95979,19978,IT,IT
146575,1700720100,1700728920,8820,81717,98875,HR,HR
175343,1700441220,1700457720,16500,105780,189893,US,US
133630,1700691420,1700725920,34500,189253,150370,TR,TR
45307,1699506720,1699523700,16980,92561,96285,AT,AT
117779,1698904860,1698938520,33660,153759,130463,TR,TR
121736,1699180200,1699186500,6300,116527,64701,GB,GB
111001,1699345080,1699350060,4980,19836,95158,GB,GB
87418,1700840340,1700843940,3600,87652,143242,NL,NL
187039,1699937760,1699941360,3600,158193,10574,GB,GB
155058,1699667340,1699702740,35400,107319,38595,MX,US
164819,1698833160,1698856260,23100,98285,121235,RO,PL
199811,1700250240,1700283720,33480,85081,127142,TR,TR
131848,1700551860,1700563920,12060,1743,3839,ES,ES
97068,1699294320,1699303740,9420,11089,136384,HR,HR
52963,1700057880,1700072760,14880,88846,85686,US,US
11184,1699158060,1699192020,33960,110962,142604,TR,TR
146669,1698801420,1698805860,4440,149047,140234,GB,GB
156281,1700801640,1700831700,30060,168945,86306,TR,TR
88489,1699617420,1699631160,13740,85820,148474,US,US
97440,1699226160,1699257660,31500,74119,101417,TR,TR
188084,1700151300,1700154900,3600,73189,197341,GB,GB
47719,1699579980,1699609080,29100,140325,88165,TR,TR
85876,1699681620,1699699440,17820,176063,132726,CZ,CZ
118952,1699111620,1699150980,39360,106751,101396,MX,MX
143442,1699954860,1699988220,33360,148117,171872,TR,TR
124373,1699143180,1699149300,6120,113140,142582,GB,GB
179696,1700173980,1700186220,12240,187274,173471,US,US
103350,1700492640,1700497260,4620,31331,20267,GB,GB
167054,1700153640,1700165460,11820,159246,156802,IT,IT
153105,1700564820,1700573160,8340,30339,4133,HR,HR
32953,1699935180,1699951440,16260,31546,5867,US,US
20890,1700024340,1700058660,34320,68826,8423,TR,TR
96600,1700443500,1700478120,34620,141143,101909,TR,TR
90653,1700051700,1700086020,34320,42293,191363,TR,TR
23769,1699405800,1699438260,32460,198365,49844,TR,TR
6952,1700451240,1700481000,29760,191515,67211,TR,TR
47713,1700370000,1700404560,34560,4868,119609,TR,TR
150366,1699574760,1699605840,31080,192299,177670,TR,TR
98223,1699280640,1699296900,16260,126314,84308,FR,FR
30418,1700627340,1700641980,14640,16831,73207,FR,FR
154611,1699009500,1699013100,3600,119455,25213,NL,NL
28142,1700276400,1700292480,16080,136730,122700,FR,RO
44098,1700683680,1700697660,13980,65680,9321,HR,HR
168087,1699942440,1699974060,31620,84129,138156,TR,TR
889,1699771020,1699825500,54480,71679,102588,BG,BG
131076,1700490300,1700512020,21720,122842,149652,HU,DE
75331,1699812120,1699846260,34140,138800,14591,TR,TR
120907,1700112960,1700126940,13980,81753,23741,AT,AT
94554,1700200740,1700259240,58500,52144,191416,UA,DE
22177,1700185980,1700211720,25740,48571,130089,PL,PL
128249,1699320960,1699376880,55920,190609,197450,BG,DE
26875,1700150100,1700157300,7200,17227,9218,HR,DE
55395,1700263200,1700278740,15540,65304,146845,CA,CA
99422,1700086980,1700093040,6060,153950,32147,GB,GB
10490,1699729680,1699739700,10020,65658,8777,IT,IT
124601,1700437440,1700465400,27960,110517,25436,RO,RO
71265,1700581200,1700584800,3600,22869,121595,NL,NL
2397,1700527800,1700560920,33120,104950,19128,TR,TR
5781,1700620380,1700650500,30120,176329,167183,TR,TR
108636,1700470800,1700485020,14220,138158,94067,IT,IT
146856,1699564860,1699594020,29160,108702,138304,TR,TR
69361,1699685700,1699698120,12420,90221,146119,CZ,DE
102362,1700683380,1700718420,35040,131655,45372,TR,TR
61522,1699433640,1699445100,11460,188309,6956,AT,AT
134523,1700547540,1700551380,3840,51092,6946,GB,GB
100728,1700187900,1700220720,32820,198511,124824,TR,TR
46688,1700094180,1700123340,29160,20655,127254,MK,AL
51002,1699402020,1699435800,33780,119432,121810,TR,TR
156263,1700647200,1700674620,27420,16113,7118,BA,HR
19269,1699162320,1699175160,12840,22494,106723,US,US
28549,1699340100,1699346160,6060,58653,97917,NL,NL
1586,1700777340,1700808000,30660,79337,130132,TR,TR
40489,1699081740,1699092300,10560,163562,160048,IT,DE
50871,1700034360,1700065440,31080,123738,65914,TR,TR
93783,1698799080,1698830700,31620,81310,26344,TR,TR
34598,1700536860,1700540460,3600,102130,164215,GB,GB
69956,1700209620,1700241540,31920,17402,166030,TR,TR
80784,1700273160,1700290740,17580,63550,104487,RS,RS
106885,1700071200,1700103900,32700,14778,159144,TR,TR
73366,1700177880,1700195040,17160,30906,117527,US,US
89158,1699949400,1699983420,34020,37400,38669,TR,TR
136697,1699086360,1699096680,10320,111249,178417,IT,IT
141014,1699630680,1699634940,4260,12759,169515,GB,GB
150653,1698878580,1698888660,10080,177880,120552,IT,IT
161934,1698912420,1698945480,33060,31645,63399,TR,TR
73324,1699653900,1699659300,5400,66044,87525,GB,GB
60655,1699262160,1699295040,32880,138936,120304,TR,TR
133343,1698944700,1698948300,3600,18348,173975,GB,GB
136930,1699559580,1699563180,3600,178313,164915,GB,GB
36903,1700378700,1700409660,30960,147837,74693,TR,TR
101392,1700029140,1700051940,22800,42475,104092,DE,PL
105676,1699043580,1699072860,29280,30222,137504,TR,TR
111603,1699995360,1700009160,13800,116252,149850,IT,IT
55430,1699745520,1699749120,3600,198289,25461,GB,GB
31825,1699689780,1699698360,8580,167070,139157,PT,PT
99711,1700395680,1700412540,16860,9550,195925,FR,FR
41369,1699452180,1699455780,3600,94814,53311,GB,GB
61508,1699196760,1699201860,5100,76111,32951,NL,NL
11264,1698858240,1698872100,13860,85997,55070,US,US
71969,1699431060,1699464840,33780,27750,36262,TR,TR
64533,1698810960,1698845820,34860,11807,22617,TR,TR
89732,1700793060,1700817540,24480,52112,12778,PL,DE
176869,1699952400,1699967400,15000,68397,172508,FR,FR
98586,1700570340,1700581200,10860,123531,149149,US,US
133659,1700434860,1700457720,22860,141801,182279,HU,RS
99638,1699850640,1699854660,4020,182905,153538,GB,GB
86847,1700136660,1700153520,16860,21970,90002,FR,NL
183523,1700115000,1700139780,24780,198605,105388,DE,IT
41285,1699151640,1699163820,12180,192963,17602,IT,IT
132346,1699820400,1699831860,11460,49385,119030,US,US
53845,1700217900,1700226780,8880,87546,60135,PT,PT
44214,1700371500,1700401320,29820,144280,28136,TR,TR
25797,1700121360,1700143620,22260,20255,58426,PL,PL
172081,1699342860,1699346460,3600,119411,130271,GB,GB
14077,1700582100,1700585700,3600,22727,96879,GB,GB
19884,1699198680,1699202280,3600,107032,136532,GB,GB
131362,1698816180,1698822420,6240,192704,126509,NL,NL
105506,1698794220,1698808800,14580,47795,40077,US,US
84108,1699290180,1699308360,18180,186381,60463,FR,DE
140560,1699564260,1699603800,39540,198224,48781,MX,MX
78757,1700081100,1700115360,34260,165015,111228,TR,TR
76890,1700598780,1700604000,5220,28203,64979,GB,GB
145239,1699777320,1699780920,3600,10276,26238,GB,GB
56152,1700565000,1700569200,4200,45219,193506,NL,NL
46531,1698818880,1698844500,25620,103807,20571,DE,DE
104574,1700812320,1700841480,29160,176233,105280,TR,TR
100442,1699385700,1699389480,3780,50620,1351,GB,GB
106138,1700172060,1700175660,3600,78945,126700,NL,NL
154199,1699610340,1699620420,10080,94320,118261,IT,IT
37234,1700023380,1700032500,9120,118261,93147,HR,BA
980,1699737360,1699752840,15480,199184,125328,US,US
118259,1700733000,1700766420,33420,54137,187667,TR,TR
90548,1699905600,1699916760,11160,146619,86673,AT,HU
102189,1700841480,1700852100,10620,113832,159907,SK,AT
69511,1698888060,1698900540,12480,27293,110142,US,US
63535,1700328480,1700360040,31560,145938,170213,TR,TR
155830,1699100160,1699137480,37320,27346,82287,MX,MX
139536,1699466880,1699478760,11880,11733,118125,US,US
141785,1699521600,1699525200,3600,3101,162335,NL,NL
198753,1699830420,1699834020,3600,58666,20325,GB,GB
7653,1700087820,1700113920,26100,27917,64647,DE,DE
187110,1700475960,1700488320,12360,54393,72292,AT,DE
120255,1700447640,1700478720,31080,145458,29613,TR,TR
70438,1700036400,1700046960,10560,21841,137717,AD,ES
74045,1699488900,1699505040,16140,57219,194958,US,US
167159,1699809600,1699817100,7500,160177,127206,IT,IT
52168,1700760300,1700772720,12420,98363,17616,US,US
109121,1700805000,1700833860,28860,7725,57807,TR,TR
166544,1700287020,1700299260,12240,34097,90205,US,US
150765,1698931260,1698943680,12420,139601,10259,US,US
79300,1699657020,1699671060,14040,88532,139047,IT,IT
39248,1700775300,1700806440,31140,198698,192848,TR,TR
188307,1700582580,1700586180,3600,189487,134857,NL,NL
130373,1700537340,1700564400,27060,27726,34334,PL,PL
103880,1699651500,1699672800,21300,171137,36162,FR,NL
77263,1699838760,1699874100,35340,73462,126695,TR,TR
163205,1698981660,1698997320,15660,13332,168100,US,US
121142,1699866840,1699883160,16320,141199,8970,AT,AT
103666,1700564340,1700596380,32040,13473,101752,TR,TR
20773,1699844820,1699863180,18360,30115,85216,FR,FR
74851,1700508540,1700530500,21960,85859,118779,RO,RO
90940,1699963920,1699967520,3600,78248,15783,GB,GB
131015,1700429040,1700443380,14340,23472,108471,IT,IT
36484,1698979440,1699013700,34260,159597,22353,TR,TR
98930,1699780380,1699815420,35040,36121,121151,MX,MX
133828,1699523700,1699527300,3600,169684,12198,GB,GB
11230,1699048140,1699100160,52020,85318,158411,BG,AT
96977,1699364580,1699373220,8640,149660,190696,ES,ES
8052,1700861820,1700888100,26280,16012,140262,DE,PL
120927,1700240400,1700255400,15000,162873,196043,US,US
179700,1699016280,1699047480,31200,82478,189220,TR,TR
91126,1699635000,1699652280,17280,32425,185663,SE,SE
93023,1699348320,1699383240,34920,120620,176500,TR,TR
18324,1699524360,1699555500,31140,170715,42168,TR,TR
35979,1698824760,1698828360,3600,150289,106741,NL,NL
49479,1700758320,1700761920,3600,3696,35457,NL,NL
177908,1699226580,1699256940,30360,11504,15992,TR,TR
35602,1700852100,1700887800,35700,197942,124573,TR,TR
27437,1699297560,1699309560,12000,148149,50250,US,US
85154,1699672620,1699684800,12180,179168,69327,US,US
72402,1700463240,1700485920,22680,113674,22763,BR,BR
44877,1700216160,1700219760,3600,71997,9048,GB,GB
171987,1700392560,1700403900,11340,8053,166177,US,US
191676,1700262600,1700278800,16200,58883,133220,US,US
62300,1699672260,1699677900,5640,182591,44443,GB,GB
91788,1700823840,1700831880,8040,105709,9407,ES,ES
184248,1700279760,1700286480,6720,194752,184748,NL,NL
80066,1700634780,1700664660,29880,176893,61452,TR,TR
92992,1699644000,1699671900,27900,49854,180334,BR,BR
86788,1699811640,1699842660,31020,163773,33355,TR,TR
164361,1700593860,1700624760,30900,13872,122462,TR,TR
24998,1700789820,1700803620,13800,192412,7901,US,US
119120,1700559660,1700584080,24420,34392,59872,RO,RO
25514,1699912860,1699946640,33780,157668,165760,TR,TR
93158,1700655000,1700667660,12660,7615,54433,PT,PT
68607,1700795460,1700829720,34260,194464,135650,TR,TR
78488,1699487340,1699509420,22080,989,192134,DE,CZ
191922,1700146560,1700162400,15840,103474,105367,RS,RS
108369,1699488960,1699500780,11820,179526,127819,IT,FR
35353,1699322280,1699328460,6180,170429,77517,GB,GB
88185,1699946640,1699977240,30600,81204,179741,TR,TR
188592,1699051920,1699055520,3600,116739,177889,GB,GB
61047,1698819840,1698854220,34380,22873,100117,TR,TR
45074,1699813200,1699816800,3600,131433,143266,GB,GB
17257,1699402440,1699427940,25500,161238,44167,BR,BR
159723,1699713060,1699725060,12000,192951,36126,US,US
107716,1700762940,1700787420,24480,47569,27472,DE,DE
170607,1699515660,1699530720,15060,161002,160682,US,US
71346,1698903060,1698919980,16920,20192,87020,US,US
103348,1698943980,1698947880,3900,124189,9059,GB,GB
61939,1699316940,1699322340,5400,50536,96228,NL,FR
46579,1700591700,1700601300,9600,190705,189267,IT,IT
83080,1699856640,1699889220,32580,79572,189388,TR,TR
193952,1699435920,1699439520,3600,141087,109498,NL,NL
89756,1699454400,1699486080,31680,138256,99549,TR,TR
90146,1700482320,1700517060,34740,132057,20603,TR,TR
51477,1700334480,1700338080,3600,168563,109712,GB,GB
39460,1700646840,1700677200,30360,101423,3762,TR,TR
114174,1698907200,1698918600,11400,20487,138428,RS,RS
481,1699966260,1699996320,30060,176207,106970,TR,TR
95800,1699634760,1699646880,12120,126499,152097,AT,AT
101223,1699184160,1699207500,23340,113938,63464,PL,PL
112653,1700325600,1700359080,33480,29269,76813,TR,TR
118930,1699767960,1699801860,33900,39620,65138,TR,TR
142795,1699727760,1699761000,33240,108557,69382,MX,MX
47251,1699567980,1699582140,14160,54245,164962,HR,HR
180913,1700245920,1700255580,9660,44110,85799,HR,HR
151833,1699574580,1699610160,35580,78525,51612,TR,TR
1534,1700523600,1700538060,14460,127336,31065,AT,SK
51001,1699471740,1699503600,31860,110380,97452,TR,TR
136718,1700759220,1700793180,33960,28467,70796,MX,MX
123621,1699564140,1699597200,33060,116028,24524,MX,MX
155485,1700345700,1700353680,7980,176272,6910,HR,HR
147693,1700391420,1700395020,3600,192103,153144,NL,NL
18055,1699392360,1699399440,7080,87040,103990,GB,GB
75371,1700171400,1700200860,29460,101259,49033,TR,TR
91715,1698988500,1699005660,17160,117298,88211,US,US
90560,1700395620,1700400420,4800,192555,153353,NL,NL
36213,1699491660,1699501380,9720,69294,41126,FI,EE
188924,1699805880,1699815840,9960,22093,183531,ES,ES
177205,1700285100,1700288700,3600,64507,76628,GB,GB
191338,1700223060,1700238180,15120,53553,110174,US,US
192580,1699042260,1699054800,12540,2901,160147,PT,PT
43617,1699328700,1699364880,36180,97136,150115,MX,MX
91741,1698973080,1698976680,3600,123880,79685,GB,GB
139463,1700183520,1700220540,37020,169304,19340,MX,MX
30939,1699868820,1699884600,15780,48270,9588,US,US
186467,1698978300,1698994380,16080,51102,193237,US,US
114589,1699638240,1699671120,32880,67407,90470,TR,TR
72167,1700509320,1700537280,27960,118991,81453,PL,PL
133847,1699363020,1699371240,8220,77124,160709,IT,IT
128987,1700083560,1700112660,29100,186864,119754,TR,TR
65519,1698847560,1698882900,35340,61629,33273,TR,TR
193027,1699092120,1699126560,34440,26143,45367,TR,TR
101185,1699680000,1699709280,29280,132160,30370,TR,TR
24141,1700847780,1700878680,30900,6400,8002,TR,TR
77860,1699025280,1699034880,9600,187443,167925,IT,IT
196128,1699343460,1699352220,8760,100826,186642,IT,IT
193,1699613760,1699623540,9780,36562,179880,PT,PT
48932,1699456440,1699467720,11280,33425,65947,US,US
144649,1700106000,1700137740,31740,88725,78355,TR,TR
43742,1698886440,1698891960,5520,190067,146581,GB,GB
112165,1700723940,1700758740,34800,186484,119285,MX,MX
103671,1700299740,1700314020,14280,190098,24280,IT,IT
150889,1700832720,1700867220,34500,132203,140579,TR,TR
171427,1700067720,1700090760,23040,113201,141816,HU,CZ
19934,1699468500,1699487040,18540,166327,90262,FR,CH
39171,1699381680,1699394340,12660,139174,100249,IT,IT
136696,1699774980,1699810800,35820,155733,50228,TR,TR
122345,1699636260,1699650600,14340,142355,188392,US,US
159470,1700200080,1700213220,13140,179014,36735,US,US
22481,1699083000,1699117500,34500,80975,146103,TR,TR
72811,1699558500,1699590240,31740,184875,145003,TR,TR
64697,1699239300,1699271880,32580,165005,11346,TR,TR
92672,1700421720,1700425320,3600,174253,147602,NL,DE
110174,1700263080,1700293620,30540,135957,199042,TR,TR
76853,1699859700,1699871820,12120,133919,160328,US,US
52789,1699615620,1699619220,3600,179678,21011,GB,GB
20598,1699639440,1699651260,11820,133167,87693,SK,AT
194506,1698882780,1698886380,3600,26770,78673,GB,GB
158325,1699434780,1699466280,31500,19735,41924,TR,TR
130004,1700690820,1700724480,33660,11661,24932,TR,TR
182071,1699832520,1699836120,3600,114395,82921,NL,NL
80726,1700499780,1700534820,35040,128513,190761,TR,TR
160696,1700342760,1700376000,33240,141706,112659,TR,TR
166654,1700569440,1700603040,33600,123647,56003,TR,TR
47211,1699881180,1699896180,15000,85757,96995,US,US
70930,1700647380,1700663580,16200,61764,25247,FR,FR
104856,1700346900,1700373360,26460,176450,71887,PL,PL
118472,1700482980,1700487360,4380,8527,133495,NL,NL
117455,1699067880,1699079400,11520,190131,58258,IT,IT
61592,1700652960,1700688540,35580,87188,125369,TR,TR
159335,1700633040,1700668980,35940,8420,71010,TR,TR
128186,1699900680,1699931280,30600,199021,168756,TR,TR
31819,1700234100,1700238180,4080,45385,120178,GB,GB
145737,1700140200,1700174640,34440,131836,51528,TR,TR
76292,1700741280,1700753040,11760,14753,151419,IT,IT
145271,1700491080,1700508300,17220,120746,103144,AT,AT
82550,1699337700,1699353240,15540,153074,115096,US,US
18749,1699350960,1699359060,8100,125399,103783,IT,IT
182296,1700493480,1700497740,4260,6235,56055,GB,GB
8912,1698882240,1698909540,27300,32167,165372,DE,FR
4951,1700076900,1700085480,8580,127824,20225,IT,IT
193544,1700028540,1700040660,12120,86707,100326,US,US
26621,1700553960,1700557560,3600,17360,36993,NL,NL
96897,1699930560,1699942860,12300,84418,150986,RS,RS
130702,1700812680,1700835060,22380,84100,57811,DE,PL
105141,1698928440,1698943740,15300,12444,21851,US,US
27473,1699842720,1699877940,35220,5840,31336,TR,TR
158107,1699752900,1699756500,3600,67855,33773,NL,GB
73170,1699511640,1699545360,33720,80091,83120,TR,TR
33510,1700294760,1700309220,14460,16195,167174,US,US
186573,1700371140,1700382240,11100,101921,183086,IT,IT
22861,1700741040,1700755680,14640,124347,43490,US,US
59956,1699306440,1699310040,3600,67187,158293,GB,GB
192149,1699118220,1699122240,4020,89674,140456,GB,GB
14143,1699588440,1699598340,9900,31287,107563,IT,IT
168897,1700318160,1700321760,3600,142747,36206,GB,GB
199735,1698849480,1698867600,18120,99795,27027,FR,IT
189582,1698878100,1698881700,3600,78607,191796,NL,DE
95302,1700130720,1700138040,7320,106730,67057,PT,PT
183958,1700368440,1700397900,29460,115196,112359,TR,TR
125318,1699387800,1699410480,22680,34803,143029,PL,PL
166026,1700390520,1700423400,32880,53743,57357,TR,TR
161230,1698833040,1698869820,36780,62878,7239,MX,MX
11783,1700483160,1700496660,13500,39412,104075,IT,IT
143934,1699403400,1699407000,3600,45107,70111,GB,GB
85709,1699712400,1699743360,30960,22350,18094,TR,TR
90278,1700046120,1700049720,3600,48142,134958,GB,GB
73502,1700054280,1700083740,29460,21280,117742,TR,TR
54245,1699186380,1699219020,32640,139745,148831,TR,TR
55570,1698918180,1698923760,5580,16254,15679,GB,GB
159831,1700700600,1700711880,11280,84070,31844,US,US
183238,1700368380,1700375100,6720,56239,94667,NL,NL
149587,1699462320,1699467900,5580,113307,106849,GB,GB
145763,1698974640,1699002660,28020,96476,64344,DE,DE
178852,1699496340,1699508040,11700,76364,99658,US,US
101606,1699752480,1699763100,10620,81766,123627,PT,PT
158525,1699843680,1699874460,30780,128800,75498,TR,TR
15563,1700262660,1700293380,30720,122468,50119,TR,TR
34521,1700672160,1700700960,28800,32092,49254,TR,TR
94501,1699948680,1699959840,11160,81134,94216,US,US
188461,1699565700,1699592460,26760,76462,34408,PL,DE
22091,1698835620,1698849840,14220,64077,74040,IT,IT
179244,1700202420,1700216160,13740,145677,98016,US,US
111093,1700376960,1700405340,28380,70439,75312,DE,IT
44971,1700227440,1700287680,60240,44098,126811,UA,DE
118616,1698801960,1698805560,3600,32175,6794,NL,LU
100624,1699152660,1699156920,4260,180824,128214,GB,GB
147096,1699574580,1699589340,14760,193287,125870,US,US
49544,1699558860,1699593840,34980,131832,34102,TR,TR
58801,1699800840,1699811040,10200,66150,3045,AD,ES
32378,1699458060,1699466460,8400,164047,146873,IT,IT
185446,1698863040,1698896280,33240,143351,118224,TR,TR
122671,1699365480,1699381560,16080,91063,149237,US,US
158880,1699568640,1699582860,14220,127016,67662,IT,DE
62694,1699883760,1699906860,23100,192232,150385,BR,BR
72428,1698926100,1698955500,29400,188359,175191,TR,TR
120141,1700824260,1700853420,29160,115843,116499,TR,TR
165633,1699747260,1699777560,30300,164986,53270,TR,TR
77168,1699964700,1699996200,31500,133143,192213,TR,TR
3614,1700841720,1700845320,3600,122755,95335,NL,NL
15431,1700747100,1700779320,32220,48640,33657,TR,TR
103327,1698839700,1698871140,31440,191798,171784,TR,TR
182943,1700765820,1700769420,3600,163064,75800,GB,GB
39719,1699983960,1700012760,28800,78656,37533,TR,TR
147643,1699309140,1699341420,32280,3549,75211,TR,TR
192454,1699630080,1699665360,35280,35590,44869,TR,TR
197568,1700556240,1700559960,3720,3767,57586,GB,GB
198805,1699651620,1699686660,35040,167816,120503,TR,TR
147578,1698922620,1698956040,33420,148579,40024,TR,TR
79585,1699209780,1699244040,34260,38930,84719,TR,TR
21837,1699061160,1699093680,32520,108126,147981,TR,TR
76121,1700709420,1700732700,23280,46898,130324,DE,DE
98031,1700555520,1700582340,26820,175140,193652,BA,BA
138121,1699528380,1699531980,3600,112216,68910,NL,NL
79072,1699621320,1699648560,27240,150673,32806,PL,DE
68439,1700406120,1700409900,3780,25632,56806,GB,GB
105626,1700336100,1700339820,3720,11645,168064,NL,NL
58078,1699137000,1699172460,35460,6338,193106,TR,TR
92101,1699531200,1699539000,7800,118274,64892,EE,EE
190242,1700822760,1700829060,6300,74788,56768,NL,NL
131223,1700105880,1700138280,32400,98564,47743,TR,TR
96012,1699448880,1699452720,3840,134903,193068,GB,GB
148366,1700442780,1700457180,14400,63827,45150,FR,DE
24145,1700130420,1700161560,31140,65914,99249,TR,TR
160265,1700857860,1700863080,5220,42816,56519,NL,NL
47453,1699757520,1699762740,5220,81014,130021,GB,GB
97118,1699915500,1699926600,11100,160745,108514,US,US
49390,1699252560,1699256160,3600,133340,133179,GB,GB
177609,1700328120,1700363040,34920,27153,96223,TR,TR
55323,1700162820,1700178120,15300,91275,91902,FR,HR
13927,1700381700,1700391600,9900,152315,138986,IT,IT
160585,1700623980,1700639940,15960,107626,119700,US,US
17580,1699603980,1699608000,4020,100383,23728,GB,GB
83967,1699374720,1699379940,5220,183151,96065,GB,GB
165033,1699258020,1699261620,3600,173563,185918,GB,GB
153797,1700122020,1700155200,33180,102717,106338,TR,TR
125478,1699189320,1699218900,29580,5583,198574,TR,TR
5941,1698890040,1698906840,16800,132775,18392,US,US
190398,1700350380,1700374980,24600,74099,140289,DE,CH
133161,1699296300,1699323780,27480,176478,99670,DE,PT
48811,1700767920,1700793240,25320,197777,192473,PL,AT
128306,1699672020,1699704360,32340,2998,167833,TR,TR
81791,1699720920,1699724520,3600,131620,129632,GB,GB
111321,1700472300,1700499780,27480,96890,104495,PL,DE
115235,1698981840,1699014540,32700,64452,71724,TR,TR
197336,1700360700,1700372220,11520,182999,59328,RS,RS
33922,1699690920,1699702320,11400,69584,51446,RS,RS
135517,1699618140,1699649220,31080,23481,142629,TR,TR
54122,1699366260,1699380720,14460,162390,106735,FR,FR
166,1699106220,1699112100,5880,166985,57872,NL,NL
150570,1699495740,1699512900,17160,89284,172783,CA,CA
136879,1699078080,1699093140,15060,69931,54180,US,US
151179,1700166120,1700201040,34920,151040,168204,TR,TR
154384,1699883340,1699914060,30720,20120,173483,TR,TR
164532,1699044600,1699076220,31620,57810,129175,TR,TR
100984,1699262100,1699279680,17580,135659,175758,US,US
179076,1700685660,1700702100,16440,158684,192384,US,US
182604,1700511060,1700543760,32700,179655,46871,TR,TR
198378,1699886100,1699917960,31860,65567,45573,TR,TR
8704,1700402400,1700415060,12660,158108,86326,US,US
24629,1699953480,1699983900,30420,161826,108998,TR,TR
106606,1700120220,1700126640,6420,33825,105581,GB,GB
10507,1699240020,1699271220,31200,105860,53232,TR,TR
168942,1699315320,1699348740,33420,199452,174239,TR,TR
151486,1700092320,1700107860,15540,68825,143939,FR,DE
109664,1700351460,1700369160,17700,192140,183293,RS,RS
39940,1699318620,1699328040,9420,153088,145254,PT,PT
170602,1700775540,1700790900,15360,147664,125513,US,US
76095,1700191560,1700198100,6540,111419,33969,GB,GB
194787,1700483940,1700514360,30420,109881,144866,TR,TR
123223,1699792560,1699809360,16800,23798,147885,US,US
109406,1700608140,1700614080,5940,161832,199499,GB,GB
122161,1699678380,1699691280,12900,165246,42212,IT,IT
109240,1699551600,1699563060,11460,82529,75547,AT,DE
85546,1700834940,1700860320,25380,164366,177885,DE,HR
24343,1699512120,1699528140,16020,37422,4846,US,US
84157,1700784900,1700793240,8340,66411,75788,ES,ES
133975,1699630260,1699654500,24240,92247,148747,AL,MK
104808,1700342520,1700355540,13020,73546,36744,US,US
179906,1699805280,1699833060,27780,161897,126083,DE,DE
50558,1699463460,1699474320,10860,154767,114574,US,US
102561,1699394820,1699411560,16740,29208,150084,US,US
144500,1698998520,1699027380,28860,97533,50882,TR,TR
56974,1700647200,1700661900,14700,113741,82517,SE,DK
191138,1699642620,1699672200,29580,79297,133643,TR,TR
172173,1699828560,1699841760,13200,60380,25984,US,US
31909,1699568160,1699573500,5340,26456,48537,GB,GB
181278,1699504080,1699534200,30120,169326,110962,TR,TR
62386,1698872820,1698886080,13260,136031,88677,IT,FR
125400,1700173080,1700176680,3600,145974,127537,GB,GB
86934,1699394820,1699424700,29880,61940,100877,TR,TR
17133,1700648400,1700680920,32520,69928,189459,TR,TR
196595,1698971820,1699006620,34800,193089,176880,TR,TR
61992,1700265180,1700300580,35400,101984,175783,TR,TR
69215,1699335420,1699350360,14940,95967,113597,US,US
89408,1700095920,1700102460,6540,53726,9418,NL,NL
102543,1700779740,1700783340,3600,98961,96557,NL,NL
38822,1699854960,1699859940,4980,66468,58128,GB,GB
180203,1700822820,1700826420,3600,36508,132305,NL,NL
64172,1698837300,1698855240,17940,136477,91136,US,MX
135911,1699449900,1699464000,14100,73271,164868,CA,US
118363,1699378800,1699394880,16080,57878,7886,US,US
32065,1700461320,1700489820,28500,44046,123006,DE,IT
3237,1699938060,1699969140,31080,131795,160809,BA,DE
24766,1700126100,1700161020,34920,1230,2611,TR,TR
51453,1700557080,1700587980,30900,117216,20721,TR,TR
132619,1699861980,1699895640,33660,3428,178111,MX,MX
181030,1698978120,1699013460,35340,162574,195600,MX,US
28393,1698816660,1698847920,31260,189857,86188,TR,TR
197306,1700375400,1700408340,32940,15929,32808,TR,TR
153417,1699865760,1699899960,34200,52869,195673,TR,TR
158033,1698978180,1698992340,14160,17989,187373,US,US
69824,1699543140,1699578120,34980,96531,162570,MX,MX
54968,1699898220,1699901880,3660,65453,35027,EE,EE
13724,1700733720,1700741520,7800,65096,83682,IT,IT
183469,1699901340,1699905840,4500,174761,90841,GB,GB
176042,1698798780,1698816000,17220,119083,70283,AT,BG
110801,1699818960,1699831500,12540,136155,69423,ES,AD
126805,1699446120,1699476420,30300,65847,101761,TR,TR
70862,1699053360,1699088100,34740,20028,130193,MX,MX
95598,1699959420,1699980720,21300,80683,155791,FR,FR
24642,1700637000,1700671200,34200,130673,197245,MX,US
31853,1698958500,1698993300,34800,40571,136601,TR,TR
107009,1699324980,1699357860,32880,81455,50344,TR,TR
82009,1698826440,1698857880,31440,7343,11891,TR,TR
8811,1700594640,1700627640,33000,110636,150122,TR,TR
182490,1698977640,1699013460,35820,103907,111646,TR,TR
26107,1699177920,1699189620,11700,189987,160094,US,US
185365,1698959400,1698991020,31620,140547,84075,TR,TR
45040,1700384940,1700395080,10140,18131,77981,IT,IT
100752,1699958280,1699973400,15120,13864,63632,CZ,SK
18220,1699160820,1699211820,51000,7962,184238,BG,BG
50126,1699199640,1699220160,20520,91392,75171,FR,DE
92235,1699226880,1699248360,21480,131529,82927,FR,FR
168908,1699494600,1699507260,12660,47535,162812,US,US
189602,1699243200,1699278420,35220,154801,118922,TR,TR
104284,1700105760,1700116980,11220,58962,81020,US,US
6479,1700574840,1700605440,30600,167737,116403,TR,TR
51541,1699996440,1700027520,31080,142013,64100,TR,TR
197354,1698802980,1698834180,31200,97522,184642,TR,TR
36805,1699528680,1699534080,5400,156279,55090,GB,GB
166031,1700187480,1700215920,28440,48984,119854,RO,RO
65631,1698894780,1698925980,31200,194748,17383,TR,TR
167423,1698887100,1698909900,22800,51825,145982,DE,DE
189342,1699136100,1699144980,8880,117052,116922,AD,ES
103419,1699560420,1699573680,13260,257,100834,ES,ES
67666,1700855640,1700870400,14760,44387,104983,US,US
126813,1699976100,1700009040,32940,74025,39836,TR,TR
96836,1699011900,1699025400,13500,10177,96908,US,US
58397,1699952580,1699969260,16680,184570,197417,AT,AT
59184,1699095180,1699121640,26460,99479,54284,PL,PL
150452,1700605620,1700620440,14820,176922,193493,FR,FR
109899,1699181100,1699190400,9300,175919,151793,IT,IT
188453,1699219980,1699229760,9780,52091,12360,IT,IT
183885,1699059120,1699072560,13440,59309,76616,IT,IT
74124,1698987420,1698991020,3600,53063,34235,GB,GB
116944,1700034660,1700069400,34740,28071,14160,TR,TR
131756,1699930320,1699965840,35520,90785,43938,TR,TR
138985,1699142160,1699174500,32340,147976,2872,TR,TR
196869,1700532960,1700562660,29700,15341,178548,TR,TR
185113,1699876380,1699906200,29820,127441,115830,TR,TR
89541,1700644380,1700657760,13380,52274,10163,RS,RS
12203,1699075740,1699102740,27000,1853,178928,CH,FR
78616,1699522140,1699538880,16740,137073,154501,US,US
138888,1699943040,1699956960,13920,35064,165804,US,US
21133,1700188740,1700192340,3600,133912,41632,GB,GB
40313,1700294880,1700318040,23160,95797,47044,HU,CZ
16019,1698831840,1698848580,16740,15362,65429,FR,BE
169195,1700730480,1700765640,35160,20568,17907,TR,TR
154907,1699907700,1699920600,12900,69045,47128,US,US
182886,1699359840,1699393080,33240,170963,197734,TR,TR
28911,1699608480,1699638480,30000,133282,73450,TR,TR
65925,1699368600,1699373340,4740,31250,83193,NL,NL
94765,1700471280,1700501820,30540,29768,165538,TR,TR
173104,1699570920,1699603680,32760,189315,104674,TR,TR
189715,1699020360,1699050600,30240,153548,150554,TR,TR
115363,1699710180,1699716960,6780,105010,51828,NL,NL
119616,1700579100,1700582700,3600,168902,150082,GB,GB
66981,1699308240,1699338060,29820,129627,143024,TR,TR
57111,1700273040,1700303700,30660,77803,188054,TR,TR
6158,1700009700,1700041380,31680,178108,138469,TR,TR
190291,1699916280,1699948080,31800,4771,43155,TR,TR
79687,1699109760,1699126560,16800,173369,9578,CZ,AT
116015,1699143120,1699146720,3600,7905,24250,GB,GB
135086,1700146800,1700160360,13560,85327,120339,HR,BA
2134,1698948180,1698962160,13980,28730,28936,IT,IT
169998,1700405700,1700409300,3600,62562,42899,NL,NL
77828,1700167320,1700175600,8280,175104,92005,IT,FR
60573,1699678860,1699714200,35340,147162,32787,TR,TR
157189,1699501200,1699507680,6480,25566,162680,GB,GB
41574,1699333380,1699364640,31260,126237,167535,TR,TR
22200,1700156820,1700174460,17640,127976,21436,US,US
75992,1700675760,1700706780,31020,49866,50147,TR,TR
69905,1699286400,1699320660,34260,54544,99836,TR,TR
126400,1698993600,1699000800,7200,135115,194623,FI,EE
143097,1699489200,1699492800,3600,27580,169349,GB,GB
187360,1700113140,1700148720,35580,156154,12420,TR,TR
92683,1699846560,1699858860,12300,4136,72198,IT,IT
3329,1700617560,1700621700,4140,170095,27910,NL,NL
166231,1699491240,1699494840,3600,4415,149627,GB,GB
25068,1700599980,1700603580,3600,66446,108154,GB,GB
2055,1699163220,1699168020,4800,17536,112527,GB,GB
57185,1699446660,1699478940,32280,138410,22220,TR,TR
93068,1700073120,1700101020,27900,22017,126492,BA,DE
181566,1699985880,1700011320,25440,8648,16640,RO,RO
177795,1700596260,1700618820,22560,6243,43712,BR,BR
29173,1698897000,1698900600,3600,127121,179004,NL,NL
196290,1698834540,1698868680,34140,169739,108862,TR,TR
84627,1699754100,1699764660,10560,174569,1818,IT,IT
18935,1699354680,1699386900,32220,51726,55630,TR,TR
125764,1698825600,1698837420,11820,115394,22059,US,US
28173,1699517820,1699533300,15480,149318,45555,US,US
51061,1699355040,1699362000,6960,4031,775,GB,GB
58435,1700644140,1700673900,29760,94607,188288,TR,TR
113673,1700312280,1700343060,30780,29869,24952,TR,TR
117547,1700682120,1700707260,25140,133347,78441,ME,HR
58769,1700088840,1700093640,4800,199020,136918,GB,GB
19452,1699066260,1699094100,27840,85670,61619,DE,DE
97149,1699037400,1699068960,31560,189878,131773,TR,TR
71537,1700291520,1700317380,25860,188899,33111,BA,DE
30698,1699844700,1699879320,34620,196538,181156,TR,TR
78410,1699645740,1699657920,12180,183953,2742,IT,IT
47415,1700563860,1700575560,11700,65064,96645,US,US
138992,1700113140,1700144160,31020,50659,56479,TR,TR
20545,1699037640,1699041240,3600,67354,36288,GB,GB
71172,1699517460,1699521060,3600,102740,72728,GB,GB
122611,1699546260,1699560120,13860,165366,158429,RS,RS
124593,1700615460,1700628480,13020,59995,23116,IT,IT
58393,1699865640,1699889460,23820,42153,174814,DE,HR
145421,1698817500,1698834180,16680,166515,130989,US,US
90734,1699312260,1699316100,3840,27560,95984,GB,GB
93808,1699632060,1699665360,33300,42693,92014,TR,TR
10038,1700833620,1700864700,31080,151550,55693,TR,TR
917,1699646640,1699677420,30780,17601,20981,TR,TR
96473,1698821760,1698856140,34380,49704,62815,TR,TR
36060,1698873000,1698888000,15000,117823,53804,FR,FR
157078,1698940980,1698970680,29700,142713,68528,TR,TR
197268,1698807180,1698818340,11160,146492,70972,IT,CH
115203,1699878900,1699913580,34680,126707,95930,TR,TR
112042,1699084080,1699116120,32040,170094,26913,TR,TR
78969,1699645860,1699659480,13620,19729,23424,HR,HR
149602,1699660020,1699692180,32160,168080,25857,TR,TR
83398,1700468220,1700500980,32760,167037,31339,TR,TR
34340,1699754820,1699770000,15180,451,41001,FR,NL
99419,1700550780,1700583360,32580,195492,52083,TR,TR
79778,1699306020,1699312260,6240,177492,125332,GB,GB
139835,1700223240,1700226840,3600,16659,199487,NL,NL
110301,1699827780,1699859400,31620,145087,24074,TR,TR
169260,1700767380,1700776260,8880,20482,73886,ES,ES
71878,1699619700,1699640280,20580,174024,136273,FR,BE
35924,1699374780,1699390500,15720,32979,46529,US,US
37994,1698899280,1698931680,32400,81947,196721,TR,TR
174768,1700782200,1700794020,11820,128495,143010,AT,RS
127588,1700847360,1700878680,31320,180589,34786,TR,TR
191968,1700348940,1700365020,16080,33380,19871,US,US
186403,1699125240,1699147560,22320,198215,11266,PL,PL
21218,1698803100,1698821760,18660,188301,76073,FR,BE
118248,1700830380,1700840940,10560,21873,93628,HR,HR
115989,1698867420,1698900960,33540,185514,192049,TR,TR
93680,1700302200,1700314980,12780,29161,6937,IT,IT
126683,1700258760,1700265660,6900,117564,5737,GB,GB
153929,1699079940,1699095840,15900,16661,84895,US,US
170538,1700593320,1700598360,5040,5757,33417,GB,GB
147224,1699371540,1699386660,15120,108176,196583,FR,FR
130660,1699408980,1699414440,5460,101697,8235,NL,BE
186202,1699772580,1699787040,14460,140203,171454,US,US
118534,1700473680,1700502780,29100,169072,192064,TR,TR
153232,1700520780,1700535480,14700,167990,117367,US,US
46129,1700231460,1700266500,35040,178785,81219,TR,TR
159484,1700858040,1700890020,31980,131476,117879,TR,TR
183166,1699393140,1699428600,35460,28435,20391,TR,TR
87153,1699257300,1699275000,17700,116339,158898,FR,DE
165685,1700153040,1700167080,14040,193354,13572,IT,IT
161043,1699585620,1699611240,25620,80220,95716,DE,DE
171747,1698864660,1698886620,21960,70499,160810,DE,IT
128608,1699091220,1699126980,35760,32075,23232,TR,TR
162948,1700166360,1700175180,8820,51037,6909,HR,HR
167309,1700661180,1700673600,12420,8361,60085,IT,IT
66482,1700556720,1700560320,3600,174187,1964,GB,GB
105645,1700490660,1700494260,3600,69669,14951,NL,NL
28993,1699432020,1699438320,6300,107832,22425,GB,GB
163658,1699462380,1699494360,31980,89219,89407,TR,TR
5086,1698810660,1698827460,16800,29606,150751,US,US
137090,1699743300,1699775700,32400,177143,174170,TR,TR
109065,1699719780,1699724280,4500,42452,67114,NL,NL
89492,1699504500,1699522380,17880,109282,1005,US,US
124390,1700454900,1700482920,28020,144474,58605,PL,PL
152675,1699993980,1700029860,35880,149827,68480,TR,TR
111305,1700056980,1700060580,3600,169537,31048,GB,GB
187552,1700758560,1700790960,32400,51811,141396,TR,TR
64292,1699701840,1699710900,9060,84759,127473,IT,IT
160442,1699503360,1699536180,32820,136058,172206,TR,TR
190911,1699944300,1699974840,30540,199839,43714,TR,TR
122386,1700728680,1700763480,34800,160926,19873,TR,TR
152893,1700137620,1700141220,3600,148299,122882,GB,GB
166434,1699865160,1699893120,27960,112321,80917,DE,HR
120685,1700627400,1700659500,32100,86277,119556,TR,TR
12727,1699627020,1699637520,10500,53377,3551,ES,ES
180813,1699989420,1700020440,31020,148764,4180,TR,TR
39758,1698826680,1698840480,13800,29152,116731,US,US
105343,1700136120,1700163420,27300,11978,18031,DE,DE
191112,1700551320,1700557260,5940,86682,158982,NL,NL
118470,1699456200,1699485600,29400,50331,125101,TR,TR
58820,1699863720,1699867320,3600,122117,104600,GB,GB
40427,1699332060,1699364460,32400,8910,45572,TR,TR
102099,1700216100,1700230200,14100,194416,166905,US,US
198727,1700386260,1700418060,31800,53730,81797,TR,TR
77754,1699483620,1699519260,35640,58306,104267,TR,TR
58396,1699970520,1700005680,35160,7524,128323,TR,TR
129524,1700135280,1700141700,6420,186372,71229,GB,GB
147468,1700291040,1700300700,9660,171205,166101,EE,EE
104083,1698920460,1698949860,29400,21417,83888,TR,TR
73741,1699418220,1699449360,31140,192699,93490,TR,TR
20941,1700463540,1700480820,17280,172765,1486,US,US
98122,1699149120,1699166280,17160,67362,66017,CZ,CZ
135665,1700262120,1700277480,15360,133103,176654,CZ,CZ
143303,1700537520,1700571720,34200,98530,126554,TR,TR
406,1699890240,1699915200,24960,111370,134755,PL,PL
130294,1698942300,1698946140,3840,116131,88613,GB,GB
152599,1699729620,1699740540,10920,131717,40402,ES,ES
47288,1700677800,1700703900,26100,100462,130706,BA,HR
5733,1699701600,1699735440,33840,109034,142020,TR,TR
10155,1698860940,1698890220,29280,6564,175716,TR,TR
190415,1699383300,1699418580,35280,149162,55764,TR,TR
20554,1700149860,1700164740,14880,119165,163156,FR,FR
193936,1698806640,1698823140,16500,150221,97486,FR,FR
54113,1699326420,1699359300,32880,107236,38510,TR,TR
178926,1700091900,1700095500,3600,3129,198219,GB,GB
149477,1699256760,1699260360,3600,181373,169304,GB,GB
106844,1700784300,1700799060,14760,76854,36527,US,US
189836,1700265240,1700268840,3600,58702,893,GB,GB
51612,1699571460,1699606980,35520,24144,40211,TR,TR
76872,1698974460,1699004280,29820,28441,28471,TR,TR
178523,1699948200,1699966080,17880,151448,73292,US,US
83164,1700604120,1700639460,35340,198061,120048,MK,RS
93733,1700861040,1700892780,31740,198496,128024,TR,TR
174450,1699264920,1699282380,17460,46010,173098,US,US
126660,1699805040,1699810560,5520,4174,21747,CL,CL
8006,1700401800,1700405400,3600,103608,56835,NL,NL
198777,1700177460,1700211120,33660,71652,116147,TR,TR
132014,1698839100,1698872040,32940,91646,92257,TR,TR
122370,1699015380,1699044540,29160,123240,153142,TR,TR
168072,1699260660,1699297200,36540,173412,104114,MX,MX
100208,1700724000,1700737140,13140,53568,198248,HR,HR
112917,1699193820,1699206600,12780,126515,100733,IT,IT
197141,1699905600,1699923480,17880,191117,29118,AT,AT
19298,1699349520,1699382880,33360,136152,198023,TR,TR
13062,1699110780,1699114380,3600,65299,177585,NL,NL
69573,1698960540,1698966780,6240,116261,38106,GB,GB
140913,1699563300,1699598940,35640,164056,61168,TR,TR
114687,1699464060,1699492920,28860,41882,73741,TR,TR
7377,1699818540,1699842720,24180,38505,19542,RO,RO
121274,1700509260,1700540160,30900,57638,1247,TR,TR
41835,1700065500,1700079660,14160,28718,97236,CZ,AT
24389,1700819220,1700832240,13020,164620,20418,AT,AT
32566,1699858140,1699869540,11400,62456,48185,HR,HR
132354,1699820700,1699831320,10620,161608,28955,IT,IT
117904,1700197560,1700203860,6300,106556,145687,NL,NL
12193,1699066320,1699069920,3600,196030,25541,NL,BE
29326,1700762100,1700789580,27480,69895,142196,BR,BR
166126,1699638720,1699673040,34320,123208,79829,TR,TR
84044,1699267500,1699283340,15840,48164,169887,US,US
96202,1700783700,1700814120,30420,26463,148576,TR,TR
114637,1699972680,1699985820,13140,19611,144282,US,US
89057,1699571880,1699603440,31560,115936,1072,TR,TR
122382,1700652240,1700655840,3600,1728,43854,GB,GB
82665,1699626360,1699629960,3600,55584,32500,GB,GB
63494,1700388120,1700425380,37260,7704,159251,MX,MX
191323,1700729460,1700738820,9360,7967,90473,IT,IT
34692,1700756400,1700769420,13020,178983,189250,IT,IT
142002,1700531580,1700549280,17700,83863,104467,BE,NL
195167,1700330400,1700350680,20280,193191,155550,FR,NL
98903,1700665860,1700677980,12120,123988,91940,AT,HU
73537,1700206380,1700237220,30840,160728,11779,TR,TR
186448,1699933140,1699946160,13020,37151,140436,IT,IT
106132,1700019720,1700029020,9300,81898,23392,IT,IT
61701,1699906260,1699921920,15660,120348,179646,CZ,CZ
2732,1699668060,1699699560,31500,183316,90297,TR,TR
83092,1699542660,1699556880,14220,91866,50508,SK,DE
115605,1698928380,1698960600,32220,124447,59574,TR,TR
43389,1700290680,1700294880,4200,157345,161413,NL,NL
69012,1699999080,1700002680,3600,189884,197988,GB,GB
36902,1699299780,1699332060,32280,67331,176657,TR,TR
65152,1700449920,1700483940,34020,62153,151588,TR,TR
19518,1700360100,1700381760,21660,142131,10589,RO,IT
27521,1700290620,1700298720,8100,32295,44183,HR,HR
76783,1700435040,1700447100,12060,109335,190061,PT,PT
9038,1700349120,1700353320,4200,164594,13436,GB,GB
52413,1699401060,1699412580,11520,30482,26168,IT,IT
128296,1699084980,1699090200,5220,97443,71266,GB,GB
40307,1699540260,1699552620,12360,130874,60407,CZ,CZ
12285,1699296000,1699329480,33480,150031,13504,TR,TR
104642,1699162020,1699173840,11820,63308,695,US,US
2469,1700005800,1700034900,29100,92176,62287,TR,TR
74908,1699824180,1699839420,15240,28465,33724,US,US
66892,1699954440,1699988580,34140,40148,22254,TR,TR
4290,1699687080,1699720080,33000,95255,91910,TR,TR
198846,1699803120,1699838580,35460,59929,58872,TR,TR
21599,1700664960,1700668560,3600,22856,186160,NL,NL
59085,1700801160,1700804760,3600,88734,24492,GB,GB
90173,1700229600,1700259600,30000,140618,64080,TR,TR
33966,1699614960,1699648860,33900,159457,62062,TR,TR
94209,1698913800,1698920280,6480,3925,36512,GB,GB
116499,1699470360,1699485780,15420,119914,48079,AT,HU
12786,1699432860,1699439700,6840,115061,53414,GB,GB
190994,1700390460,1700419920,29460,169080,114000,TR,TR
144961,1698880200,1698891780,11580,50207,160590,PT,PT
123669,1699894320,1699929840,35520,71238,103796,TR,TR
124426,1699263660,1699269120,5460,11406,71183,GB,GB
61328,1699057500,1699092840,35340,153913,10157,TR,TR
158345,1699683240,1699695960,12720,16964,161490,US,US
82193,1700530440,1700546280,15840,142209,121344,US,US
97608,1700257260,1700270040,12780,11554,73684,PT,PT
122052,1700785080,1700817180,32100,52270,43631,TR,TR
194026,1700086560,1700098080,11520,113380,68854,PT,PT
134203,1698880860,1698914160,33300,190969,81169,TR,TR
130217,1699047120,1699063200,16080,48125,123254,FR,NL
35909,1699230000,1699286580,56580,114178,177634,UA,PL
105260,1700584680,1700616600,31920,135950,185822,TR,TR
88892,1699603440,1699621140,17700,171793,153860,US,US
27063,1699557060,1699575600,18540,145638,78783,FR,NL
156149,1699183500,1699204680,21180,180905,71234,SE,SE
136393,1698990840,1699004760,13920,141174,69162,AT,BG
42364,1700090040,1700093640,3600,138231,72391,GB,GB
48751,1700400480,1700413920,13440,191072,164102,HR,HR
49485,1698856320,1698868860,12540,26853,176581,IT,IT
53795,1699017300,1699023300,6000,6651,113310,NL,NL
174889,1700081640,1700088180,6540,157471,161202,GB,GB
171746,1700472480,1700476380,3900,72607,112887,GB,GB
176140,1699292640,1699324140,31500,111953,177354,TR,TR
117052,1699233180,1699248840,15660,196370,12257,US,US
184904,1700397900,1700412840,14940,101172,90194,US,US
114695,1698891720,1698907500,15780,175664,148808,US,US
68551,1698796740,1698828720,31980,9186,47173,TR,TR
174124,1699701120,1699706160,5040,46797,182266,GB,GB
127985,1699936800,1699944180,7380,175910,14323,PT,PT
49422,1700556600,1700574360,17760,188608,152723,BE,FR
152511,1699770120,1699793340,23220,2728,176431,BR,BR
19945,1699337040,1699367580,30540,188372,70542,TR,TR
126008,1700048640,1700077860,29220,22217,72720,TR,TR
33455,1700739840,1700745120,5280,32920,121836,GB,GB
197334,1699592280,1699609740,17460,155019,75803,FR,FR
47621,1700788200,1700820420,32220,45257,56480,TR,TR
27151,1698863880,1698878040,14160,93337,59314,HR,HR
183867,1699607520,1699639920,32400,117081,75576,TR,TR
941,1699579560,1699583580,4020,115403,114830,EE,EE
107218,1700843220,1700848020,4800,156210,142009,NL,NL
17507,1699224600,1699243800,19200,49646,92625,BE,NL
11008,1700269980,1700287200,17220,149252,123406,US,US
134719,1700529060,1700541660,12600,193096,141851,AT,AT
46675,1700123160,1700136540,13380,95175,55510,HR,HR
118896,1699211520,1699227300,15780,187900,185795,US,US
182566,1700027520,1700031120,3600,186584,161493,GB,GB
22161,1700679180,1700695800,16620,193623,27274,FR,FR
80203,1700833200,1700868180,34980,5446,167252,TR,TR
50896,1700686860,1700699640,12780,73195,55797,IT,IT
185141,1700144340,1700160300,15960,8133,151896,US,MX
192999,1700659500,1700666100,6600,6114,167970,GB,GB
96300,1699019400,1699045920,26520,94394,36291,BA,BA
153994,1699780200,1699783800,3600,37331,92483,GB,GB
3768,1699395840,1699432800,36960,55385,74494,MX,MX
34866,1700356380,1700359980,3600,140357,104090,NL,NL
156660,1699798140,1699801740,3600,164338,22800,GB,GB
33637,1699834200,1699851300,17100,25660,143864,US,US
163897,1699874100,1699877700,3600,10019,194842,NL,BE
43015,1699282980,1699300680,17700,112244,152930,US,US
185048,1698870480,1698892920,22440,87388,76182,PL,SE
111378,1699674660,1699709520,34860,65306,1271,TR,TR
109418,1698942960,1698946560,3600,120439,19093,NL,NL
82334,1699563300,1699596300,33000,95476,70280,TR,TR
59874,1699280040,1699311480,31440,175185,146468,TR,TR
58807,1700719020,1700753640,34620,151330,60534,TR,TR
36625,1700416800,1700420400,3600,73633,37217,GB,GB
198897,1700123280,1700157240,33960,5196,76317,TR,TR
59474,1700580900,1700594160,13260,143909,47219,RS,HU
150725,1700501520,1700507880,6360,109688,91823,GB,GB
93689,1700229720,1700236200,6480,61260,2804,GB,GB
181909,1700861940,1700866620,4680,70492,86332,NL,NL
88516,1699824060,1699829100,5040,133851,66334,GB,GB
159296,1700494020,1700525940,31920,115350,190789,TR,TR
19475,1699750800,1699767720,16920,97364,171221,AT,AT
21980,1699420680,1699454040,33360,15630,114223,TR,TR
7527,1699657140,1699693980,36840,1532,35218,MX,MX
190178,1700792940,1700796540,3600,111043,146952,GB,GB
50416,1698804360,1698838380,34020,22577,36769,TR,TR
124629,1700137020,1700151060,14040,37603,101356,HR,HR
149962,1700794860,1700798460,3600,152425,37106,GB,GB
117422,1699103640,1699109220,5580,94458,149370,GB,GB
170381,1700028000,1700062020,34020,111090,174543,TR,TR
24735,1699631700,1699649040,17340,159245,148428,US,US
50136,1699354800,1699387680,32880,46714,143034,TR,TR
197883,1699407240,1699438620,31380,179303,186766,TR,TR
59091,1700626200,1700658780,32580,61223,39419,TR,TR
61528,1699762740,1699773900,11160,192973,85616,US,US
109959,1698905220,1698937980,32760,142632,5805,TR,TR
185932,1699311180,1699318800,7620,79540,187256,HR,HR
159303,1700112720,1700150580,37860,124578,13013,MX,MX
163632,1700443260,1700467080,23820,146134,149190,DE,DE
137795,1700735820,1700766300,30480,155745,115584,TR,TR
70210,1698800580,1698818280,17700,108614,59902,US,US
12020,1699531260,1699539060,7800,151787,106892,IT,IT
167569,1700274720,1700304960,30240,95780,108134,TR,TR
185189,1699268520,1699300500,31980,82691,199211,TR,TR
88963,1700175960,1700208480,32520,22184,151311,TR,TR
70795,1699576740,1699580820,4080,15586,84006,NL,NL
85016,1699140660,1699192200,51540,40983,159096,BG,AT
155222,1699086360,1699100160,13800,199169,62943,US,MX
186658,1700393580,1700419620,26040,12234,16234,DE,DE
71354,1700250420,1700259060,8640,74973,65051,SK,SK
199396,1699241280,1699256760,15480,6925,80606,FR,FR
43170,1700275200,1700289660,14460,71717,142230,AT,UA
89755,1700675400,1700693820,18420,104303,4485,FR,FR
182791,1700801520,1700833260,31740,174362,53595,TR,TR
118311,1699493640,1699509420,15780,89653,70574,US,US
28182,1699113120,1699138080,24960,136051,60168,PL,PL
136685,1700019900,1700034360,14460,140704,112696,FR,FR
37391,1700071680,1700098740,27060,191601,75476,RO,RO
45869,1699849560,1699866060,16500,89919,179480,US,US
65601,1700756040,1700763480,7440,19657,191252,IT,IT
186692,1699253220,1699262520,9300,139167,131020,IT,IT
155845,1698973560,1699005000,31440,89562,36901,TR,TR
122944,1699877040,1699909980,32940,40686,38423,TR,TR
84415,1700508600,1700512200,3600,187201,19724,NL,NL
101919,1699255920,1699284300,28380,83167,145473,PL,PL
118006,1699966380,1699969980,3600,24772,169792,GB,GB
166469,1700094180,1700111640,17460,97027,36026,US,US
133245,1700815080,1700829060,13980,185609,12481,AT,HU
91301,1699412940,1699416540,3600,77855,173318,GB,GB
48378,1699089060,1699097460,8400,199755,112984,ES,ES
181032,1699129200,1699160940,31740,166836,64064,TR,TR
99219,1699687020,1699692420,5400,182511,50299,NL,NL
125879,1700830320,1700838360,8040,133940,125764,PT,PT
99466,1699849920,1699876440,26520,49816,176519,DE,DE
53114,1699934520,1699947480,12960,52550,51779,IT,IT
5963,1700532300,1700558760,26460,87953,140977,BA,DE
54693,1700574120,1700583240,9120,126689,129304,IT,IT
194426,1698878820,1698913200,34380,2427,22776,TR,TR
125870,1699813380,1699830540,17160,55616,87751,CZ,PL
62836,1698793740,1698810600,16860,170034,73780,US,US
100269,1699955580,1699988640,33060,188079,43914,MX,MX
192269,1700077260,1700088180,10920,127523,63996,US,US
171518,1699214520,1699249140,34620,36783,170031,TR,TR
49458,1700464860,1700468460,3600,3695,29943,NL,NL
60703,1700779800,1700812380,32580,1058,16559,TR,TR
85559,1699116120,1699151820,35700,29796,42160,TR,TR
2981,1699305000,1699343220,38220,22917,23015,MX,MX
172600,1698965820,1698969420,3600,67808,60747,NL,NL
191164,1700856600,1700875380,18780,65031,32525,DK,SE
33212,1700472120,1700525160,53040,64523,160238,BG,DE
64376,1700362020,1700382840,20820,143896,43047,FR,DE
5834,1699047240,1699082100,34860,106852,21605,TR,TR
89131,1700281320,1700311140,29820,185269,52209,TR,TR
49342,1700223180,1700239140,15960,71330,122237,US,US
116064,1699308660,1699343340,34680,54037,68008,TR,TR
89205,1700703900,1700720580,16680,74393,19862,US,US
163985,1699090080,1699122900,32820,80440,115831,TR,TR
109865,1700704920,1700712480,7560,57380,63997,PT,PT
57797,1699768920,1699780680,11760,158595,152281,IT,IT
45325,1698905880,1698939900,34020,109389,47192,TR,TR
113363,1699734720,1699751520,16800,109999,139165,US,US
79706,1699350060,1699381380,31320,134987,107401,TR,TR
183133,1699453680,1699488360,34680,144157,178937,TR,TR
153537,1698968580,1698999360,30780,122567,192234,TR,TR
195067,1700402160,1700436660,34500,13325,48287,TR,TR
46924,1700762940,1700791140,28200,10805,138922,BR,BR
178351,1700814420,1700827680,13260,81110,123414,IT,IT
25507,1699120680,1699152540,31860,12875,51045,TR,TR
36327,1699572060,1699575660,3600,121417,21752,NL,NL
20335,1700084340,1700096340,12000,132013,47161,US,US
22906,1700709180,1700725560,16380,33886,80089,US,US
167112,1700083380,1700089080,5700,54658,151372,NL,NL
47434,1699519320,1699552740,33420,14348,179862,TR,TR
23436,1699783020,1699809240,26220,77467,176660,HU,CZ
114965,1699232460,1699271220,38760,44143,125585,MX,MX
147739,1700418840,1700448180,29340,194555,74757,TR,TR
120062,1699289280,1699304880,15600,90324,189631,US,US
152741,1699306260,1699326180,19920,82358,28635,FR,FR
127017,1699020360,1699024800,4440,126049,67622,GB,GB
64919,1700843040,1700862600,19560,12426,153218,FR,RS
130375,1699441560,1699456560,15000,43407,18871,US,US
135362,1699064760,1699080240,15480,100464,44940,RS,RS
181822,1699893240,1699916820,23580,120392,165863,BR,BR
78147,1700028240,1700057940,29700,21184,65393,TR,TR
173096,1699199580,1699225920,26340,165442,87857,RO,MD
6392,1700684220,1700692320,8100,27610,39160,IT,DE
79595,1699911240,1699938120,26880,19716,184740,CH,IT
30178,1699330440,1699365420,34980,26510,67975,TR,TR
99198,1699906980,1699940280,33300,76108,150423,TR,TR
117278,1698862680,1698889860,27180,92402,166722,RO,RO
90870,1699507080,1699519800,12720,83362,120027,ES,FR
71136,1699061160,1699064760,3600,14012,100432,NL,NL
64684,1700261100,1700267460,6360,141826,98961,EE,FI
159755,1700583900,1700619120,35220,118258,187195,TR,TR
163885,1698882360,1698912120,29760,12271,147793,TR,TR
7751,1700405940,1700419500,13560,62214,7002,US,US
47659,1700256240,1700265300,9060,16347,117106,PT,PT
168811,1699676520,1699694220,17700,21106,119373,BE,NL
143217,1699178940,1699188480,9540,53459,83546,ES,ES
113695,1699446480,1699458300,11820,112697,189977,US,US
53113,1700731860,1700741400,9540,191946,188521,ES,ES
189162,1700383920,1700401680,17760,8535,137655,US,US
148343,1700385660,1700425080,39420,52104,18872,MX,MX
10165,1699421100,1699432740,11640,154762,76091,HR,HR
172545,1699659960,1699672440,12480,136236,26287,IT,IT
111311,1699567320,1699579740,12420,51872,113767,CZ,CZ
23624,1700226420,1700232060,5640,174562,179652,NL,NL
151589,1700094840,1700127120,32280,184654,58587,TR,TR
80291,1699117980,1699152240,34260,129839,198887,TR,TR
12448,1699634640,1699638240,3600,92603,59368,GB,GB
122381,1699796640,1699811820,15180,107260,25479,US,US
138388,1700007420,1700020920,13500,15972,163189,IT,DE
39927,1699024980,1699059600,34620,12532,116958,TR,TR
188033,1699579380,1699609020,29640,138363,171092,TR,TR
39859,1699280280,1699294800,14520,38830,8292,US,US
57151,1699073520,1699078320,4800,132468,76572,NL,NL
81310,1700242800,1700251200,8400,160977,138677,IT,CH
107994,1698908580,1698943440,34860,152183,51761,TR,TR
61945,1699131240,1699164300,33060,80015,152799,TR,TR
35993,1700233500,1700270580,37080,42137,102408,MX,MX
189233,1699885080,1699917240,32160,139578,73565,TR,TR
132823,1699288320,1699323300,34980,74127,107014,TR,TR
161847,1699546020,1699578540,32520,96855,152238,TR,TR
25998,1699077360,1699091460,14100,1825,133437,US,US
89018,1700675280,1700691480,16200,100468,170617,RS,RS
18063,1699728900,1699747200,18300,110562,11622,FR,FR
162518,1699161240,1699193220,31980,67961,48902,TR,TR
132612,1699321320,1699324920,3600,70778,25775,GB,GB
36894,1700104560,1700120220,15660,118085,49685,US,US
119676,1700498880,1700507040,8160,123696,88308,ES,AD
193571,1700241300,1700248260,6960,62972,3785,NL,NL
17409,1700652540,1700685720,33180,16110,39870,TR,TR
74234,1700623920,1700640000,16080,193045,156794,FR,ES
9320,1699825680,1699829280,3600,170406,4964,NL,NL
112625,1700711220,1700727960,16740,108088,74827,US,US
165678,1700118840,1700132220,13380,21096,155291,US,US
53295,1700340180,1700343780,3600,175942,31913,GB,GB
18894,1699145940,1699162140,16200,31334,163196,US,US
123125,1700341080,1700344680,3600,117628,8165,GB,GB
13655,1699033860,1699037460,3600,190502,38660,NL,NL
9128,1699331820,1699335420,3600,12677,158501,GB,GB
136344,1699318380,1699348740,30360,152561,17205,TR,TR
172283,1700652060,1700668080,16020,33323,59089,US,US
51016,1699766400,1699778700,12300,83608,9195,IT,IT
135630,1699685220,1699718700,33480,162678,77011,TR,TR
32623,1700596200,1700629980,33780,171851,123316,TR,TR
27627,1698872280,1698907800,35520,114315,139813,MX,MX
88720,1700206560,1700231580,25020,7495,110441,DE,AT
93031,1700492220,1700522400,30180,144238,81576,TR,TR
62155,1699083360,1699086960,3600,39367,100611,GB,GB
65875,1700400060,1700427900,27840,32217,45723,ME,RS
8843,1699666620,1699680420,13800,183362,2032,US,US
104019,1699577220,1699608600,31380,81146,96047,TR,TR
187524,1699429680,1699433280,3600,129474,4808,GB,GB
55217,1699844100,1699867260,23160,36058,102925,DE,DE
95023,1698929760,1698964920,35160,22363,44587,TR,TR
197843,1699086240,1699118820,32580,54751,110163,MX,MX
40054,1699879260,1699882860,3600,118409,17503,NL,NL
179556,1699885200,1699892340,7140,87565,58786,GB,GB
12491,1698965820,1698994860,29040,23687,11949,TR,TR
73349,1699836060,1699839660,3600,69099,117561,NL,NL
14993,1699665360,1699682040,16680,166838,37005,US,US
179757,1699138140,1699142460,4320,184392,85198,NL,NL
164529,1700637240,1700657280,20040,111601,167735,FR,FR
24527,1699529640,1699553760,24120,111277,197416,PL,CZ
38615,1699749600,1699763700,14100,148233,53401,US,US
141604,1700574480,1700604780,30300,50325,18256,TR,TR
95720,1699355520,1699385700,30180,178272,89585,TR,TR
187317,1699770960,1699800240,29280,89682,7412,TR,TR
125687,1700497200,1700513340,16140,193065,101489,US,US
190257,1700589000,1700602020,13020,187312,35150,ES,ES
169470,1699824720,1699832400,7680,52007,144355,IT,IT
179236,1700809800,1700845560,35760,172341,135592,TR,TR
26433,1699188900,1699202760,13860,114135,113780,IT,IT
152064,1700177040,1700207160,30120,159224,98569,TR,TR
27226,1699247220,1699260540,13320,109507,148379,US,US
59892,1698936840,1698970620,33780,53111,161951,TR,TR
76032,1699150560,1699179900,29340,179178,7073,TR,TR
30725,1700605080,1700639580,34500,37129,68905,TR,TR
91112,1700613420,1700643300,29880,96811,93241,TR,TR
130327,1700474160,1700499540,25380,168896,116164,BA,BA
174748,1699276680,1699306740,30060,174970,100457,TR,TR
165680,1700695380,1700709780,14400,9760,74593,AT,HU
196425,1698988260,1698993660,5400,161914,44839,GB,GB
137133,1699346940,1699382820,35880,80443,171866,TR,TR
181124,1700174580,1700185380,10800,37146,197593,IT,IT
104854,1699156440,1699189260,32820,133589,46416,TR,TR
168404,1699733460,1699744800,11340,181520,176293,IT,IT
48028,1700082120,1700115300,33180,36036,168875,TR,TR
94370,1700072640,1700078100,5460,188898,163208,GB,GB
56455,1700257560,1700270820,13260,111703,75189,US,US
111069,1700321460,1700356740,35280,178688,59985,TR,TR
181709,1699593060,1699608600,15540,172,158599,FR,FR
41703,1700138160,1700141760,3600,5587,82257,GB,GB
45373,1700842140,1700872500,30360,70310,31773,TR,TR
45951,1700502420,1700509380,6960,63471,139347,NL,NL
63648,1700489400,1700493000,3600,51487,44089,GB,GB
147661,1699003800,1699019460,15660,103782,61358,US,US
189410,1700782440,1700811780,29340,93946,74591,TR,TR
6637,1698981420,1698994560,13140,180508,62126,AT,AT
69479,1700841000,1700853000,12000,22743,32771,SK,SK
167655,1700037420,1700066280,28860,110730,135523,TR,TR
156226,1699249560,1699285680,36120,76153,140780,MX,MX
9689,1699675800,1699679400,3600,106118,143211,GB,GB
26421,1699660500,1699677000,16500,197734,41977,US,US
198011,1700130780,1700140740,9960,9619,70352,CL,CL
60929,1699741500,1699749600,8100,22258,138797,IT,IT
170821,1699102800,1699106400,3600,176219,175816,GB,GB
46939,1699869660,1699899840,30180,38065,99668,TR,TR
10129,1700090100,1700102820,12720,98842,102046,AT,AT
198177,1699745640,1699759620,13980,42963,80179,HR,HR
39918,1699716060,1699719660,3600,10644,158737,GB,GB
67872,1700299740,1700312280,12540,89991,81055,ES,AD
52427,1699653840,1699661100,7260,120137,193219,IT,IT
107533,1700034420,1700063880,29460,9130,94541,TR,TR
5463,1699736400,1699759440,23040,83384,153827,DE,HU
33804,1698984180,1698987780,3600,111546,173372,GB,GB
178544,1699086540,1699097880,11340,157237,152688,IT,IT
193835,1700688420,1700718900,30480,36169,102872,TR,TR
172260,1700591040,1700604780,13740,120752,25260,US,US
134789,1700395500,1700421120,25620,143173,45993,DE,BG
104917,1700690700,1700694300,3600,127560,143127,GB,GB
165822,1700599800,1700637600,37800,75960,64723,MX,MX
79265,1700229840,1700244840,15000,173898,32124,AT,HU
60664,1700285220,1700292840,7620,162763,140656,IT,IT
136731,1699336320,1699367640,31320,153482,112072,TR,TR
87718,1700454240,1700487060,32820,154416,19590,TR,TR
151385,1699614720,1699628820,14100,117266,136439,ES,ES
17315,1699783560,1699789140,5580,37698,146039,GB,GB
197109,1699081140,1699106640,25500,102374,87579,BR,BR
176344,1699678020,1699689360,11340,22273,185137,PT,PT
108804,1699885620,1699919220,33600,109338,11677,MX,MX
144150,1699860720,1699893900,33180,108214,132207,TR,TR
18394,1699052580,1699083660,31080,165985,80201,TR,TR
78794,1699406340,1699409940,3600,180364,198442,GB,GB
55699,1700862480,1700897160,34680,33095,30898,TR,TR
180827,1699004160,1699007760,3600,42857,13378,GB,GB
157107,1700357940,1700389140,31200,110489,145386,TR,TR
178168,1700662080,1700678220,16140,34310,90785,US,US
163870,1699927380,1699930980,3600,28909,52796,NL,NL
163016,1699808940,1699819140,10200,114021,195373,ES,ES
33539,1699324080,1699358700,34620,82577,137017,TR,TR
192966,1699488840,1699523880,35040,106042,137342,TR,TR
25418,1700501160,1700530680,29520,78181,135767,TR,TR
129594,1700318040,1700321640,3600,9224,199594,GB,GB
24966,1698885720,1698898800,13080,130481,49686,US,US
26589,1699879800,1699903560,23760,25034,164204,DK,DK
184879,1700426880,1700440140,13260,36913,177631,HR,HR
6014,1698984360,1698997560,13200,92115,88827,ES,ES
72465,1699120620,1699125480,4860,1195,161397,CL,CL
143730,1699652100,1699673520,21420,131157,26967,FR,ES
7004,1699331760,1699336260,4500,73500,19872,GB,GB
167477,1699988640,1700001900,13260,59746,41098,US,US
15538,1700833080,1700865900,32820,111976,143719,TR,TR
37657,1700074440,1700108220,33780,196065,154254,MX,MX
42513,1699922400,1699951680,29280,6684,82132,TR,TR
44613,1700128800,1700137680,8880,88561,170034,IT,IT
2329,1698819060,1698845880,26820,65858,78829,BR,BR
6468,1700724000,1700735160,11160,10877,159569,PT,PT
15144,1699624260,1699629840,5580,192496,121778,GB,GB
54339,1700171400,1700203140,31740,31479,153115,TR,TR
74623,1699674300,1699681620,7320,15136,22888,IT,IT
58080,1699307640,1699334400,26760,109081,93563,BA,DE
160561,1700315940,1700322120,6180,5924,190069,GB,GB
57931,1700735580,1700765640,30060,43411,180584,TR,TR
115399,1700495460,1700525460,30000,87517,184485,TR,TR
129694,1699595220,1699598820,3600,139310,129207,GB,GB
88660,1699061100,1699077120,16020,193475,148195,BE,DK
36539,1700174760,1700210100,35340,23982,115213,TR,TR
147841,1699709280,1699740000,30720,82118,92128,TR,TR
69692,1700651940,1700687700,35760,80214,133054,TR,TR
143389,1698836940,1698855000,18060,99072,117858,FR,CH
111225,1700296740,1700327520,30780,63901,186728,TR,TR
146644,1699521300,1699532640,11340,10461,166334,US,US
169227,1699783980,1699813020,29040,164500,97086,TR,TR
147871,1700730300,1700747100,16800,104199,54478,US,US
170321,1699890720,1699923720,33000,56635,50071,TR,TR
144969,1698901320,1698934560,33240,143873,12832,TR,TR
21392,1700564040,1700579640,15600,151538,92468,RS,RS
176253,1700282940,1700286540,3600,21803,155274,NL,NL
138309,1699193760,1699204980,11220,186526,104950,IT,IT
155121,1699740060,1699773780,33720,171289,152586,TR,TR
8455,1700232480,1700261340,28860,30103,4998,TR,TR
173183,1700790780,1700797620,6840,93066,30290,GB,GB
18309,1700564160,1700578380,14220,90704,24754,AT,DE
30380,1699774620,1699808220,33600,1285,168544,TR,TR
166346,1700162400,1700177880,15480,134200,10434,US,US
82515,1699928160,1699946460,18300,94830,192312,FR,FR
129977,1699612140,1699616220,4080,37507,52297,GB,GB
197278,1700552280,1700556480,4200,43625,39969,NL,NL
127644,1700115780,1700121240,5460,181321,47324,GB,GB
80624,1700254020,1700285880,31860,77862,100521,TR,TR
16882,1699300800,1699332660,31860,65441,47519,TR,TR
146458,1700685960,1700717880,31920,163703,176214,TR,TR
83752,1700824320,1700837640,13320,125819,57734,US,US
10505,1700692560,1700703360,10800,100162,86506,US,US
146717,1700155560,1700191380,35820,5487,195142,TR,TR
66383,1699633140,1699646940,13800,161330,152707,CA,CA
56646,1700080440,1700097660,17220,179855,191058,FR,AD
83937,1700830440,1700861400,30960,1633,95323,TR,TR
150992,1700504280,1700534520,30240,110443,168351,BA,ME
90772,1700728500,1700761740,33240,37029,42933,TR,TR
62607,1700635980,1700649720,13740,160171,33177,IT,IT
89507,1700826780,1700853780,27000,153230,19276,DE,IT
109758,1699492320,1699521660,29340,8383,63561,TR,TR
63588,1700111760,1700147580,35820,156408,77262,TR,TR
109456,1699403880,1699409400,5520,115952,165449,GB,GB
141220,1700427240,1700440920,13680,102769,82211,ES,ES
86599,1700499480,1700516940,17460,164885,50444,FR,FR
186549,1699740300,1699760940,20640,68416,56255,FR,FR
63898,1700592780,1700627400,34620,70695,119930,TR,TR
165232,1699981440,1700016180,34740,12097,9165,TR,TR
71602,1700050140,1700053740,3600,121915,73692,GB,GB
99950,1699044720,1699078500,33780,174115,144388,TR,TR
7856,1699574160,1699593180,19020,154806,60431,FR,FR
60608,1699171020,1699179660,8640,90413,18976,PT,PT
63312,1699601100,1699611420,10320,171516,159339,IT,IT
81579,1700282760,1700295720,12960,8548,66165,PT,PT
132423,1699211460,1699226640,15180,157567,78919,FR,BE
96276,1699603860,1699633140,29280,121602,191682,TR,TR
190166,1699303500,1699310340,6840,110251,189859,GB,GB
118892,1699766040,1699770120,4080,63419,33434,NL,NL
20484,1700452740,1700487180,34440,184182,105372,TR,TR
96219,1700847720,1700854140,6420,79627,26660,NL,NL
75941,1700474100,1700506680,32580,81845,120130,TR,TR
67440,1700237280,1700247360,10080,26394,42846,IT,MK
32735,1699357140,1699389960,32820,2285,88011,TR,TR
62159,1700435880,1700469660,33780,149060,144083,MX,MX
199295,1699656600,1699662420,5820,109225,199919,GB,GB
25207,1700345040,1700370000,24960,170942,165987,PL,PL
179050,1699700460,1699729560,29100,79341,140060,TR,TR
72775,1700256000,1700271360,15360,139201,89046,RS,RS
3346,1699830900,1699860420,29520,64666,68755,TR,TR
47692,1699251660,1699261380,9720,167147,37511,AD,FR
71235,1699201320,1699207200,5880,188269,76693,NL,NL
176853,1698854880,1698861360,6480,159293,154130,GB,GB
176186,1700368620,1700401440,32820,156690,132384,TR,TR
196017,1700074800,1700096940,22140,52205,8111,DE,DK
79792,1699590480,1699596900,6420,34071,36344,NL,NL
132613,1698876000,1698901080,25080,70321,123090,RO,RO
51675,1699152300,1699163580,11280,80496,107097,RS,RS
16228,1700208420,1700241060,32640,7664,194748,TR,TR
172518,1699618800,1699636140,17340,58149,14771,AT,CZ
132685,1699493460,1699527480,34020,29459,44023,TR,TR
163466,1700456760,1700489160,32400,90987,15672,TR,TR
41000,1698984540,1699006740,22200,31286,39970,BR,BR
177128,1699302180,1699305780,3600,90184,48931,GB,GB
76501,1699462680,1699469640,6960,56951,140451,NL,BE
134360,1699450860,1699454460,3600,34379,55709,GB,GB
127083,1700819880,1700830860,10980,38974,6926,US,US
42593,1698903720,1698907320,3600,171510,189076,NL,NL
6719,1700310240,1700318040,7800,103456,119112,HR,HR
109353,1699108560,1699139940,31380,86752,7383,TR,TR
17745,1700138460,1700152980,14520,66095,159689,US,US
33652,1699954560,1699965420,10860,7935,73393,US,US
99958,1699719900,1699739100,19200,159304,7176,FR,FR
168969,1699775760,1699784340,8580,18180,113539,HR,HR
108312,1700152560,1700188080,35520,49841,188484,TR,TR
142520,1698954240,1698966240,12000,173128,150528,US,US
188462,1699858020,1699873080,15060,136428,90308,US,US
28152,1700062680,1700075640,12960,183932,167279,SK,AT
142246,1700865120,1700889300,24180,154686,134089,HU,DE
116548,1699165080,1699199280,34200,177425,8960,TR,TR
98694,1699291680,1699307340,15660,181139,139525,US,US
175937,1700832780,1700854020,21240,109446,69577,FR,FR
4840,1700430240,1700437200,6960,131564,14870,GB,GB
62631,1699896840,1699905300,8460,144722,65614,HR,HR
54016,1700563560,1700592600,29040,16415,69700,TR,TR
185438,1699591260,1699607100,15840,87605,197537,FR,FR
129996,1699020900,1699050720,29820,105549,164073,TR,TR
184859,1699157160,1699169460,12300,75545,65924,IT,IT
72607,1698924600,1698956580,31980,6,163565,TR,TR
184292,1698809760,1698813360,3600,104161,171348,GB,GB
145033,1699504800,1699522500,17700,112869,79284,US,US
148614,1700818860,1700851080,32220,21587,199848,TR,TR
127072,1700314980,1700318580,3600,57060,139374,NL,NL
35574,1699209600,1699239240,29640,56480,12262,TR,TR
176372,1699745100,1699774260,29160,67372,85263,TR,TR
154486,1699344060,1699377960,33900,151418,74638,TR,TR
21874,1699943160,1699954980,11820,69738,117705,AT,AT
103496,1699608300,1699642440,34140,119555,186595,TR,TR
107498,1699893660,1699927920,34260,134004,101015,TR,TR
166141,1699397280,1699433160,35880,165966,48895,TR,TR
56013,1698994800,1699020840,26040,165138,174950,DE,IT
199200,1699922640,1699951920,29280,102362,127572,TR,TR
147649,1700585100,1700618640,33540,64729,75461,TR,TR
1574,1698801480,1698833940,32460,128070,81,TR,TR
187090,1700783040,1700818380,35340,59095,63127,TR,TR
83783,1700525280,1700539620,14340,175362,62095,IT,IT
104278,1700279820,1700317800,37980,25210,20910,MX,MX
40738,1700528220,1700551860,23640,66645,141010,RO,RO
9610,1699673040,1699698900,25860,81591,143456,RO,RO
93438,1699851540,1699859220,7680,104248,154451,HR,HR
182460,1700233020,1700242500,9480,143392,44853,IT,IT
11822,1700397660,1700423520,25860,47228,37309,PL,PL
147254,1699297980,1699301580,3600,123056,128984,GB,GB
55931,1699896060,1699918320,22260,125992,24172,BR,BR
8973,1698855600,1698872820,17220,94477,17001,US,US
69100,1699175460,1699187880,12420,37736,49411,IT,IT
148210,1700407200,1700438340,31140,10675,171213,TR,TR
90712,1700509080,1700536860,27780,122887,163346,DE,PL
182564,1699527900,1699561260,33360,60365,5241,TR,TR
122562,1700505120,1700535780,30660,156370,25305,TR,TR
108043,1699523820,1699558620,34800,170350,50949,TR,TR
115075,1700710980,1700724480,13500,94071,96703,US,CA
99360,1700748420,1700784000,35580,128792,155377,TR,TR
101197,1700464500,1700494740,30240,138041,121295,TR,TR
145192,1699999980,1700013180,13200,93620,136291,IT,IT
43101,1700846580,1700868300,21720,121263,27176,RO,MD
64717,1700454240,1700472060,17820,156670,16468,AT,AT
73031,1698821820,1698833220,11400,91669,43418,CA,CA
37325,1700519580,1700554500,34920,34702,120376,TR,TR
185292,1699955580,1699973460,17880,2851,169407,AT,DE
122348,1699480740,1699511460,30720,116368,141492,TR,TR
140703,1699653480,1699669680,16200,100541,76650,US,US
32845,1698882600,1698897900,15300,172080,12070,US,US
175327,1699167000,1699199040,32040,160919,80280,TR,TR
171146,1699172220,1699185420,13200,159778,114864,IT,IT
149441,1699205280,1699236840,31560,47766,122151,BA,SI
156721,1699530180,1699539840,9660,162317,84784,HR,HR
133726,1700701680,1700718540,16860,193828,133989,US,US
111119,1700808240,1700843340,35100,47193,51438,TR,TR
45634,1699006020,1699041240,35220,184398,31253,TR,TR
99953,1699368240,1699396980,28740,9728,177663,DE,DE
21200,1698869460,1698877620,8160,152981,191085,IT,IT
23610,1699301280,1699319100,17820,40367,80717,US,US
99582,1699028760,1699039500,10740,73587,198575,HR,HR
102744,1700597100,1700613660,16560,42055,160569,FR,FR
70154,1700183700,1700187780,4080,113072,151481,GB,GB
6405,1700534160,1700537760,3600,142861,54734,GB,GB
75749,1699447140,1699481580,34440,47080,182500,TR,TR
197184,1700523780,1700562540,38760,91,66542,MX,US
156704,1699362600,1699371180,8580,153383,139495,ES,ES
116290,1699190640,1699223640,33000,146240,52278,TR,TR
90644,1699383960,1699418220,34260,166298,199043,TR,TR
108794,1699585740,1699615620,29880,94495,100565,TR,TR
98292,1700737260,1700749440,12180,138085,153599,US,US
62081,1699551480,1699567380,15900,29734,159993,FR,BE
149372,1698951840,1698963480,11640,1630,65231,SK,CZ
65059,1699119780,1699123380,3600,111841,188566,GB,GB
107176,1699088040,1699120560,32520,78787,156487,TR,TR
185428,1700834160,1700847900,13740,51278,35679,IT,IT
58014,1699640940,1699644540,3600,3439,139517,GB,GB
162840,1698990240,1699009680,19440,191461,91694,FR,FR
136674,1699293360,1699308480,15120,116798,161799,RS,HR
114892,1698882780,1698915840,33060,104410,142548,MX,MX
44250,1699658940,1699683480,24540,81080,131046,ME,RS
189800,1699882260,1699886940,4680,156380,182787,NL,NL
1217,1700380860,1700411100,30240,191980,36582,TR,TR
85950,1699345440,1699380840,35400,11477,81552,TR,TR
65247,1699115880,1699151280,35400,6452,1001,TR,TR
49139,1699572240,1699583400,11160,6939,168778,AT,AT
13889,1700264640,1700282040,17400,15008,181861,FR,NL
189642,1700278200,1700289660,11460,43420,81285,IT,IT
140484,1698860160,1698876000,15840,90424,191352,US,US
50875,1699989180,1700031660,42480,130056,76538,LV,AT
11737,1699971360,1699982160,10800,50116,182596,IT,IT
94621,1699354740,1699365240,10500,31023,86296,EE,EE
4890,1700556240,1700560920,4680,178051,184261,GB,GB
91098,1700680440,1700710620,30180,182477,69837,TR,TR
76593,1700701740,1700715480,13740,108626,142293,IT,IT
140438,1699728660,1699758900,30240,157126,99776,TR,TR
199002,1699502220,1699507740,5520,87421,154661,GB,GB
149296,1699813020,1699846740,33720,7085,145507,TR,TR
118607,1698868440,1698875340,6900,27792,137445,GB,GB
37746,1698950040,1698962040,12000,153514,124521,CA,US
46693,1699503900,1699536720,32820,14384,104778,TR,TR
192329,1700548920,1700566620,17700,20812,70390,CZ,DK
163362,1699233900,1699247700,13800,94164,157100,IT,IT
157551,1699509540,1699520760,11220,156966,123324,CZ,HU
97926,1699879320,1699910460,31140,118170,197036,TR,TR
10376,1700113440,1700130600,17160,133404,99808,US,US
111715,1698844800,1698877200,32400,24558,90796,TR,TR
40500,1699852860,1699888620,35760,55065,9213,MX,MX
105392,1699927380,1699937700,10320,123583,168615,PT,PT
85135,1699524420,1699532940,8520,98884,143489,HR,DE
97862,1699966740,1699978080,11340,13838,194904,RS,RS
29918,1699629900,1699640700,10800,8427,78267,US,US
102471,1698886260,1698919800,33540,97301,58427,TR,TR
86338,1699103280,1699137060,33780,73538,103180,TR,TR
158816,1699943400,1699977120,33720,82829,48273,TR,TR
58713,1700058720,1700081880,23160,165715,183273,CH,CZ
90593,1700002440,1700034000,31560,183857,182127,TR,TR
185619,1699069920,1699100940,31020,137724,58195,TR,TR
2182,1699468560,1699480020,11460,135110,18543,US,US
74602,1700117160,1700141940,24780,98599,145955,MD,RO
190183,1699530600,1699548480,17880,14862,84197,CZ,HR
18561,1699693980,1699718580,24600,128127,38829,RO,RO
45956,1699894620,1699929660,35040,192225,7910,TR,TR
53772,1700491560,1700507460,15900,8534,25987,US,US
124635,1700729820,1700743680,13860,141316,188444,AT,NL
171649,1699693200,1699729020,35820,37849,9655,TR,TR
129040,1699158540,1699169280,10740,132083,195380,EE,EE
22959,1700579820,1700615700,35880,83663,129781,TR,TR
35429,1700211000,1700240520,29520,198107,48935,TR,TR
184898,1700745240,1700757300,12060,104549,42114,US,US
72163,1699675560,1699710180,34620,183732,112476,TR,TR
131565,1700452380,1700464140,11760,157476,77241,HR,HR
100183,1699970880,1699974720,3840,196447,181577,GB,GB
128133,1699681560,1699710780,29220,182142,127530,TR,TR
117046,1700801280,1700807280,6000,124875,129945,GB,GB
113470,1699019940,1699054680,34740,28189,12214,TR,TR
125561,1700288400,1700296440,8040,192520,33127,HR,ME
6547,1700313120,1700322480,9360,36264,124773,FI,EE
104386,1700810640,1700821860,11220,66614,195181,US,US
8235,1699723740,1699727340,3600,161013,129816,GB,GB
12618,1699401960,1699411740,9780,166297,60405,IT,IT
130602,1699917180,1699947960,30780,371,189182,TR,TR
194561,1700058120,1700062920,4800,19440,20701,GB,GB
92227,1699089960,1699115340,25380,91452,152247,DE,DE
96084,1698801840,1698833520,31680,109686,128884,TR,TR
36506,1700667120,1700684400,17280,110767,37757,CZ,CZ
134078,1698946440,1698977640,31200,111287,147605,TR,TR
79714,1699199340,1699214160,14820,33037,36013,US,US
98479,1699553580,1699560060,6480,21176,146346,EE,EE
16369,1700191260,1700221680,30420,12611,156284,TR,TR
104988,1700346960,1700355780,8820,126987,23988,EE,LT
48278,1700262360,1700277720,15360,28963,24668,FR,ES
11967,1700044740,1700070600,25860,179743,154720,DE,HR
192022,1698979800,1698993120,13320,181934,193664,US,US
82951,1700064180,1700080920,16740,181967,115678,US,US
40029,1700392560,1700422380,29820,50098,150404,TR,TR
80488,1700614800,1700627580,12780,185969,130274,IT,IT
104806,1700500560,1700509860,9300,29345,12565,IT,IT
137208,1699243920,1699276260,32340,60675,131286,TR,TR
174830,1699037520,1699072560,35040,122796,177297,TR,TR
188766,1699209060,1699221120,12060,150444,84234,HR,HR
100405,1699594140,1699600560,6420,131506,35717,GB,GB
10540,1700196600,1700229540,32940,182399,2488,TR,TR
67532,1700060220,1700093400,33180,110931,118053,TR,TR
35874,1699960440,1699995420,34980,173870,151866,TR,TR
162972,1698940800,1698951840,11040,182933,32139,HR,HR
3051,1699706640,1699714320,7680,169976,110520,PT,PT
44013,1699574820,1699585140,10320,27884,164031,IT,IT
194610,1699731780,1699735380,3600,138690,190345,NL,NL
105556,1699893180,1699912020,18840,59320,66402,BE,CH
16983,1699545600,1699549200,3600,42352,120944,GB,GB
165996,1700487180,1700498220,11040,19537,74093,CZ,DE
168616,1699412340,1699429980,17640,131906,37524,US,US
187713,1700239560,1700270700,31140,186836,611,TR,TR
123813,1700614440,1700630520,16080,196026,80873,US,US
12364,1698827760,1698841200,13440,104337,122791,US,US
42318,1698991740,1699028580,36840,190043,141403,MX,MX
22971,1700393460,1700401860,8400,106467,180430,IT,IT
9085,1699689300,1699724460,35160,192404,6587,TR,TR
148566,1699541100,1699576680,35580,192961,155361,TR,TR
134673,1699917720,1699946640,28920,199995,190598,TR,TR
186030,1700412360,1700447640,35280,140599,67650,TR,TR
118600,1699488960,1699505640,16680,198843,32791,US,US
166169,1700424540,1700451300,26760,184708,136672,DE,SE
34657,1699312260,1699326660,14400,184618,52018,US,US
93085,1700641680,1700654100,12420,5672,54799,US,US
12687,1699366800,1699399200,32400,131937,47647,TR,TR
148635,1698957960,1698961560,3600,121824,75215,GB,GB
187858,1699377960,1699395000,17040,55514,46565,US,US
189316,1699629060,1699664820,35760,111711,172313,TR,TR
152288,1700319300,1700334480,15180,114447,70543,US,US
51494,1700259300,1700283180,23880,7169,35580,MD,RO
159729,1699195200,1699198800,3600,140918,76006,NL,NL
101936,1699926660,1699930260,3600,137720,197178,NL,NL
85162,1699980240,1700005440,25200,46966,26195,BA,HR
128967,1698825480,1698861060,35580,187617,176942,TR,TR
77994,1698971400,1699003800,32400,78314,196378,TR,TR
197554,1699622640,1699653780,31140,52921,33695,TR,TR
82067,1699541580,1699549080,7500,133217,186500,IT,IT
15648,1700173740,1700191620,17880,176682,133271,FR,FR
9378,1698836580,1698843180,6600,27883,114013,GB,GB
117477,1700382600,1700398980,16380,134014,133125,US,US
113589,1700708400,1700721720,13320,192467,51337,US,US
39295,1699391460,1699413360,21900,16015,19714,DE,NL
85494,1700158860,1700165160,6300,62706,144934,GB,GB
59510,1699041300,1699050600,9300,117189,122936,IT,IT
27542,1700549880,1700583480,33600,193492,10911,TR,TR
64879,1699479900,1699491120,11220,36615,39442,US,US
23887,1699029360,1699060800,31440,188123,85355,TR,TR
93448,1699443240,1699477800,34560,113778,72626,TR,TR
7630,1699211760,1699244700,32940,143403,67397,TR,TR
69648,1698875880,1698894060,18180,30446,131770,SE,SE
92199,1700579400,1700611080,31680,31869,179719,TR,TR
101102,1699226280,1699255200,28920,30772,143553,TR,TR
73885,1700638440,1700642040,3600,183981,135970,NL,NL
46247,1700729280,1700732880,3600,143585,154614,GB,GB
36193,1699534560,1699549680,15120,62496,144944,US,US
21077,1700318220,1700371680,53460,88630,117859,BG,DE
56551,1700590140,1700621760,31620,6109,1015,TR,TR
26355,1699935540,1699946760,11220,44464,100327,US,US
187748,1700533260,1700536860,3600,45960,109530,GB,GB
156843,1699963740,1699984980,21240,157756,100231,FR,FR
177745,1699884480,1699922400,37920,149176,187234,MX,MX
181176,1699589100,1699603320,14220,95469,107583,US,US
76022,1700523480,1700554200,30720,183212,6976,TR,TR
82587,1700420760,1700452800,32040,167439,70154,TR,TR
110140,1699159740,1699166100,6360,78171,18455,GB,GB
171868,1699853580,1699879620,26040,174479,157015,DE,DE
21336,1699222020,1699232820,10800,61369,48897,AT,AT
98701,1700514720,1700526780,12060,66988,39176,HR,PL
30683,1700302920,1700335140,32220,99960,100957,TR,TR
175645,1699919760,1699933140,13380,50124,22364,PT,PT
160533,1699563420,1699594620,31200,67157,81101,TR,TR
99590,1699483380,1699496520,13140,179316,2679,IT,IT
60279,1700465580,1700493180,27600,31979,121397,DE,PL
97813,1699436940,1699470180,33240,134448,76551,TR,TR
79140,1700794860,1700827320,32460,9396,174450,TR,TR
159515,1698798900,1698803520,4620,147724,182961,GB,GB
57584,1699481580,1699485180,3600,170791,39778,GB,GB
161514,1699558800,1699573980,15180,51947,165595,US,US
23342,1700261940,1700285460,23520,40425,27961,PL,UA
157211,1700324760,1700328360,3600,48649,118210,NL,NL
30910,1700729580,1700763240,33660,57149,139738,TR,TR
171440,1699870500,1699903440,32940,40872,38446,TR,TR
137390,1698924660,1698954300,29640,188191,73894,TR,TR
168625,1700233860,1700264100,30240,41181,113348,TR,TR
115917,1700615100,1700634840,19740,120017,63607,FR,FR
127876,1700150040,1700181000,30960,111637,150988,TR,TR
67644,1700434800,1700449920,15120,10553,156681,US,US
31293,1699637340,1699671720,34380,63607,95887,TR,TR
36119,1700178300,1700181900,3600,144211,195607,NL,NL
91101,1699139940,1699143540,3600,32768,138973,NL,NL
199129,1700257740,1700287620,29880,198863,104862,TR,TR
136713,1699632600,1699646040,13440,152662,122507,US,US
145752,1700239080,1700250840,11760,23166,134607,RS,DE
119648,1699336620,1699370460,33840,104973,23210,TR,TR
133432,1700081400,1700085000,3600,164730,151968,GB,GB
117350,1699870320,1699899240,28920,114707,173900,TR,TR
75395,1700618700,1700629020,10320,182342,53491,IT,IT
124565,1700059920,1700077980,18060,84591,30624,FR,FR
168573,1699932840,1699946460,13620,166832,147358,IT,IT
181940,1700106120,1700120220,14100,133240,30554,IT,IT
72316,1700512920,1700544780,31860,85793,177988,TR,TR
105290,1699147680,1699158600,10920,38443,122644,AT,AT
131898,1699503060,1699534080,31020,37001,47800,TR,TR
80168,1700296500,1700300100,3600,129699,152025,GB,GB
116812,1699862040,1699890840,28800,180245,109496,TR,TR
72836,1700169600,1700177280,7680,24480,26083,IT,IT
186179,1698807240,1698830640,23400,119515,35989,DE,HR
103443,1699628220,1699657440,29220,56604,189968,TR,TR
173419,1699138080,1699150080,12000,71544,127952,US,US
105257,1700354760,1700385840,31080,79345,121874,TR,TR
10579,1699076520,1699090260,13740,13415,166051,IT,IT
137175,1700177400,1700207640,30240,142506,16009,TR,TR
173680,1700589000,1700600700,11700,156707,58665,HR,HR
120817,1699392720,1699409220,16500,133405,106976,US,US
38154,1699791300,1699804620,13320,140762,183318,US,US
17080,1700354220,1700389560,35340,58540,167075,TR,TR
1147,1699452180,1699455780,3600,156987,167260,GB,GB
47447,1700206560,1700220000,13440,126508,8616,PT,PT
124335,1699212720,1699226880,14160,96749,19198,US,US
138223,1700556360,1700569020,12660,17040,133069,AT,AT
190776,1700346060,1700356140,10080,108630,117485,IT,IT
197361,1700626500,1700643660,17160,109131,51816,FR,NL
8073,1700860320,1700893800,33480,180985,175537,TR,TR
68095,1698867900,1698871800,3900,117842,158562,EE,EE
157661,1700680620,1700684220,3600,165549,46443,NL,NL
145794,1698845640,1698863040,17400,94135,199646,US,US
22218,1699677480,1699681140,3660,27808,68521,GB,GB
29804,1699537080,1699543860,6780,181277,98888,GB,GB
122580,1699359840,1699390260,30420,81645,37268,TR,TR
18706,1699152180,1699163700,11520,177250,76204,US,US
21906,1699730400,1699745340,14940,147793,1672,US,US
17866,1699052640,1699086840,34200,24129,174591,TR,TR
156370,1699777320,1699792200,14880,190257,34835,US,US
108744,1698980340,1698993900,13560,191378,47712,HR,HR
87924,1700134740,1700148600,13860,10626,191067,IT,IT
99296,1699765440,1699782360,16920,114306,96584,CZ,CZ
89522,1699655700,1699687620,31920,93642,129458,TR,TR
63851,1700780160,1700786580,6420,186355,89994,GB,GB
9473,1700642820,1700667600,24780,102655,99342,PL,UA
72989,1699245720,1699277520,31800,33911,141769,TR,TR
117517,1700661000,1700698200,37200,54066,126000,MX,MX
199605,1700122080,1700145840,23760,82686,141509,BR,BR
48213,1700515200,1700530920,15720,16655,164083,RS,RS
137002,1699669260,1699681440,12180,50243,157292,IT,IT
26155,1700018460,1700022060,3600,112543,140651,GB,GB
69640,1700526360,1700540460,14100,193872,56944,HR,HR
24349,1700014200,1700034780,20580,100122,82006,FR,FR
76884,1700535360,1700569920,34560,39077,176035,TR,TR
5129,1698932100,1698943740,11640,26009,30345,US,US
101860,1698926880,1698934440,7560,115448,31231,IT,IT
76627,1699452660,1699486320,33660,184554,114548,TR,TR
156444,1700312340,1700328180,15840,99112,130718,US,US
72596,1699900320,1699909440,9120,17964,15969,IT,IT
85594,1700367600,1700399760,32160,46175,151380,TR,TR
77764,1699389420,1699425240,35820,58136,21903,TR,TR
130806,1700440080,1700469300,29220,174593,79960,TR,TR
40062,1700134740,1700147280,12540,137340,10313,US,US
97827,1700466240,1700500080,33840,167454,170438,TR,TR
89318,1699264440,1699278420,13980,165359,105121,US,US
157777,1699903020,1699933140,30120,93332,115751,BA,HR
140751,1699904700,1699910160,5460,144646,46096,GB,GB
111857,1700526180,1700537880,11700,14577,148231,US,US
73568,1700192520,1700197680,5160,3047,127262,GB,GB
138661,1699211700,1699250760,39060,14989,118026,MX,MX
152690,1700175660,1700181120,5460,33612,182557,NL,NL
10204,1699935540,1699969740,34200,122540,36844,TR,TR
31942,1698952740,1698988500,35760,95568,30151,TR,TR
118515,1698933480,1698951000,17520,110283,136128,US,US
6787,1699994400,1700006520,12120,12341,183997,US,US
187149,1700856120,1700862720,6600,19373,179841,AD,FR
29650,1698941940,1698950340,8400,160010,72218,IT,IT
197186,1700199900,1700212440,12540,31943,121941,IT,IT
162511,1699486500,1699519980,33480,104811,188537,TR,TR
47120,1699946160,1699953720,7560,164605,190619,IT,IT
170017,1700348160,1700356380,8220,131699,86323,HR,HR
148927,1699761300,1699771920,10620,194684,113342,EE,FI
108503,1699008840,1699029660,20820,85891,25572,FR,DE
27548,1700295840,1700299560,3720,148349,4841,NL,BE
78186,1698935700,1698948060,12360,100325,193429,US,US
2688,1699360920,1699375140,14220,136485,191737,IT,IT
39686,1698903060,1698933660,30600,183705,188336,TR,TR
142196,1699283880,1699289760,5880,66759,70888,NL,NL
83236,1699932660,1699936260,3600,4252,91021,NL,NL
114526,1699068180,1699071780,3600,110970,108553,NL,NL
78193,1699358880,1699366020,7140,36219,9438,GB,GB
153598,1700298180,1700313720,15540,180709,65353,AT,AT
145307,1700781420,1700812200,30780,53187,56814,TR,TR
13570,1700404980,1700421420,16440,182260,166904,US,US
38139,1699463760,1699493340,29580,9187,90204,TR,TR
97063,1700824320,1700842200,17880,140010,52047,AT,AT
29027,1698899160,1698903360,4200,57993,153273,GB,GB
32809,1700133780,1700146860,13080,143582,156906,ES,ES
117075,1700054280,1700060400,6120,39246,166907,GB,GB
157179,1700524920,1700557080,32160,41405,113573,TR,TR
151099,1699684440,1699706760,22320,26311,192189,CH,IT
127298,1699431180,1699463640,32460,41380,17138,TR,TR
21027,1700738520,1700750340,11820,183092,165925,US,US
1585,1699261500,1699276680,15180,194880,47478,FR,FR
68194,1699406400,1699438980,32580,137932,135357,TR,TR
69269,1700079300,1700108280,28980,111041,8047,TR,TR
52058,1699052280,1699055880,3600,179693,1829,GB,GB
150091,1699089480,1699122600,33120,7114,126496,TR,TR
10442,1700650920,1700654520,3600,52276,22087,GB,GB
103850,1700814600,1700820960,6360,140255,93469,NL,NL
67027,1700299620,1700331540,31920,109057,146444,TR,TR
27776,1700196240,1700230440,34200,34417,78758,TR,TR
126327,1698834540,1698841320,6780,159192,10882,GB,GB
170913,1698977280,1698984660,7380,138893,40056,HR,HR
6025,1699127760,1699158420,30660,191950,730,TR,TR
133876,1699174680,1699207560,32880,24114,174619,TR,TR
96391,1699141140,1699160940,19800,114072,8216,FR,FR
176059,1700048520,1700061540,13020,1241,78114,US,US
122588,1699188000,1699202700,14700,185751,128253,US,MX
196709,1699742160,1699749660,7500,156471,33884,HR,HR
92712,1700089500,1700108160,18660,155115,43775,FR,PL
189479,1700837880,1700841480,3600,7859,19847,GB,GB
173817,1700199000,1700208660,9660,184297,69242,PT,PT
180390,1699716720,1699769640,52920,55339,114564,BG,DE
170202,1699732500,1699741740,9240,48824,126915,SK,AT
112247,1700615100,1700642760,27660,26388,93264,DE,DE
107684,1700323500,1700343780,20280,63361,178300,FR,DE
177154,1698918660,1698922260,3600,141383,104329,NL,NL
10377,1699845960,1699878720,32760,5085,116444,TR,TR
134953,1700625900,1700640300,14400,29604,174562,US,US
115924,1700121000,1700125200,4200,111676,93261,AD,ES
73041,1699404240,1699416420,12180,14842,73010,HR,HR
77634,1699153500,1699166940,13440,114822,66188,ES,ES
45107,1699379880,1699418520,38640,65083,12645,MX,MX
183897,1700213220,1700216820,3600,174229,198549,GB,GB
142635,1699554060,1699588080,34020,108670,175609,TR,TR
2475,1700456880,1700462700,5820,6465,136579,GB,GB
14984,1700852220,1700883660,31440,3027,25920,TR,TR
6701,1698836460,1698840060,3600,50374,34452,NL,NL
155103,1699619640,1699655220,35580,16346,164320,TR,TR
63124,1699934220,1699951500,17280,112868,88152,US,US
184703,1700277540,1700281140,3600,35764,161705,GB,GB
195897,1699792620,1699822560,29940,35978,45226,TR,TR
61361,1700322540,1700351400,28860,139384,74886,TR,TR
190781,1699767600,1699772940,5340,82308,41599,GB,GB
69281,1699755180,1699771140,15960,14508,88979,US,US
193865,1700280960,1700314260,33300,18124,112374,TR,TR
155393,1699210500,1699226040,15540,69245,48792,US,US
44318,1699650780,1699685100,34320,67447,183562,TR,TR
17446,1700801820,1700812440,10620,34846,101893,IT,IT
72616,1699305720,1699321860,16140,160705,95586,US,US
185329,1700146320,1700154000,7680,97828,80491,IT,FR
7772,1700478960,1700506920,27960,167984,81321,PL,PL
65475,1699086240,1699102020,15780,67611,191268,US,US
123029,1698890880,1698907860,16980,17166,153763,US,US
93895,1699888200,1699921800,33600,53794,117128,MX,MX
56204,1700806620,1700820720,14100,133928,57329,CZ,UA
4593,1698922260,1698952020,29760,72198,13397,TR,TR
126876,1700295180,1700330220,35040,37911,31617,TR,TR
64550,1700344980,1700401140,56160,146885,128759,BG,BG
134021,1699543440,1699547040,3600,127488,130716,NL,NL
81583,1698796680,1698829920,33240,44844,11975,TR,TR
194198,1699068480,1699097340,28860,136964,62354,TR,TR
103166,1698981120,1698997320,16200,136953,151878,US,US
171254,1699785480,1699810800,25320,27336,63018,CH,FR
7379,1698869700,1698887400,17700,120314,153838,US,US
114224,1700614980,1700624940,9960,136500,169978,IT,IT
106322,1698848160,1698859800,11640,64026,76117,US,US
167894,1700442780,1700455320,12540,186049,3548,AT,AT
102151,1698893940,1698903120,9180,131663,66332,HR,DE
199353,1698954300,1698985140,30840,141960,133574,TR,TR
96059,1700697480,1700701440,3960,154637,108364,GB,GB
16306,1700114280,1700134500,20220,126369,185741,FR,NL
110756,1700720700,1700752740,32040,199164,101263,TR,TR
63580,1700780880,1700784480,3600,131380,85555,NL,NL
99297,1699402140,1699408920,6780,140214,183984,GB,GB
151732,1699870680,1699885260,14580,144224,86603,US,US
169571,1700256720,1700289300,32580,190346,1802,TR,TR
145785,1700578620,1700613540,34920,164519,23670,TR,TR
76545,1700219880,1700238180,18300,173099,21039,SE,SE
32743,1700363160,1700380080,16920,22967,57977,US,US
156557,1699455000,1699489740,34740,55369,154438,TR,TR
177112,1700329500,1700345760,16260,32503,79487,US,US
96096,1698836700,1698868560,31860,17109,73193,TR,TR
66727,1700019720,1700050980,31260,65027,136174,TR,TR
54465,1699671360,1699694700,23340,91665,85864,DE,ES
36462,1700346900,1700353740,6840,134162,129707,GB,GB
168794,1700077380,1700094600,17220,11033,125071,FR,FR
118728,1699318380,1699330980,12600,103812,34136,AT,PL
81792,1700551140,1700557020,5880,64853,34142,GB,GB
157149,1700598360,1700619780,21420,130040,176670,LT,PL
21430,1699730700,1699738380,7680,199490,105744,EE,EE
140477,1699331880,1699361520,29640,55935,147078,TR,TR
40079,1699707720,1699744800,37080,167012,7506,MX,MX
40876,1699447860,1699462560,14700,175553,117888,US,US
86930,1699917120,1699932660,15540,153,56280,US,US
138260,1700844480,1700878980,34500,150949,18713,TR,TR
176713,1699060380,1699090620,30240,186718,172939,TR,TR
27059,1700732100,1700762340,30240,163808,47107,TR,TR
184101,1699976880,1700004720,27840,168012,28748,DE,FR
15561,1699968600,1699981560,12960,48073,79822,AT,AT
76699,1699680120,1699711620,31500,102241,144706,TR,TR
27791,1699817580,1699821180,3600,7251,147034,NL,NL
174264,1700023500,1700027100,3600,118291,151833,NL,BE
12742,1698867360,1698896760,29400,101133,62116,TR,TR
178668,1700768700,1700786520,17820,71843,177732,CZ,CZ
167131,1700826420,1700836080,9660,122228,171009,HR,DE
53411,1699441860,1699445460,3600,117951,198942,GB,GB
141556,1699688580,1699699140,10560,190299,79878,IT,IT
77670,1700751660,1700757420,5760,172930,101289,GB,GB
23312,1700174520,1700181180,6660,27053,159073,NL,BE
138024,1698944940,1698951480,6540,29635,144935,GB,GB
10291,1699616520,1699625040,8520,133952,34158,PT,PT
91124,1699331760,1699366140,34380,2898,24151,TR,TR
174776,1699412880,1699420560,7680,154874,58013,IT,IT
162119,1699362840,1699397640,34800,155214,68028,TR,TR
194194,1699701180,1699735260,34080,199681,121873,TR,TR
9766,1700706780,1700741160,34380,42809,195717,TR,TR
82610,1700568240,1700599020,30780,107346,5814,TR,TR
94966,1699032780,1699045860,13080,23446,6272,US,US
157246,1700126460,1700150460,24000,189892,139287,PL,PL
104824,1699889460,1699893060,3600,25528,113586,GB,GB
164886,1700446440,1700476680,30240,53005,186511,TR,TR
113998,1700754180,1700787780,33600,119512,17699,TR,TR
32489,1698958980,1698968100,9120,172605,72701,IT,IT
158878,1698982680,1698989340,6660,16302,182414,NL,NL
112557,1699148280,1699161060,12780,169370,159392,PT,PT
14497,1699232760,1699262460,29700,39249,74209,TR,TR
65561,1699017120,1699043880,26760,297,99624,BA,HR
122958,1698960120,1698978420,18300,70446,152944,DK,DK
185572,1699233060,1699246860,13800,116277,149675,US,US
91149,1698892680,1698901200,8520,93523,81254,IT,IT
129083,1700292060,1700303100,11040,70400,56869,IT,IT
126130,1700340420,1700354460,14040,195913,116881,HR,HR
197524,1699245360,1699259880,14520,3232,132589,US,US
185324,1700614560,1700644380,29820,191146,196379,TR,TR
106291,1699857780,1699891680,33900,131516,162093,TR,TR
1908,1700343780,1700350440,6660,142320,4291,GB,GB
103218,1698803640,1698837900,34260,137375,19172,TR,TR
86205,1699269660,1699283220,13560,68767,57871,IT,IT
195736,1700035560,1700048460,12900,10977,88797,US,US
91529,1699805640,1699812180,6540,160524,177476,NL,NL
7755,1699711980,1699727760,15780,7828,59557,US,US
191578,1700715480,1700724060,8580,151512,1274,ES,DE
66834,1700366220,1700380500,14280,198892,21435,IT,IT
188382,1699726560,1699730160,3600,134513,66748,GB,GB
81324,1700010600,1700014200,3600,99437,108703,NL,NL
8878,1700295060,1700311740,16680,87982,180778,FR,AD
42326,1698976800,1698994980,18180,30237,57372,SI,RS
79305,1700457420,1700470560,13140,41693,181167,RS,DE
127633,1700395140,1700418960,23820,45948,181268,DE,DE
168063,1699212000,1699244340,32340,129125,188482,TR,TR
102524,1699057380,1699088520,31140,128392,63060,TR,TR
192404,1699259340,1699274340,15000,16155,117492,RS,BA
33037,1700691060,1700702460,11400,95077,32186,HR,HR
135768,1699203960,1699207560,3600,109944,184407,GB,GB
57576,1700724240,1700727840,3600,7409,81809,GB,GB
79842,1700845440,1700852520,7080,113901,97988,NL,NL
105011,1699846080,1699863900,17820,116912,130500,US,US
5378,1698959820,1698994320,34500,181514,151453,TR,TR
25886,1700353020,1700377260,24240,4915,84167,DE,DE
47148,1700794020,1700828460,34440,193548,32686,TR,TR
45980,1700801400,1700821860,20460,24393,92013,FR,DE
158053,1699708440,1699739160,30720,113985,143782,TR,TR
3763,1699822680,1699842600,19920,27906,195000,FR,FR
98522,1700715660,1700745360,29700,133066,71446,TR,TR
90368,1700128980,1700161320,32340,99110,95367,TR,TR
165604,1699389120,1699402620,13500,149887,115321,US,US
23885,1699523640,1699558140,34500,151576,160673,TR,TR
98062,1698986220,1699002720,16500,95252,31141,US,US
17046,1700325720,1700350440,24720,162479,175350,PL,PL
54246,1700768760,1700788080,19320,173225,44575,FR,ES
185018,1699134480,1699156500,22020,51715,44537,RO,BG
79471,1700481360,1700514480,33120,50527,137091,TR,TR
184358,1700736360,1700771100,34740,63075,65862,TR,TR
66599,1699282020,1699288440,6420,20769,107129,NL,NL
90805,1700627340,1700657460,30120,193635,44437,TR,TR
118451,1699735200,1699741500,6300,44275,45052,NL,DE
145954,1699456980,1699486980,30000,70709,151273,TR,TR
86029,1699788720,1699792320,3600,95075,16396,GB,GB
3451,1698794220,1698827280,33060,46031,37438,TR,TR
17079,1699731900,1699764720,32820,143885,57596,TR,TR
13305,1700755740,1700759340,3600,9631,22215,NL,NL
148605,1700041860,1700077140,35280,97636,175472,TR,TR
69128,1700144640,1700176440,31800,125334,63055,TR,TR
139077,1700054280,1700081400,27120,162512,1500,PL,PL
137069,1698805440,1698839640,34200,155880,112340,TR,TR
102486,1699591740,1699603560,11820,170637,13370,RS,RS
91635,1699720020,1699737120,17100,37915,149522,CZ,CZ
142534,1699155480,1699168140,12660,155636,142217,IT,IT
36396,1699184340,1699216380,32040,182317,148503,TR,TR
34544,1699577280,1699581540,4260,194647,60061,GB,GB
91386,1700140860,1700152740,11880,132530,126736,PT,PT
45688,1699668600,1699676760,8160,21338,182066,ES,ES
133423,1699187940,1699200540,12600,67585,61057,US,US
115772,1700822280,1700851800,29520,16323,129108,TR,TR
104922,1699646040,1699656840,10800,17727,165777,HR,HR
9790,1699230780,1699257000,26220,168190,38778,DE,DE
184253,1700304240,1700325720,21480,139430,35947,FR,DE
58498,1699569960,1699604940,34980,117495,83779,TR,TR
87268,1699740600,1699744200,3600,133341,71757,NL,NL
51489,1699071060,1699077420,6360,134395,169283,GB,GB
126570,1700246040,1700257980,11940,153356,38656,US,US
97218,1699774140,1699808400,34260,161917,56389,TR,TR
71691,1700017620,1700034600,16980,47020,195586,SE,SE
77331,1699876620,1699906140,29520,155514,147963,TR,TR
124901,1700239680,1700274000,34320,78742,176004,TR,TR
118884,1699835400,1699867320,31920,159372,127884,TR,TR
76820,1700457000,1700479080,22080,158846,5765,HU,BG
185877,1700711940,1700741280,29340,147875,130810,TR,TR
12355,1698963960,1698991140,27180,152541,123031,DE,DE
172735,1700353920,1700386980,33060,140499,81517,TR,TR
92289,1699115700,1699151160,35460,17391,6015,TR,TR
70048,1700439540,1700469060,29520,26785,114462,TR,TR
35463,1699558200,1699591080,32880,11474,121930,TR,TR
6454,1699497300,1699528080,30780,124870,176560,TR,TR
133358,1700455500,1700471220,15720,158082,190250,SE,RO
124583,1700767860,1700793540,25680,40665,86061,NO,SE
98120,1698983220,1698989100,5880,75122,191187,NL,BE
190859,1698863940,1698898200,34260,93773,139276,TR,TR
147725,1699058340,1699089540,31200,92041,38074,TR,TR
69265,1700536560,1700546040,9480,125299,68784,PT,PT
154581,1699297800,1699313280,15480,169742,188012,US,US
99113,1700587260,1700599740,12480,14004,133348,US,US
193756,1700220120,1700224800,4680,46464,21776,NL,NL
70397,1699871220,1699901340,30120,2253,15271,TR,TR
2537,1699238520,1699242120,3600,12376,106812,GB,GB
46030,1699615080,1699622280,7200,101994,159940,HR,DE
181876,1700171940,1700204100,32160,48646,159950,TR,TR
85087,1698808560,1698840360,31800,107983,53688,TR,TR
93171,1700795820,1700830440,34620,30107,38022,TR,TR
146016,1700162400,1700166000,3600,163069,173030,NL,NL
84214,1699553520,1699584960,31440,83858,169899,TR,TR
121336,1699605900,1699612680,6780,50259,137665,NL,NL
199126,1700653260,1700687280,34020,27326,22609,TR,TR
72851,1699706160,1699718880,12720,166080,64228,AT,BG
70071,1699854780,1699866540,11760,191567,172990,US,US
85776,1700047920,1700051520,3600,40698,193834,NL,NL
145265,1699908540,1699912140,3600,137151,9751,GB,GB
33062,1700438220,1700455620,17400,74709,28231,US,US
75078,1699121040,1699124640,3600,188882,38052,GB,GB
186411,1700176500,1700180100,3600,172636,134263,NL,IT
35457,1699519140,1699551660,32520,128000,42294,TR,TR
35354,1698817260,1698820920,3660,79376,146200,NL,NL
67791,1700463060,1700477820,14760,151643,67620,FR,NL
146986,1700091300,1700111760,20460,91014,12937,FR,AD
4556,1699127040,1699140000,12960,143510,39900,US,US
84123,1700001180,1700004780,3600,96637,160833,GB,GB
147394,1700807400,1700818860,11460,77175,30719,US,US
161686,1699809300,1699836300,27000,27298,168315,DE,IT
104996,1700461680,1700474100,12420,34375,184424,US,US
176863,1698872880,1698891600,18720,117561,10046,FR,NL
162857,1699640760,1699646460,5700,117994,53162,NL,NL
98744,1700834460,1700838060,3600,69212,54680,GB,GB
101582,1699537920,1699575300,37380,83750,110085,MX,MX
23936,1700247660,1700279460,31800,13479,75339,TR,TR
156770,1699654560,1699680060,25500,116446,166806,DE,DE
111052,1699592700,1699613160,20460,33081,174262,FR,FR
174474,1698823440,1698830100,6660,88886,172665,GB,GB
50040,1699668000,1699684260,16260,168272,77192,AT,AT
50321,1699417920,1699432200,14280,117570,132965,HR,HR
143454,1700367060,1700378220,11160,97137,23329,AT,SK
181720,1699165740,1699177680,11940,171881,33849,US,US
110040,1699553640,1699557240,3600,18342,73470,GB,GB
164453,1699733760,1699737360,3600,19653,162190,GB,GB
48136,1698958260,1698970620,12360,50805,158987,US,US
189924,1699743660,1699767600,23940,198860,1187,CH,FR
74193,1699276020,1699312800,36780,117946,112497,MX,MX
64924,1700054340,1700088240,33900,112221,140518,TR,TR
196843,1700532720,1700565120,32400,108590,58297,TR,TR
32989,1700574900,1700578500,3600,179596,19991,GB,GB
148896,1700193240,1700222100,28860,55028,90154,TR,TR
110453,1699908060,1699932900,24840,18874,102520,DE,DE
122930,1699602540,1699635360,32820,184505,196319,TR,TR
64334,1700425440,1700429040,3600,23061,194800,NL,NL
164912,1700468340,1700477160,8820,85414,92994,ES,FR
194735,1698939720,1698967800,28080,138945,196644,BR,BR
154981,1699588320,1699601040,12720,81602,156858,RS,RS
159119,1699607820,1699621020,13200,193374,37149,PT,PT
128255,1699897200,1699908180,10980,151892,48516,IT,IT
162399,1699512240,1699524180,11940,179906,27955,RS,RS
84894,1698828240,1698842040,13800,85660,2091,US,US
40877,1699432620,1699445880,13260,6085,196711,RS,RS
29308,1698816360,1698836520,20160,62914,87801,FR,DE
14934,1699752540,1699782060,29520,33585,56861,TR,TR
183139,1699913160,1699927200,14040,128608,67808,US,US
63775,1700787600,1700791200,3600,122492,188153,NL,AT
178452,1699665540,1699681020,15480,179446,76123,AT,AT
11020,1699475340,1699490340,15000,101936,32755,SE,SE
82645,1699444080,1699455060,10980,54390,195399,AT,HU
8710,1699966500,1699980420,13920,47627,61175,IT,IT
175088,1699046700,1699060200,13500,59968,165580,US,US
31380,1699183680,1699208640,24960,118843,29237,BR,BR
29808,1699539780,1699568160,28380,59332,196717,PL,PL
101937,1700560740,1700564340,3600,36299,93882,GB,GB
121918,1700371920,1700383140,11220,159934,155508,PT,PT
197370,1699206360,1699235460,29100,76731,195067,TR,TR
58225,1699914180,1699948080,33900,16176,157555,TR,TR
93852,1699055340,1699069380,14040,88683,25057,US,US
35202,1698905160,1698908760,3600,82396,141295,NL,NL
26834,1700134380,1700167500,33120,195529,38574,TR,TR
174897,1699721700,1699733040,11340,173042,87847,RS,RS
32572,1698907020,1698911880,4860,159971,32056,NL,NL
108134,1700221440,1700238240,16800,151949,53746,FR,AD
51322,1698989580,1698993180,3600,155221,141846,NL,NL
184932,1699022940,1699032000,9060,39492,71409,IT,IT
153794,1698952440,1698979620,27180,188425,189484,BR,BR
104825,1699905420,1699926960,21540,109473,92503,FR,FR
176937,1699929120,1699932720,3600,5287,17136,GB,GB
29886,1699557480,1699571220,13740,111746,124644,HR,HR
40578,1699401300,1699414380,13080,41633,54724,RS,RS
197332,1700104860,1700108460,3600,76095,192840,NL,NL
185590,1699361520,1699393620,32100,96489,31380,TR,TR
52135,1699941120,1699953180,12060,177480,140811,US,US
14892,1699269300,1699281240,11940,193327,108470,ES,ES
156199,1700460780,1700494260,33480,88443,175268,MX,MX
82063,1700405940,1700412540,6600,146427,181791,NL,NL
188690,1700077860,1700084580,6720,176212,102500,NL,NL
99772,1700754060,1700764680,10620,89554,8823,PT,DE
7613,1700339160,1700363820,24660,88301,39817,DE,IT
40222,1699340340,1699370220,29880,55175,120729,TR,TR
50067,1699924800,1699953840,29040,39396,175845,TR,TR
54390,1700748540,1700780220,31680,22061,173823,TR,TR
56115,1699908060,1699941300,33240,105519,178718,TR,TR
164972,1700458740,1700488740,30000,68583,177825,TR,TR
171621,1700185380,1700188980,3600,69908,79388,NL,NL
14396,1700065320,1700096460,31140,99873,97635,TR,TR
148505,1700419980,1700432100,12120,187010,141190,US,US
32856,1699584420,1699618200,33780,114025,145273,TR,TR
62855,1699738980,1699752060,13080,92214,11356,US,US
4066,1698923400,1698955080,31680,114251,60844,TR,TR
39504,1699604280,1699611960,7680,96792,1382,IT,IT
53800,1700250240,1700269380,19140,115979,142202,FR,IT
28220,1699519620,1699530360,10740,134593,79657,HR,HR
7642,1700512800,1700530500,17700,47612,197805,CZ,CZ
107864,1699773360,1699776960,3600,138604,97563,NL,NL
142461,1700708760,1700730480,21720,71592,180480,DE,PL
168929,1699702560,1699715220,12660,136430,29778,SK,AT
96139,1699427700,1699440540,12840,21393,31404,PT,PT
172247,1700040600,1700048040,7440,111571,12947,PT,PT
169342,1698994560,1699004880,10320,89906,186720,HR,HR
152366,1700484780,1700502480,17700,163168,174004,US,US
199737,1700553480,1700575320,21840,104128,183552,RO,RO
9587,1699312020,1699347540,35520,138249,97751,TR,TR
190505,1700293860,1700297640,3780,25293,8286,GB,GB
99615,1700617440,1700628540,11100,4312,71660,US,US
54739,1700335740,1700365320,29580,174167,49247,TR,TR
153117,1699285200,1699318920,33720,31785,157602,TR,TR
4884,1700333220,1700343780,10560,106591,125088,EE,EE
171172,1698840180,1698865680,25500,190910,113192,DE,DE
107270,1700570460,1700581200,10740,165711,164928,PT,PT
198233,1699777560,1699803660,26100,199095,160965,PL,DE
180175,1699133580,1699146300,12720,135721,86590,IT,IT
44617,1700731560,1700757120,25560,196182,97116,HU,HR
126640,1699108620,1699144020,35400,106317,120630,TR,TR
116455,1699184520,1699197960,13440,54666,8557,US,US
103999,1700612340,1700633880,21540,195101,135179,FR,FR
175481,1699138680,1699150680,12000,16081,88517,US,US
48160,1699739640,1699753080,13440,149972,1725,US,US
95469,1698802500,1698820260,17760,134323,18814,US,US
150142,1699772520,1699804860,32340,61132,40740,TR,TR
80939,1699350960,1699356180,5220,47159,96877,EE,EE
139470,1700648700,1700663520,14820,9915,66282,US,US
150247,1699383060,1699412700,29640,152550,50312,TR,TR
82224,1699270740,1699293660,22920,99414,131257,DE,DE
86733,1700034660,1700046540,11880,162490,107398,US,US
87226,1699100940,1699129140,28200,53415,177801,DE,DE
117394,1699095000,1699098600,3600,89862,1094,NL,NL
147551,1699271700,1699284060,12360,196336,168659,US,US
62561,1700214360,1700235960,21600,64133,105525,DE,DE
113813,1700555820,1700591280,35460,187816,29117,TR,TR
169034,1699082040,1699116780,34740,186392,47160,TR,TR
6231,1699845120,1699859580,14460,9687,84245,CA,US
87406,1699845660,1699873200,27540,31366,143699,DE,DE
48462,1700429520,1700434380,4860,190355,41423,GB,GB
173678,1698951720,1698985980,34260,118595,25843,TR,TR
191468,1700529660,1700541360,11700,64399,126066,US,US
197806,1699397940,1699410840,12900,192060,117431,PT,PT
71961,1699951380,1699961280,9900,62381,194657,HR,HR
86498,1698984840,1699012080,27240,143093,24680,PL,UA
181337,1700431200,1700444640,13440,102900,106503,US,MX
168171,1699204740,1699212480,7740,117139,150715,IT,IT
144357,1700456040,1700467380,11340,15379,133388,HR,HR
79766,1699151700,1699184040,32340,116851,18950,TR,TR
1104,1700332200,1700369400,37200,70065,77481,MX,US
92104,1698882120,1698917100,34980,138268,169897,TR,TR
23988,1700394660,1700428080,33420,71103,109787,TR,TR
165337,1699555740,1699573440,17700,109951,137528,FR,BE
178555,1698978780,1699014360,35580,156601,92399,TR,TR
193670,1698796320,1698802740,6420,31173,76045,GB,GB
154974,1699732620,1699757760,25140,193148,66077,DE,DE
77166,1700017200,1700046240,29040,76241,59093,TR,TR
172658,1700571480,1700580360,8880,176054,153407,IT,IT
128012,1699419300,1699429020,9720,66769,87816,IT,IT
193042,1699542960,1699546560,3600,87532,53048,GB,GB
19470,1700371440,1700380680,9240,173450,79875,IT,IT
110257,1698883560,1698895380,11820,20349,93814,US,US
189662,1699109340,1699121580,12240,178809,170510,US,US
143567,1698867240,1698900480,33240,184396,144742,TR,TR
171,1700115840,1700119440,3600,35739,40074,GB,GB
167977,1699340640,1699376700,36060,55783,85035,MX,MX
67,1700785860,1700789460,3600,134754,23,NL,NL
33851,1699524900,1699538160,13260,114560,171043,PT,PT
142906,1699524960,1699529220,4260,3160,2332,NL,NL
50817,1699363080,1699392180,29100,135387,48196,TR,TR
191300,1700152860,1700160720,7860,53598,115643,IT,IT
36337,1700549760,1700579160,29400,36295,140045,TR,TR
133361,1700464800,1700474640,9840,34340,61563,PT,PT
102889,1699248060,1699259520,11460,161592,172822,HR,HR
40799,1700529540,1700553600,24060,17264,148404,BR,BR
192159,1700842920,1700877540,34620,173660,142739,TR,TR
57539,1699852140,1699869960,17820,110928,136163,FR,FR
104267,1699799580,1699830840,31260,33956,113824,TR,TR
71550,1699560900,1699594260,33360,133631,56941,TR,TR
65785,1699876800,1699895640,18840,179945,162764,SE,NO
90085,1699348020,1699378320,30300,122069,114587,TR,TR
182271,1699764240,1699774440,10200,70477,178690,IT,IT
123085,1700326080,1700358840,32760,19658,17546,TR,TR
43753,1699297980,1699301880,3900,164468,130556,NL,NL
151467,1698832440,1698848220,15780,54592,112597,US,US
17861,1698939780,1698970320,30540,95009,84358,TR,TR
71725,1699589760,1699599120,9360,89767,89666,IT,IT
169801,1700733120,1700758380,25260,151176,10067,PL,PL
53064,1700558280,1700574000,15720,39755,130287,US,US
164907,1700406480,1700427900,21420,96808,159728,FR,CH
6806,1698883020,1698894060,11040,51145,107184,IT,IT
195395,1700784120,1700814120,30000,63435,137273,TR,TR
108999,1699145880,1699157160,11280,91142,78241,US,US
94798,1699001940,1699017960,16020,93247,184580,US,US
146515,1700029440,1700035260,5820,133313,24964,GB,GB
134313,1700424960,1700454960,30000,118725,83612,TR,TR
86279,1700547000,1700580000,33000,120290,56059,TR,TR
20384,1699075920,1699082700,6780,43786,149003,GB,GB
18760,1700833500,1700866320,32820,116381,160385,TR,TR
88938,1699009320,1699042200,32880,103630,36167,TR,TR
96823,1699445880,1699451640,5760,141444,166967,GB,GB
165762,1699863900,1699871760,7860,6313,196660,EE,EE
67187,1700323560,1700335500,11940,46468,40986,CZ,AT
183783,1700374080,1700398320,24240,66590,24433,DE,DE
120996,1698975420,1699010940,35520,124415,70776,TR,TR
20417,1699757880,1699766040,8160,150414,177206,HR,HR
115329,1700781720,1700814780,33060,59636,54320,TR,TR
87229,1700062620,1700079900,17280,25268,47887,CZ,PL
92521,1699622400,1699634160,11760,62022,23638,US,US
165609,1700516640,1700551800,35160,145193,193310,TR,TR
16028,1698899280,1698916620,17340,111454,178824,US,US
139836,1698826020,1698838500,12480,140732,167931,PT,PT
87764,1700649420,1700653020,3600,62626,45753,GB,GB
122663,1700261340,1700294400,33060,181806,197822,TR,TR
187755,1699197600,1699231080,33480,198503,121369,TR,TR
90615,1699287120,1699292640,5520,161146,158335,GB,GB
32945,1698942360,1698977640,35280,43124,141592,TR,TR
192885,1700011980,1700018220,6240,110585,109432,GB,GB
58508,1699701120,1699704720,3600,193598,109539,GB,GB
72109,1700757000,1700795400,38400,109052,147758,MX,MX
48041,1700261760,1700271600,9840,78716,57062,HR,HR
98342,1700105400,1700144700,39300,163195,26037,MX,MX
70383,1700140560,1700169780,29220,103135,115897,TR,TR
112018,1699102380,1699135920,33540,121937,134897,TR,TR
164621,1699608180,1699619220,11040,63687,139392,IT,IT
183533,1700291280,1700311800,20520,94667,61442,FR,AD
137373,1700256600,1700284260,27660,71345,20147,PL,PL
46217,1699540920,1699547160,6240,88624,141344,GB,FR
101120,1700786400,1700798280,11880,158350,57392,PT,PT
138295,1699583040,1699587240,4200,14925,92827,GB,GB
3355,1699910700,1699933800,23100,5761,102112,DE,DE
144449,1700710500,1700746320,35820,142864,82953,TR,TR
149017,1700860020,1700892780,32760,26694,78935,TR,TR
83268,1700235000,1700266020,31020,6719,102649,TR,TR
13477,1700065260,1700100360,35100,15828,115565,TR,TR
58500,1698923520,1698957600,34080,117821,148234,TR,TR
193086,1700003220,1700035620,32400,145161,150393,TR,TR
80780,1699193880,1699209000,15120,151804,176425,US,US
19291,1700175540,1700205420,29880,78719,109342,TR,TR
134600,1700101560,1700112000,10440,98108,24171,HR,HR
14072,1699074720,1699096680,21960,199767,135758,BR,BR
172983,1699102140,1699106040,3900,22748,139044,GB,GB
170510,1699857420,1699861020,3600,197289,46526,GB,GB
163285,1699144800,1699158840,14040,182819,99573,IT,IT
147121,1700820420,1700835480,15060,103868,188725,US,US
196676,1699988100,1699992180,4080,133824,175396,NL,NL
76031,1699877340,1699893900,16560,181260,137964,US,US
155603,1699700160,1699714380,14220,60563,29735,RS,RS
95450,1699941960,1699957560,15600,69405,151004,CZ,CZ
158650,1699087140,1699101060,13920,26798,135506,RS,HR
104498,1699709580,1699732140,22560,25751,146184,AL,MK
64935,1699495500,1699521780,26280,148653,199813,DE,NL
146444,1700649300,1700679060,29760,107078,37342,TR,TR
78308,1700023260,1700053260,30000,71881,136670,TR,TR
115221,1699089240,1699101900,12660,18868,72376,IT,IT
139714,1699765500,1699797060,31560,39772,181306,TR,TR
111546,1699714380,1699737180,22800,40067,10199,HU,AT
127547,1699525500,1699560060,34560,171682,109306,TR,TR
143475,1700161380,1700164980,3600,63426,109991,GB,GB
181113,1698794460,1698810120,15660,133290,131891,US,US
113975,1699053240,1699056840,3600,4417,117429,GB,GB
111422,1699751880,1699781580,29700,195476,633,TR,TR
145994,1700304840,1700315460,10620,147258,158230,IT,IT
185648,1699167900,1699174020,6120,15585,28404,NL,NL
10249,1699599900,1699624680,24780,128663,114452,NO,SE
45531,1699969320,1700001000,31680,175477,194433,TR,TR
100989,1699267320,1699279560,12240,111317,177726,US,US
2987,1699223100,1699252440,29340,120672,6845,TR,TR
101892,1699651560,1699686840,35280,140789,29182,TR,TR
194657,1699033560,1699062720,29160,2027,41587,TR,TR
35718,1699631520,1699644720,13200,44370,110409,US,US
62624,1699120800,1699132560,11760,163887,137844,US,US
2197,1698946020,1698981000,34980,129524,5813,TR,TR
39794,1699380180,1699413120,32940,15706,100355,TR,TR
10758,1700182020,1700194020,12000,184052,61040,US,US
86006,1698871980,1698885120,13140,20363,4663,ES,ES
38018,1699732680,1699736280,3600,158882,18784,GB,GB
150060,1700636040,1700648160,12120,168849,120230,US,US
56281,1699461780,1699476660,14880,41685,149234,US,US
125511,1699757400,1699788000,30600,141052,22188,TR,TR
50115,1700140920,1700172360,31440,27233,117656,TR,TR
126158,1700586480,1700598180,11700,2080,70961,US,US
20201,1699567680,1699603980,36300,72991,48317,MX,MX
129439,1699960080,1699966020,5940,137691,176338,GB,GB
16000,1698903000,1698915480,12480,152252,199861,ES,ES
47011,1699765860,1699783560,17700,48739,67342,FR,NL
107491,1699458780,1699487820,29040,109018,154974,TR,TR
168037,1699554540,1699582560,28020,18320,17032,DE,DE
179275,1700440680,1700448300,7620,47210,179836,PT,PT
102274,1698813300,1698849240,35940,77815,161012,TR,TR
15381,1699981140,1699984740,3600,68083,94068,GB,GB
71636,1700848440,1700852040,3600,16860,45352,GB,GB
159316,1699482120,1699515360,33240,1054,153176,TR,TR
128099,1699352160,1699373100,20940,194259,77809,FR,RO
100351,1699367340,1699402560,35220,85996,179975,TR,TR
128328,1700094540,1700115960,21420,198951,20963,FR,CZ
113824,1699412100,1699441680,29580,73790,126435,TR,TR
182141,1700864820,1700874240,9420,155705,148564,IT,IT
187287,1700483460,1700494440,10980,85898,54063,ES,ES
102775,1699906620,1699941120,34500,17460,156179,TR,TR
172205,1700115600,1700119200,3600,79407,157133,NL,NL
10417,1700226720,1700235360,8640,79032,153825,PT,PT
115238,1698853800,1698885840,32040,56051,45836,TR,TR
82615,1700200380,1700219280,18900,157622,39405,FR,FR
59371,1700728620,1700748900,20280,119488,22514,FR,PT
98691,1699225560,1699238880,13320,123085,169895,PT,PT
151436,1700491560,1700501160,9600,37737,101141,IT,DE
154085,1699618920,1699637640,18720,169793,112560,FR,BE
118966,1699381980,1699393020,11040,162640,95029,US,CA
163681,1699062060,1699097880,35820,67971,72219,TR,TR
69190,1699360920,1699374600,13680,27638,158538,IT,IT
106580,1699381620,1699398480,16860,96387,83108,US,US
88799,1699477260,1699494840,17580,139919,13983,US,US
47639,1700239680,1700260860,21180,109666,165950,SE,NO
15035,1700352840,1700357460,4620,167555,48702,GB,GB
15211,1698840420,1698872700,32280,54206,136497,TR,TR
34788,1699890960,1699907400,16440,71343,68705,FR,CH
81398,1699342620,1699356540,13920,44279,162017,IT,IT
151454,1700160540,1700172960,12420,165387,132835,US,US
119785,1698910740,1698945300,34560,80253,147931,TR,TR
48554,1699679460,1699692780,13320,41623,115434,US,US
8411,1700699760,1700713620,13860,144687,48703,HR,HR
90091,1700065620,1700100840,35220,178583,88665,TR,TR
53838,1699756560,1699761660,5100,57063,48756,NL,FR
163034,1700760420,1700793840,33420,198724,62819,TR,TR
42470,1700802180,1700836080,33900,138676,181481,TR,TR
74930,1699241640,1699253040,11400,14575,3129,IT,IT
197327,1699809720,1699819800,10080,11589,86123,IT,IT
186650,1700352180,1700365140,12960,59689,42851,IT,IT
28604,1700771640,1700787960,16320,131936,33488,BE,FR
72474,1699477860,1699481460,3600,71128,5864,NL,NL
164407,1700562240,1700570040,7800,19258,61371,ES,ES
86768,1699248720,1699264380,15660,74940,114185,US,US
50278,1699499700,1699525740,26040,51697,114776,DE,NL
179947,1700050920,1700078700,27780,135409,126583,DE,DE
50226,1700630880,1700638080,7200,160959,135782,IT,IT
15877,1700203560,1700223420,19860,94184,112164,DK,DE
61438,1700084040,1700097240,13200,191781,61802,US,US
50923,1699211280,1699222920,11640,43560,9539,US,US
12931,1700676480,1700705340,28860,94200,153579,TR,TR
156772,1699320540,1699324500,3960,87788,37904,GB,GB
189951,1700159160,1700168400,9240,116503,1272,IT,IT
45363,1700562660,1700566260,3600,168653,85419,GB,GB
55017,1700211120,1700218020,6900,29095,30301,GB,GB
30186,1699481400,1699488300,6900,99786,50221,NL,NL
163750,1700392020,1700425260,33240,16503,26765,MX,MX
154087,1700751420,1700787240,35820,8211,14592,TR,TR
136338,1699699380,1699710900,11520,31880,113223,PT,ES
39605,1698867780,1698886080,18300,831,28857,FR,NL
133457,1700854980,1700867040,12060,169214,57569,AT,AT
27886,1700791380,1700826540,35160,77625,181764,TR,TR
147711,1700643960,1700676420,32460,11795,134780,TR,TR
75454,1700061720,1700065680,3960,32521,175974,GB,GB
9080,1698980760,1698993120,12360,52954,137486,SK,AT
197801,1699252320,1699257480,5160,143643,102504,GB,GB
155110,1699717680,1699747740,30060,129021,41817,TR,TR
83938,1700714040,1700722080,8040,45346,172985,PT,PT
90693,1699905000,1699935300,30300,57385,196530,TR,TR
147816,1700749080,1700774520,25440,139350,123393,DE,BA
171848,1700517360,1700550300,32940,27593,171045,TR,TR
3308,1699898280,1699923060,24780,163137,150540,DE,DE
127069,1698858960,1698894000,35040,34669,146724,TR,TR
184267,1700146320,1700170920,24600,64532,172113,DE,PL
179460,1698962220,1698987660,25440,124829,194514,BA,AT
184149,1700393820,1700400480,6660,174536,164985,NL,NL
171827,1698896280,1698911460,15180,143806,60854,AT,AT
82157,1700760780,1700787120,26340,188893,189643,DE,DE
102839,1700832780,1700846580,13800,136214,61731,US,US
100930,1700140740,1700158380,17640,161572,141172,US,US
175741,1700738760,1700755740,16980,87399,43894,CA,CA
26448,1700151900,1700161380,9480,110936,141685,PT,PT
176607,1699172760,1699205220,32460,122241,14287,TR,TR
69068,1699428120,1699450320,22200,20074,129549,DE,BG
95759,1700631060,1700660640,29580,39250,172210,TR,TR
136141,1698908940,1698913860,4920,132121,119428,GB,GB
121139,1700836200,1700840040,3840,114728,148134,GB,GB
167508,1700797200,1700823420,26220,2365,31348,HU,BG
70111,1699864620,1699877280,12660,2768,177292,IT,IT
111516,1699033440,1699037880,4440,164333,139551,GB,GB
109853,1700860740,1700865960,5220,50628,153672,GB,GB
136341,1699391820,1699396680,4860,4979,7143,NL,NL
102532,1700672040,1700688540,16500,164906,147253,AT,AT
3439,1699307220,1699341420,34200,3560,176915,TR,TR
56814,1699403880,1699407480,3600,188029,35527,GB,GB
142050,1700516580,1700520540,3960,36240,182847,NL,NL
103953,1700050500,1700080200,29700,154203,185584,TR,TR
102112,1699984980,1700017380,32400,108764,190425,TR,TR
160189,1700080860,1700086260,5400,77852,78701,GB,GB
15013,1699755720,1699765320,9600,63622,75763,PT,PT
169629,1699120200,1699155900,35700,150106,69684,TR,TR
24531,1699408740,1699444260,35520,77288,83767,MX,US
26567,1699379880,1699401240,21360,27731,119595,MD,RO
27526,1699833600,1699846500,12900,65891,193253,PT,PT
111680,1699987620,1700019060,31440,119462,170514,TR,TR
98521,1699223100,1699233300,10200,155330,180486,IT,IT
48540,1699760580,1699775220,14640,127646,15432,CZ,CZ
30721,1699268640,1699273620,4980,4719,73240,GB,GB
50885,1699094160,1699098480,4320,136785,118939,GB,GB
194637,1699018920,1699029540,10620,92688,38580,PT,PT
39093,1699189260,1699212060,22800,134917,188905,DK,SE
198455,1698827580,1698840960,13380,106648,9954,US,US
11454,1699723620,1699727220,3600,115051,184094,GB,GB
188339,1699786560,1699791780,5220,58076,98384,GB,GB
123063,1699864920,1699868520,3600,76716,16265,GB,GB
161741,1699600320,1699633260,32940,73842,188598,TR,TR
153522,1699204260,1699214340,10080,146050,100330,IT,IT
40011,1699980420,1699984020,3600,170240,68339,GB,GB
55605,1700164680,1700195220,30540,153004,186762,TR,TR
109493,1699893720,1699911420,17700,101194,24233,SE,SE
137197,1700767200,1700784960,17760,187696,85089,CZ,DE
119500,1699527540,1699560960,33420,116348,151989,TR,TR
3216,1700756820,1700769120,12300,168429,138040,IT,IT
65367,1699047060,1699082640,35580,50395,88490,TR,TR
98979,1700224200,1700232960,8760,39370,133735,IT,IT
7159,1700089320,1700098500,9180,158985,71247,IT,IT
116681,1699627860,1699632180,4320,176848,21834,NL,NL
21229,1700805360,1700838000,32640,121925,39709,MX,MX
57259,1700352360,1700382540,30180,179555,7145,TR,TR
87417,1700801640,1700832660,31020,107955,75088,TR,TR
40855,1700291100,1700306460,15360,126402,115058,CZ,AT
166768,1699955400,1699991700,36300,147146,187168,MX,MX
41845,1698882120,1698908160,26040,69604,124781,RO,RO
118220,1700680500,1700708880,28380,144388,140807,HU,DE
39592,1699310580,1699329960,19380,159121,192707,FR,FR
8442,1699813200,1699847220,34020,161677,112741,TR,TR
109300,1700262420,1700296320,33900,132142,117265,MX,US
57602,1699496040,1699504080,8040,186640,112322,FI,EE
40843,1699086780,1699120620,33840,139545,84742,TR,BG
134072,1699348380,1699359960,11580,63908,166642,PT,PT
138409,1699883340,1699894980,11640,163777,92650,IT,IT
11642,1700050140,1700086020,35880,58298,99699,TR,TR
118877,1698918660,1698949620,30960,149643,110019,TR,TR
76084,1699267140,1699296300,29160,22966,9781,TR,TR
4017,1699995480,1700029920,34440,192936,77383,TR,TR
11749,1698990420,1699008120,17700,191834,90814,FR,FR
182535,1700504460,1700508660,4200,3892,71671,GB,GB
121419,1700019480,1700051940,32460,181086,170634,TR,TR
25161,1699919880,1699933860,13980,129908,19348,US,US
105831,1698847080,1698864540,17460,112315,68435,US,US
181868,1698797940,1698827040,29100,129437,165256,TR,TR
181928,1700176020,1700210160,34140,150762,30175,TR,TR
15862,1700855280,1700865120,9840,90468,9634,IT,IT
23341,1699641060,1699672500,31440,49921,59934,TR,TR
16360,1699299780,1699303380,3600,85077,67840,NL,NL
47338,1699360500,1699364100,3600,194407,14982,NL,NL
105061,1699457100,1699492020,34920,6041,189251,TR,TR
88126,1699924560,1699937400,12840,80374,67815,US,US
38048,1700410620,1700432520,21900,175080,189307,PL,DE
79460,1699602120,1699636440,34320,140586,43893,TR,TR
125655,1699433220,1699450620,17400,165190,40304,US,US
43678,1699274640,1699306020,31380,175284,51356,TR,TR
61714,1700340300,1700343900,3600,64155,171745,GB,GB
16770,1699568700,1699574880,6180,83197,109644,GB,GB
95058,1698950160,1698962700,12540,163727,115696,HR,BA
20183,1699118220,1699149060,30840,58737,72817,TR,TR
163547,1698901020,1698918000,16980,7031,29045,RS,RS
153435,1699907460,1699940700,33240,115587,34369,TR,TR
25752,1699071780,1699084440,12660,71918,194165,IT,IT
55185,1700692320,1700722380,30060,19460,183829,TR,TR
3647,1699308900,1699326000,17100,103957,155610,US,US
125425,1699954020,1699957620,3600,55524,6872,GB,GB
193323,1700571180,1700602140,30960,141703,175005,TR,TR
121331,1699147980,1699177680,29700,109470,128674,TR,TR
105269,1699954020,1699964160,10140,46789,137775,IT,IT
153970,1699187340,1699198380,11040,45317,138814,AT,AT
93786,1700415600,1700425320,9720,92393,130563,IT,IT
190782,1700413980,1700427480,13500,15831,123917,US,US
89857,1699482240,1699520100,37860,31627,163078,MX,MX
174064,1700169000,1700172600,3600,25569,87639,NL,NL
187535,1700635440,1700648220,12780,170409,145222,IT,IT
7101,1699581420,1699597200,15780,40839,58609,CZ,CZ
199796,1700283600,1700297640,14040,82375,134920,CZ,UA
92010,1700565420,1700577600,12180,139580,18554,AT,AT
120803,1700223120,1700259060,35940,70983,191965,TR,TR
124556,1698911820,1698915420,3600,59007,102320,NL,NL
118778,1700317380,1700337900,20520,16453,59871,FR,CZ
130361,1699183140,1699196580,13440,109647,161648,IT,DE
16823,1700045760,1700056500,10740,158278,23073,IT,IT
92839,1699424280,1699449780,25500,100307,62351,DE,AT
192852,1699751640,1699764540,12900,123516,168039,PT,PT
143110,1699600380,1699615020,14640,87007,58450,US,US
144867,1700092980,1700130000,37020,199585,36944,MX,MX
130033,1699219500,1699252680,33180,151767,59365,TR,TR
177890,1699544460,1699578360,33900,77545,20252,TR,TR
69078,1700211120,1700244360,33240,133050,75115,MX,MX
33138,1699037400,1699041420,4020,156542,148083,GB,GB
144671,1700253000,1700256600,3600,103482,106100,GB,GB
97529,1699774740,1699778820,4080,21054,1910,GB,GB
49395,1699253880,1699283880,30000,37185,172838,TR,TR
196513,1700392740,1700419680,26940,118909,150105,PL,PL
119539,1700794500,1700799900,5400,96110,19897,GB,GB
192485,1699494960,1699498560,3600,157034,11933,GB,GB
154357,1698952620,1698987420,34800,103736,103313,TR,TR
143385,1700148660,1700163960,15300,2579,90483,US,US
107922,1699360080,1699375920,15840,84431,112495,US,US
67860,1699645500,1699659660,14160,82079,74896,IT,IT
23379,1699939800,1699974240,34440,48687,41430,TR,TR
29546,1698886260,1698925380,39120,169480,94078,MX,MX
194958,1699423800,1699433880,10080,12476,181789,IT,IT
66609,1700190060,1700207760,17700,28489,104963,US,US
13574,1700182080,1700216040,33960,79251,99410,TR,TR
73958,1700244780,1700256180,11400,105291,131767,SK,AT
56058,1699957740,1699970640,12900,171991,39209,US,US
112491,1700344080,1700355360,11280,90955,86567,CA,CA
173256,1700659380,1700669100,9720,186617,38407,IT,IT
56194,1699332060,1699336260,4200,181692,199359,AD,FR
108768,1699862820,1699891380,28560,65336,92416,DE,DE
141303,1699561140,1699574340,13200,87860,177669,US,US
59472,1700559240,1700585940,26700,34638,145397,BA,HR
154769,1699048920,1699061760,12840,59694,144651,US,US
155658,1700729280,1700732880,3600,148711,63036,GB,GB
57663,1700271180,1700287020,15840,143621,186599,SE,SE
179472,1700846340,1700861100,14760,187348,112753,US,US
419,1699594500,1699628160,33660,34119,42745,TR,TR
35349,1699910760,1699914360,3600,113006,96235,NL,NL
2407,1700725200,1700730240,5040,4169,141802,NL,NL
183627,1699034760,1699058400,23640,113252,21599,DK,DK
119033,1700485200,1700518020,32820,150712,105713,TR,TR
102260,1698917520,1698948900,31380,158317,15566,TR,TR
20970,1699720620,1699724220,3600,170923,95843,NL,NL
63451,1700227920,1700244960,17040,53176,124917,US,US
172758,1698850320,1698876900,26580,10374,153869,RO,RO
31390,1700859420,1700863020,3600,44380,162728,GB,GB
3539,1700817300,1700825400,8100,24075,30323,PT,PT
121893,1699151880,1699165020,13140,165796,114471,IT,IT
11827,1698940320,1698943920,3600,121551,93017,GB,GB
183347,1699664880,1699697100,32220,50257,183228,TR,TR
135211,1699612740,1699637400,24660,115967,73000,BR,BR
168395,1699779060,1699814460,35400,196174,40411,TR,TR
162918,1699612560,1699668240,55680,58489,192821,BG,DE
39275,1699589520,1699593120,3600,137409,164258,NL,NL
17992,1699110240,1699126680,16440,72319,57058,US,US
193097,1700659980,1700695140,35160,10815,334,TR,TR
173568,1700331480,1700364240,32760,22117,13678,TR,TR
109359,1698850800,1698873960,23160,115927,113271,RO,RO
148159,1699656120,1699687920,31800,78728,155758,TR,TR
9838,1699714860,1699730880,16020,171739,10817,CZ,CZ
83210,1700845020,1700867880,22860,191624,4085,MD,RO
180414,1698928920,1698934380,5460,198352,105801,GB,GB
88511,1699311300,1699318560,7260,54787,92345,HR,HR
10220,1700595420,1700623980,28560,5243,136706,BA,HR
181045,1699812420,1699825320,12900,72256,138133,PT,PT
43011,1699248360,1699254840,6480,78039,35365,NL,NL
140672,1699220760,1699255020,34260,61423,42121,TR,TR
18973,1700478060,1700494320,16260,25342,64204,US,US
179758,1698849060,1698884040,34980,26220,162219,TR,TR
161709,1700451360,1700456280,4920,6874,137814,NL,NL
91620,1698939540,1698952680,13140,85510,143493,AT,CZ
2622,1700514300,1700520900,6600,186248,164653,GB,GB
172292,1699971240,1699998360,27120,2821,104187,BR,BR
56764,1699160040,1699173780,13740,74529,782,RS,ME
12316,1700362320,1700390520,28200,12582,86750,DE,DE
139667,1698997200,1699031520,34320,118316,43261,TR,TR
173137,1700308860,1700348100,39240,98023,33582,MX,MX
142111,1699691460,1699700520,9060,100197,61246,HR,HR
174815,1699163880,1699181280,17400,187330,112341,US,US
131628,1699438500,1699472220,33720,111860,145344,TR,TR
7548,1699151700,1699180920,29220,172316,192232,TR,TR
61971,1699283940,1699315980,32040,71212,43689,TR,TR
33593,1699668960,1699684620,15660,109991,161285,AT,AT
199766,1700659080,1700673780,14700,111473,78499,FR,FR
46394,1700112660,1700145600,32940,164239,147949,TR,TR
54328,1700038140,1700070000,31860,115145,179708,TR,TR
75017,1699044840,1699081920,37080,31576,95831,MX,MX
1820,1699087680,1699091280,3600,195121,21528,GB,GB
60359,1699212060,1699243140,31080,108384,69607,TR,TR
91797,1700144640,1700151360,6720,11158,5926,GB,GB
33153,1699454640,1699488960,34320,112057,106899,TR,TR
15649,1700042520,1700076120,33600,185835,129873,TR,TR
72300,1700109120,1700115120,6000,75810,144612,GB,GB
61464,1700860020,1700868240,8220,36771,59434,ES,ES
61151,1700371200,1700385720,14520,37409,87178,US,US
174140,1698899400,1698903240,3840,112130,121762,GB,GB
195944,1700728680,1700736060,7380,94176,49638,HR,HR
139833,1698950280,1698985080,34800,160374,162756,TR,TR
23811,1700720520,1700728260,7740,7616,103444,IT,IT
83934,1700759940,1700795820,35880,122810,3678,TR,TR
166872,1699560660,1699591560,30900,16138,184841,TR,TR
193646,1700019780,1700028780,9000,46897,15778,HR,RS
78279,1699176300,1699188360,12060,100079,22871,US,US
157891,1700492700,1700525760,33060,177235,122474,MX,MX
124853,1699038420,1699048200,9780,140684,181596,IT,IT
121800,1699274760,1699309980,35220,198189,162623,TR,TR
84636,1700459100,1700493780,34680,183626,150817,TR,TR
41077,1699712640,1699721040,8400,134198,76639,IT,IT
98754,1700766900,1700779440,12540,100109,199194,US,US
7460,1700629800,1700653500,23700,120936,121790,DE,AT
48364,1700342940,1700349660,6720,166275,178633,NL,NL
8170,1700860260,1700874180,13920,195719,89945,US,US
68662,1699721160,1699734180,13020,16900,93961,IT,IT
48995,1699734180,1699752060,17880,179992,48035,CZ,CZ
185439,1699479300,1699483140,3840,176114,26306,NL,FR
162674,1699327500,1699363020,35520,197346,137448,TR,TR
117655,1699078440,1699082040,3600,186756,17690,NL,NL
133124,1700720640,1700755320,34680,72189,28046,TR,TR
116324,1700612820,1700625600,12780,18251,191408,US,US
65307,1700573820,1700583060,9240,16485,82374,IT,IT
136212,1699810380,1699844520,34140,198986,168929,TR,TR
132254,1699457700,1699474740,17040,134813,69529,RS,RS
123027,1700142780,1700155500,12720,104596,115499,PT,FR
12904,1699930860,1699962840,31980,129230,180610,TR,TR
166185,1699871940,1699903800,31860,47933,140092,TR,TR
180531,1699860300,1699884300,24000,58352,36960,PL,PL
113718,1699177560,1699181160,3600,97602,75477,NL,NL
100657,1700595720,1700625360,29640,82387,83479,TR,TR
98160,1700492460,1700499960,7500,86150,172601,AD,FR
149925,1699930200,1699954200,24000,111070,83145,RO,RO
75429,1700228580,1700254740,26160,163325,111225,DE,SE
36661,1700860800,1700882220,21420,129410,116995,DK,SE
70271,1700136600,1700155800,19200,153535,152644,FR,FR
146989,1700114520,1700118540,4020,76558,35595,NL,NL
103125,1699889580,1699902060,12480,138631,38673,US,US
179926,1699744980,1699777740,32760,68313,145124,TR,TR
167245,1699201020,1699234800,33780,97733,31464,TR,TR
154670,1699657740,1699686720,28980,196785,37993,TR,TR
150227,1699588620,1699615620,27000,195891,108653,DE,CZ
171255,1700344320,1700356500,12180,74993,31951,IT,IT
147188,1700382900,1700417340,34440,10252,82380,TR,TR
3331,1700035620,1700040120,4500,169747,76620,NL,NL
84100,1699502700,1699507440,4740,156813,22646,GB,GB
104127,1700114340,1700129580,15240,124431,79375,AT,AT
130868,1698984660,1699000860,16200,59230,166508,FR,FR
195942,1700098200,1700133600,35400,73912,64540,TR,TR
32710,1700717280,1700746680,29400,171292,188531,TR,TR
179749,1698823440,1698833100,9660,71753,163977,SK,IT
183023,1699911300,1699946280,34980,7822,96658,TR,TR
37207,1699983840,1700014080,30240,115871,119520,TR,TR
83441,1699554840,1699587300,32460,186428,61160,TR,TR
106338,1700800080,1700830200,30120,108430,4594,TR,TR
76250,1700186520,1700198940,12420,129930,87944,IT,IT
50208,1699176180,1699190820,14640,66203,91228,RS,DE
12544,1700799840,1700833320,33480,41016,4488,TR,TR
133352,1700590980,1700613060,22080,93341,80984,DE,DE
98689,1700322480,1700378340,55860,193874,117460,UA,PL
124739,1700483040,1700486640,3600,149877,19557,NL,NL
78556,1699670340,1699687020,16680,135498,72527,US,US
107905,1699030860,1699055160,24300,140160,128486,BR,BR
154711,1699441620,1699458240,16620,149098,50022,US,US
149292,1700671500,1700677980,6480,123063,7762,GB,GB
75808,1699527420,1699562100,34680,116808,112916,TR,TR
40548,1700571720,1700605740,34020,127255,84071,TR,TR
109007,1700696760,1700718840,22080,84831,130712,CH,DE
12771,1698926580,1698937500,10920,126542,52347,IT,IT
187118,1700766480,1700798820,32340,73294,53563,BA,AT
57154,1698924120,1698962460,38340,162530,10357,MX,MX
32055,1699572720,1699605780,33060,154950,71873,TR,TR
198981,1699653300,1699669980,16680,3636,197823,BE,NL
130147,1699048500,1699067640,19140,115025,140814,DK,DE
114050,1700203020,1700230980,27960,39673,128380,RO,RO
189407,1699403340,1699417020,13680,163051,158157,IT,IT
77680,1700333580,1700348460,14880,85664,167107,US,US
36311,1700733900,1700737500,3600,113504,23829,GB,GB
184933,1699362780,1699372380,9600,130079,137125,IT,IT
91830,1699489920,1699493520,3600,85795,43294,GB,GB
179338,1700050860,1700084700,33840,152653,171433,TR,TR
81101,1700672340,1700676300,3960,166388,131561,NL,NL
197808,1700451120,1700483280,32160,94389,89937,TR,TR
148048,1698955200,1698969480,14280,130256,60683,IT,IT
186704,1699272840,1699288680,15840,65942,168004,US,US
21866,1698909960,1698939960,30000,7252,60530,TR,TR
165185,1699754160,1699766760,12600,158091,109770,US,US
101194,1700672220,1700694600,22380,103615,149482,DE,AT
6546,1699858500,1699869900,11400,69175,91383,CZ,CZ
69388,1699451940,1699455540,3600,72171,86560,GB,GB
20764,1699337100,1699368720,31620,114516,85972,TR,TR
119861,1699424400,1699443060,18660,44274,31624,DK,DE
138869,1700186520,1700217900,31380,154856,46034,TR,TR
116855,1698908580,1698917340,8760,183033,124891,IT,IT
147836,1699317000,1699321920,4920,90800,57576,NL,NL
6559,1699123740,1699151760,28020,118540,83235,DE,AT
109662,1700190780,1700218080,27300,171939,19899,DE,AT
134331,1698902280,1698937560,35280,79027,26683,TR,TR
36853,1700850600,1700863980,13380,135576,6559,RS,SI
136974,1699285260,1699292640,7380,24098,121534,IT,IT
148101,1700087940,1700101980,14040,59486,100427,PT,PT
165354,1700289780,1700295660,5880,8249,188851,NL,NL
126496,1700628000,1700662560,34560,67962,82781,MX,MX
54250,1699836240,1699840080,3840,132977,102916,EE,EE
40020,1700280660,1700284260,3600,108185,141984,NL,NL
63567,1700190300,1700205540,15240,43174,153150,US,US
132725,1699310700,1699314300,3600,199550,187830,NL,NL
116274,1699633860,1699645020,11160,149075,57158,US,US
6581,1700226660,1700238840,12180,9596,194162,US,US
159483,1700145360,1700180700,35340,198126,170824,TR,TR
87593,1699628760,1699636200,7440,18934,40040,HR,HR
70475,1700782860,1700800020,17160,42378,173102,FR,FR
74014,1699633020,1699649400,16380,22424,163011,US,CA
94935,1699266840,1699297320,30480,169097,55122,TR,TR
139227,1700735400,1700767980,32580,100927,195131,TR,TR
83004,1698983460,1699015260,31800,24666,103826,TR,TR
128234,1699607520,1699622040,14520,22295,138296,US,US
72581,1699017480,1699031280,13800,27005,63724,US,US
30258,1700143380,1700149800,6420,129298,46022,NL,NL
164462,1699249800,1699285500,35700,11336,104020,TR,TR
48312,1700316360,1700322360,6000,71202,130093,GB,GB
123846,1699928280,1699931880,3600,7724,69037,GB,GB
116524,1699810020,1699838880,28860,178521,24431,TR,TR
139658,1699463640,1699474680,11040,118757,65972,US,US
19612,1699090680,1699115580,24900,11176,26124,RO,RO
63513,1699335120,1699338720,3600,162614,109280,NL,NL
120487,1698978300,1698996060,17760,4014,150558,CA,US
185519,1699887480,1699891080,3600,143029,99399,GB,GB
96426,1699091040,1699125780,34740,68409,29001,TR,TR
88929,1699380360,1699395420,15060,64162,3982,RS,RS
18569,1700423940,1700458860,34920,64321,50727,TR,TR
4423,1698798300,1698810360,12060,151955,176714,RS,DE
105672,1700141520,1700148120,6600,12310,6097,GB,GB
108415,1698973140,1698986460,13320,58494,66564,HR,BA
81422,1699649820,1699673340,23520,44836,96532,PL,PL
117343,1699693680,1699708560,14880,100853,120875,US,MX
3530,1699962840,1699977540,14700,3522,9833,US,US
130860,1699179540,1699195560,16020,77510,107661,US,US
120852,1698887760,1698894420,6660,65192,134290,GB,GB
146369,1700350680,1700365260,14580,85837,41294,US,US
48005,1700194680,1700210640,15960,70871,96146,US,US
21497,1699910160,1699920720,10560,185664,141628,IT,IT
181207,1699124040,1699131960,7920,4105,182660,IT,IT
151066,1700661660,1700672700,11040,82206,189490,US,US
110241,1699831680,1699861920,30240,174838,166644,TR,TR
177928,1700368140,1700397420,29280,58861,157378,TR,TR
102490,1699962900,1699993620,30720,111649,67983,TR,TR
166949,1700422620,1700433720,11100,160203,173741,IT,IT
118560,1699023480,1699033020,9540,82925,172516,IT,DE
164050,1700189100,1700202120,13020,108624,130891,CA,CA
109898,1699182960,1699186560,3600,98674,192452,GB,GB
7503,1699737300,1699757760,20460,11342,30871,FR,DE
193587,1698854100,1698887880,33780,83504,165824,TR,TR
96547,1698935040,1698942780,7740,96983,147612,IT,IT
65507,1700263200,1700280480,17280,26274,13070,US,US
173712,1700338560,1700351580,13020,148554,7722,IT,IT
175662,1700225640,1700229240,3600,55093,105403,NL,NL
20676,1699688400,1699702140,13740,152985,174350,IT,IT
4569,1699145760,1699149360,3600,132947,82942,NL,NL
172937,1700285460,1700315820,30360,99711,191191,TR,TR
81887,1698867180,1698883080,15900,135054,55925,FR,FR
133396,1699384080,1699403100,19020,137180,137902,FR,DE
72796,1700811120,1700841240,30120,109982,96693,TR,TR
197766,1699517280,1699523640,6360,122795,152298,GB,GB
133199,1699089840,1699112280,22440,135491,162890,DE,PL
35941,1700499120,1700527440,28320,15092,155483,DE,BE
94507,1700619900,1700623500,3600,69844,27835,NL,BE
183657,1698905040,1698916680,11640,40430,60782,IT,IT
43214,1700760120,1700774820,14700,74806,152549,FR,FR
169787,1699075140,1699105860,30720,167558,62985,TR,TR
42296,1699378200,1699403520,25320,114572,70866,HU,AT
92365,1699749780,1699780080,30300,87852,10205,TR,TR
120138,1699189740,1699222080,32340,117002,89685,TR,TR
88314,1699734240,1699748160,13920,66369,174902,HR,HR
52723,1700726880,1700758680,31800,129328,142762,TR,TR
23314,1699503900,1699543440,39540,115991,84290,MX,MX
38897,1699044780,1699074960,30180,100479,112854,TR,TR
163006,1699133640,1699139100,5460,33877,69517,GB,GB
141805,1699275540,1699284360,8820,1116,93492,ES,PT
89499,1700455140,1700458740,3600,12180,118622,GB,GB
139784,1699748100,1699754040,5940,81111,137566,GB,GB
55429,1699212960,1699248780,35820,49836,6819,TR,TR
197165,1700419740,1700452500,32760,59322,168179,TR,TR
192552,1699573980,1699609500,35520,150266,58125,TR,TR
144954,1700097240,1700109540,12300,50619,69745,IT,IT
181508,1700097720,1700110560,12840,14540,188195,US,US
102207,1700479140,1700490360,11220,50155,125320,HR,DE
18847,1700553960,1700583840,29880,40809,121866,TR,TR
123407,1699130700,1699154220,23520,1257,143313,RO,RO
131003,1699162620,1699174560,11940,29172,22193,PT,PT
35071,1700760540,1700773140,12600,141608,39675,US,US
197937,1700233020,1700250000,16980,62237,183380,US,US
133437,1699073220,1699096800,23580,51235,169803,PL,HU
168381,1698966240,1698984300,18060,157339,79826,BE,NL
19381,1699514280,1699528260,13980,37251,127731,US,US
181810,1698957780,1698970020,12240,80635,156152,PT,PT
9614,1699541820,1699572900,31080,95269,46504,TR,TR
18530,1699880460,1699888680,8220,162336,162494,IT,IT
198629,1700527440,1700533500,6060,144266,48862,NL,NL
108221,1699938300,1699942020,3720,148545,135488,EE,EE
184856,1700272200,1700301960,29760,137108,128345,TR,TR
130843,1700411100,1700440080,28980,158941,95172,TR,TR
58950,1700469120,1700473140,4020,1356,182006,GB,GB
49768,1700320380,1700351220,30840,112648,31658,TR,TR
81986,1699753740,1699788240,34500,54386,172183,TR,TR
29438,1699330680,1699390080,59400,73413,176939,UA,HU
136699,1699993440,1700027580,34140,101081,52706,TR,TR
77092,1699130280,1699145520,15240,51130,63099,FR,BA
25831,1699135080,1699168020,32940,3586,96066,TR,TR
153773,1699278300,1699310040,31740,62281,188050,TR,TR
18117,1700110020,1700124360,14340,18112,64686,US,US
34385,1699496640,1699527480,30840,94150,151949,TR,TR
195024,1700299740,1700335680,35940,50462,12865,TR,TR
47678,1700496300,1700529360,33060,142885,190755,TR,TR
52137,1699165980,1699169580,3600,199824,119405,NL,NL
133888,1700725680,1700747580,21900,130702,47270,NO,SE
122513,1698803280,1698835200,31920,84257,147210,TR,TR
100792,1699316760,1699350840,34080,74144,40865,TR,TR
13642,1699353000,1699384200,31200,166860,75875,TR,TR
86677,1700008620,1700020620,12000,89149,152667,US,US
4844,1699825620,1699829220,3600,32018,105896,GB,GB
173155,1700116800,1700147040,30240,75673,12047,TR,TR
82201,1699558800,1699590780,31980,177986,19215,TR,TR
45946,1700266680,1700286960,20280,45821,153159,FR,FR
150153,1700103000,1700133000,30000,44593,110151,TR,TR
181185,1700128320,1700158860,30540,15429,149785,TR,TR
180747,1700357640,1700388240,30600,137791,179835,TR,TR
4609,1699496760,1699502820,6060,51754,128422,NL,NL
93071,1698893820,1698916320,22500,87916,143367,PL,PL
132305,1700653380,1700659740,6360,30040,7811,GB,GB
163950,1699236180,1699260420,24240,100636,161772,PL,PL
81236,1699731600,1699744080,12480,24383,91732,US,US
146203,1700778720,1700786100,7380,108504,120392,IT,FR
5220,1698861600,1698895680,34080,112016,138718,TR,TR
18539,1700371020,1700377740,6720,147995,46588,NL,NL
157390,1700456280,1700474100,17820,165916,45297,RS,SI
75937,1700703600,1700709060,5460,29921,191189,GB,GB
137285,1698852060,1698864360,12300,158790,28513,IT,IT
26601,1699196220,1699209720,13500,111977,173749,AT,AT
114120,1699272900,1699302960,30060,86892,124290,TR,TR
188390,1699782240,1699799220,16980,174391,91450,RS,AT
100316,1699215480,1699235400,19920,18012,95760,FR,ES
111047,1700250840,1700305320,54480,71041,49799,BG,RO
24210,1700379540,1700409540,30000,189965,138824,TR,TR
34442,1699097520,1699110300,12780,183951,126228,US,US
56089,1699914360,1699934400,20040,112486,29700,FR,FR
8998,1699020660,1699048380,27720,164504,169669,DE,DE
88421,1699288260,1699309860,21600,58806,32404,PL,DE
183915,1700049060,1700079420,30360,154171,175910,TR,TR
188176,1700848740,1700883900,35160,24782,6524,TR,TR
105399,1699735860,1699751760,15900,149873,174596,US,US
100451,1700744100,1700756460,12360,19421,145164,US,US
192859,1699454220,1699474680,20460,164897,99159,FR,FR
98602,1699653480,1699666860,13380,28573,46275,US,CA
197355,1700045880,1700101800,55920,179543,113448,BG,DE
76348,1699038120,1699041720,3600,66271,162622,GB,DE
196272,1699610460,1699645980,35520,112753,59609,TR,TR
30524,1698905580,1698919440,13860,89398,192230,HR,IT
176855,1699052700,1699064160,11460,118657,4608,US,US
24375,1698795720,1698815460,19740,35644,74927,FR,FR
128338,1700153400,1700175060,21660,12555,196678,DE,DE
23620,1700151960,1700155560,3600,131601,5667,NL,NL
15287,1700387940,1700421060,33120,156816,191501,TR,TR
80619,1699634760,1699652160,17400,87137,158333,US,US
147869,1700461680,1700495400,33720,96158,68308,TR,TR
135972,1699332000,1699339260,7260,39801,17489,IT,IT
9472,1700204940,1700227920,22980,95226,122370,DE,IT
162810,1699872180,1699903260,31080,18000,115172,TR,TR
50340,1698937980,1698941580,3600,31623,137612,GB,GB
41772,1698800940,1698827160,26220,88030,18477,DE,CZ
190814,1698918060,1698952500,34440,114355,130403,TR,TR
131272,1700350920,1700354520,3600,141690,166385,NL,NL
148702,1699296720,1699300320,3600,8947,191212,GB,GB
65545,1700462820,1700473680,10860,180481,194383,PT,PT
5180,1699747920,1699751700,3780,160083,11505,GB,GB
62353,1700378760,1700397360,18600,60118,187087,FR,FR
170547,1699097640,1699131000,33360,1515,51922,TR,TR
190979,1700035620,1700065800,30180,124803,126089,TR,TR
39527,1699767900,1699771500,3600,190531,52467,GB,GB
184796,1700016540,1700024580,8040,39846,27466,ES,AD
17770,1699972260,1699979160,6900,113491,155652,GB,GB
174712,1700641740,1700670840,29100,22829,118003,TR,TR
139441,1699797660,1699810800,13140,79834,126074,HR,HR
129889,1700318940,1700351160,32220,164457,154173,TR,TR
122577,1699528740,1699551480,22740,180111,91639,PL,PL
155368,1699044420,1699059780,15360,195850,166986,CZ,HU
123418,1699156620,1699183740,27120,196471,171477,DE,DE
42551,1699484640,1699497600,12960,115462,34591,AT,SK
18631,1700106480,1700110080,3600,127975,64734,NL,NL
47052,1699324260,1699359540,35280,140676,9939,TR,TR
187150,1699784640,1699802520,17880,23016,98597,US,US
60439,1700296800,1700301780,4980,155519,197106,GB,GB
10501,1699692300,1699722720,30420,132351,173490,TR,TR
138010,1700432640,1700467620,34980,73541,41999,TR,TR
124065,1699528620,1699532580,3960,136819,142686,GB,GB
187242,1699740180,1699771920,31740,96620,21204,TR,TR
133578,1698885120,1698901740,16620,141411,100940,FR,FR
91551,1699814640,1699843800,29160,120286,198044,TR,TR
25439,1699026360,1699043700,17340,149428,142443,US,US
2711,1699182900,1699192920,10020,192088,54285,HR,HR
33963,1700159220,1700165700,6480,134251,110323,GB,GB
148827,1699314240,1699317960,3720,54052,84103,NL,NL
163082,1700157840,1700183400,25560,121397,838,DE,AT
14986,1699225440,1699231260,5820,7328,157498,NL,NL
193168,1699079580,1699092060,12480,31024,48108,US,US
39323,1700861160,1700894280,33120,87222,48840,TR,TR
84301,1700576400,1700580000,3600,51057,11875,NL,NL
117810,1700449860,1700480280,30420,33554,182370,TR,TR
6197,1698988800,1698994620,5820,144429,188185,GB,GB
196078,1699788000,1699797780,9780,27815,26948,IT,IT
23889,1700075100,1700093700,18600,120191,38662,BE,FR
45863,1698965340,1698969840,4500,84792,93322,GB,GB
119379,1699490220,1699525380,35160,57254,160764,TR,TR
99801,1700137560,1700152260,14700,176896,59455,US,US
118345,1700176320,1700208600,32280,93410,86287,TR,TR
42922,1700381340,1700386800,5460,197455,36133,GB,GB
88959,1698869520,1698904320,34800,63494,105881,TR,TR
61514,1699490460,1699501320,10860,59327,150431,US,US
29700,1700607480,1700621220,13740,103197,2073,US,US
4476,1700655360,1700671020,15660,121352,40415,US,US
74977,1700593860,1700601600,7740,123827,164755,IT,IT
134393,1700107560,1700133780,26220,97906,50961,DE,SE
119009,1699103820,1699112340,8520,87499,14470,ES,ES
187067,1699928940,1699954080,25140,59016,16037,DE,DE
162707,1698870600,1698901920,31320,126974,166507,TR,TR
178457,1700637780,1700641380,3600,52763,72690,NL,NL
6428,1700602320,1700605920,3600,167036,7732,GB,GB
116039,1699655220,1699685100,29880,70858,47435,TR,TR
5886,1699684440,1699705500,21060,106310,88327,IN,IN
70307,1698990660,1699022640,31980,86620,90586,TR,TR
71374,1699053840,1699086300,32460,27184,51985,MX,MX
10119,1699469820,1699488360,18540,129688,12859,FR,DE
21168,1699761120,1699764720,3600,148347,72758,NL,NL
52317,1699871400,1699904340,32940,27408,117471,TR,TR
21789,1699915620,1699947420,31800,105171,99795,TR,TR
194569,1699147860,1699163520,15660,149111,22833,US,US
16593,1700543700,1700554500,10800,83839,1286,RS,ME
180218,1699786800,1699824240,37440,154647,69531,MX,MX
131499,1699476360,1699526820,50460,156220,82352,BG,TR
142869,1699235880,1699255740,19860,65517,196894,FR,ES
37900,1700301960,1700305560,3600,121165,177254,GB,GB
138599,1698913740,1698917340,3600,119531,117262,NL,NL
44700,1699134300,1699137900,3600,29521,19370,NL,NL
175503,1700098560,1700102160,3600,151681,89146,NL,NL
197571,1699233420,1699259760,26340,45297,94385,BR,BR
106594,1698799500,1698812040,12540,45355,80649,US,US
169289,1699915140,1699926780,11640,166976,176120,IT,IT
134692,1699047180,1699050780,3600,145453,167074,NL,DE
147009,1699710720,1699723740,13020,4180,93297,RS,RS
60754,1699773060,1699790460,17400,75934,89455,US,US
77882,1699807080,1699838880,31800,135061,26922,TR,TR
118379,1699845240,1699851780,6540,170467,168219,NL,DE
81248,1699386600,1699391100,4500,58296,60637,GB,GB
155197,1700237520,1700243220,5700,108114,109355,AD,ES
39931,1700843340,1700877060,33720,70803,161090,TR,TR
73042,1699935360,1699938960,3600,74490,185482,GB,GB
12114,1700542800,1700573700,30900,135791,19742,TR,TR
153087,1699179120,1699195260,16140,174460,187344,RS,HR
169320,1699991280,1700021820,30540,88271,99253,TR,TR
50593,1698964260,1698986340,22080,57275,90953,DE,HU
114798,1698864300,1698895980,31680,96724,88636,TR,TR
45467,1699865220,1699868820,3600,66322,180659,NL,NL
17858,1700050200,1700079420,29220,110089,174196,TR,TR
184845,1698904080,1698938820,34740,135436,29709,TR,TR
104628,1699901880,1699930200,28320,67279,50607,DE,PL
107027,1699454940,1699458540,3600,157422,189017,GB,GB
196922,1699896300,1699899900,3600,151720,53628,GB,GB
133418,1699494000,1699506120,12120,95339,77255,US,US
21452,1699659720,1699671660,11940,79766,26776,IT,IT
63351,1699553460,1699584180,30720,66314,198372,TR,TR
44713,1700031180,1700049780,18600,6847,129557,FR,ES
92065,1699246740,1699280220,33480,121846,130135,TR,TR
155305,1700625660,1700643060,17400,73392,48090,US,US
28655,1700824200,1700837460,13260,141487,62326,US,US
143382,1700799960,1700826000,26040,199412,187229,DE,DE
46520,1700023080,1700026680,3600,7206,133226,NL,NL
61504,1699956360,1699968960,12600,99239,2107,ES,AD
71243,1698952980,1698985620,32640,6270,88997,TR,TR
5279,1700454960,1700492040,37080,107787,187273,MX,US
171894,1699087740,1699104300,16560,191873,112416,US,US
65379,1700848440,1700862540,14100,1277,196000,HR,HR
43021,1700221620,1700254260,32640,93006,71054,TR,TR
103895,1700848200,1700881920,33720,79227,127954,TR,TR
13230,1700047800,1700051400,3600,95856,137798,NL,NL
27082,1699245060,1699270860,25800,31119,51399,DE,DE
61596,1700633460,1700641920,8460,171059,92770,EE,EE
174545,1700135820,1700151540,15720,82661,181432,AT,DE
7979,1700361300,1700393100,31800,30182,121159,TR,TR
57446,1699867620,1699897020,29400,69980,79413,TR,TR
54366,1698868440,1698903600,35160,52462,8065,TR,TR
130838,1700163840,1700195280,31440,169724,178359,TR,TR
139039,1700050080,1700063400,13320,145408,73422,IT,IT
147782,1698893880,1698923340,29460,95448,88330,TR,TR
81065,1699022640,1699054800,32160,4760,147568,TR,TR
128368,1700781720,1700810580,28860,85677,189118,TR,TR
38815,1699599780,1699605900,6120,148738,120213,GB,GB
32725,1699977240,1700010720,33480,167049,114937,TR,TR
75767,1700161500,1700186220,24720,32173,82663,ME,RS
196230,1700782440,1700805240,22800,186767,49725,CH,DE
85921,1699670160,1699704360,34200,79958,15246,TR,TR
148803,1698973020,1698984900,11880,162576,157845,CA,US
155673,1700026200,1700029800,3600,67547,87581,GB,GB
14397,1699174860,1699209780,34920,196873,116796,TR,TR
182328,1699892520,1699903620,11100,198029,162918,US,US
69437,1699000200,1699011840,11640,82912,2594,US,US
92081,1700712420,1700720760,8340,24538,148891,ES,AD
25976,1698860940,1698894180,33240,29711,147270,TR,TR
133512,1700448660,1700452260,3600,109981,105909,GB,GB
135034,1700365020,1700395260,30240,45714,148506,TR,TR
195131,1699219680,1699234860,15180,109921,40167,US,US
119376,1700454300,1700457900,3600,33090,17105,GB,GB
79617,1698859380,1698890700,31320,124573,128745,TR,TR
55702,1700749380,1700761320,11940,195508,163360,IT,IT
195594,1700510160,1700523780,13620,123249,115304,US,US
12331,1700214900,1700226480,11580,142392,56649,IT,IT
156178,1700212740,1700246880,34140,89071,144648,TR,TR
195862,1700040960,1700071080,30120,90525,8472,TR,TR
102710,1699529280,1699551840,22560,182086,41927,PL,DE
59256,1699831020,1699868700,37680,170489,46490,MX,MX
167060,1698937260,1698966240,28980,120848,167294,TR,TR
38344,1700633580,1700652900,19320,183170,44251,FR,RS
72131,1700747220,1700779680,32460,108951,58202,TR,TR
79322,1700193780,1700197380,3600,191258,112388,GB,GB
163441,1699887420,1699891200,3780,24671,27036,NL,NL
42019,1700213700,1700232900,19200,8782,160769,FR,BE
156002,1699590240,1699603620,13380,171057,145664,PT,PT
27833,1699546920,1699556640,9720,163337,56387,IT,IT
141542,1700410260,1700414220,3960,2656,58494,CL,CL
17551,1700369820,1700401140,31320,5069,149576,TR,TR
137547,1699947840,1699954740,6900,189171,85106,NL,NL
166641,1700853600,1700883660,30060,133746,48474,MK,RS
8615,1699875900,1699893600,17700,110154,114533,FR,FR
153902,1699898460,1699915800,17340,120134,5489,AT,SK
143995,1699612440,1699620960,8520,33973,186718,IT,IT
104136,1700289540,1700312880,23340,71425,108323,HU,CZ
37478,1698846180,1698881940,35760,87098,102197,TR,TR
23749,1700640360,1700645640,5280,139581,44745,NL,NL
112056,1699606500,1699623480,16980,126641,96602,BE,NL
20623,1699836300,1699890300,54000,42853,11437,BG,DE
94806,1700594940,1700626980,32040,182609,103202,TR,TR
187639,1700673660,1700687700,14040,98596,7198,US,US
52399,1699836060,1699839780,3720,109458,150573,NL,NL
195692,1700049300,1700063940,14640,108793,100413,US,CA
91000,1699949040,1699952640,3600,65500,1936,GB,GB
180405,1698970860,1698982740,11880,126450,60035,IT,IT
97018,1699911720,1699945860,34140,189166,63405,TR,TR
23481,1699089960,1699120980,31020,41452,163059,TR,TR
183119,1700263140,1700297340,34200,61363,125073,TR,TR
47041,1699827480,1699835820,8340,36052,28095,IT,IT
179417,1700752140,1700755740,3600,107140,170357,NL,NL
154514,1699535160,1699553280,18120,173792,25719,FR,FR
172613,1700286300,1700320800,34500,68143,65113,MX,MX
127687,1699762140,1699792200,30060,10338,166682,TR,TR
72762,1700770140,1700784360,14220,141273,106904,ES,ES
148402,1700231340,1700240460,9120,104670,9735,IT,IT
10837,1700321100,1700338500,17400,75808,173234,US,US
103607,1699783560,1699807200,23640,35262,95800,PL,IT
174795,1700608020,1700626500,18480,55448,16181,DK,RO
186789,1698958740,1698991500,32760,91235,122273,TR,TR
177978,1699492200,1699505400,13200,88692,196482,HR,HR
20858,1699716420,1699750500,34080,106530,74997,TR,TR
171873,1700738820,1700773020,34200,16962,166318,TR,TR
22059,1699753680,1699761960,8280,64754,158384,HR,HR
78364,1699479120,1699496760,17640,115962,168859,US,US
6326,1700398200,1700432940,34740,7789,154717,TR,TR
104582,1699941240,1699972800,31560,92228,159965,TR,TR
11381,1700247180,1700282100,34920,5352,126280,TR,TR
57229,1699103280,1699139220,35940,87267,2759,TR,TR
142718,1699471140,1699482060,10920,90488,169842,IT,IT
141082,1699755120,1699764360,9240,134747,79669,IT,IT
165171,1700238480,1700258580,20100,179818,106764,FR,FR
7060,1700737620,1700751000,13380,134078,40546,US,US
28312,1699954500,1699983600,29100,3807,26504,TR,TR
154591,1698987120,1699018380,31260,52210,89711,TR,TR
151953,1699432680,1699436280,3600,152797,166347,GB,GB
49292,1700216160,1700229660,13500,176888,5609,CZ,PL
110947,1698911100,1698941160,30060,128586,79995,TR,TR
194274,1699221660,1699256280,34620,111872,167776,TR,TR
189959,1700274540,1700284320,9780,48256,84122,HR,HR
130864,1700822460,1700832840,10380,143552,54574,PT,PT
107661,1699350960,1699354560,3600,138938,63013,GB,GB
87696,1699357320,1699384740,27420,64323,42424,DE,FR
191748,1700686920,1700695920,9000,97793,126969,ES,FR
35123,1700201640,1700214720,13080,29522,77657,US,US
151491,1699616700,1699634160,17460,22891,146863,US,US
103834,1700100720,1700123040,22320,97816,14845,PL,FR
2511,1698964860,1698974880,10020,25004,102887,HR,HR
32441,1699955700,1699979400,23700,35694,79125,RO,MD
194691,1699869660,1699890180,20520,98440,38100,BE,NL
182548,1699631760,1699635360,3600,3406,184713,GB,GB
55696,1699378680,1699392900,14220,126735,183747,IT,IT
75005,1700420700,1700433900,13200,71504,50263,IT,IT
116541,1700610840,1700639700,28860,170312,100247,TR,TR
163063,1700037960,1700042520,4560,150395,26466,EE,EE
27805,1700062260,1700076660,14400,138481,130121,US,US
145806,1700042220,1700046480,4260,144155,48210,GB,GB
129006,1700513760,1700536800,23040,17164,6688,BR,BR
17216,1699530720,1699541700,10980,36515,41736,HR,DE
191636,1700109720,1700115840,6120,82515,32405,GB,GB
143851,1700761920,1700770560,8640,88169,156786,PT,PT
45707,1698863220,1698880500,17280,127513,156242,US,US
159200,1699448340,1699460160,11820,32361,144370,US,US
81695,1700424660,1700460240,35580,126394,122195,TR,TR
145771,1699044960,1699048560,3600,146159,6093,NL,NL
90694,1700369760,1700380560,10800,176021,70790,HR,HR
122064,1698923820,1698932220,8400,34631,48751,ES,ES
155917,1699728840,1699756800,27960,97864,123953,DE,RS
124575,1699399500,1699425180,25680,50891,152826,BR,BR
172117,1700238900,1700242500,3600,199971,45620,GB,GB
8522,1699107720,1699129980,22260,128186,135598,DE,DE
131579,1700774880,1700782440,7560,186198,172497,EE,EE
141996,1699536840,1699568820,31980,142934,147921,TR,TR
140911,1698937380,1698968760,31380,111700,91547,TR,TR
140394,1700427420,1700457000,29580,5139,79219,TR,TR
173187,1699732920,1699756320,23400,160732,141146,PL,PL
176637,1700661120,1700675760,14640,121253,39672,FR,BE
176576,1699729920,1699733520,3600,34132,152322,GB,GB
143800,1700572200,1700607900,35700,62846,159227,TR,TR
23402,1699255680,1699285020,29340,161482,93598,TR,TR
182498,1700408580,1700418660,10080,23058,19218,HR,HR
40270,1699429620,1699463700,34080,7761,139348,TR,TR
23089,1700225460,1700246040,20580,169863,13842,FR,FR
142410,1699645500,1699659360,13860,138569,178737,US,US
68940,1698960780,1698977040,16260,121141,54439,RS,RS
149749,1699579260,1699614060,34800,153070,186387,TR,TR
149304,1699020720,1699024320,3600,157198,37649,GB,GB
3546,1699509000,1699544820,35820,76963,26364,TR,TR
52088,1699974000,1700007120,33120,145125,159094,TR,TR
174555,1700568180,1700600520,32340,166863,187957,TR,TR
31592,1700354880,1700360400,5520,143752,145023,NL,NL
59173,1700775600,1700779260,3660,57783,157983,NL,NL
80872,1700036220,1700047260,11040,96479,64157,RS,RS
88174,1698985980,1699000800,14820,199173,23427,FR,FR
164132,1700457300,1700489580,32280,112145,125048,TR,TR
133680,1700591880,1700596260,4380,180656,192087,GB,GB
120418,1698931380,1698965040,33660,29557,184277,TR,TR
142601,1699967580,1699971180,3600,127676,136266,GB,GB
76258,1699913280,1699916880,3600,172761,134603,GB,GB
50983,1699790940,1699800000,9060,112076,69355,ES,ES
71307,1700436240,1700456940,20700,64112,186021,FR,BE
86120,1700155680,1700171640,15960,66780,71551,CZ,DE
74996,1699121580,1699126320,4740,67664,80417,GB,GB
191540,1698814680,1698818280,3600,47562,139040,NL,NL
156825,1699229820,1699244520,14700,58584,14239,AT,AT
152862,1699608660,1699641960,33300,89647,58110,TR,TR
71236,1700355360,1700362440,7080,184518,192901,NL,NL
71070,1699868940,1699901160,32220,36657,92727,TR,TR
62920,1699821900,1699837140,15240,157085,175868,FR,FR
13390,1699868700,1699875720,7020,74524,3586,GB,GB
21869,1699272060,1699301460,29400,22564,95288,TR,TR
31972,1699287240,1699322220,34980,160477,58620,TR,TR
40878,1700845560,1700851620,6060,99717,135223,GB,GB
124728,1699864920,1699894620,29700,138485,151727,TR,TR
96427,1700058180,1700089140,30960,125929,106137,TR,TR
120642,1699419960,1699453380,33420,26605,143548,TR,TR
92471,1699772640,1699811040,38400,81238,191150,MX,MX
148971,1699058580,1699063740,5160,77652,138293,NL,NL
14502,1700165640,1700182140,16500,18550,59263,RS,RS
32655,1700460180,1700484540,24360,174375,119011,DE,PL
109515,1700459700,1700463300,3600,156789,160468,GB,GB
54660,1698965040,1698981240,16200,101804,103671,FR,NL
122486,1700409660,1700419800,10140,159823,175613,EE,EE
126633,1699295160,1699303800,8640,190625,9184,IT,IT
106894,1699976460,1699986660,10200,59276,114956,PT,PT
176254,1700671980,1700675580,3600,32060,71567,GB,GB
3930,1699757580,1699766280,8700,199160,31545,IT,IT
125114,1699527420,1699540920,13500,52884,142983,AT,AT
68305,1700750820,1700786700,35880,15787,16552,TR,TR
128903,1700345160,1700374740,29580,151335,98259,TR,TR
143623,1699135800,1699152360,16560,133591,127805,FR,FR
151481,1700590740,1700604000,13260,142646,47837,US,US
142028,1698837900,1698855480,17580,97585,110613,US,US
158637,1700261280,1700291040,29760,104616,69549,TR,TR
177415,1700332740,1700338440,5700,46817,56598,GB,GB
59290,1699025640,1699058640,33000,88830,3184,TR,TR
70254,1699780320,1699811340,31020,73017,73968,TR,TR
160175,1699386660,1699391760,5100,194278,76425,NL,NL
86649,1699677060,1699709640,32580,50650,55381,TR,TR
30454,1700085180,1700119140,33960,38864,75427,TR,TR
408,1699783500,1699791000,7500,8961,45160,HR,HR
197426,1700689860,1700702460,12600,194096,28727,US,US
156932,1700711580,1700736300,24720,174628,43961,PL,DE
36802,1700371860,1700388000,16140,111225,190623,US,US
128129,1699510740,1699518720,7980,127501,177737,PT,ES
180855,1700079420,1700112600,33180,41303,189758,TR,TR
11399,1700628300,1700646240,17940,191652,173779,US,US
190462,1699114440,1699145820,31380,58344,84484,TR,TR
55647,1699100040,1699117440,17400,118287,16985,US,US
122006,1699863780,1699899600,35820,61904,10809,TR,TR
184549,1698946260,1698950040,3780,160403,181172,GB,GB
18951,1699625220,1699638000,12780,7561,21316,HR,HR
129614,1699348320,1699380720,32400,188355,42267,TR,TR
146682,1699597500,1699656900,59400,101044,61069,UA,CZ
98291,1700824620,1700859780,35160,189309,21509,TR,TR
22186,1700787060,1700790660,3600,160522,6735,GB,GB
18992,1699257360,1699273500,16140,134906,137804,US,US
103279,1699099380,1699110240,10860,9181,15885,IT,IT
6279,1698831900,1698845160,13260,123445,144345,IT,IT
50662,1698883800,1698918420,34620,28987,29388,TR,TR
136565,1699249560,1699253160,3600,153520,97519,NL,LU
175277,1699989480,1700021040,31560,48411,29310,TR,TR
193301,1700391420,1700422800,31380,24299,197815,TR,TR
153789,1699486500,1699510740,24240,47236,144003,PL,DE
84587,1700466300,1700496480,30180,166103,127888,TR,TR
133146,1700228700,1700238000,9300,41043,129703,IT,IT
193946,1699781100,1699813320,32220,55604,187259,TR,TR
89685,1699436340,1699445820,9480,180327,35156,HR,HR
71310,1699049460,1699060860,11400,112157,70476,HR,HR
118355,1699308900,1699337580,28680,56153,110157,DE,DE
179498,1700835780,1700848260,12480,78011,87250,US,US
143959,1700249400,1700282820,33420,122192,97669,TR,TR
24158,1699905540,1699920180,14640,184679,156867,FR,FR
142607,1699296840,1699323180,26340,162346,58992,DE,AT
32057,1699356780,1699379340,22560,34395,71240,RO,RO
72888,1698945600,1698974640,29040,143881,109270,TR,TR
173044,1699273320,1699284720,11400,59969,156379,US,US
146212,1698818880,1698849120,30240,128521,161229,TR,TR
121886,1699726200,1699756080,29880,178173,108276,TR,TR
79215,1700211180,1700235960,24780,64977,88041,DE,BG
12788,1699148460,1699177560,29100,15005,183799,TR,TR
26914,1700579760,1700613360,33600,181735,45721,TR,TR
79227,1700715660,1700729940,14280,23430,43277,CA,CA
115356,1699189740,1699228500,38760,178147,13051,MX,MX
15971,1700492340,1700519760,27420,154376,171404,BR,BR
142629,1700440260,1700469420,29160,36432,13122,TR,TR
11094,1699545420,1699561320,15900,124552,159203,BE,DE
34803,1699764720,1699768320,3600,52408,44562,GB,GB
184939,1700695680,1700707800,12120,175659,31153,AT,AT
122196,1699253580,1699275600,22020,181397,90715,AL,MK
63468,1700032380,1700042160,9780,135979,117504,IT,IT
139786,1699079880,1699083480,3600,75717,28664,GB,GB
47334,1699383360,1699418340,34980,41556,14165,TR,TR
87005,1700348700,1700374620,25920,112890,198592,BR,BR
185494,1698927180,1698939900,12720,161069,140013,HR,HR
11507,1698993060,1698996660,3600,50544,41937,GB,GB
145125,1699835880,1699865460,29580,101346,188761,TR,TR
156171,1699484940,1699514940,30000,90628,168208,TR,TR
64213,1699378020,1699392300,14280,168640,128678,US,US
149889,1700620800,1700654040,33240,102351,186038,TR,TR
15635,1700622000,1700625600,3600,123682,145690,NL,NL
31176,1699270560,1699286400,15840,46444,120197,US,US
20727,1699686480,1699722120,35640,174546,136620,TR,TR
17921,1698918540,1698942000,23460,98017,48873,PL,SK
175974,1699684320,1699688820,4500,87300,54038,GB,GB
126445,1700279220,1700307540,28320,95230,101543,DE,DE
54085,1700468580,1700484600,16020,187409,128870,US,US
160403,1700324760,1700358360,33600,84824,191694,TR,TR
122135,1700613780,1700629680,15900,59814,71865,CZ,UA
116264,1700165580,1700172240,6660,46595,9554,GB,GB
89720,1699665180,1699676520,11340,41929,131774,IT,IT
11456,1699247700,1699283640,35940,88353,102337,TR,TR
136164,1700805180,1700840700,35520,124273,178503,TR,TR
72303,1698872700,1698909780,37080,151779,127137,MX,MX
119397,1698926400,1698939120,12720,70276,167419,AT,AT
199881,1700203980,1700207580,3600,89413,185449,NL,NL
25544,1699660740,1699673820,13080,137261,77588,SK,AT
37679,1700011260,1700045880,34620,3119,171894,TR,TR
78627,1699761180,1699789380,28200,50389,147310,DE,DK
74657,1699991940,1700013000,21060,79960,69994,BE,FR
83362,1698971640,1699004460,32820,154743,178257,TR,TR
123717,1700592840,1700603520,10680,17290,169829,IT,IT
140642,1699139040,1699154940,15900,125005,114950,US,US
68244,1699342860,1699370580,27720,108500,63376,RO,RO
38169,1700041500,1700057040,15540,166802,17963,US,US
120353,1699181760,1699210740,28980,95442,162095,TR,TR
114853,1699573980,1699599420,25440,54532,180927,BR,BR
190643,1699706160,1699709760,3600,146227,80510,GB,GB
137233,1699138020,1699145640,7620,136846,177746,EE,EE
55828,1700291400,1700323260,31860,33161,44916,TR,TR
24223,1700233740,1700243400,9660,110821,130679,HR,HR
27079,1699308060,1699342800,34740,145727,19879,TR,TR
45795,1699848480,1699868340,19860,105165,171688,FR,FR
123888,1700225880,1700229480,3600,154156,70341,NL,NL
11501,1699933560,1699964460,30900,180129,76745,TR,TR
110871,1700126700,1700139720,13020,22249,27933,IT,IT
34845,1699765680,1699780200,14520,129063,140125,AT,AT
163464,1700195580,1700220540,24960,80619,106534,DK,DE
17053,1700538960,1700571900,32940,62534,120919,TR,TR
92424,1699715160,1699747080,31920,22586,122269,TR,TR
28394,1698946080,1698956100,10020,172184,85051,PT,PT
60597,1699322400,1699357860,35460,5707,15830,TR,TR
35698,1700277960,1700291340,13380,150074,193665,US,US
198686,1698846900,1698886020,39120,198119,4817,MX,MX
104112,1700380440,1700411340,30900,27908,171380,TR,TR
70707,1700070120,1700077620,7500,111996,131199,IT,IT
102666,1699196160,1699204260,8100,53291,96566,IT,LU
26013,1700611920,1700623920,12000,73062,123895,IT,IT
185278,1699192440,1699222200,29760,153202,184286,TR,TR
162876,1699540200,1699567560,27360,46102,106492,DE,HU
10315,1700345220,1700361420,16200,127152,69915,US,US
46053,1699854720,1699891560,36840,141182,167913,MX,MX
132653,1699780080,1699815240,35160,10556,129236,TR,TR
59970,1699697220,1699729800,32580,146735,50893,TR,TR
158902,1699398060,1699408980,10920,18340,155173,IT,IT
123531,1700089140,1700120700,31560,131335,49839,TR,TR
65983,1700155560,1700189520,33960,145723,173202,TR,TR
172372,1699822200,1699834080,11880,62206,449,IT,IT
97637,1698810480,1698869040,58560,154700,179329,UA,PL
164498,1699145280,1699175040,29760,109199,19608,TR,TR
18258,1700434380,1700448540,14160,111342,138509,IT,IT
187193,1699277760,1699289640,11880,151693,191826,IT,IT
21578,1700137440,1700161200,23760,175207,196659,DE,DE
50616,1700620320,1700625600,5280,173263,12871,NL,NL
23612,1699768980,1699792980,24000,83814,27197,DK,RO
28529,1699356540,1699388760,32220,80972,148477,TR,TR
105179,1699858320,1699870500,12180,87180,16239,US,US
118697,1698909780,1698939720,29940,116485,29432,TR,TR
102437,1700428080,1700440140,12060,41966,132536,US,US
105339,1700600640,1700608500,7860,140389,169215,SK,DE
154559,1699617180,1699642980,25800,138968,32217,HU,PL
59030,1698884700,1698901080,16380,147530,66008,US,US
98219,1699557180,1699561560,4380,35672,145822,NL,NL
38944,1699979520,1699985820,6300,51177,106119,GB,GB
139914,1698899880,1698914340,14460,158490,84565,US,US
93522,1698796980,1698803520,6540,46650,45108,GB,GB
145556,1700122740,1700131380,8640,86808,102584,ES,PT
67063,1700472660,1700489100,16440,142303,23528,IN,IN
198286,1700805360,1700834160,28800,158463,58763,TR,TR
13659,1699500060,1699555440,55380,37317,69181,UA,PL
193520,1698830040,1698864300,34260,10966,92317,TR,TR
138518,1699380720,1699413480,32760,114441,109430,TR,TR
44322,1700400960,1700436000,35040,14391,101142,TR,TR
129901,1700279880,1700301660,21780,29189,120803,PL,UA
101401,1699554960,1699567680,12720,171705,44279,IT,IT
16974,1700237880,1700247660,9780,90213,110164,IT,IT
103195,1699328940,1699342020,13080,83642,10881,IT,IT
124488,1700774640,1700778240,3600,199522,73657,GB,GB
143321,1700619060,1700635800,16740,90861,191810,US,US
155171,1699186680,1699204440,17760,70063,132725,US,US
39634,1700497080,1700529900,32820,155263,73085,TR,TR
102879,1699971480,1700005860,34380,109809,45582,TR,TR
65727,1699306800,1699311480,4680,142886,40174,GB,GB
110410,1699126200,1699139220,13020,26003,24452,AT,SK
19989,1700092260,1700104440,12180,29730,4168,IT,IT
158641,1699012500,1699045740,33240,101359,101278,TR,TR
32887,1699827660,1699842120,14460,78869,134404,US,US
51046,1700750760,1700781360,30600,54464,111963,TR,TR
189735,1699938960,1699944840,5880,87658,92430,GB,GB
38371,1700368620,1700398860,30240,125716,123443,TR,TR
26053,1699789080,1699801140,12060,180538,7218,ES,ES
49955,1699587240,1699592880,5640,153481,118753,NL,NL
109197,1700344740,1700349300,4560,83565,141012,GB,GB
2916,1699941540,1699974660,33120,126556,146789,TR,TR
932,1700152920,1700156520,3600,178851,49728,GB,GB
12595,1700818560,1700825160,6600,10206,195512,GB,GB
112803,1700094060,1700111040,16980,85707,82177,CZ,DE
53201,1700310120,1700342340,32220,189772,170585,TR,TR
15758,1700301840,1700317560,15720,72490,108485,CZ,CZ
35333,1700759460,1700775060,15600,139530,25024,US,US
27909,1699498080,1699501680,3600,61975,154831,NL,NL
89930,1699558200,1699583700,25500,199313,105542,DE,DE
12100,1698872460,1698884640,12180,184315,92915,AT,AT
120113,1699049580,1699073940,24360,178207,94501,DE,AT
81761,1699017000,1699045680,28680,199914,70910,BA,AT
38134,1699696140,1699727580,31440,90007,107305,TR,TR
44501,1700634840,1700666040,31200,190962,100217,TR,TR
55879,1699690440,1699706220,15780,127665,158316,US,US
12504,1698830640,1698862980,32340,46887,24013,TR,TR
3675,1699476660,1699488960,12300,64201,94609,US,US
18269,1700422260,1700455740,33480,61724,148717,TR,TR
189305,1700735820,1700748360,12540,113813,128715,US,US
84068,1699216200,1699249260,33060,130726,49743,TR,TR
110757,1699294320,1699297920,3600,89549,32079,GB,GB
182357,1699209360,1699240200,30840,7998,40068,TR,TR
175423,1699725360,1699728960,3600,67043,33450,GB,GB
59166,1699642920,1699678800,35880,198177,197618,TR,TR
45505,1700128800,1700132400,3600,64828,36935,NL,FR
183414,1700396580,1700405640,9060,124166,52765,IT,IT
70416,1699741860,1699774320,32460,163090,75618,TR,TR
118722,1698847620,1698879900,32280,164397,27899,TR,TR
116557,1699699980,1699733640,33660,89834,153949,TR,TR
143429,1699948380,1699951980,3600,181749,175074,NL,FR
93933,1699781100,1699812420,31320,3649,77013,TR,TR
105870,1700116620,1700138400,21780,16271,4655,RO,RO
64968,1698794220,1698827640,33420,107416,123638,TR,TR
135453,1700498820,1700532900,34080,58019,45616,MK,RS
140195,1700110980,1700114580,3600,112547,184001,GB,GB
152426,1699410660,1699442040,31380,107878,101616,TR,TR
109293,1700320860,1700334660,13800,61660,42354,ES,ES
105117,1699947780,1699964220,16440,161258,171297,AT,BG
179766,1699733460,1699737060,3600,92312,130117,GB,GB
153569,1700233620,1700244480,10860,76957,12115,IT,IT
139037,1699807680,1699822500,14820,181465,1065,US,US
51331,1700404320,1700418840,14520,1860,78993,AT,AT
39156,1699681380,1699712400,31020,150412,85794,TR,BG
38874,1699099440,1699115340,15900,31963,99170,US,US
134995,1699230900,1699246200,15300,33237,198003,US,US
160361,1698921960,1698944940,22980,156632,4700,BR,BR
16253,1699715580,1699726980,11400,12550,191136,HR,HR
153042,1699051020,1699068240,17220,119335,164265,US,US
4981,1698877260,1698909900,32640,117178,33137,TR,TR
11795,1700369640,1700403000,33360,124989,114770,TR,TR
164248,1698948300,1698960060,11760,178701,98573,US,US
32348,1699291740,1699299960,8220,487,196431,IT,IT
189651,1700016120,1700027700,11580,105610,32900,HR,HR
102053,1700696340,1700707020,10680,33271,5714,HR,HR
146353,1700677860,1700693100,15240,87573,137730,AT,AT
22356,1699684380,1699688040,3660,82885,125393,NL,NL
88866,1700755500,1700765400,9900,159168,38071,IT,IT
3461,1700185620,1700211300,25680,183920,12319,DE,CZ
192408,1700790660,1700800500,9840,131318,91152,PT,PT
194681,1700627040,1700636460,9420,12481,2629,IT,IT
66465,1699450320,1699485000,34680,182373,10182,TR,TR
152818,1700665560,1700672940,7380,125647,131849,IT,IT
2771,1699905780,1699920420,14640,34027,152882,FR,FR
95665,1700201520,1700215020,13500,88345,31959,HR,HR
58336,1699962600,1699971960,9360,87254,39950,HR,HR
11099,1700282820,1700314560,31740,106541,106748,TR,TR
9890,1698890160,1698907020,16860,118450,92964,FR,FR
85942,1699356540,1699388520,31980,196681,41940,TR,TR
80003,1700744700,1700755320,10620,170268,67962,IT,IT
169056,1700037960,1700047380,9420,59627,186993,ES,ES
115543,1699963740,1699981320,17580,96282,113285,US,US
158906,1699389360,1699419180,29820,148789,47393,TR,TR
80339,1700487060,1700516700,29640,179462,76797,TR,TR
76367,1699323780,1699336200,12420,103691,66881,IT,IT
67118,1700645640,1700681280,35640,15840,107925,TR,TR
193398,1700021580,1700057100,35520,96950,48969,TR,TR
198853,1700694180,1700701380,7200,19473,61005,IT,IT
134822,1699157220,1699165140,7920,24826,128904,IT,IT
175906,1699431720,1699457820,26100,116007,15278,PL,PL
5679,1699870620,1699899660,29040,39161,68572,TR,TR
164620,1700448120,1700461080,12960,31095,7269,IT,IT
6729,1699439160,1699450800,11640,25020,54608,ES,ES
22313,1699949880,1699979160,29280,102245,185291,TR,TR
83998,1699545300,1699550580,5280,109191,98860,EE,FI
142453,1699659840,1699690680,30840,166463,19855,TR,TR
30543,1699117320,1699128540,11220,10572,107601,US,US
60974,1698825960,1698841920,15960,24726,189320,US,US
179991,1699351320,1699360500,9180,50344,3553,SK,SK
143374,1700584680,1700612580,27900,135541,77938,DE,DE
151360,1698912120,1698923400,11280,15915,184543,RS,RS
67527,1700777880,1700813520,35640,8134,67718,TR,TR
7114,1700257140,1700289180,32040,32305,44620,TR,TR
86308,1700346060,1700360220,14160,17606,145653,PT,PT
129252,1699106100,1699109700,3600,17018,138196,GB,GB
5271,1699771260,1699799760,28500,69388,171171,PL,PL
70225,1699284900,1699288740,3840,37373,22486,GB,GB
175584,1700762760,1700788380,25620,38610,195180,PL,PL
11607,1700239320,1700247900,8580,151653,83061,IT,IT
81952,1700574660,1700602800,28140,183685,134975,NO,SE
74451,1700659500,1700666280,6780,192685,171499,GB,GB
112194,1700014920,1700031420,16500,10090,62547,US,US
33000,1698892260,1698923280,31020,31065,32767,TR,TR
168252,1699723260,1699726860,3600,77829,117844,NL,NL
140669,1700820180,1700845620,25440,159790,29907,DE,AT
137970,1699121220,1699124820,3600,153413,149323,GB,GB
62041,1698795840,1698829620,33780,176275,162353,TR,TR
121534,1700546460,1700572140,25680,190499,175475,HU,DE
80547,1700649720,1700672820,23100,162750,101462,MD,RO
154909,1699663800,1699690560,26760,113368,198865,RO,RO
180948,1700756100,1700788440,32340,104084,130866,TR,TR
158996,1700186160,1700189760,3600,76842,39032,GB,GB
121469,1699255800,1699272540,16740,27805,56082,US,US
12404,1698883560,1698898320,14760,34980,570,US,US
60805,1700717700,1700750580,32880,48718,31684,TR,TR
171371,1700816340,1700849580,33240,87482,12450,TR,TR
10930,1700653320,1700682840,29520,142752,67783,TR,TR
12519,1699366260,1699398840,32580,144654,404,TR,TR
2112,1700022480,1700036820,14340,10550,72684,CZ,CZ
158554,1700226240,1700238540,12300,41030,169416,US,US
160836,1698906600,1698912240,5640,172786,142197,GB,GB
132321,1699582680,1699586280,3600,37882,198040,GB,GB
140516,1700661360,1700672580,11220,16105,160703,US,US
183744,1699191960,1699209240,17280,158903,104610,US,MX
93632,1699194480,1699227480,33000,143857,187269,TR,TR
157924,1700300520,1700334300,33780,18604,159849,TR,TR
59714,1699985520,1700019300,33780,98341,85916,TR,TR
696,1699664400,1699679580,15180,94226,59727,US,US
184673,1700296440,1700309700,13260,65377,28296,US,US
138379,1700835960,1700866800,30840,50767,116641,TR,TR
120284,1700463960,1700494620,30660,99565,30056,TR,TR
76738,1700688900,1700722440,33540,10896,1597,TR,TR
24588,1700605320,1700617680,12360,155277,157590,US,US
46886,1700112900,1700147460,34560,157336,105234,MX,MX
19559,1699290420,1699294560,4140,57738,135038,GB,GB
102878,1699491480,1699522560,31080,196673,6383,TR,TR
94637,1700777700,1700783880,6180,96718,11325,NL,NL
172755,1698806640,1698840900,34260,72161,81299,TR,TR
167745,1699454100,1699466400,12300,45580,2053,US,US
193368,1700185680,1700201460,15780,130119,195470,US,US
103634,1700613240,1700619000,5760,62014,166656,GB,GB
193125,1699619400,1699648500,29100,72673,128873,BA,DE
69684,1698936540,1698962400,25860,115363,40528,PL,UA
122792,1698942300,1698972000,29700,155147,38379,TR,TR
139196,1699749180,1699765140,15960,72813,37211,IN,IN
55520,1699221900,1699227840,5940,7596,3127,NL,FR
3527,1699691640,1699723080,31440,110184,199915,TR,TR
34371,1699725000,1699751760,26760,20531,94384,PL,PL
197210,1699529220,1699532820,3600,198362,193870,GB,GB
10327,1700418840,1700449920,31080,53221,129365,TR,TR
32325,1700590500,1700622660,32160,121002,123,TR,TR
84456,1698985680,1699016940,31260,80571,192790,TR,TR
162149,1699985640,1700013180,27540,2162,117322,BA,HR
139710,1700478180,1700492580,14400,76299,55706,US,US
7604,1699191300,1699202820,11520,94949,195070,PT,PT
187555,1699495260,1699504680,9420,39356,68041,IT,IT
157808,1698863520,1698874500,10980,157954,128210,IT,IT
177093,1700727000,1700760780,33780,115012,112844,TR,TR
144084,1700751840,1700803380,51540,47319,60833,BG,DE
17459,1699965960,1699995360,29400,89580,173566,TR,TR
84512,1699927980,1699932840,4860,82779,44447,GB,GB
120158,1699063380,1699098420,35040,105478,131109,TR,TR
187132,1700702340,1700724720,22380,176335,149211,DE,DE
147889,1700504160,1700518260,14100,33419,107013,US,US
139345,1700034120,1700047920,13800,12488,190484,RS,RS
188197,1699344480,1699369500,25020,29032,13675,PL,PL
68709,1700384100,1700419380,35280,80483,145557,TR,TR
74468,1699908300,1699911900,3600,37490,175329,GB,GB
157288,1699788900,1699801440,12540,131012,8191,ES,ES
43752,1700075160,1700103060,27900,70797,91847,RO,RO
51374,1698957000,1698960600,3600,45907,182519,NL,FR
175729,1699789620,1699804560,14940,28876,29803,CZ,HU
136795,1700840880,1700845440,4560,69814,111783,GB,GB
119686,1698856920,1698870480,13560,93533,50785,IT,IT
190069,1698830760,1698843660,12900,129387,41141,SK,SK
169098,1700505480,1700538360,32880,63734,47272,TR,TR
187032,1700740260,1700775480,35220,6236,138332,TR,TR
139596,1700376480,1700380080,3600,163424,187297,GB,GB
139183,1699403640,1699435980,32340,162308,171758,TR,TR
153992,1699823160,1699847700,24540,48180,29429,DE,BG
89253,1700500020,1700503620,3600,146177,131976,GB,GB
60621,1699199820,1699203420,3600,181010,149870,NL,NL
178336,1699907700,1699937040,29340,50199,88117,TR,TR
178132,1700802840,1700834220,31380,8712,192704,TR,TR
61033,1699202940,1699233600,30660,135557,174021,TR,TR
180889,1699059060,1699066860,7800,172118,98539,HR,HR
193960,1699645080,1699676640,31560,182208,118773,TR,TR
39459,1699673520,1699706400,32880,72690,175225,TR,TR
104609,1700815680,1700849460,33780,71359,79572,TR,TR
38398,1699881420,1699891560,10140,185137,173047,AD,ES
167682,1699596060,1699613760,17700,21964,89255,US,US
68558,1700599740,1700603340,3600,188465,128335,GB,GB
115218,1699129620,1699139340,9720,99231,186579,IT,IT
57105,1699577280,1699593420,16140,62276,18278,US,US
190445,1700815260,1700825700,10440,35403,181469,CL,CL
130619,1700788260,1700811480,23220,1657,78224,PL,PL
21449,1699577460,1699598160,20700,65838,7379,MD,RO
67329,1698938820,1698956400,17580,9264,139401,US,US
77354,1699764180,1699777560,13380,197655,27601,PT,PT
176446,1699295160,1699302900,7740,150236,91227,HR,BA
161806,1699352820,1699385280,32460,61242,174111,TR,TR
102681,1699443300,1699472580,29280,75581,188123,TR,TR
44966,1699261560,1699276500,14940,154276,165728,RS,RS
91998,1700644740,1700675100,30360,104201,141405,TR,TR
100812,1700061360,1700078040,16680,18780,89136,US,CA
34941,1699201080,1699235760,34680,75838,150330,TR,TR
79901,1699064880,1699074600,9720,9974,124909,PT,PT
17933,1698795600,1698806400,10800,21101,113360,US,US
13105,1699245060,1699256340,11280,75869,4082,IT,DE
94001,1699369200,1699387320,18120,6667,180057,FR,FR
161247,1699078020,1699089060,11040,19468,193825,AT,BG
131161,1698828960,1698844920,15960,19259,23468,US,US
136199,1699789200,1699795860,6660,97946,15589,GB,GB
56979,1700325180,1700335140,9960,30020,94444,SK,SK
110023,1700208840,1700213220,4380,108274,55561,NL,NL
62220,1700769240,1700798640,29400,120661,171428,TR,TR
130903,1700144760,1700148360,3600,137342,190996,GB,GB
3532,1698970500,1698993420,22920,46798,96459,PL,PL
17541,1700164020,1700177880,13860,150555,184969,US,US
158088,1699650840,1699674000,23160,143262,65401,DE,NL
102065,1700321820,1700357040,35220,60302,24523,TR,TR
117260,1699046400,1699077660,31260,121540,156517,TR,TR
78495,1699077660,1699081260,3600,159059,44142,GB,GB
157518,1700401500,1700405100,3600,5557,43741,GB,GB
92030,1699272660,1699301460,28800,160500,72044,TR,TR
176461,1700175960,1700203200,27240,116467,177793,RO,RO
25383,1699062960,1699074780,11820,147375,50909,US,US
135712,1699634400,1699670280,35880,143557,82178,TR,TR
145837,1699219380,1699248480,29100,74373,8660,TR,TR
120073,1699492080,1699496220,4140,193144,73625,NL,NL
77472,1698839580,1698843180,3600,37905,27926,NL,NL
73147,1699970940,1699984980,14040,109102,97576,IT,IT
58009,1700496000,1700514240,18240,179341,166490,FR,FR
147036,1700308320,1700319360,11040,138915,122039,IT,IT
49595,1699543920,1699576380,32460,133788,66338,TR,TR
127806,1700838120,1700874000,35880,5394,191812,TR,TR
179093,1699830840,1699835280,4440,95891,69860,GB,GB
122618,1699563600,1699568820,5220,195478,191065,GB,GB
198037,1698896760,1698910980,14220,88091,137858,US,US
27318,1700520660,1700526600,5940,180999,164543,NL,NL
44243,1700168880,1700178540,9660,151818,56040,PT,PT
74700,1700347140,1700377140,30000,103599,143649,TR,TR
71040,1700042940,1700056620,13680,106656,42278,US,US
142089,1699965720,1699994640,28920,6937,148448,TR,TR
99975,1699452660,1699488540,35880,36332,90929,TR,TR
163837,1699884540,1699895940,11400,160137,97666,IT,IT
60166,1699992900,1700021820,28920,137629,157153,TR,TR
79747,1699109820,1699138860,29040,149874,45729,TR,TR
172821,1698996060,1699031460,35400,20297,71597,TR,TR
137808,1700378760,1700389560,10800,65408,141308,IT,MK
10550,1700667960,1700700000,32040,189521,173769,TR,TR
71846,1699237680,1699252740,15060,144511,41941,AT,AT
4873,1700669400,1700689620,20220,19667,166485,FR,FR
191250,1699902120,1699906140,4020,13394,77233,EE,EE
182739,1700117640,1700130300,12660,58416,149487,US,US
136932,1699317300,1699328880,11580,13531,11535,AT,DE
115186,1700781240,1700813220,31980,136888,193347,TR,TR
125754,1700232840,1700266080,33240,191822,136785,TR,TR
61099,1700278560,1700282160,3600,181383,140554,GB,GB
197074,1700296320,1700329980,33660,65757,83041,TR,TR
103504,1699508160,1699530360,22200,50887,178205,CH,PT
45606,1700339100,1700346420,7320,108654,73468,ES,AD
75868,1699148280,1699161120,12840,71429,66422,US,US
132016,1700402880,1700436600,33720,144936,26363,TR,TR
60908,1699889100,1699905300,16200,73131,152109,US,US
20591,1700447940,1700458260,10320,56522,80251,IT,IT
191328,1700273820,1700284440,10620,195421,97410,IT,IT
170963,1699967100,1699998300,31200,79887,140207,TR,TR
155285,1699334100,1699340700,6600,74433,7359,GB,GB
72010,1700554380,1700587980,33600,73002,194200,TR,TR
14552,1699229280,1699245780,16500,9891,74802,CZ,CZ
185381,1699010460,1699014060,3600,88990,144021,GB,GB
105606,1699272420,1699303020,30600,78048,194696,TR,TR
50498,1699981080,1699989300,8220,49815,176420,ES,IT
180960,1700415000,1700439960,24960,174333,92287,HU,AT
96308,1699936800,1699968960,32160,23740,85943,TR,TR
130123,1699859460,1699881420,21960,62916,75352,PL,DE
161583,1699222200,1699225800,3600,55450,37516,NL,NL
193276,1699477500,1699511400,33900,13645,62319,TR,TR
63832,1699005540,1699033380,27840,44455,179737,DE,DE
12110,1699139940,1699157880,17940,28316,149226,US,US
157071,1699930020,1699965480,35460,18957,14750,TR,TR
25772,1699199580,1699203900,4320,99828,39460,GB,GB
18306,1699777980,1699790040,12060,4526,169900,US,US
117193,1699660680,1699677000,16320,150321,135530,AT,DE
171114,1700094720,1700105940,11220,30256,118521,CZ,PL
54072,1699439820,1699451100,11280,27111,119945,IT,IT
141518,1700061060,1700093820,32760,98472,44280,TR,TR
117939,1699757460,1699781220,23760,80317,46703,PL,PL
168607,1699035480,1699047120,11640,2983,65166,US,US
15761,1699435200,1699447740,12540,7971,39575,CZ,CZ
10135,1700056560,1700091180,34620,31077,130157,TR,TR
101750,1700763780,1700776380,12600,81641,45806,IT,IT
85708,1699340460,1699363440,22980,152408,85297,DE,DE
70963,1700812140,1700841060,28920,184449,26901,TR,TR
7153,1699677900,1699707840,29940,150263,110566,TR,TR
114130,1700659320,1700693820,34500,39830,147631,TR,TR
156426,1700202420,1700232180,29760,32591,190632,TR,TR
71159,1700355600,1700367960,12360,189300,88502,HR,HR
137465,1699848480,1699862580,14100,182532,5216,US,US
167206,1698980760,1699009860,29100,85630,197669,TR,TR
127435,1700181540,1700192940,11400,184239,348,HR,HR
65180,1700258640,1700262240,3600,124593,54152,GB,GB
166778,1700496900,1700526300,29400,119523,103691,TR,TR
5648,1699518180,1699524540,6360,159303,116039,GB,GB
191350,1700819760,1700848680,28920,147185,142108,TR,TR
86366,1700536980,1700571780,34800,13271,64823,TR,TR
115155,1700548920,1700553900,4980,24945,131106,NL,NL
7065,1698842340,1698877080,34740,49316,74173,TR,TR
111678,1700189040,1700210280,21240,22473,176922,FR,FR
9584,1699251540,1699269300,17760,179131,152023,US,US
85191,1700201160,1700210340,9180,89364,113177,IT,IT
9068,1698811320,1698844920,33600,102585,78327,TR,TR
160789,1699188000,1699201800,13800,158086,49177,AT,AT
76547,1700489760,1700521320,31560,171060,178546,TR,TR
55522,1700375100,1700388900,13800,93628,188264,HR,HR
52148,1699436220,1699446000,9780,62677,81690,SK,CZ
79845,1700183220,1700197140,13920,115381,14503,CZ,NL
138119,1699737060,1699772700,35640,145393,26157,TR,TR
41359,1700276880,1700280480,3600,65828,16683,NL,NL
128439,1700660640,1700690640,30000,151356,61768,TR,TR
157533,1700700540,1700716800,16260,172740,51424,US,US
23783,1700584020,1700597160,13140,47658,92709,SK,SK
65153,1699756320,1699789740,33420,116178,176397,TR,TR
179659,1699669020,1699702740,33720,196983,44129,TR,TR
149155,1699846380,1699849980,3600,64230,46862,GB,GB
62999,1699936620,1699949400,12780,98494,140571,IT,IT
113628,1698993480,1699004700,11220,79002,94210,SK,SK
153157,1700541000,1700576040,35040,30313,101226,TR,TR
21504,1700005560,1700013780,8220,182527,146398,IT,IT
75885,1699220400,1699239660,19260,98831,179078,FR,FR
130946,1700737740,1700749560,11820,179050,85688,IT,IT
177480,1700489580,1700521080,31500,132506,71375,TR,TR
84792,1700243520,1700248500,4980,199399,5171,GB,GB
192773,1700245260,1700259480,14220,30254,128751,IT,IT
77407,1699477680,1699481280,3600,62554,3582,GB,GB
61386,1699573920,1699612560,38640,118400,55688,MX,MX
59999,1699052520,1699067580,15060,185460,72717,CZ,CZ
111701,1699684860,1699713660,28800,118736,165368,TR,TR
131081,1699718940,1699748340,29400,165643,5430,TR,TR
10828,1699820040,1699853040,33000,49489,127586,TR,TR
171777,1700462220,1700476740,14520,2331,157269,US,US
121386,1699956960,1699990260,33300,19146,93461,TR,TR
139760,1699940880,1699961100,20220,139337,170435,FR,ES
31105,1699150380,1699161360,10980,140709,135014,PT,LU
57292,1699125420,1699140780,15360,198438,176168,CZ,FR
160999,1700798040,1700826600,28560,110012,27371,BR,BR
185277,1700280660,1700306760,26100,85457,153683,PL,PL
59355,1699392480,1699405020,12540,89292,56157,US,US
153251,1700004240,1700007840,3600,30642,115071,GB,GB
167663,1700498580,1700530920,32340,14085,189869,TR,TR
32567,1699626840,1699630440,3600,176853,176683,GB,GB
55049,1699334940,1699342860,7920,128508,30650,HR,HR
100802,1698901620,1698936000,34380,94084,150373,TR,TR
73389,1699314600,1699350540,35940,127745,141121,TR,TR
99387,1699896480,1699912560,16080,67077,199914,US,US
116843,1698950040,1698976920,26880,177524,57910,DE,PL
115000,1699113420,1699119480,6060,29221,3288,GB,GB
120068,1700143320,1700149860,6540,143057,2205,NL,NL
157560,1700692440,1700721360,28920,188455,193852,TR,TR
174825,1699394880,1699419180,24300,186737,69632,DE,DE
84243,1699150260,1699180260,30000,158730,16523,TR,TR
197526,1699256580,1699281000,24420,64344,131557,BR,BR
146867,1699577700,1699581300,3600,13917,68559,GB,GB
134394,1700063880,1700070840,6960,116456,106617,NL,NL
56272,1699751760,1699803480,51720,182012,184680,BG,AT
81176,1699488000,1699493940,5940,27448,180162,NL,NL
90039,1700180520,1700213880,33360,66258,114420,MX,MX
172274,1700757000,1700792400,35400,153076,184042,MX,MX
158755,1699802820,1699813980,11160,192262,14887,US,US
190497,1699412880,1699446780,33900,52660,38665,TR,TR
109280,1700087520,1700121360,33840,34241,170729,TR,TR
51647,1699331100,1699365180,34080,183354,44295,TR,TR
175094,1700076660,1700080260,3600,147385,74435,NL,NL
164958,1699524600,1699550700,26100,118669,97436,DE,DE
46323,1699494420,1699526100,31680,186611,35372,TR,TR
181693,1699881420,1699914540,33120,182988,116680,TR,TR
192438,1699791240,1699802700,11460,88105,50529,PT,PT
147977,1699200600,1699235160,34560,46113,82384,TR,TR
69900,1698914940,1698948540,33600,138546,70310,TR,TR
95430,1699542540,1699554120,11580,104063,108340,HR,HR
152801,1700312340,1700315940,3600,85249,62226,NL,GB
188172,1699624860,1699629720,4860,109578,188462,GB,GB
121357,1700476320,1700498460,22140,53867,153560,DE,DE
179475,1700051280,1700064300,13020,90402,32102,IT,IT
11927,1698795180,1698816180,21000,4468,112182,FR,DE
10521,1699876740,1699890300,13560,179083,58381,PT,PT
33866,1698902160,1698905760,3600,153875,35920,GB,GB
113266,1700777400,1700811360,33960,197107,178474,MX,MX
2496,1699195980,1699231860,35880,77278,112571,TR,TR
71262,1699302600,1699314180,11580,31355,122472,HR,HR
186485,1700557020,1700589840,32820,75486,142750,TR,TR
150090,1699738260,1699751100,12840,172202,20637,US,US
31535,1699362240,1699393140,30900,11153,92051,TR,TR
117636,1700839740,1700873220,33480,18663,168918,TR,TR
59276,1698944040,1698978540,34500,145056,85391,TR,TR
99965,1699491840,1699500960,9120,100865,143732,IT,IT
53756,1700550840,1700562420,11580,27584,72188,HR,DE
104704,1699828740,1699860360,31620,70665,114156,TR,TR
196794,1700141880,1700183640,41760,54793,135731,LV,AT
44894,1699030560,1699040220,9660,77880,6417,HR,HR
148421,1699084980,1699088580,3600,114274,148420,GB,GB
65111,1700147100,1700177640,30540,165570,178907,TR,TR
128550,1700550540,1700579160,28620,193902,130662,DE,IT
131549,1700459160,1700494200,35040,99858,73017,TR,TR
185725,1699040880,1699045140,4260,44497,88389,GB,GB
33737,1700829660,1700836200,6540,7994,100628,GB,GB
16739,1700574180,1700580060,5880,113996,117727,AD,ES
159607,1699579560,1699610640,31080,72326,32551,BA,DE
73355,1700527560,1700561280,33720,142058,143849,TR,TR
113121,1699489800,1699503120,13320,104826,100102,ES,ES
199828,1699077300,1699111380,34080,171340,162071,TR,TR
98883,1699555500,1699584000,28500,158804,178125,DE,HR
51552,1700432280,1700464500,32220,182068,65828,TR,TR
190668,1699721160,1699737060,15900,118612,141443,FR,ES
25055,1700604540,1700617200,12660,45019,178118,US,US
9224,1699027320,1699060560,33240,176200,98442,TR,TR
4648,1699073940,1699102800,28860,135016,88519,TR,TR
13473,1700199420,1700206320,6900,22212,159057,GB,GB
193172,1699094700,1699114020,19320,87426,164716,DK,DE
136167,1700410980,1700427060,16080,83181,21406,CA,CA
68164,1699596240,1699629420,33180,113026,49632,TR,TR
104387,1700457300,1700473740,16440,76967,150531,US,US
71844,1700147220,1700164020,16800,75880,192855,US,US
58709,1699417320,1699430400,13080,166086,164957,HR,HR
46593,1699018440,1699023060,4620,175839,179653,GB,GB
135163,1699134120,1699145220,11100,6901,47771,US,US
67515,1699616340,1699651020,34680,22584,195720,TR,TR
130855,1698846840,1698876180,29340,11049,159108,TR,TR
129834,1700708820,1700723400,14580,53099,47343,US,US
35940,1699083780,1699117860,34080,37274,93864,TR,TR
131760,1699028760,1699057800,29040,189604,61538,TR,TR
86442,1699098780,1699132320,33540,101075,106188,TR,TR
1615,1700109360,1700141400,32040,94771,84156,TR,TR
178837,1699547160,1699575060,27900,146085,86206,DE,HR
142588,1700783040,1700791860,8820,90002,52747,IT,IT
17639,1700003460,1700007060,3600,7963,50105,GB,GB
117069,1699242300,1699271460,29160,144258,54379,TR,TR
55527,1699776600,1699789860,13260,173010,40631,IT,IT
181283,1699957020,1699974360,17340,19074,119408,US,CA
11351,1698830160,1698845880,15720,30434,180627,US,US
65951,1699682160,1699709220,27060,94428,101939,DE,IT
53907,1698893460,1698897060,3600,32938,190413,GB,GB
106721,1699264020,1699267860,3840,70918,161539,GB,GB
100870,1699949340,1699957140,7800,36192,108812,IT,IT
175963,1700009520,1700038920,29400,129426,2316,TR,TR
92832,1700728440,1700739360,10920,67038,98464,HR,HR
9,1700683920,1700700360,16440,147770,38396,US,US
12878,1698945720,1698978360,32640,194883,120026,TR,TR
162973,1700095620,1700108640,13020,130960,70779,US,US
93618,1698839100,1698871980,32880,109513,47655,TR,TR
64650,1700396520,1700429940,33420,61766,28532,TR,TR
158497,1700797980,1700801580,3600,161373,163184,GB,GB
185066,1700523840,1700534160,10320,88723,18400,IT,IT
3844,1698970740,1698999840,29100,54190,165061,TR,TR
90312,1699336560,1699349520,12960,18548,148697,US,US
1657,1699895040,1699921140,26100,145222,136376,RO,RO
96894,1700692860,1700705220,12360,89296,131536,US,US
81408,1698933540,1698945420,11880,169868,147322,US,US
92360,1700349180,1700374200,25020,23632,125010,AL,MK
42023,1699227600,1699261860,34260,77101,117040,TR,TR
133875,1699465740,1699479900,14160,85339,31671,HR,HR
88831,1699239660,1699251660,12000,111554,112159,AT,AT
28702,1700602440,1700606040,3600,23029,44505,NL,BE
6978,1700051580,1700064540,12960,147698,44204,IT,IT
6251,1700522640,1700555220,32580,127231,141201,TR,TR
93812,1700255160,1700274480,19320,154490,197693,DK,DK
116233,1699131900,1699147260,15360,152809,91831,US,US
9052,1700618400,1700652180,33780,159736,4029,TR,TR
95190,1700443020,1700459280,16260,144320,151368,US,US
189143,1698867060,1698882960,15900,14579,192928,US,US
22527,1699887480,1699904100,16620,137728,105857,US,MX
39168,1699395900,1699427940,32040,2025,143601,TR,TR
163909,1698979860,1699009500,29640,151103,90764,TR,TR
101624,1699569660,1699605300,35640,183979,95752,TR,TR
13965,1700017260,1700028780,11520,107789,8209,US,US
74703,1698906120,1698909720,3600,114865,41346,GB,GB
36676,1700054100,1700085060,30960,176095,411,TR,TR
34293,1700256180,1700269440,13260,4677,65638,US,US
199865,1700629860,1700660340,30480,85261,130230,TR,TR
197081,1698889980,1698921480,31500,103923,164079,TR,TR
12149,1700278680,1700292360,13680,11582,55027,SK,SK
23046,1698863940,1698874380,10440,181897,79357,IT,IT
14277,1700132880,1700140680,7800,132388,175357,PT,PT
121712,1699505520,1699541580,36060,163940,197037,MX,MX
99883,1698962460,1698994320,31860,43053,178658,TR,TR
94638,1700829060,1700833860,4800,177829,28564,GB,GB
132799,1699738140,1699751640,13500,23036,135284,IT,IT
95291,1700160540,1700164140,3600,40939,23549,GB,GB
137245,1699402980,1699434000,31020,38635,189799,TR,TR
124821,1699751640,1699755240,3600,169041,133310,NL,NL
156008,1700713920,1700745240,31320,162803,118071,TR,TR
8748,1699576320,1699587300,10980,161753,35488,HR,HR
190173,1699433100,1699436700,3600,111094,199214,NL,NL
154537,1699358460,1699391820,33360,127598,146964,MX,MX
78629,1700371560,1700405700,34140,16582,165285,TR,TR
12810,1699050420,1699061940,11520,183677,31874,US,US
174175,1700187360,1700220780,33420,76106,60821,TR,TR
186302,1699126140,1699145340,19200,175905,43520,SE,DK
128005,1699019040,1699046280,27240,20549,164354,DE,HU
104313,1699054140,1699087500,33360,172888,85279,TR,TR
65103,1700469300,1700492040,22740,21006,11329,HU,IT
54800,1700473860,1700486580,12720,97162,2748,US,US
89872,1700848320,1700859900,11580,74026,101620,HR,FR
43519,1700849820,1700859960,10140,26708,180010,HR,HR
99300,1699887660,1699921500,33840,157821,35385,MX,MX
6666,1700434500,1700455500,21000,42207,35177,FR,PT
95333,1700550360,1700559240,8880,67485,61169,HR,HR
156375,1700184900,1700215560,30660,134023,26851,TR,TR
126056,1699004460,1699038840,34380,22124,17257,TR,TR
63534,1700683920,1700691300,7380,162170,111427,PT,PT
124287,1700856540,1700891880,35340,81939,137162,TR,TR
123390,1700355360,1700359980,4620,57972,59374,GB,GB
15802,1699606920,1699640160,33240,13334,150242,TR,TR
199875,1699471200,1699504140,32940,129106,71336,TR,TR
72769,1700604120,1700628540,24420,163505,158314,DE,PL
19429,1699973220,1700008380,35160,130283,169480,TR,TR
14124,1699503120,1699532040,28920,31169,33623,TR,TR
134815,1700617140,1700637960,20820,162911,155883,BE,NL
89487,1698919440,1698953760,34320,107931,84800,TR,TR
2374,1699260420,1699295760,35340,93740,180351,TR,TR
66369,1699453920,1699458060,4140,127551,93277,NL,NL
127107,1700297160,1700331600,34440,1931,197382,MX,MX
92146,1699891740,1699905960,14220,185907,133487,IT,IT
115467,1699390200,1699416600,26400,79338,165228,BR,BR
157852,1699315560,1699327560,12000,199594,147437,IT,IT
144972,1700368320,1700399340,31020,116817,112567,TR,TR
103964,1699155000,1699182540,27540,194224,125248,BA,HR
120173,1699371060,1699402680,31620,65566,164762,TR,TR
190682,1699058700,1699089900,31200,121423,66674,TR,TR
194473,1700318040,1700342520,24480,21919,93154,DE,NL
116284,1699409220,1699442220,33000,143929,46546,TR,TR
49974,1699269900,1699284120,14220,97901,43503,IT,IT
18437,1698970740,1699003860,33120,126173,15723,TR,TR
157651,1699357080,1699360680,3600,73600,159991,GB,GB
119842,1700480520,1700519760,39240,37221,154986,MX,MX
29365,1700040840,1700075820,34980,56924,117535,TR,TR
24236,1700835600,1700867460,31860,91883,164392,TR,TR
87249,1699214160,1699236960,22800,72778,106956,SI,PL
32832,1700419800,1700427540,7740,151203,179945,PT,PT
40643,1700697540,1700733060,35520,144531,87132,TR,TR
95135,1699606680,1699642380,35700,169267,94977,TR,TR
108898,1699174680,1699178280,3600,164858,195855,GB,GB
47545,1700736780,1700772480,35700,84168,106196,TR,TR
16326,1699089060,1699100520,11460,186387,32824,IT,IT
140632,1699664460,1699669860,5400,4447,163798,GB,GB
4567,1699194240,1699231260,37020,188878,148594,MX,MX
145113,1699920300,1699936380,16080,121731,166957,US,US
186699,1699696080,1699729680,33600,64236,51853,TR,TR
820,1700185560,1700199660,14100,143883,1210,RS,RS
25403,1699371300,1699407060,35760,62386,107073,TR,TR
24856,1698895860,1698926520,30660,43610,145892,TR,TR
110076,1700145780,1700179380,33600,76516,16241,TR,TR
112635,1700100000,1700115480,15480,108803,46863,US,US
16226,1700786760,1700793240,6480,100076,90199,EE,EE
168185,1699701540,1699712700,11160,92903,136438,CZ,AT
84219,1699751700,1699768440,16740,10852,28280,AT,DE
186781,1699050780,1699060320,9540,142937,53713,HR,HR
52797,1700632800,1700644800,12000,140221,52084,IT,IT
94494,1700248560,1700277360,28800,199182,183801,TR,TR
131514,1698885600,1698924660,39060,103880,93441,MX,MX
191420,1700200500,1700210340,9840,142414,188594,IT,IT
63584,1699793580,1699797180,3600,127500,164094,NL,NL
92947,1699865940,1699879440,13500,26270,44223,RS,HU
139411,1700128740,1700138460,9720,113866,59062,IT,IT
61674,1700821920,1700835900,13980,69134,116125,US,US
95310,1700801280,1700836380,35100,16996,18229,MX,MX
71069,1699786140,1699815240,29100,160917,109049,TR,TR
147151,1698962580,1698980580,18000,23713,55973,FR,FR
73232,1699619160,1699648500,29340,194133,180914,TR,TR
1931,1699704300,1699739700,35400,189074,62907,TR,TR
884,1699413840,1699421520,7680,41495,13767,EE,DE
35833,1699398840,1699428960,30120,68253,109144,TR,TR
48927,1699997640,1700015460,17820,114124,153169,CZ,CZ
30215,1698876960,1698892020,15060,93754,130045,US,US
190508,1700442780,1700446380,3600,34455,174980,GB,GB
125348,1699553220,1699568520,15300,199035,170705,US,US
62488,1699195980,1699206600,10620,112672,152186,HR,HR
78005,1698823200,1698853560,30360,66844,147075,TR,TR
57078,1699248840,1699260420,11580,163780,133134,US,US
7464,1698870840,1698884280,13440,137927,80019,HR,HR
88624,1700177100,1700205960,28860,16017,198343,TR,TR
55971,1699848480,1699881360,32880,128970,99751,MX,MX
175394,1700407980,1700429940,21960,3952,57091,CH,DE
79064,1698857700,1698864060,6360,170254,40592,GB,GB
137950,1699958280,1699961880,3600,119556,8330,NL,NL
90045,1699996500,1700030280,33780,173578,7559,MX,MX
63902,1699988280,1699999320,11040,197129,137468,US,US
184854,1700793660,1700817480,23820,71510,27297,DE,BA
182828,1700139720,1700174820,35100,103450,80157,TR,TR
32771,1699105200,1699108920,3720,122261,167101,GB,GB
64452,1699544100,1699561020,16920,167771,91635,CZ,PL
153299,1700743980,1700779080,35100,95303,9107,TR,TR
38128,1699740960,1699752240,11280,31694,58429,US,US
52765,1698853020,1698856620,3600,167238,144561,NL,NL
198204,1700038920,1700071320,32400,183948,21037,TR,TR
108350,1698993660,1699005720,12060,195855,110483,AT,SK
88893,1700346540,1700350140,3600,125373,70258,GB,GB
84874,1700161620,1700165280,3660,31977,51955,NL,NL
136168,1700582700,1700613240,30540,174811,136270,TR,TR
57249,1699486860,1699490460,3600,178588,181265,NL,NL
22122,1700829420,1700865360,35940,44979,194574,TR,TR
165247,1699721100,1699733940,12840,136702,146248,US,US
112124,1700139300,1700143680,4380,79155,12499,GB,GB
104419,1699570080,1699573740,3660,181648,8006,GB,GB
147169,1699181880,1699212900,31020,119360,82228,TR,TR
168561,1700245800,1700279640,33840,76376,18944,TR,TR
26346,1700572080,1700596320,24240,138540,85765,BR,BR
175804,1699169760,1699173360,3600,14824,169434,NL,NL
162403,1700572140,1700581620,9480,146840,20326,IT,IT
187190,1699715700,1699731840,16140,32794,27752,US,US
198742,1699237080,1699247400,10320,173080,95641,IT,IT
191623,1699545840,1699580940,35100,23152,35633,TR,TR
176051,1699102200,1699114080,11880,128857,160470,IT,IT
184754,1700425800,1700460420,34620,157882,199100,TR,TR
136375,1699551000,1699606740,55740,60640,18174,BG,DE
129960,1700277840,1700292480,14640,23710,133033,FR,FR
182869,1699272540,1699276140,3600,106700,39593,GB,GB
84750,1699481220,1699495560,14340,134481,149031,HR,HR
58842,1698874800,1698884580,9780,66583,193448,IT,IT
74268,1699213260,1699233300,20040,92023,198750,FR,FR
106660,1700596920,1700629320,32400,126383,144869,TR,TR
49917,1700412840,1700419320,6480,34352,122418,GB,GB
123017,1700833860,1700847900,14040,1060,73543,CZ,CZ
54811,1699285500,1699316700,31200,57540,57562,TR,TR
128164,1700245860,1700275020,29160,193610,80292,TR,TR
199892,1700461080,1700493060,31980,126240,16445,TR,TR
162261,1700508660,1700512860,4200,154987,177590,NL,NL
190688,1700496060,1700527740,31680,83437,32530,TR,TR
105172,1699691220,1699722840,31620,12654,25480,TR,TR
114989,1700718840,1700734200,15360,142576,191747,FR,FR
195668,1700583360,1700592540,9180,124228,186938,IT,LU
6109,1699854300,1699858140,3840,87342,184471,NL,NL
199140,1700298300,1700314800,16500,103379,188060,US,US
159748,1699922400,1699956300,33900,144849,21032,TR,TR
101762,1698845280,1698859140,13860,54612,176144,PT,PT
157703,1700092980,1700123040,30060,43302,86945,TR,TR
3248,1700785620,1700820540,34920,84922,170612,TR,TR
167160,1699269120,1699273680,4560,199936,61066,GB,GB
97727,1699547160,1699579620,32460,16983,44170,MX,MX
93757,1700273700,1700285820,12120,24448,100402,US,US
182859,1699852860,1699856460,3600,12679,145444,GB,GB
192894,1699977420,1699998660,21240,21582,100160,SE,RO
179286,1700536500,1700565360,28860,82884,103677,TR,TR
153061,1700677800,1700710980,33180,144570,34402,TR,TR
75051,1698959520,1698971160,11640,137135,108077,US,US
61566,1699605780,1699637880,32100,28791,94306,TR,TR
136082,1698856200,1698871200,15000,37314,128358,FR,ES
25554,1699006860,1699019760,12900,22885,7264,IT,IT
180347,1700838240,1700847660,9420,31371,35743,IT,IT
145538,1700780760,1700791560,10800,71752,96739,PT,PT
54035,1699320420,1699355520,35100,164460,62476,TR,TR
85502,1700764740,1700794200,29460,73102,41436,TR,TR
105186,1698822780,1698850620,27840,82731,115365,DE,HU
111555,1700079480,1700108400,28920,16571,12584,TR,TR
35414,1699526760,1699559820,33060,149630,31892,TR,TR
110792,1699026660,1699058820,32160,89303,106962,TR,TR
63304,1699200000,1699215420,15420,17843,76406,US,CA
26282,1699892940,1699906980,14040,142007,135931,US,US
129841,1700842440,1700874960,32520,194896,81458,TR,TR
14018,1700719860,1700747520,27660,19708,68158,NO,DK
19110,1700265900,1700278080,12180,96267,7426,CA,US
138657,1700187540,1700203200,15660,63468,140216,US,US
14838,1700490720,1700504940,14220,126002,147878,IT,IT
193458,1699353420,1699382880,29460,137602,106626,TR,TR
91266,1700525880,1700555160,29280,38735,135238,TR,TR
102886,1700574840,1700608200,33360,26154,23102,TR,TR
158638,1699479720,1699513680,33960,119785,186409,TR,TR
126388,1699668960,1699701960,33000,135232,141812,TR,TR
189454,1698867360,1698876720,9360,174689,76913,IT,IT
100941,1700106480,1700119080,12600,169149,15498,IT,IT
159355,1700599440,1700611500,12060,24673,74055,US,US
168595,1698876120,1698903060,26940,186069,20346,HU,DE
135386,1699574700,1699598040,23340,133632,97460,BR,BR
154893,1700830140,1700860800,30660,152384,196731,TR,TR
185089,1700387580,1700394780,7200,10622,77075,IT,IT
108558,1699752120,1699763820,11700,91586,128224,US,US
170653,1700419740,1700425140,5400,42104,9982,NL,NL
43077,1698859260,1698890760,31500,66138,36257,TR,TR
194564,1700194740,1700203320,8580,118511,171786,HR,HR
175517,1700546160,1700581680,35520,156447,99849,TR,TR
8761,1699553280,1699570320,17040,112744,64875,US,US
16796,1700005200,1700033220,28020,47769,92708,HU,DE
197493,1699327080,1699339080,12000,52570,164943,US,US
184187,1700420220,1700429100,8880,151873,172416,IT,IT
161116,1700463480,1700474160,10680,143653,99457,CL,CL
148764,1699379520,1699415460,35940,47302,36254,TR,TR
67309,1699152120,1699184280,32160,150559,155578,TR,TR
56465,1699096740,1699107540,10800,112786,13812,IT,IT
18738,1699125480,1699138440,12960,36930,68301,HR,HR
60101,1699249680,1699258260,8580,123861,3545,EE,FI
148460,1699705920,1699738140,32220,119372,54035,TR,TR
173810,1699474440,1699485480,11040,50081,147415,IT,IT
197472,1700252400,1700257620,5220,119232,163835,EE,EE
72582,1700162040,1700165760,3720,3408,30787,GB,GB
61815,1699603020,1699636200,33180,147825,173487,TR,TR
66171,1699456980,1699461540,4560,32558,111997,EE,EE
118102,1700376120,1700408040,31920,135731,53695,TR,TR
106832,1700330880,1700343660,12780,12777,169481,CZ,CZ
78609,1700399220,1700417160,17940,163239,106955,US,MX
71161,1698828900,1698856200,27300,33172,86648,PL,SK
28163,1699468860,1699494120,25260,67320,124434,PL,SI
93662,1699945920,1699949520,3600,107753,185692,NL,NL
198746,1700663820,1700667420,3600,14015,136457,NL,NL
11891,1699680000,1699713840,33840,139526,35029,TR,TR
140675,1699238340,1699244520,6180,181406,157493,NL,NL
72175,1699389300,1699399920,10620,13718,27958,ES,ES
72527,1700032860,1700057880,25020,22974,1083,DE,HR
71423,1700426760,1700437680,10920,167115,184391,US,US
126981,1700154240,1700165520,11280,157225,188994,HR,HR
96142,1698872820,1698904560,31740,123165,151991,TR,TR
188009,1699208640,1699223760,15120,159479,198677,FR,CH
190626,1700067780,1700081040,13260,54952,113989,US,US
157654,1698935040,1698942600,7560,174490,124440,IT,IT
107529,1700585880,1700589480,3600,169679,40289,GB,GB
149054,1699231500,1699266540,35040,33252,141003,TR,TR
2350,1699206240,1699240800,34560,174773,107551,TR,TR
41873,1700825340,1700828940,3600,8098,80701,GB,GB
124163,1698985200,1698999360,14160,80480,128206,IT,IT
70031,1699059540,1699071360,11820,87814,154781,IT,NL
152888,1700183220,1700194680,11460,128150,148206,US,US
163265,1698855780,1698884940,29160,93355,110624,TR,TR
129422,1699228500,1699242720,14220,106760,18645,US,US
30131,1700338020,1700354880,16860,45340,128755,AT,CZ
170442,1699709100,1699741800,32700,95196,81640,TR,TR
119712,1699739700,1699743300,3600,39194,198114,GB,GB
189445,1700129640,1700162400,32760,101674,115064,TR,TR
182026,1700037120,1700048880,11760,87612,164437,CZ,HU
43675,1699609560,1699640460,30900,129178,196345,TR,TR
146105,1699615680,1699650240,34560,56454,88499,TR,TR
113811,1700805000,1700841720,36720,127129,129084,MX,MX
66709,1700678640,1700706000,27360,60038,156105,DE,DE
72233,1700827380,1700844300,16920,199414,140655,US,US
197990,1699189260,1699198560,9300,135389,109811,HR,FR
18857,1698985260,1699008540,23280,56284,117288,PL,NL
30375,1699857060,1699890000,32940,167158,174924,TR,TR
105866,1700444280,1700471100,26820,179615,162912,NO,SE
36312,1700763660,1700774400,10740,189466,133375,HR,IT
189577,1699743180,1699748160,4980,197262,37142,GB,GB
195389,1700850780,1700883060,32280,162483,110344,TR,TR
180236,1699793280,1699828200,34920,11627,121648,TR,TR
114474,1700689800,1700702160,12360,190804,159129,IT,IT
164426,1698890520,1698903300,12780,180413,142142,IT,IT
57230,1699370520,1699384920,14400,139303,196399,US,US
71600,1699968900,1700001540,32640,145520,196910,TR,TR
4817,1699781640,1699806600,24960,48558,192669,HU,CZ
114715,1700297820,1700332380,34560,174102,5426,TR,TR
48465,1700151780,1700176800,25020,129370,108404,DE,DE
41688,1699846860,1699868820,21960,174996,33932,PL,UA
21441,1700415240,1700422740,7500,448,93401,IT,IT
75728,1699519560,1699530240,10680,73932,50656,HR,HR
7555,1699390860,1699425540,34680,58389,9099,TR,TR
108128,1699607520,1699619580,12060,106950,43788,US,US
103155,1699999380,1700031000,31620,8775,179779,TR,TR
137674,1700824140,1700830440,6300,2888,143385,GB,GB
124089,1700233680,1700268300,34620,119956,139769,MX,MX
103747,1699879080,1699888980,9900,22956,15319,IT,CH
108852,1699091460,1699095060,3600,82965,175588,GB,GB
108482,1700737920,1700771400,33480,110289,107977,TR,TR
119908,1700422560,1700450160,27600,43397,131915,PL,PL
37614,1700404080,1700435700,31620,100442,117174,TR,TR
176383,1698884400,1698916200,31800,80840,21893,TR,TR
8345,1699520640,1699526880,6240,163863,134282,GB,GB
193170,1700315040,1700329920,14880,169282,74249,AT,AT
24888,1698930660,1698945720,15060,40373,35698,SE,SE
125772,1699407480,1699431360,23880,74185,123518,DE,BG
172704,1698859080,1698910620,51540,78367,131996,BG,DE
149291,1699698600,1699733700,35100,28307,36749,TR,TR
78683,1699696980,1699708560,11580,147670,114703,US,US
87998,1700075520,1700082060,6540,176382,194147,NL,NL
192488,1698958920,1698992640,33720,147145,162023,TR,TR
15674,1699288380,1699296720,8340,193682,129369,ES,ES
66494,1700223960,1700257920,33960,677,86402,TR,TR
33418,1700665200,1700679180,13980,166271,110929,CZ,CZ
70059,1700853960,1700866920,12960,199016,121003,IT,IT
38231,1700687280,1700721600,34320,132123,123342,TR,TR
30599,1699418100,1699422120,4020,74548,155500,GB,GB
62153,1698873780,1698903540,29760,74173,149917,TR,TR
195867,1700446140,1700479440,33300,78753,162573,TR,TR
169684,1699276620,1699302480,25860,74251,10195,DE,FR
187304,1700534400,1700538000,3600,98304,61048,GB,GB
152598,1698960960,1698966600,5640,150021,61283,NL,NL
116619,1700507280,1700541180,33900,22531,97226,MX,MX
184826,1699680960,1699687260,6300,23103,154252,NL,NL
66855,1700152380,1700183700,31320,115347,91318,TR,TR
63557,1699852200,1699855800,3600,163129,158460,GB,GB
78249,1699543200,1699549320,6120,151906,62720,GB,GB
97324,1699625580,1699658940,33360,133407,197011,TR,TR
167750,1700550420,1700602800,52380,24182,178091,BG,DE
193226,1700322420,1700351340,28920,126005,14324,TR,TR
39109,1699463700,1699477440,13740,55125,144261,US,US
17572,1700320740,1700350500,29760,97366,180829,TR,TR
173177,1699824180,1699859400,35220,12448,152652,TR,TR
84171,1700341680,1700373300,31620,73079,20943,TR,TR
106210,1700548920,1700552520,3600,72041,113434,GB,GB
130542,1698856140,1698873780,17640,50717,153762,CA,CA
63737,1699889400,1699900680,11280,140740,184819,PT,PT
145098,1698823680,1698857220,33540,128170,117926,TR,TR
36548,1700072580,1700076180,3600,116975,45918,NL,NL
58681,1699243500,1699254960,11460,145404,49678,AT,AT
125485,1699626660,1699660620,33960,183662,181448,TR,TR
38560,1700234460,1700261340,26880,123536,109597,PL,NL
4857,1700484000,1700542800,58800,19367,128563,UA,DE
149008,1699029060,1699040820,11760,116878,20438,AT,AT
16046,1700854560,1700888880,34320,181004,126813,TR,TR
181714,1700367300,1700398620,31320,45079,169807,TR,TR
186575,1699426500,1699438980,12480,74722,88628,US,US
154703,1700701740,1700726340,24600,181498,57307,PL,DE
27460,1700189100,1700218440,29340,11571,11725,TR,TR
32264,1700448420,1700478840,30420,36741,92234,MK,AL
62926,1700628840,1700636460,7620,144658,42666,IT,IT
176858,1699830060,1699859940,29880,180844,159126,TR,TR
147949,1700764500,1700794020,29520,176795,106108,TR,TR
146684,1700456760,1700460660,3900,56745,129367,GB,GB
72610,1700264640,1700278140,13500,56400,91949,US,US
42367,1700086320,1700119680,33360,63979,149645,TR,TR
104898,1699880700,1699910580,29880,197097,43351,TR,TR
8079,1700802180,1700821080,18900,14079,106518,FR,HR
159768,1699888200,1699909020,20820,152563,114599,FR,FR
84428,1699078560,1699113900,35340,94786,198398,TR,TR
146621,1700616240,1700650020,33780,8791,188180,MX,US
63753,1699513020,1699535820,22800,166170,81584,PL,AT
84261,1700408880,1700418360,9480,52176,107500,ES,FR
105575,1700676480,1700681340,4860,173078,73062,NL,NL
2829,1700662860,1700697720,34860,9707,178997,TR,TR
180569,1699811520,1699815120,3600,49560,84881,NL,NL
107606,1700734020,1700769120,35100,43980,193811,TR,TR
120659,1700063640,1700075460,11820,41349,169225,AT,HU
178278,1700171640,1700201700,30060,44638,155121,TR,TR
44949,1699467660,1699477860,10200,139417,1522,PT,PT
138343,1699761900,1699793220,31320,110426,117546,TR,TR
53211,1699956300,1699981320,25020,792,58357,RO,RO
178730,1700483580,1700512020,28440,76750,19780,DE,PL
75340,1700344860,1700380500,35640,176100,48484,TR,TR
161390,1700367060,1700399100,32040,1041,155452,TR,TR
176312,1698952680,1698987120,34440,4804,118669,TR,TR
88152,1700660760,1700685360,24600,70610,9229,BR,BR
196178,1700558940,1700584440,25500,53671,150350,BA,ME
9156,1699688880,1699705080,16200,114257,72876,US,US
85929,1700572380,1700579760,7380,176649,98946,IT,IT
36359,1699319520,1699332660,13140,192029,155954,IT,IT
147540,1700487660,1700491260,3600,160685,136610,NL,NL
113325,1699466520,1699470120,3600,74184,24562,GB,GB
163176,1699335540,1699340580,5040,149777,197249,GB,GB
4272,1700446680,1700481840,35160,148507,18619,TR,TR
141219,1698994560,1699007460,12900,181349,161230,RS,RS
59523,1699969140,1699979640,10500,31586,161864,EE,EE
155365,1699336380,1699339980,3600,13431,57070,GB,GB
193765,1699379220,1699411800,32580,17138,92016,MX,MX
75838,1700400900,1700404500,3600,36114,22727,GB,GB
119733,1700403780,1700436000,32220,122369,150937,TR,TR
16587,1699032180,1699064040,31860,163705,102610,TR,TR
16425,1700671860,1700675460,3600,29042,133302,NL,NL
193438,1699253880,1699289820,35940,185202,3403,TR,TR
29575,1700250540,1700263500,12960,161946,69196,US,US
13837,1698989940,1698993540,3600,92282,43388,GB,GB
89332,1699052460,1699081860,29400,112742,17072,TR,TR
127766,1700341380,1700369820,28440,132508,37591,PL,PL
52401,1700074560,1700096580,22020,193010,58790,RO,RO
10335,1699163220,1699166820,3600,20300,48460,GB,GB
75085,1700786280,1700810280,24000,58274,166808,DE,RS
176200,1699497480,1699555680,58200,8418,112652,UA,PL
92751,1699213500,1699242840,29340,114157,137207,TR,TR
133133,1700138700,1700165760,27060,185558,189430,DE,DE
106704,1699338060,1699371360,33300,173873,165159,TR,TR
40150,1699852620,1699864980,12360,157342,14368,ES,BE
21654,1700231160,1700266200,35040,59001,90501,MX,US
108488,1699435020,1699444800,9780,165048,56767,IT,IT
63670,1699108080,1699143300,35220,67105,157500,TR,TR
91402,1699196760,1699213860,17100,63024,150973,AT,SK
161631,1699549140,1699562940,13800,189939,39067,RS,DE
175060,1700256720,1700286060,29340,20138,33267,TR,TR
196788,1699340280,1699368000,27720,129872,4139,PL,PL
57008,1699815180,1699830600,15420,177983,137306,AT,AT
69521,1698909360,1698943440,34080,68149,159871,TR,TR
177760,1699680960,1699690320,9360,144346,97458,ES,ES
25077,1699253820,1699269240,15420,199938,104767,US,US
192449,1700857740,1700870880,13140,106181,81518,US,US
37099,1698895380,1698907500,12120,176977,137834,RS,RS
11517,1699548060,1699563240,15180,630,176551,AT,AT
95264,1700762040,1700774520,12480,15764,108517,AT,AT
197907,1698925320,1698960900,35580,6683,40910,TR,TR
86596,1700012580,1700022420,9840,111849,96154,IT,IT
192910,1699679880,1699687560,7680,175686,34363,IT,IT
36726,1700037300,1700055120,17820,93097,3306,FR,PL
193298,1700058960,1700063460,4500,126902,162186,GB,GB
100334,1700071320,1700103180,31860,85621,192401,TR,TR
8892,1699499820,1699529280,29460,112448,25071,TR,TR
70907,1700515740,1700536020,20280,182886,100785,FR,FR
173733,1698913140,1698933960,20820,39139,78323,FR,BE
179835,1700457300,1700469360,12060,28326,104928,US,US
1618,1699510560,1699514460,3900,106047,137225,GB,GB
173194,1700060100,1700077860,17760,160017,4965,BE,NL
56496,1700480340,1700500500,20160,30835,135039,AL,MK
104122,1699891980,1699895580,3600,190681,153007,GB,GB
114480,1699930200,1699965360,35160,20001,169701,TR,TR
166306,1700411880,1700441460,29580,159179,87169,TR,TR
61200,1700766540,1700799360,32820,96325,9123,TR,TR
88904,1699977720,1699984020,6300,185217,74663,GB,GB
101802,1700127420,1700140560,13140,104050,194195,IT,IT
80467,1699178940,1699207680,28740,78370,139448,PL,UA
16182,1700813160,1700825100,11940,145689,164509,US,US
105005,1700330520,1700334120,3600,126043,182290,GB,GB
10072,1700670540,1700675340,4800,35665,63933,GB,GB
46839,1700566020,1700591400,25380,15887,30537,BR,BR
184810,1700809080,1700812680,3600,56224,45577,NL,NL
107487,1699572660,1699578960,6300,31122,73645,NL,NL
177017,1700803740,1700834880,31140,75998,21681,TR,TR
5003,1700770320,1700778720,8400,84928,148024,ES,CH
195181,1699142640,1699160760,18120,39725,192125,FR,DE
121524,1700807400,1700838960,31560,58213,149996,BA,RS
56953,1699628100,1699662840,34740,145140,132632,TR,TR
1570,1700131800,1700167440,35640,147201,60406,TR,TR
37627,1699651500,1699663320,11820,105416,3875,US,US
174661,1700538720,1700569320,30600,132396,174295,TR,TR
3704,1700034240,1700065800,31560,119873,142332,TR,TR
63709,1700253600,1700279940,26340,82032,19530,DE,CZ
73398,1700190720,1700225940,35220,109243,40320,TR,TR
33448,1700210400,1700221260,10860,175683,117962,IT,IT
145373,1700443080,1700472240,29160,166075,72653,TR,TR
165567,1699192980,1699222500,29520,152024,15944,TR,TR
72168,1700251440,1700255040,3600,76459,143079,GB,GB
51114,1698841980,1698845700,3720,48417,52871,GB,GB
180559,1699685580,1699709220,23640,73148,116664,DE,DE
122695,1699708140,1699714140,6000,15811,32453,GB,GB
160381,1700468520,1700483580,15060,198112,53591,US,US
198085,1699900680,1699910880,10200,45701,89678,FI,EE
28093,1698821760,1698833280,11520,61461,160336,PT,PT
166160,1699203420,1699211160,7740,36888,187817,IT,IT
154188,1699686660,1699690260,3600,159650,187841,GB,GB
71339,1700547120,1700577000,29880,181402,112989,TR,TR
125203,1700228700,1700244420,15720,143543,61214,BE,NL
24304,1700207940,1700215560,7620,129031,49159,IT,IT
144451,1699195860,1699229460,33600,121212,196665,TR,TR
50582,1699706160,1699740540,34380,148219,196891,TR,TR
76106,1699226280,1699258500,32220,184703,158450,TR,TR
181525,1700684820,1700714580,29760,155502,135023,TR,TR
173460,1699854420,1699888620,34200,34615,19069,TR,TR
157319,1699973940,1700003520,29580,31656,39892,TR,TR
35911,1700459640,1700495580,35940,48249,168195,TR,TR
69124,1699616400,1699647540,31140,137880,185240,TR,TR
157342,1700805600,1700822580,16980,118086,145004,SE,SE
7404,1700757120,1700766720,9600,94789,153998,IT,IT
152099,1699117380,1699152540,35160,199161,164431,TR,TR
35708,1700548980,1700560980,12000,198421,87161,IT,IT
146180,1700113860,1700120100,6240,68933,140559,NL,NL
78171,1700393580,1700427000,33420,132069,108734,TR,TR
187442,1698807000,1698829140,22140,94950,180269,DE,DE
102724,1700158860,1700190360,31500,137148,92272,TR,TR
119946,1699394220,1699400280,6060,9361,81475,NL,NL
39238,1700339460,1700351100,11640,112225,10539,US,US
56684,1700068440,1700099220,30780,29432,150612,TR,TR
199804,1700542860,1700567100,24240,71010,126463,DE,CH
14398,1700128920,1700161500,32580,3235,2485,TR,TR
186282,1700450700,1700479620,28920,32529,68829,TR,TR
131222,1700008620,1700043720,35100,146386,190833,TR,TR
20027,1700588160,1700623620,35460,199324,34983,TR,TR
157917,1699379640,1699397520,17880,142042,38559,BE,FR
41732,1700788860,1700792460,3600,7087,64076,GB,GB
137973,1700256300,1700291280,34980,17155,128923,TR,TR
86397,1698821340,1698857100,35760,185245,15626,TR,TR
186673,1700769660,1700773260,3600,126112,41870,GB,GB
111206,1699884120,1699889340,5220,4371,137072,NL,NL
134572,1698960540,1698971460,10920,88140,84082,US,US
42324,1700632140,1700654820,22680,137612,109263,PL,PL
2549,1699075200,1699090080,14880,116902,52305,US,US
5028,1700010540,1700044260,33720,190593,149479,TR,TR
192333,1700402820,1700410440,7620,175310,46630,IT,IT
165359,1699148580,1699178820,30240,142819,1228,TR,TR
133134,1700364060,1700396640,32580,153940,88829,TR,TR
172107,1700804820,1700833680,28860,63504,113640,TR,TR
10875,1699717320,1699722600,5280,110819,165563,GB,GB
27882,1700272440,1700307060,34620,89842,55471,TR,TR
23391,1698817980,1698829320,11340,5978,160950,US,US
11486,1699348500,1699382220,33720,45498,125097,TR,TR
106130,1699665780,1699700940,35160,164079,108275,TR,TR
156546,1700267940,1700279040,11100,155235,87952,US,US
138581,1699719900,1699732080,12180,198051,35355,IT,IT
77746,1698945180,1698952800,7620,99104,172447,ES,ES
89394,1699270260,1699300980,30720,135618,136274,TR,TR
13594,1699189560,1699200360,10800,52772,198658,PT,ES
111802,1699878060,1699887300,9240,67561,79688,HR,CZ
184979,1699865580,1699874280,8700,55749,2587,HR,HR
54951,1699028400,1699044000,15600,141863,67341,SE,SE
689,1700537580,1700569440,31860,38632,95299,TR,TR
172077,1699292100,1699330620,38520,35470,8418,MX,MX
164200,1700286600,1700294760,8160,171988,31853,IT,ES
24719,1699349340,1699383600,34260,119433,21329,TR,TR
107369,1699984380,1700018100,33720,47738,22769,TR,TR
20767,1699400820,1699426860,26040,105766,23123,DE,IT
134036,1700632020,1700635620,3600,74192,175408,GB,GB
137725,1700022120,1700044320,22200,113987,28393,PL,DE
136435,1699811520,1699819080,7560,173242,70955,IT,IT
186811,1700548980,1700555760,6780,27458,59008,GB,GB
45287,1699007700,1699037700,30000,159286,165279,TR,TR
40897,1700516880,1700545080,28200,118275,87805,DE,PL
122762,1700495160,1700498760,3600,101149,35290,GB,GB
138410,1699027740,1699088400,60660,363,77345,UA,HU
127189,1700494080,1700516040,21960,50756,32505,DE,SE
76717,1699659840,1699663620,3780,55924,20127,GB,GB
8853,1699835760,1699842180,6420,166411,30708,GB,GB
116705,1699159980,1699194600,34620,48779,158412,TR,TR
61254,1699577220,1699595280,18060,23285,134403,SE,SE
176953,1699413600,1699467240,53640,41576,135418,BG,DE
125403,1700479800,1700493780,13980,47487,74353,PT,PT
103236,1700465820,1700488140,22320,96538,17273,ME,RS
114200,1699345620,1699380480,34860,116929,178868,TR,TR
164816,1699189860,1699199340,9480,47488,36142,PT,PT
199420,1699823160,1699838220,15060,162728,156812,US,US
93318,1700540700,1700569500,28800,49690,165812,TR,TR
157900,1700121000,1700127660,6660,48724,5482,FI,EE
149551,1700752260,1700763540,11280,6128,103812,IT,IT
186920,1699022040,1699026660,4620,113559,156074,GB,GB
132366,1700292960,1700310540,17580,11928,39579,AT,BG
101996,1699549800,1699583520,33720,131628,111584,TR,TR
158021,1700146380,1700178000,31620,12084,93360,TR,TR
70916,1699294560,1699306320,11760,178309,177950,IT,IT
2667,1700199060,1700216760,17700,17378,183390,US,US
93445,1699683240,1699686840,3600,103974,2374,NL,NL
125072,1699951320,1699968120,16800,150471,60668,US,US
74880,1699828200,1699841760,13560,180922,150589,AT,CZ
74664,1699954020,1699957620,3600,16214,4812,NL,NL
122319,1699150500,1699160520,10020,152846,79058,IT,IT
171921,1699171860,1699182060,10200,195569,133514,IT,IT
103146,1698838680,1698850260,11580,8373,132667,US,US
143955,1699864260,1699879140,14880,182313,115512,US,MX
45361,1699211100,1699214700,3600,173694,31860,GB,GB
118931,1700490780,1700494860,4080,38415,130837,NL,IT
164754,1699198740,1699233540,34800,199374,55025,TR,BG
141058,1699778520,1699793280,14760,59017,75939,US,MX
78988,1700659560,1700665800,6240,159091,15863,GB,GB
88767,1699689060,1699703460,14400,13293,169274,RS,SI
86070,1700796900,1700811360,14460,83164,379,US,US
139818,1700131560,1700143080,11520,23045,42793,RS,RS
184873,1700304960,1700340900,35940,77861,77072,TR,TR
73526,1699168860,1699181940,13080,148791,78223,IT,IT
170575,1700829420,1700836980,7560,75466,72678,IT,IT
176539,1699482960,1699513080,30120,166197,182291,TR,TR
52166,1699276620,1699306440,29820,25646,76633,TR,TR
72352,1699679580,1699692300,12720,153965,124247,IT,IT
145375,1700276940,1700286720,9780,185415,158759,ES,ES
73528,1700476140,1700505240,29100,59596,57178,TR,TR
188350,1698941400,1698965760,24360,133572,72355,DE,DE
38665,1700623980,1700658180,34200,10287,75942,TR,TR
132686,1700562120,1700569680,7560,64217,151107,PT,PT
145064,1698873540,1698885960,12420,125033,50199,PT,PT
75390,1699274160,1699313220,39060,64078,50562,MX,MX
142164,1700665260,1700697060,31800,105090,68119,TR,TR
81982,1699434600,1699438200,3600,180248,190822,NL,NL
140088,1700503380,1700520660,17280,154537,16674,US,US
36331,1700495280,1700532180,36900,194936,41246,MX,MX
74405,1700453640,1700462760,9120,158260,37650,IT,IT
185918,1700570880,1700604780,33900,28391,156746,TR,TR
170680,1700358360,1700361960,3600,142046,124673,GB,GB
26761,1699860240,1699877400,17160,105360,40697,US,US
185029,1700261460,1700294940,33480,109831,37683,TR,TR
154319,1700618100,1700621700,3600,137733,117761,GB,GB
162162,1699973340,1699988640,15300,197752,34494,CZ,DE
60469,1699926780,1699949940,23160,199924,55598,PL,PL
104606,1699999800,1700034900,35100,113442,30581,TR,TR
162402,1699645260,1699673460,28200,142182,83578,DE,PL
38263,1700183160,1700195040,11880,179301,63926,RS,DE
167322,1700342460,1700373780,31320,145956,191063,TR,TR
113053,1699081980,1699107420,25440,129628,6247,DE,DE
126989,1698869040,1698882180,13140,189076,74047,IT,IT
47584,1700139960,1700174280,34320,28689,175860,TR,TR
81160,1699071300,1699093500,22200,22830,107784,DK,DE
52494,1699580640,1699604100,23460,45850,36021,DE,BA
181610,1700410680,1700424000,13320,56294,138880,US,US
110518,1700486640,1700504520,17880,89745,158608,US,US
176824,1700168640,1700203440,34800,105853,194058,TR,TR
119549,1700633400,1700668620,35220,81322,182535,MX,MX
77745,1700193300,1700206380,13080,153595,60275,CZ,CZ
89560,1700001180,1700034000,32820,187395,37073,TR,TR
82024,1700816520,1700824200,7680,56411,15476,PT,PT
167403,1699723620,1699758240,34620,87699,106853,TR,TR
151987,1700646240,1700678100,31860,98319,26900,TR,TR
28826,1699228140,1699241940,13800,46913,67388,HR,HR
42134,1700423820,1700430720,6900,10474,96676,GB,GB
188073,1699774680,1699786380,11700,42654,138587,HR,HR
40512,1700671020,1700697000,25980,20890,28220,BA,DE
110441,1700387280,1700410920,23640,28048,92382,DE,PL
47331,1700787180,1700801340,14160,136649,24656,US,US
183927,1698796620,1698830520,33900,145872,92965,TR,TR
72051,1699843920,1699878060,34140,148463,174903,TR,TR
82418,1700346900,1700381220,34320,92611,174930,TR,TR
121010,1700265240,1700284260,19020,121560,61620,FR,FR
107193,1699760880,1699778100,17220,108738,157163,US,US
181290,1700071560,1700103960,32400,6634,882,TR,TR
190902,1699148040,1699159500,11460,86121,146108,US,US
67350,1698822420,1698856920,34500,131729,157389,TR,TR
76177,1700796900,1700825520,28620,54764,36594,RO,RO
41104,1699505220,1699542480,37260,76624,47624,MX,MX
193909,1699418280,1699433100,14820,133795,33883,US,US
101376,1699272420,1699305300,32880,8885,77033,TR,TR
101000,1699931220,1699946880,15660,5077,113939,FR,FR
156387,1699823040,1699857300,34260,169590,18918,TR,TR
47454,1700297880,1700332380,34500,117520,16031,TR,TR
93570,1698851640,1698864240,12600,37658,195210,IT,IT
76629,1699683660,1699698240,14580,142314,135487,US,US
